APMC,Commodity,Year,min_price,max_price,absolute_fluctuation,relative_fluctuation
Mumbai,RICE(PADDY-HUS),2016,4562,9381,4819,105.63349408154318
Sangali,RICE(PADDY-HUS),2016,2164,5586,3422,158.13308687615526
Solapur,RICE(PADDY-HUS),2016,2265,5300,3035,133.99558498896246
Karjat (Raigad),RICE(PADDY-HUS),2016,2000,5022,3022,151.1
Kolhapur-Laxmipuri,RICE(PADDY-HUS),2016,2100,4910,2810,133.8095238095238
Lasalgaon,SUNFLOWER,2016,3201,5851,2650,82.78662917838176
Pen,RICE(PADDY-HUS),2016,3550,6053,2503,70.50704225352112
Akola,RICE(PADDY-HUS),2016,3110,5453,2343,75.33762057877813
Vasai,RICE(PADDY-HUS),2016,2098,4359,2261,107.76930409914203
Umared,RICE(PADDY-HUS),2016,2000,4013,2013,100.65
Ulhasnagar,RICE(PADDY-HUS),2016,3459,5313,1854,53.59930615784909
Mangaon(Bhadav),RICE(PADDY-HUS),2016,1813,3627,1814,100.05515719801434
Mahagaon,PIGEON PEA (TUR),2016,5300,7000,1700,32.075471698113205
Kolhapur-Laxmipuri,SORGUM(JAWAR),2016,2372,4044,1672,70.48903878583474
Buldhana,PIGEON PEA (TUR),2016,4333,5767,1434,33.094853450265404
Pune,RICE(PADDY-HUS),2016,3659,5062,1403,38.34380978409401
Akot,SESAMUM,2016,5000,6400,1400,28.0
Phaltan,SORGUM(JAWAR),2016,1638,2941,1303,79.54822954822954
Karmala,SUNFLOWER,2016,1827,3110,1283,70.22441160372195
Kolhapur-Laxmipuri,WHEAT(HUSKED),2016,2140,3418,1278,59.7196261682243
Indapur-Bhigwan,SORGUM(JAWAR),2016,1800,3034,1234,68.55555555555556
Barshi,SORGUM(JAWAR),2016,1790,3013,1223,68.32402234636872
Karmala,SORGUM(JAWAR),2016,1713,2913,1200,70.05253940455341
Mumbai,COCONUT,2016,800,2000,1200,150.0
Nandura,SESAMUM,2016,4784,5967,1183,24.72826086956522
Ulhasnagar,GR.NUT KERNELS,2016,7667,8833,1166,15.20803443328551
Pathardi,COTTON,2016,3875,5000,1125,29.032258064516128
Shirpur,SESAMUM,2016,4523,5630,1107,24.474906035816936
Jalna,SORGUM(JAWAR),2016,1763,2842,1079,61.20249574588769
Nandurbar,SUNFLOWER,2016,2838,3913,1075,37.878787878787875
Murud,RICE(PADDY-HUS),2016,2543,3543,1000,39.32363350373574
Ahmedpur,PIGEON PEA (TUR),2016,4336,5321,985,22.71678966789668
Kurdwadi-Modnimb,SORGUM(JAWAR),2016,1661,2630,969,58.33835039133052
Nira-Saswad,SORGUM(JAWAR),2016,1736,2691,955,55.01152073732719
Ulhasnagar,WHEAT(HUSKED),2016,2000,2953,953,47.65
Mohol,SORGUM(JAWAR),2016,1650,2602,952,57.696969696969695
Mumbai,SPLIT BLACK GRAM,2016,9228,10176,948,10.273081924577372
Latur,WHEAT(HUSKED),2016,1699,2631,932,54.85579752795762
Sangali,SORGUM(JAWAR),2016,1943,2873,930,47.864127637673704
Baramati,SORGUM(JAWAR),2016,1675,2605,930,55.52238805970149
Sangali,WHEAT(HUSKED),2016,1940,2869,929,47.88659793814433
Kada,WHEAT(HUSKED),2016,1711,2635,924,54.003506721215665
Amarawati,SESAMUM,2016,6319,7238,919,14.543440417787625
Alibag,RICE(PADDY-HUS),2016,3324,4239,915,27.52707581227437
Palghar(Bevur),RICE(PADDY-HUS),2016,2569,3473,904,35.188789412222654
Kada (Ashti),SORGUM(JAWAR),2016,1825,2725,900,49.31506849315068
Kada,SORGUM(JAWAR),2016,1930,2820,890,46.1139896373057
Ahmedpur,SESAMUM,2016,4043,4929,886,21.914419985159537
Mangrulpeer,PIGEON PEA (TUR),2016,4951,5835,884,17.854978792163198
Ambad(Vadi Godri),WHEAT(HUSKED),2016,1670,2544,874,52.33532934131737
Phaltan,BAJRI,2016,1340,2205,865,64.55223880597015
Hingoli,PIGEON PEA (TUR),2016,5215,6066,851,16.3183125599233
Latur,PIGEON PEA (TUR),2016,5098,5944,846,16.594743036484896
Indapur,WHEAT(HUSKED),2016,1711,2551,840,49.09409701928697
Kolhapur-Laxmipuri,SPLIT BLACK GRAM,2016,11367,12200,833,7.328230843670274
Kalamb (Os),NIGER-SEED,2016,2100,2931,831,39.57142857142857
Gangakhed,COTTON,2016,4160,4989,829,19.927884615384617
Nira-Saswad,RICE(PADDY-HUS),2016,2700,3525,825,30.555555555555557
Indapur-Bhigwan,BAJRI,2016,1371,2191,820,59.81035740335521
Akola,WHEAT(HUSKED),2016,2057,2861,804,39.08604764219737
Phaltan,WHEAT(HUSKED),2016,1500,2296,796,53.06666666666667
Bhivandi,RICE(PADDY-HUS),2016,2092,2877,785,37.523900573613766
Pathardi,WHEAT(HUSKED),2016,1620,2400,780,48.148148148148145
Dound,BAJRI,2016,1237,2012,775,62.65157639450283
Jamkhed,SORGUM(JAWAR),2016,2025,2800,775,38.27160493827161
Indapur-Bhigwan,WHEAT(HUSKED),2016,1700,2456,756,44.470588235294116
Shirala,PADDY-UNHUSKED,2016,1500,2250,750,50.0
Amarawati,SUNFLOWER,2016,4870,5609,739,15.174537987679672
Malkapur,PIGEON PEA (TUR),2016,5260,5998,738,14.03041825095057
Nagpur,PIGEON PEA (TUR),2016,4733,5467,734,15.508134375660259
Jalna,BAJRI,2016,1226,1959,733,59.78792822185971
Gevrai,WHEAT(HUSKED),2016,1654,2373,719,43.47037484885127
Umared,WHEAT(HUSKED),2016,1600,2313,713,44.5625
Osmanabad,SORGUM(JAWAR),2016,1851,2563,712,38.4656942193409
Akola,SESAMUM,2016,6000,6700,700,11.666666666666666
Baramati,SUNFLOWER,2016,2600,3300,700,26.923076923076923
Akole,WHEAT(HUSKED),2016,1500,2200,700,46.666666666666664
Kurdwadi,SORGUM(JAWAR),2016,2048,2747,699,34.130859375
Pune,GR.NUT KERNELS,2016,7516,8207,691,9.193720063863758
Nira-Saswad,WHEAT(HUSKED),2016,1650,2338,688,41.696969696969695
Ahmedpur,SORGUM(JAWAR),2016,1147,1832,685,59.72101133391456
Lasalgaon,BAJRI,2016,1293,1975,682,52.74555297757154
Hingoli-Kanegaon Naka,PIGEON PEA (TUR),2016,5240,5916,676,12.900763358778626
Hinganghat,PIGEON PEA (TUR),2016,5165,5841,676,13.08809293320426
Pusad,BAJRI,2016,1445,2120,675,46.71280276816609
Kille Dharur,WHEAT(HUSKED),2016,1850,2525,675,36.486486486486484
Lonand,SORGUM(JAWAR),2016,1650,2300,650,39.39393939393939
Indapur,BAJRI,2016,1151,1800,649,56.38575152041703
Indapur,SORGUM(JAWAR),2016,2011,2651,640,31.82496270512183
Ulhasnagar,SORGUM(JAWAR),2016,1739,2378,639,36.74525589419206
Daryapur,PIGEON PEA (TUR),2016,5190,5828,638,12.292870905587668
Khamgaon,PIGEON PEA (TUR),2016,5348,5983,635,11.8735976065819
Nira-Saswad,BAJRI,2016,1560,2195,635,40.705128205128204
Dhule,BAJRI,2016,1080,1706,626,57.96296296296296
Jalgaon Jamod-Aasalgaon,PIGEON PEA (TUR),2016,4825,5450,625,12.953367875647668
Sangrampur-Varvatbakal,PIGEON PEA (TUR),2016,4764,5386,622,13.056255247691016
Kalamb (Os),WHEAT(HUSKED),2016,2106,2716,610,28.96486229819563
Akola,PIGEON PEA (TUR),2016,5329,5937,608,11.40927003190092
Kolhapur-Laxmipuri,GR.NUT KERNELS,2016,8128,8732,604,7.431102362204724
Vasai,WHEAT(HUSKED),2016,1890,2493,603,31.904761904761905
Satana,WHEAT(HUSKED),2016,1673,2275,602,35.98326359832636
Kej,WHEAT(HUSKED),2016,1400,2001,601,42.92857142857143
Gevrai,SORGUM(JAWAR),2016,1902,2492,590,31.019978969505782
Ambad(Vadi Godri),BAJRI,2016,1165,1748,583,50.042918454935624
Solapur,WHEAT(HUSKED),2016,2226,2809,583,26.19047619047619
Karanja,PIGEON PEA (TUR),2016,5392,5973,581,10.775222551928783
Dudhani,BAJRI,2016,1250,1830,580,46.4
Sinner,WHEAT(HUSKED),2016,1781,2361,580,32.565974171813586
Lonar,SORGUM(JAWAR),2016,1701,2275,574,33.74485596707819
Risod,PIGEON PEA (TUR),2016,5526,6100,574,10.387260224393774
Lasalgaon,WHEAT(HUSKED),2016,1790,2361,571,31.899441340782122
Anajngaon Surji,WHEAT(HUSKED),2016,1550,2113,563,36.32258064516129
Akola,SORGUM(JAWAR),2016,1283,1843,560,43.64770070148091
Manmad,BAJRI,2016,1416,1975,559,39.4774011299435
Mehkar,PIGEON PEA (TUR),2016,5050,5601,551,10.910891089108912
Chopda,SUNFLOWER,2016,2401,2951,550,22.907122032486463
Anajngaon Surji,PIGEON PEA (TUR),2016,4920,5465,545,11.077235772357724
Ambad(Vadi Godri),SORGUM(JAWAR),2016,2009,2551,542,26.97859631657541
Shrigonda,WHEAT(HUSKED),2016,1558,2100,542,34.78818998716303
Dound,WHEAT(HUSKED),2016,1756,2298,542,30.865603644646924
Ausa,WHEAT(HUSKED),2016,2326,2867,541,23.258813413585553
Babhulgaon,PIGEON PEA (TUR),2016,5300,5838,538,10.150943396226415
Nandurbar,BAJRI,2016,1287,1821,534,41.49184149184149
Jamkhed,WHEAT(HUSKED),2016,1867,2400,533,28.548473486877345
Mumbai,SPILT GERRN GRAM,2016,6136,6668,532,8.670143415906129
Anajngaon Surji,SORGUM(JAWAR),2016,1088,1613,525,48.25367647058823
Lonand,WHEAT(HUSKED),2016,1663,2188,525,31.569452796151534
Shirpur,BAJRI,2016,1093,1614,521,47.66697163769442
Jalna,PIGEON PEA (TUR),2016,4878,5397,519,10.63960639606396
Dondaicha,WHEAT(HUSKED),2016,1689,2208,519,30.72824156305506
Baramati,BAJRI,2016,1581,2094,513,32.44781783681214
Murtizapur,PIGEON PEA (TUR),2016,5283,5795,512,9.691463183797085
Loha,PIGEON PEA (TUR),2016,5200,5711,511,9.826923076923077
Dhule,WHEAT(HUSKED),2016,1785,2296,511,28.627450980392158
Bhivandi,WHEAT(HUSKED),2016,1670,2180,510,30.538922155688624
Nandurbar,WHEAT(HUSKED),2016,1606,2114,508,31.63138231631382
Akole,PADDY-UNHUSKED,2016,1505,2013,508,33.754152823920265
Majalgaon,SORGUM(JAWAR),2016,1719,2223,504,29.319371727748692
Jalna-Badnapur,COTTON,2016,4524,5028,504,11.140583554376658
Chandur Bajar,PIGEON PEA (TUR),2016,5252,5756,504,9.596344249809597
Ausa,PIGEON PEA (TUR),2016,4500,5001,501,11.133333333333333
Amalner,SESAMUM,2016,4275,4775,500,11.695906432748538
Akole,BAJRI,2016,1450,1950,500,34.48275862068966
Ulhasnagar,BAJRI,2016,1585,2085,500,31.545741324921135
Vaijapur,PIGEON PEA (TUR),2016,4100,4600,500,12.195121951219512
Chalisgaon,BAJRI,2016,1176,1675,499,42.43197278911565
Nandura,PIGEON PEA (TUR),2016,5153,5649,496,9.625460896565107
Shrirampur,WHEAT(HUSKED),2016,1825,2318,493,27.013698630136986
Karmala,BAJRI,2016,1063,1556,493,46.37817497648165
Shirpur,WHEAT(HUSKED),2016,1743,2234,491,28.16982214572576
Akkolkot,PIGEON PEA (TUR),2016,5650,6140,490,8.672566371681416
Latur,SORGUM(JAWAR),2016,1658,2147,489,29.493365500603137
Kej,BAJRI,2016,1181,1669,488,41.32091447925487
Lasalgaon,SORGUM(JAWAR),2016,1386,1874,488,35.20923520923521
Malegaon,BAJRI,2016,1332,1817,485,36.411411411411414
Dhamangaon-Rly,PIGEON PEA (TUR),2016,5133,5616,483,9.409701928696668
Chikhali,WHEAT(HUSKED),2016,1517,1992,475,31.31179960448253
Nandurbar,SORGUM(JAWAR),2016,1213,1686,473,38.99422918384172
Raver,SORGUM(JAWAR),2016,1120,1591,471,42.05357142857143
Beed,SORGUM(JAWAR),2016,1938,2408,470,24.251805985552117
Shrirampur,SORGUM(JAWAR),2016,1653,2123,470,28.433151845130066
Nandgaon Khandeshwar,PIGEON PEA (TUR),2016,5230,5700,470,8.98661567877629
Kada,BAJRI,2016,1270,1735,465,36.61417322834646
Ahmednagar,SORGUM(JAWAR),2016,2030,2487,457,22.51231527093596
Sinner,SORGUM(JAWAR),2016,1371,1824,453,33.04157549234136
Satana,BAJRI,2016,1336,1788,452,33.83233532934132
Indapur-Bhigwan,SUNFLOWER,2016,2500,2950,450,18.0
Kada (Ashti),BAJRI,2016,1176,1626,450,38.265306122448976
Nampur,SUNFLOWER,2016,2900,3350,450,15.517241379310345
Amalner,SORGUM(JAWAR),2016,1645,2094,449,27.29483282674772
Pathardi,SORGUM(JAWAR),2016,1658,2106,448,27.020506634499398
Lasur Station,WHEAT(HUSKED),2016,1836,2282,446,24.29193899782135
Sangamner,WHEAT(HUSKED),2016,1730,2173,443,25.606936416184972
Chopda,SESAMUM,2016,5040,5480,440,8.73015873015873
Rahuri-Vambori,BAJRI,2016,1205,1644,439,36.43153526970954
Kolhapur-Laxmipuri,SPILT GERRN GRAM,2016,7000,7433,433,6.185714285714286
Gevrai,BAJRI,2016,1207,1639,432,35.791217895608945
Washim,WHEAT(HUSKED),2016,1925,2357,432,22.441558441558442
Sangamner,BAJRI,2016,1349,1776,427,31.653076352853965
Kannad,WHEAT(HUSKED),2016,1643,2070,427,25.98904443091905
Dondaicha,SORGUM(JAWAR),2016,1538,1964,426,27.698309492847855
Vadvani,SORGUM(JAWAR),2016,1625,2051,426,26.215384615384615
Chandur Bajar,WHEAT(HUSKED),2016,1700,2117,417,24.529411764705884
Chikhali,PIGEON PEA (TUR),2016,4617,5034,417,9.03183885640026
Malkapur,SORGUM(JAWAR),2016,1161,1578,417,35.917312661498705
Lasalgaon-Vinchur,SORGUM(JAWAR),2016,1200,1616,416,34.666666666666664
Malegaon,WHEAT(HUSKED),2016,1755,2170,415,23.646723646723647
Achalpur,PIGEON PEA (TUR),2016,5357,5771,414,7.728206085495613
Chalisgaon,WHEAT(HUSKED),2016,1440,1854,414,28.75
Paranda,SORGUM(JAWAR),2016,1800,2213,413,22.944444444444443
Pathari,MAIZE,2016,4200,4601,401,9.547619047619047
Atpadi,SORGUM(JAWAR),2016,2000,2400,400,20.0
Shrigonda,BAJRI,2016,1083,1483,400,36.93444136657433
Hadgaon-Tamsa,COTTON,2016,4600,5000,400,8.695652173913043
Buldhana-Dhad,SORGUM(JAWAR),2016,1200,1600,400,33.333333333333336
Yawal,WHEAT(HUSKED),2016,1400,1800,400,28.571428571428573
Dudhani,PIGEON PEA (TUR),2016,5506,5904,398,7.228478023973847
Karanja,SORGUM(JAWAR),2016,1391,1788,397,28.54061826024443
Udgir,PIGEON PEA (TUR),2016,6061,6456,395,6.517076390034648
Baramati,WHEAT(HUSKED),2016,1827,2221,394,21.565407772304322
Lasalgaon-Vinchur,WHEAT(HUSKED),2016,1735,2129,394,22.70893371757925
Lasur Station,SORGUM(JAWAR),2016,1965,2358,393,20.0
Akot,PIGEON PEA (TUR),2016,5176,5563,387,7.476816074188562
Dondaicha,BAJRI,2016,1179,1560,381,32.31552162849873
Washim,PIGEON PEA (TUR),2016,5550,5928,378,6.8108108108108105
Lasur Station,BAJRI,2016,1159,1530,371,32.01035375323555
Dound,SORGUM(JAWAR),2016,2237,2607,370,16.540008940545373
Kalamb (Os),SORGUM(JAWAR),2016,1599,1967,368,23.014383989993746
Nagpur,SORGUM(JAWAR),2016,1500,1867,367,24.466666666666665
Sinner,BAJRI,2016,1409,1772,363,25.762952448545068
Kalamb (Os),SESAMUM,2016,4659,5021,362,7.769907705516205
Pathardi,BAJRI,2016,1350,1712,362,26.814814814814813
Murtizapur,WHEAT(HUSKED),2016,1610,1970,360,22.36024844720497
Lonand,BAJRI,2016,1415,1775,360,25.441696113074205
Latur,BAJRI,2016,1250,1610,360,28.8
Ahmednagar,BAJRI,2016,1453,1810,357,24.5698554714384
Akot,SORGUM(JAWAR),2016,1213,1570,357,29.43116240725474
Mangalwedha,SORGUM(JAWAR),2016,2180,2537,357,16.376146788990827
Telhara,PIGEON PEA (TUR),2016,5125,5481,356,6.946341463414634
Kille Dharur,BAJRI,2016,1219,1574,355,29.122231337161608
Sengaon,PIGEON PEA (TUR),2016,5730,6085,355,6.195462478184991
Solapur,SORGUM(JAWAR),2016,2335,2687,352,15.074946466809422
Shrigonda,SORGUM(JAWAR),2016,1767,2117,350,19.807583474816074
Ambejogai,SORGUM(JAWAR),2016,1829,2179,350,19.136139967195188
Amarawati,SORGUM(JAWAR),2016,1771,2121,350,19.76284584980237
Buldhana,WHEAT(HUSKED),2016,1438,1788,350,24.339360222531294
Savner,PIGEON PEA (TUR),2016,4730,5073,343,7.251585623678647
Shrirampur,BAJRI,2016,1176,1516,340,28.91156462585034
Pathari,WHEAT(HUSKED),2016,1976,2312,336,17.004048582995953
Pune,WHEAT(HUSKED),2016,2497,2832,335,13.41609931918302
Jalgaon Jamod-Aasalgaon,WHEAT(HUSKED),2016,1500,1833,333,22.2
Lasalgaon-Niphad,WHEAT(HUSKED),2016,1842,2173,331,17.969598262757874
Jamner-Neri,COTTON,2016,4461,4789,328,7.3526115220802515
Morshi,PIGEON PEA (TUR),2016,5311,5638,327,6.15703257390322
Beed,WHEAT(HUSKED),2016,2103,2429,326,15.501664289110794
Jamner,COTTON,2016,4481,4807,326,7.275161794242357
Mantha,WHEAT(HUSKED),2016,1888,2213,325,17.213983050847457
Manora,PIGEON PEA (TUR),2016,5484,5809,325,5.9263311451495255
Sindi (Selu),WHEAT(HUSKED),2016,1461,1785,324,22.17659137577002
Vaijapur,BAJRI,2016,1406,1730,324,23.044096728307256
Amarawati,WHEAT(HUSKED),2016,1843,2159,316,17.145957677699403
Lonar,PIGEON PEA (TUR),2016,5317,5633,316,5.943201053225503
Barshi,WHEAT(HUSKED),2016,1901,2217,316,16.622830089426618
Nagpur,PADDY-UNHUSKED,2016,1508,1822,314,20.822281167108752
Umarga,MAIZE,2016,945,1258,313,33.12169312169312
Jalgaon,SORGUM(JAWAR),2016,1692,2005,313,18.498817966903072
Pusad,WHEAT(HUSKED),2016,1863,2176,313,16.800858829844337
Kalvan,MAIZE,2016,994,1306,312,31.388329979879277
Nampur,BAJRI,2016,1270,1582,312,24.566929133858267
Gangapur,WHEAT(HUSKED),2016,1778,2089,311,17.49156355455568
Nandurbar,MAIZE,2016,1228,1539,311,25.3257328990228
Shahada,WHEAT(HUSKED),2016,1738,2047,309,17.779056386651323
Karanja,WHEAT(HUSKED),2016,1781,2089,308,17.29365524985963
Vani,COTTON,2016,4620,4927,307,6.645021645021645
Loha,SORGUM(JAWAR),2016,1151,1456,305,26.498696785403997
Shirpur,SORGUM(JAWAR),2016,1468,1773,305,20.77656675749319
Kej,SORGUM(JAWAR),2016,1774,2079,305,17.192784667418263
Shahada,MAIZE,2016,1071,1373,302,28.197945845004668
Shirala,SORGUM(JAWAR),2016,1700,2000,300,17.647058823529413
Malkapur,COTTON,2016,4700,5000,300,6.382978723404255
Manora,WHEAT(HUSKED),2016,1500,1800,300,20.0
Balapur,SORGUM(JAWAR),2016,1275,1575,300,23.529411764705884
Darwha,COTTON,2016,4500,4800,300,6.666666666666667
Mahagaon,COTTON,2016,4665,4964,299,6.409431939978564
Devala,BAJRI,2016,1366,1665,299,21.888726207906295
Wardha,PIGEON PEA (TUR),2016,5114,5412,298,5.8271411810715685
Amarawati,BAJRI,2016,1821,2118,297,16.30971993410214
Nagpur,RICE(PADDY-HUS),2016,2667,2964,297,11.136107986501687
Nandura,SORGUM(JAWAR),2016,1147,1440,293,25.544899738448127
Chalisgaon,MAIZE,2016,941,1233,292,31.030818278427205
Kalvan,BAJRI,2016,1359,1650,291,21.41280353200883
Malkapur,WHEAT(HUSKED),2016,1834,2125,291,15.866957470010906
Barshi Takli,COTTON,2016,4605,4896,291,6.319218241042345
Parli-Vaijnath,SORGUM(JAWAR),2016,1427,1716,289,20.25227750525578
Lasalgaon-Vinchur,BAJRI,2016,1224,1513,289,23.61111111111111
Pune,BAJRI,2016,2126,2415,289,13.59360301034807
Nampur,WHEAT(HUSKED),2016,1500,1789,289,19.266666666666666
Jawala-Bajar,COTTON,2016,4656,4944,288,6.185567010309279
Hinganghat,COTTON,2016,4729,5015,286,6.047790230492705
Sangrampur-Varvatbakal,WHEAT(HUSKED),2016,1567,1853,286,18.251435864709638
Yeotmal,PIGEON PEA (TUR),2016,5280,5563,283,5.359848484848484
Vaijapur,WHEAT(HUSKED),2016,1785,2065,280,15.686274509803921
Pachora,BAJRI,2016,1074,1351,277,25.79143389199255
Pusad,SORGUM(JAWAR),2016,1350,1626,276,20.444444444444443
Beed,BAJRI,2016,1359,1635,276,20.309050772626932
Amalner,BAJRI,2016,1160,1435,275,23.70689655172414
Kopargaon,BAJRI,2016,1138,1412,274,24.077328646748683
Sakri,MAIZE,2016,871,1143,272,31.228473019517796
Tiwasa,COTTON,2016,4700,4971,271,5.76595744680851
Buldhana,SORGUM(JAWAR),2016,1200,1471,271,22.583333333333332
Bhandara,RICE(PADDY-HUS),2016,2790,3060,270,9.67741935483871
Umarga,BAJRI,2016,1087,1357,270,24.83900643974241
Sakri,WHEAT(HUSKED),2016,1467,1737,270,18.404907975460123
Raver,WHEAT(HUSKED),2016,1832,2102,270,14.737991266375547
Kopargaon,SORGUM(JAWAR),2016,1798,2067,269,14.961067853170189
Mangalwedha,WHEAT(UNHUSKED),2016,2890,3159,269,9.30795847750865
Kannad,BAJRI,2016,1333,1602,269,20.180045011252812
Nagpur,WHEAT(HUSKED),2016,2016,2285,269,13.343253968253968
Pune,SORGUM(JAWAR),2016,2804,3072,268,9.557774607703282
Yawal,SORGUM(JAWAR),2016,1080,1347,267,24.72222222222222
Ahmednagar,WHEAT(HUSKED),2016,1849,2116,267,14.440237966468361
Shrigonda,SUNFLOWER,2016,2933,3200,267,9.103307193999319
Nilanga,SORGUM(JAWAR),2016,1048,1314,266,25.38167938931298
Rahuri-Vambori,WHEAT(HUSKED),2016,1803,2068,265,14.697726012201885
Jalna,MAIZE,2016,1034,1298,264,25.53191489361702
Yeola,SORGUM(JAWAR),2016,1655,1917,262,15.830815709969789
Solapur,PIGEON PEA (TUR),2016,5437,5699,262,4.818833915762369
Partur,SORGUM(JAWAR),2016,1875,2137,262,13.973333333333333
Ambejogai,BAJRI,2016,1390,1651,261,18.776978417266186
Umarga,SUNFLOWER,2016,2620,2880,260,9.923664122137405
Lasur Station,MAIZE,2016,936,1194,258,27.564102564102566
Gevrai,COTTON,2016,4638,4895,257,5.541181543768866
Shahada,SORGUM(JAWAR),2016,1341,1596,255,19.01565995525727
Rajura,COTTON,2016,4594,4849,255,5.550718328254245
Wardha,COTTON,2016,4687,4941,254,5.41924471943674
Chandur Bajar,SORGUM(JAWAR),2016,1254,1508,254,20.25518341307815
Mul,PADDY-UNHUSKED,2016,1851,2104,253,13.668287412209617
Deulgaon Raja,COTTON,2016,4681,4933,252,5.3834650715659045
Pombhurni,PADDY-UNHUSKED,2016,1908,2160,252,13.20754716981132
Kada,PIGEON PEA (TUR),2016,4700,4950,250,5.319148936170213
Taloda,MAIZE,2016,1120,1370,250,22.321428571428573
Mahagaon,WHEAT(HUSKED),2016,1550,1800,250,16.129032258064516
Bhokar,PIGEON PEA (TUR),2016,5808,6058,250,4.304407713498622
Ambad(Vadi Godri),MAIZE,2016,969,1219,250,25.799793601651185
Partur,WHEAT(HUSKED),2016,1871,2120,249,13.308391234633886
Khamgaon,SORGUM(JAWAR),2016,1186,1431,245,20.657672849915684
Katol,PIGEON PEA (TUR),2016,4643,4887,244,5.255222916217963
Yawal,MAIZE,2016,960,1201,241,25.104166666666668
Lasalgaon,MAIZE,2016,1027,1267,240,23.369036027263874
Akot,WHEAT(HUSKED),2016,1680,1920,240,14.285714285714286
Bhandara,WHEAT(HUSKED),2016,1766,2005,239,13.533408833522083
Ausa,SORGUM(JAWAR),2016,1581,1820,239,15.117014547754586
Kopargaon,WHEAT(HUSKED),2016,1756,1995,239,13.610478359908884
Washim-Ansing,PIGEON PEA (TUR),2016,5767,6000,233,4.040228888503555
Paithan,BAJRI,2016,1339,1571,232,17.32636295743092
Newasa,WHEAT(HUSKED),2016,1814,2045,231,12.734288864388093
Bhiwapur,PADDY-UNHUSKED,2016,1870,2101,231,12.352941176470589
Majalgaon,BAJRI,2016,1330,1560,230,17.293233082706767
Nampur,MAIZE,2016,1049,1279,230,21.9256434699714
Dhule,SORGUM(JAWAR),2016,1233,1463,230,18.653690186536902
Nandura,WHEAT(HUSKED),2016,1605,1835,230,14.330218068535826
Mantha,SORGUM(JAWAR),2016,1870,2100,230,12.29946524064171
Sangrampur-Varvatbakal,SORGUM(JAWAR),2016,1077,1307,230,21.355617455896006
Amarawati,PIGEON PEA (TUR),2016,5774,6003,229,3.966054728091444
Mehkar,WHEAT(HUSKED),2016,1736,1965,229,13.191244239631336
Dondaicha-Sindkheda,WHEAT(HUSKED),2016,1734,1962,228,13.14878892733564
Latur,SAFFLOWER,2016,2592,2819,227,8.757716049382717
Sailu,SORGUM(JAWAR),2016,2044,2270,226,11.056751467710372
Shrigonda,MAIZE,2016,1108,1333,225,20.306859205776174
Jalgaon Jamod-Aasalgaon,SORGUM(JAWAR),2016,1075,1300,225,20.930232558139537
Parbhani,SORGUM(JAWAR),2016,1696,1920,224,13.20754716981132
Shegaon,SORGUM(JAWAR),2016,1244,1466,222,17.84565916398714
Dhule,MAIZE,2016,1007,1228,221,21.94637537239325
Sakri,BAJRI,2016,1185,1406,221,18.649789029535864
Vaijapur,MAIZE,2016,987,1208,221,22.391084093211752
Kopargaon,MAIZE,2016,989,1209,220,22.24469160768453
Maregaon,COTTON,2016,4683,4903,220,4.6978432628656845
Sangali,BAJRI,2016,1590,1808,218,13.71069182389937
Amalner,MAIZE,2016,1059,1277,218,20.585457979225684
Lasalgaon-Vinchur,MAIZE,2016,1034,1250,216,20.889748549323016
Kalamb (Os),BAJRI,2016,1082,1298,216,19.963031423290204
Shirpur,MAIZE,2016,1014,1230,216,21.301775147928993
Satana,MAIZE,2016,1057,1270,213,20.151371807000945
Chopda,SORGUM(JAWAR),2016,1460,1673,213,14.58904109589041
Jafrabad,COTTON,2016,4744,4956,212,4.4688026981450255
Vaduj,SORGUM(JAWAR),2016,2256,2467,211,9.352836879432624
Mandhal,PADDY-UNHUSKED,2016,1650,1860,210,12.727272727272727
Mangalwedha,BAJRI,2016,1222,1432,210,17.18494271685761
Nagbhid,PADDY-UNHUSKED,2016,1726,1936,210,12.16685979142526
Majalgaon,COTTON,2016,4691,4900,209,4.45534001279045
Ahmedpur,SUNFLOWER,2016,2763,2972,209,7.564241766196163
Kurdwadi-Modnimb,BAJRI,2016,1393,1602,209,15.003589375448671
Devala,WHEAT(HUSKED),2016,1784,1993,209,11.715246636771301
Yeola,MAIZE,2016,1047,1255,208,19.866284622731616
Shrirampur,MAIZE,2016,943,1151,208,22.057264050901377
Bhokar,COTTON,2016,4755,4963,208,4.374342797055731
Buldhana-Dhad,MAIZE,2016,1006,1213,207,20.576540755467196
Dondaicha,MAIZE,2016,1249,1455,206,16.493194555644514
Malegaon,MAIZE,2016,1078,1283,205,19.01669758812616
Shrirampur-Belapur,MAIZE,2016,935,1140,205,21.925133689839573
Varora,COTTON,2016,4659,4863,204,4.3786220218931104
Varud,MAIZE,2016,1085,1289,204,18.80184331797235
Chikhali,SORGUM(JAWAR),2016,1198,1400,202,16.86143572621035
Ahmednagar,PIGEON PEA (TUR),2016,5051,5252,201,3.9794100178182537
Kolhapur-Laxmipuri,BAJRI,2016,1906,2106,200,10.49317943336831
Varud-Rajura Bazar,PIGEON PEA (TUR),2016,6050,6250,200,3.3057851239669422
Sillod-Bharadi,WHEAT(HUSKED),2016,1650,1850,200,12.121212121212121
Ghansawangi,SORGUM(JAWAR),2016,1600,1800,200,12.5
Mangrulpeer,WHEAT(HUSKED),2016,1665,1865,200,12.012012012012011
Akhadabalapur,COTTON,2016,4722,4922,200,4.235493434985176
Barshi,SUNFLOWER,2016,2600,2800,200,7.6923076923076925
Shegaon,PIGEON PEA (TUR),2016,4872,5072,200,4.105090311986864
Murum,PIGEON PEA (TUR),2016,5448,5648,200,3.671071953010279
Atpadi,BAJRI,2016,1600,1800,200,12.5
Bhiwapur,COTTON,2016,4650,4849,199,4.279569892473118
Chalisgaon,SORGUM(JAWAR),2016,1080,1277,197,18.24074074074074
Savner,MAIZE,2016,1092,1289,197,18.04029304029304
Tasgaon,SORGUM(JAWAR),2016,1706,1902,196,11.48886283704572
Sillod,MAIZE,2016,933,1128,195,20.90032154340836
Baramati,MAIZE,2016,1170,1364,194,16.581196581196583
Zarijamini,COTTON,2016,4651,4845,194,4.171145990109654
Washim-Ansing,WHEAT(HUSKED),2016,1567,1760,193,12.316528398213146
Amalner,WHEAT(HUSKED),2016,1730,1923,193,11.15606936416185
Parola,BAJRI,2016,997,1189,192,19.25777331995988
Ghansawangi,COTTON,2016,4742,4933,191,4.027836355967946
Rahuri-Vambori,SORGUM(JAWAR),2016,2013,2204,191,9.488325881768505
Chandvad,MAIZE,2016,1084,1275,191,17.619926199261993
Kille Dharur,SORGUM(JAWAR),2016,1765,1955,190,10.76487252124646
Manwat,SORGUM(JAWAR),2016,1925,2115,190,9.87012987012987
Lasalgaon-Niphad,MAIZE,2016,1043,1233,190,18.21668264621285
Jafrabad,MAIZE,2016,900,1088,188,20.88888888888889
Achalpur,WHEAT(HUSKED),2016,1765,1953,188,10.65155807365439
Dudhani,SORGUM(JAWAR),2016,2176,2363,187,8.59375
Jalkot,SORGUM(JAWAR),2016,1079,1266,187,17.330861909175162
Sinner,MAIZE,2016,1066,1252,186,17.4484052532833
Barshi,MAIZE,2016,1081,1266,185,17.113783533765034
Kalmeshwar,COTTON,2016,4738,4923,185,3.904601097509498
Fulambri,COTTON,2016,4713,4897,184,3.904095056227456
Kej,MAIZE,2016,1114,1297,183,16.427289048473966
Manmad,MAIZE,2016,1078,1260,182,16.883116883116884
Indapur-Bhigwan,MAIZE,2016,1375,1556,181,13.163636363636364
Paithan,WHEAT(HUSKED),2016,2019,2199,180,8.915304606240714
Bhokar,SORGUM(JAWAR),2016,1404,1583,179,12.749287749287749
Pachora,MAIZE,2016,1055,1234,179,16.966824644549764
Hinganghat,WHEAT(HUSKED),2016,1734,1913,179,10.322952710495963
Nandura,BAJRI,2016,1220,1397,177,14.508196721311476
Malkapur,MAIZE,2016,1107,1284,177,15.989159891598916
Bori,SORGUM(JAWAR),2016,1837,2013,176,9.580838323353293
Yeotmal,COTTON,2016,4753,4928,175,3.681885125184094
Akole,MAIZE,2016,1392,1567,175,12.57183908045977
Varud-Rajura Bazar,MAIZE,2016,1200,1375,175,14.583333333333334
Taloda,SORGUM(JAWAR),2016,1290,1465,175,13.565891472868216
Ahmedpur,MAIZE,2016,1264,1438,174,13.765822784810126
Sillod-Bharadi,MAIZE,2016,981,1154,173,17.63506625891947
Sangali,WHEAT(UNHUSKED),2016,3491,3664,173,4.955600114580349
Sonpeth,SORGUM(JAWAR),2016,1981,2151,170,8.581524482584554
Ghatanji,COTTON,2016,4778,4947,169,3.537044788614483
Narkhed,COTTON,2016,4736,4903,167,3.5261824324324325
Karmala,MAIZE,2016,1120,1287,167,14.910714285714286
Jalgaon Jamod-Aasalgaon,MAIZE,2016,1050,1217,167,15.904761904761905
Washim,SORGUM(JAWAR),2016,1050,1217,167,15.904761904761905
Khultabad,MAIZE,2016,1042,1208,166,15.930902111324377
Devala,MAIZE,2016,1097,1263,166,15.132178669097538
Mahagaon,SORGUM(JAWAR),2016,1485,1650,165,11.11111111111111
Chopda,MAIZE,2016,1059,1223,164,15.486307837582626
Manmad,WHEAT(HUSKED),2016,2024,2187,163,8.053359683794467
Kurdwadi,MAIZE,2016,1137,1300,163,14.335971855760773
Pachora,SORGUM(JAWAR),2016,1318,1480,162,12.291350531107739
Shahapur,PADDY-UNHUSKED,2016,1536,1698,162,10.546875
Jalna,WHEAT(HUSKED),2016,2013,2174,161,7.9980129160457025
Buldhana,MAIZE,2016,1180,1340,160,13.559322033898304
Pathari,SORGUM(JAWAR),2016,1844,2004,160,8.676789587852495
Vaijapur,SORGUM(JAWAR),2016,2004,2164,160,7.984031936127744
Ralegaon,COTTON,2016,4809,4969,160,3.3270950301517987
Dondaicha-Sindkheda,BAJRI,2016,1084,1243,159,14.66789667896679
Chimur,COTTON,2016,4748,4907,159,3.3487784330244312
Katol,COTTON,2016,4797,4955,158,3.293725244944757
Kalmeshwar,WHEAT(HUSKED),2016,1245,1403,158,12.690763052208835
Digras,COTTON,2016,4660,4817,157,3.369098712446352
Parola,SORGUM(JAWAR),2016,1075,1231,156,14.511627906976743
Parola,MAIZE,2016,996,1152,156,15.662650602409638
Vaduj,WHEAT(HUSKED),2016,1844,2000,156,8.459869848156183
Sillod,WHEAT(HUSKED),2016,1627,1782,155,9.526736324523663
Shirur,BAJRI,2016,1260,1411,151,11.984126984126984
Armori-Desaiganj,PADDY-UNHUSKED,2016,1540,1691,151,9.805194805194805
Raver-Sawada,WHEAT(HUSKED),2016,1700,1850,150,8.823529411764707
Sindi (Selu),SORGUM(JAWAR),2016,1050,1200,150,14.285714285714286
Lonar,WHEAT(HUSKED),2016,1650,1800,150,9.090909090909092
Jalgaon Jamod,MAIZE,2016,1050,1200,150,14.285714285714286
Kannad,MAIZE,2016,905,1055,150,16.574585635359117
Akola,BAJRI,2016,1738,1888,150,8.63060989643268
Ausa,MAIZE,2016,1281,1430,149,11.631537861046057
Mehkar,SORGUM(JAWAR),2016,1663,1812,149,8.959711365003006
Kalamb (Os),PIGEON PEA (TUR),2016,4601,4750,149,3.238426429037166
Dhamangaon-Rly,WHEAT(HUSKED),2016,1752,1899,147,8.39041095890411
Paithan,SORGUM(JAWAR),2016,2153,2299,146,6.781235485369252
Khamgaon,WHEAT(HUSKED),2016,1856,2002,146,7.866379310344827
Raver-Sawada,SORGUM(JAWAR),2016,1058,1203,145,13.705103969754253
Digras,PIGEON PEA (TUR),2016,5699,5844,145,2.5443060185997544
Shegaon,WHEAT(HUSKED),2016,1573,1718,145,9.218054672600127
Latur-Murud,SORGUM(JAWAR),2016,1791,1934,143,7.984366275823562
Achalpur,SORGUM(JAWAR),2016,1375,1518,143,10.4
Shevgaon-Bodhegaon,BAJRI,2016,1102,1244,142,12.885662431941924
Manwat,COTTON,2016,4976,5117,141,2.8336012861736335
Pulgaon,COTTON,2016,4840,4980,140,2.8925619834710745
Shevgaon,SORGUM(JAWAR),2016,2174,2314,140,6.439742410303588
Kada,MAIZE,2016,1150,1290,140,12.173913043478262
Pusad,PIGEON PEA (TUR),2016,5580,5720,140,2.5089605734767026
Samudrapur,COTTON,2016,4811,4950,139,2.88921222199127
Dhadgaon,SORGUM(JAWAR),2016,1085,1224,139,12.811059907834101
Tumsar,PADDY-UNHUSKED,2016,1715,1853,138,8.0466472303207
Rahata,MAIZE,2016,977,1115,138,14.12487205731832
Partur,COTTON,2016,4887,5025,138,2.823818293431553
Rahuri-Vambori,MAIZE,2016,1129,1266,137,12.134632418069089
Ausa,SAFFLOWER,2016,2669,2806,137,5.133008617459723
Korpana,COTTON,2016,4727,4864,137,2.898244129469008
Mukhed,SORGUM(JAWAR),2016,1125,1261,136,12.088888888888889
Varud,COTTON,2016,4821,4957,136,2.820991495540344
Dondaicha-Sindkheda,MAIZE,2016,1084,1219,135,12.453874538745387
Chimur,PADDY-UNHUSKED,2016,2003,2137,134,6.689965052421368
Chikhali,MAIZE,2016,1111,1245,134,12.061206120612061
Ausa,SUNFLOWER,2016,2783,2916,133,4.77901545095221
Dound,MAIZE,2016,1225,1358,133,10.857142857142858
Kalamb (Os),MAIZE,2016,1104,1236,132,11.956521739130435
Akot,MAIZE,2016,1124,1255,131,11.654804270462634
Yeola,BAJRI,2016,1325,1456,131,9.88679245283019
Yeola,WHEAT(HUSKED),2016,1844,1973,129,6.995661605206074
Pachora,WHEAT(HUSKED),2016,1617,1745,128,7.915893630179345
Savali,PADDY-UNHUSKED,2016,1914,2042,128,6.687565308254963
Nagpur,MAIZE,2016,1160,1288,128,11.03448275862069
Telhara,WHEAT(HUSKED),2016,1691,1818,127,7.510348905972797
Mantha,COTTON,2016,4868,4995,127,2.608874281018899
Bhusaval,SORGUM(JAWAR),2016,1105,1231,126,11.402714932126697
Morshi,SORGUM(JAWAR),2016,1194,1320,126,10.552763819095478
Raver,MAIZE,2016,1059,1185,126,11.898016997167138
Kurdwadi-Modnimb,MAIZE,2016,1225,1350,125,10.204081632653061
Chamorshi,PADDY-UNHUSKED,2016,1932,2057,125,6.469979296066253
Mauda,WHEAT(HUSKED),2016,1500,1625,125,8.333333333333334
Sindi (Selu),COTTON,2016,4784,4908,124,2.591973244147157
Dondaicha-Sindkheda,SORGUM(JAWAR),2016,1462,1586,124,8.481532147742818
Gevrai,PIGEON PEA (TUR),2016,4789,4913,124,2.589267070369597
Dharangaon,MAIZE,2016,1047,1171,124,11.843361986628462
Telhara,SORGUM(JAWAR),2016,1219,1342,123,10.090237899917966
Vaduj,BAJRI,2016,1678,1800,122,7.270560190703218
Umarga,SORGUM(JAWAR),2016,1390,1512,122,8.776978417266188
Indapur-Bhigwan,RICE(PADDY-HUS),2016,1601,1722,121,7.557776389756402
Shevgaon,BAJRI,2016,1151,1272,121,10.5125977410947
Dharangaon,SORGUM(JAWAR),2016,1121,1242,121,10.793933987511151
Ner Parasopant,PIGEON PEA (TUR),2016,5610,5730,120,2.1390374331550803
Chopda,BAJRI,2016,1312,1431,119,9.070121951219512
Malkapur,BAJRI,2016,1375,1494,119,8.654545454545454
Sillod-Bharadi,BAJRI,2016,1283,1400,117,9.11925175370226
Gangapur,SORGUM(JAWAR),2016,2162,2279,117,5.411655874190564
Jalgaon,BAJRI,2016,1378,1494,116,8.417997097242381
Jalgaon,MAIZE,2016,1100,1215,115,10.454545454545455
Sailu,COTTON,2016,5041,5155,114,2.2614560603054947
Gondiya,PADDY-UNHUSKED,2016,1404,1515,111,7.905982905982906
Shrigonda-Ghogargaon,COTTON,2016,4917,5028,111,2.2574740695546063
Shrirampur-Belapur,BAJRI,2016,1078,1189,111,10.296846011131725
Sangrampur-Varvatbakal,MAIZE,2016,990,1100,110,11.11111111111111
Chakur,SUNFLOWER,2016,2942,3052,110,3.7389530931339223
Patur,SORGUM(JAWAR),2016,1358,1467,109,8.026509572901325
Varud-Rajura Bazar,SORGUM(JAWAR),2016,1341,1450,109,8.128262490678598
Shevgaon-Bodhegaon,SORGUM(JAWAR),2016,2278,2387,109,4.784899034240562
Shirur,MAIZE,2016,1198,1307,109,9.098497495826377
Kalamb (Os),SUNFLOWER,2016,2703,2811,108,3.995560488346282
Brahmpuri,PADDY-UNHUSKED,2016,1701,1809,108,6.349206349206349
Barshi,PADDY-UNHUSKED,2016,1646,1754,108,6.561360874848116
Dhamangaon-Rly,COTTON,2016,4864,4972,108,2.2203947368421053
Barshi,BAJRI,2016,1181,1289,108,9.144792548687553
Shirur,SORGUM(JAWAR),2016,1753,1860,107,6.103822019395322
Solapur,BAJRI,2016,1496,1603,107,7.152406417112299
Dhadgaon,MAIZE,2016,1081,1187,106,9.805735430157261
Varud,SORGUM(JAWAR),2016,1253,1359,106,8.459696727853153
Rahata,BAJRI,2016,1199,1305,106,8.84070058381985
Nandgaon Khandeshwar,WHEAT(HUSKED),2016,1500,1605,105,7.0
Gangapur,BAJRI,2016,1398,1503,105,7.510729613733906
Sindevahi,PADDY-UNHUSKED,2016,2096,2199,103,4.91412213740458
Sindi,COTTON,2016,4828,4931,103,2.1333885666942836
Mangalwedha,MAIZE,2016,1170,1272,102,8.717948717948717
Naigaon,SORGUM(JAWAR),2016,1150,1251,101,8.782608695652174
Shirala,MAIZE,2016,1400,1500,100,7.142857142857143
Sillod-Bharadi,SORGUM(JAWAR),2016,1250,1350,100,8.0
Morshi,WHEAT(HUSKED),2016,1667,1767,100,5.9988002399520095
Balapur,PIGEON PEA (TUR),2016,5900,6000,100,1.694915254237288
Kolhapur-Laxmipuri,MAIZE,2016,1900,2000,100,5.2631578947368425
Kolhapur-Laxmipuri,PADDY-UNHUSKED,2016,1725,1825,100,5.797101449275362
Dharni,WHEAT(HUSKED),2016,1600,1700,100,6.25
Dharni,SORGUM(JAWAR),2016,1360,1460,100,7.352941176470588
Basmat,COTTON,2016,4750,4850,100,2.1052631578947367
Umarkhed,WHEAT(HUSKED),2016,1500,1600,100,6.666666666666667
Dharni,MAIZE,2016,1250,1350,100,8.0
Umarkhed-Danki,WHEAT(HUSKED),2016,1500,1600,100,6.666666666666667
Gondpimpri,PADDY-UNHUSKED,2016,2351,2451,100,4.253509145044662
Sillod,BAJRI,2016,1314,1414,100,7.610350076103501
Shrirampur-Belapur,WHEAT(HUSKED),2016,1500,1600,100,6.666666666666667
Nandura,MAIZE,2016,1110,1210,100,9.00900900900901
Sillod,SORGUM(JAWAR),2016,1350,1450,100,7.407407407407407
Gangapur,MAIZE,2016,1033,1132,99,9.583736689254598
Gevrai,MAIZE,2016,1139,1236,97,8.516242317822652
Tiroda,PADDY-UNHUSKED,2016,1530,1627,97,6.339869281045751
Sonpeth,COTTON,2016,4677,4773,96,2.0525978191148173
Kalvan,WHEAT(HUSKED),2016,1724,1819,95,5.510440835266821
Tumsar,RICE(PADDY-HUS),2016,2614,2709,95,3.6342769701606734
Armori,PADDY-UNHUSKED,2016,1613,1707,94,5.827650340979541
Umared,COTTON,2016,4823,4916,93,1.9282604188264565
Tasgaon,MAIZE,2016,1367,1460,93,6.803218727139722
Gadchiroli,PADDY-UNHUSKED,2016,1707,1798,91,5.330990041007616
Rahata,WHEAT(HUSKED),2016,1833,1923,90,4.909983633387888
Navapur,MAIZE,2016,1200,1289,89,7.416666666666667
Sangli-Miraj,WHEAT(UNHUSKED),2016,3570,3658,88,2.4649859943977592
Khamgaon,BAJRI,2016,1416,1504,88,6.214689265536723
Goregaon,PADDY-UNHUSKED,2016,1533,1619,86,5.609915198956295
Pune,MAIZE,2016,1434,1518,84,5.857740585774058
Tuljapur,MAIZE,2016,1210,1290,80,6.6115702479338845
Karjat (Raigad),PADDY-UNHUSKED,2016,1470,1550,80,5.442176870748299
Akot,COTTON,2016,5085,5161,76,1.494591937069813
Shevgaon,MAIZE,2016,1091,1166,75,6.8744271310724105
Bhadrawati,COTTON,2016,4814,4889,75,1.557955961778147
Ahmedpur,BAJRI,2016,1133,1208,75,6.619593998234775
Navapur,COTTON,2016,4667,4742,75,1.6070280694236125
Jalna,COTTON,2016,4857,4931,74,1.5235742227712579
Shevgaon,WHEAT(HUSKED),2016,1633,1707,74,4.53153704837722
Dudhani,MAIZE,2016,1161,1233,72,6.2015503875969
Navapur,SORGUM(JAWAR),2016,1203,1275,72,5.985037406483791
Amarawati,COTTON,2016,4936,5007,71,1.4384116693679092
Tuljapur,SORGUM(JAWAR),2016,1986,2057,71,3.5750251762336354
Khamgaon,MAIZE,2016,1124,1195,71,6.316725978647687
Jalgaon-Masawat,MAIZE,2016,1047,1117,70,6.685768863419293
Vadvani,BAJRI,2016,1600,1670,70,4.375
Phaltan,MAIZE,2016,1280,1350,70,5.46875
Wardha,WHEAT(HUSKED),2016,1863,1932,69,3.7037037037037037
Ahmednagar,MAIZE,2016,1204,1272,68,5.647840531561462
Jalna-Badnapur,SORGUM(JAWAR),2016,1850,1917,67,3.6216216216216215
Ramtek,WHEAT(HUSKED),2016,1750,1817,67,3.8285714285714287
Balapur,WHEAT(HUSKED),2016,1733,1800,67,3.866128101557992
Pavani,PADDY-UNHUSKED,2016,1807,1873,66,3.652462645268401
Katol,MAIZE,2016,1179,1243,64,5.4283290924512295
Palghar(Bevur),WHEAT(HUSKED),2016,2283,2347,64,2.803328953131844
Mangalwedha,WHEAT(HUSKED),2016,2231,2294,63,2.823845809054236
Aamgaon,PADDY-UNHUSKED,2016,1388,1451,63,4.538904899135447
Bhokar,SESAMUM,2016,6025,6088,63,1.045643153526971
Parshiwani,COTTON,2016,4824,4886,62,1.285240464344942
Kille Dharur,COTTON,2016,4946,5008,62,1.253538212697129
Jalgaon-Masawat,SORGUM(JAWAR),2016,1107,1169,62,5.600722673893405
Kille Dharur,MAIZE,2016,1388,1450,62,4.46685878962536
Parbhani,COTTON,2016,5073,5131,58,1.1433077074709246
Raver-Sawada,MAIZE,2016,925,983,58,6.27027027027027
Kurdwadi-Modnimb,WHEAT(HUSKED),2016,1315,1373,58,4.4106463878327
Chopda,WHEAT(HUSKED),2016,1743,1801,58,3.327596098680436
Arvi,COTTON,2016,4929,4987,58,1.176709271657537
Mohol,MAIZE,2016,1219,1276,57,4.6759639048400325
Katol,SORGUM(JAWAR),2016,1194,1251,57,4.773869346733668
Gangakhed,SORGUM(JAWAR),2016,1625,1680,55,3.3846153846153846
Amarawati,MAIZE,2016,1294,1349,55,4.250386398763524
Bhokardan-Pimpalgaon Renu,MAIZE,2016,1020,1074,54,5.294117647058823
Bhokardan-Pimpalgaon Renu,BAJRI,2016,1405,1458,53,3.772241992882562
Sangali,MAIZE,2016,1387,1440,53,3.8211968276856525
Shevgaon-Bodhegaon,WHEAT(HUSKED),2016,1958,2009,51,2.6046986721144023
Newasa,SORGUM(JAWAR),2016,1810,1860,50,2.7624309392265194
Navapur,WHEAT(HUSKED),2016,1700,1750,50,2.9411764705882355
Mantha,BAJRI,2016,1400,1450,50,3.5714285714285716
Partur,BAJRI,2016,1250,1300,50,4.0
Varud,PIGEON PEA (TUR),2016,5350,5400,50,0.9345794392523364
Indapur,MAIZE,2016,1231,1281,50,4.061738424045491
Naigaon,COTTON,2016,4800,4850,50,1.0416666666666667
Telhara,COTTON,2016,4850,4900,50,1.0309278350515463
Bhokardan-Pimpalgaon Renu,SORGUM(JAWAR),2016,1600,1650,50,3.125
Katol,WHEAT(HUSKED),2016,1930,1978,48,2.4870466321243523
Latur-Murud,WHEAT(HUSKED),2016,2282,2329,47,2.0595968448729183
Chandur Rly.,PIGEON PEA (TUR),2016,5455,5501,46,0.843263061411549
Savner,WHEAT(HUSKED),2016,1651,1697,46,2.786190187764991
Nanded,SORGUM(JAWAR),2016,1206,1251,45,3.7313432835820897
Atpadi,MAIZE,2016,1390,1435,45,3.237410071942446
Bhokardan-Pimpalgaon Renu,WHEAT(HUSKED),2016,1600,1645,45,2.8125
Jalna-Badnapur,MAIZE,2016,993,1038,45,4.531722054380665
Pachora,SUNFLOWER,2016,2595,2638,43,1.6570327552986512
Jalgaon,WHEAT(HUSKED),2016,1858,1900,42,2.2604951560818085
Navapur,PADDY-UNHUSKED,2016,1242,1284,42,3.3816425120772946
Devri,PADDY-UNHUSKED,2016,1470,1510,40,2.7210884353741496
Pen,PADDY-UNHUSKED,2016,1470,1510,40,2.7210884353741496
Sangamner,SORGUM(JAWAR),2016,1754,1793,39,2.2234891676168758
Mandhal,COTTON,2016,4733,4772,39,0.8240016902598775
Akola,MAIZE,2016,1470,1508,38,2.5850340136054424
Sangli-Miraj,MAIZE,2016,1410,1448,38,2.6950354609929077
Ramtek,PADDY-UNHUSKED,2016,1706,1744,38,2.2274325908558033
Vaduj,MAIZE,2016,1335,1373,38,2.846441947565543
Bhokardan,BAJRI,2016,1403,1440,37,2.6372059871703493
Digras,WHEAT(HUSKED),2016,1752,1789,37,2.1118721461187215
Bhokardan,MAIZE,2016,1055,1090,35,3.3175355450236967
Bhokardan,SORGUM(JAWAR),2016,1610,1645,35,2.1739130434782608
Pandharpur,MAIZE,2016,1298,1333,35,2.6964560862865947
Lakhandur,PADDY-UNHUSKED,2016,1542,1575,33,2.140077821011673
Barshi,PIGEON PEA (TUR),2016,5167,5200,33,0.6386684730017418
Udgir,SORGUM(JAWAR),2016,1134,1167,33,2.9100529100529102
Bhokardan,WHEAT(HUSKED),2016,1604,1636,32,1.9950124688279303
Akkalkuwa,MAIZE,2016,1327,1358,31,2.3360964581763377
Parli-Vaijnath,BAJRI,2016,1107,1138,31,2.8003613369467026
Mangaon(Bhadav),PADDY-UNHUSKED,2016,1470,1500,30,2.0408163265306123
Savner,SORGUM(JAWAR),2016,1087,1116,29,2.6678932842686294
Savner,COTTON,2016,4877,4906,29,0.5946278449866721
Ahmedpur,WHEAT(HUSKED),2016,1438,1467,29,2.0166898470097356
Achalpur,MAIZE,2016,1374,1400,26,1.8922852983988354
Shahada,BAJRI,2016,1275,1298,23,1.803921568627451
Vadvani,COTTON,2016,4858,4880,22,0.45286125977768626
Newasa,BAJRI,2016,1388,1410,22,1.585014409221902
Nanded,WHEAT(HUSKED),2016,1746,1767,21,1.2027491408934707
Murud,PADDY-UNHUSKED,2016,1480,1500,20,1.3513513513513513
Alibag,PADDY-UNHUSKED,2016,1480,1500,20,1.3513513513513513
Paithan,MAIZE,2016,1140,1158,18,1.5789473684210527
Pulgaon,PIGEON PEA (TUR),2016,5305,5323,18,0.3393025447690858
Shirur,WHEAT(HUSKED),2016,1605,1623,18,1.1214953271028036
Kalamb (Os),SAFFLOWER,2016,2431,2449,18,0.7404360345536816
Arjuni Morgaon,PADDY-UNHUSKED,2016,1563,1580,17,1.0876519513755598
Varud,WHEAT(HUSKED),2016,1867,1883,16,0.8569898232458489
Majalgaon,WHEAT(HUSKED),2016,1895,1910,15,0.7915567282321899
Rahata,SORGUM(JAWAR),2016,1380,1394,14,1.0144927536231885
Yeotmal,WHEAT(HUSKED),2016,1775,1785,10,0.5633802816901409
Akkalkuwa,SORGUM(JAWAR),2016,1340,1350,10,0.746268656716418
Newasa,MAIZE,2016,1370,1375,5,0.36496350364963503
Solapur,MAIZE,2016,1366,1371,5,0.36603221083455345
Aheri,MAIZE,2016,1425,1425,0,0.0
Aheri,RICE(PADDY-HUS),2016,2000,2000,0,0.0
Aheri,PADDY-UNHUSKED,2016,1757,1757,0,0.0
Aheri,SESAMUM,2016,4500,4500,0,0.0
Indapur,PIGEON PEA (TUR),2016,5200,5200,0,0.0
Hingoli,WHEAT(HUSKED),2016,2245,2245,0,0.0
Hingoli-Kanegaon Naka,WHEAT(HUSKED),2016,2100,2100,0,0.0
Hingoli,SORGUM(JAWAR),2016,2095,2095,0,0.0
Umarga,PIGEON PEA (TUR),2016,5682,5682,0,0.0
Umarga,WHEAT(HUSKED),2016,1425,1425,0,0.0
Umarga,WHEAT(UNHUSKED),2016,2250,2250,0,0.0
Kalvan,PIGEON PEA (TUR),2016,4800,4800,0,0.0
Achalpur,SESAMUM,2016,5777,5777,0,0.0
Kalamnuri,WHEAT(HUSKED),2016,1600,1600,0,0.0
Jalna,MUSTARD,2016,3600,3600,0,0.0
Jalna-Badnapur,BAJRI,2016,1250,1250,0,0.0
Jamner,MAIZE,2016,1365,1365,0,0.0
Jamner-Neri,MAIZE,2016,1365,1365,0,0.0
Jintur,SORGUM(JAWAR),2016,1985,1985,0,0.0
Beed,MAIZE,2016,1417,1417,0,0.0
Ambejogai,PIGEON PEA (TUR),2016,5287,5287,0,0.0
Akola,SAFFLOWER,2016,2067,2067,0,0.0
Bhokar,MAIZE,2016,1325,1325,0,0.0
Bhokar,WHEAT(HUSKED),2016,1500,1500,0,0.0
Devala,PIGEON PEA (TUR),2016,4895,4895,0,0.0
Devani,PIGEON PEA (TUR),2016,5401,5401,0,0.0
Devani,SAFFLOWER,2016,2600,2600,0,0.0
Devani,SORGUM(JAWAR),2016,1601,1601,0,0.0
Ahmedpur,SAFFLOWER,2016,2700,2700,0,0.0
Devala,SORGUM(JAWAR),2016,1194,1194,0,0.0
Akhadabalapur,SORGUM(JAWAR),2016,1625,1625,0,0.0
Digras,SORGUM(JAWAR),2016,1628,1628,0,0.0
Dhule,SESAMUM,2016,4000,4000,0,0.0
Bhusaval,WHEAT(HUSKED),2016,1790,1790,0,0.0
Vaijapur,SAFFLOWER,2016,2600,2600,0,0.0
Bhusaval,MAIZE,2016,1150,1150,0,0.0
Bori,BAJRI,2016,1500,1500,0,0.0
Chakur,PIGEON PEA (TUR),2016,5491,5491,0,0.0
Chakur,SORGUM(JAWAR),2016,2451,2451,0,0.0
Bori,PIGEON PEA (TUR),2016,4375,4375,0,0.0
Bori,SAFFLOWER,2016,2200,2200,0,0.0
Bori,WHEAT(HUSKED),2016,1721,1721,0,0.0
Chakur,BAJRI,2016,1363,1363,0,0.0
Akkolkot,MAIZE,2016,1238,1238,0,0.0
Akkolkot,BAJRI,2016,1438,1438,0,0.0
Chandur Rly.,WHEAT(HUSKED),2016,1850,1850,0,0.0
Pusad,SESAMUM,2016,5305,5305,0,0.0
Rahuri-Vambori,SUNFLOWER,2016,2800,2800,0,0.0
Rahuri-Vambori,PIGEON PEA (TUR),2016,4526,4526,0,0.0
Pandharpur,SORGUM(JAWAR),2016,1845,1845,0,0.0
Parli-Vaijnath,PIGEON PEA (TUR),2016,4300,4300,0,0.0
Parli-Vaijnath,WHEAT(HUSKED),2016,1711,1711,0,0.0
Solapur,WHEAT(UNHUSKED),2016,3100,3100,0,0.0
Patur,PIGEON PEA (TUR),2016,4000,4000,0,0.0
Patur,WHEAT(HUSKED),2016,1900,1900,0,0.0
Parola,WHEAT(HUSKED),2016,1667,1667,0,0.0
Shegaon,SESAMUM,2016,4450,4450,0,0.0
Shegaon,BAJRI,2016,1190,1190,0,0.0
Shegaon,MAIZE,2016,1025,1025,0,0.0
Shevgaon-Bodhegaon,MAIZE,2016,1313,1313,0,0.0
Shirur,PIGEON PEA (TUR),2016,4300,4300,0,0.0
Shirur,SUNFLOWER,2016,2600,2600,0,0.0
Sailu,WHEAT(HUSKED),2016,2125,2125,0,0.0
Roha,PADDY-UNHUSKED,2016,1510,1510,0,0.0
Sadak Arjuni,PADDY-UNHUSKED,2016,1470,1470,0,0.0
Sakri,RICE(PADDY-HUS),2016,2700,2700,0,0.0
Sironcha,PADDY-UNHUSKED,2016,1713,1713,0,0.0
Sinner,RICE(PADDY-HUS),2016,1700,1700,0,0.0
Ramtek,PIGEON PEA (TUR),2016,4000,4000,0,0.0
Sironcha,RICE(PADDY-HUS),2016,2000,2000,0,0.0
Raver,RICE(PADDY-HUS),2016,1450,1450,0,0.0
Sangamner,MAIZE,2016,1400,1400,0,0.0
Sangamner,PIGEON PEA (TUR),2016,5800,5800,0,0.0
Lonand,MAIZE,2016,1375,1375,0,0.0
Latur-Murud,SUNFLOWER,2016,2657,2657,0,0.0
Latur-Murud,MAIZE,2016,1150,1150,0,0.0
Lakhandur,RICE(PADDY-HUS),2016,1617,1617,0,0.0
Lakhandur,WHEAT(HUSKED),2016,1550,1550,0,0.0
Lakhani,PADDY-UNHUSKED,2016,1918,1918,0,0.0
Kurdwadi,WHEAT(HUSKED),2016,1951,1951,0,0.0
Lasur Station,PIGEON PEA (TUR),2016,5500,5500,0,0.0
Lasalgaon-Niphad,SUNFLOWER,2016,5701,5701,0,0.0
Mangrulpeer,COTTON,2016,4900,4900,0,0.0
Mangrulpeer,SORGUM(JAWAR),2016,1355,1355,0,0.0
Manmad,SORGUM(JAWAR),2016,2380,2380,0,0.0
Mangalwedha,PIGEON PEA (TUR),2016,5000,5000,0,0.0
Tumsar,WHEAT(HUSKED),2016,1674,1674,0,0.0
Khamgaon,SESAMUM,2016,4700,4700,0,0.0
Khamgaon,SUNFLOWER,2016,2700,2700,0,0.0
Kannad,SORGUM(JAWAR),2016,1414,1414,0,0.0
Umared,PIGEON PEA (TUR),2016,4393,4393,0,0.0
Umared,MUSTARD,2016,3400,3400,0,0.0
Umared,SORGUM(JAWAR),2016,2475,2475,0,0.0
Kurdwadi,BAJRI,2016,1421,1421,0,0.0
Nandurbar,PIGEON PEA (TUR),2016,5546,5546,0,0.0
Nandurbar,RICE(PADDY-HUS),2016,3000,3000,0,0.0
Nanded,PIGEON PEA (TUR),2016,4800,4800,0,0.0
Navapur,RICE(PADDY-HUS),2016,1800,1800,0,0.0
Sonpeth,SESAMUM,2016,4600,4600,0,0.0
Osmanabad,PIGEON PEA (TUR),2016,5000,5000,0,0.0
Osmanabad,SUNFLOWER,2016,2501,2501,0,0.0
Sonpeth,WHEAT(HUSKED),2016,1918,1918,0,0.0
Nira-Saswad,MAIZE,2016,1531,1531,0,0.0
Mohol,WHEAT(HUSKED),2016,2200,2200,0,0.0
Naigaon,SESAMUM,2016,4000,4000,0,0.0
Naigaon,WHEAT(HUSKED),2016,1600,1600,0,0.0
Nampur,SORGUM(JAWAR),2016,3150,3150,0,0.0
Murum,SORGUM(JAWAR),2016,2600,2600,0,0.0
Murum,WHEAT(UNHUSKED),2016,2100,2100,0,0.0
