APMC,Commodity,Year,min_price,max_price,absolute_fluctuation,relative_fluctuation
Atpadi,Goats,2016,4000,1600090,1596090,39902.25
Mumbai,Cashewnuts,2015,70000,140000,70000,100.0
Mumbai,Cardamom,2016,86471,152941,66470,76.86970198101098
Sangli-Phale Bhajipalam,Mango,2016,17422,83075,65653,376.8396280564803
Mumbai,CARDAMOM,2016,110313,174375,64062,58.07293791302929
Mumbai,Cardamom,2015,93420,156473,63053,67.49411260971955
Mumbai,Cardamom,2016,84286,145714,61428,72.88043091379352
Mumbai,Cardamom,2015,95000,154167,59167,62.281052631578945
Mumbai,Cashewnuts,2015,62905,119048,56143,89.25045703839122
Umarkhed,Pigeon Pea (Tur),2016,5800,61200,55400,955.1724137931035
Mumbai,Cardamom,2015,61718,113376,51658,83.70005508927703
Mumbai,Cardamom,2015,70000,120800,50800,72.57142857142857
Mumbai,Cardamom,2015,84667,134667,50000,59.054885610686576
Mumbai,Cashewnuts,2015,62391,111304,48913,78.39752528409547
Mumbai,Cardamom,2014,72667,120952,48285,66.44694290393163
Khamgaon,Buffalo,2016,20000,68000,48000,240.0
Mumbai,Cashewnuts,2016,87895,133684,45789,52.095113487684166
Mumbai,Cardamom,2015,83333,128333,45000,54.000216000864
Mumbai,Cardamom,2015,90000,134375,44375,49.30555555555556
Mumbai,Cashewnuts,2015,45769,90000,44231,96.63964692258952
Mumbai,Cardamom,2014,80000,124000,44000,55.0
Mumbai,Cardamom,2016,50333,92667,42334,84.10784177378657
Mumbai,Cashewnuts,2014,52632,94526,41894,79.59796321629427
Mumbai,Cashewnuts,2016,69087,110435,41348,59.84917567704488
Mumbai,Cardamom,2016,40000,80000,40000,100.0
Mumbai,Cardamom,2016,70000,110000,40000,57.142857142857146
Mumbai,Cardamom,2016,50000,90000,40000,80.0
Mumbai,Cardamom,2016,53636,93636,40000,74.57677679170706
Mumbai,CASHEWNUTS,2016,66154,106154,40000,60.464975662847294
Mumbai,Cardamom,2016,40000,80000,40000,100.0
Gadhinglaj,Chillies(Red),2015,5683,45114,39431,693.8412810135492
Mumbai,Cardamom,2014,77333,116667,39334,50.86315027219945
Mumbai,Cashewnuts,2014,52381,91429,39048,74.54611404898723
Mumbai,Cardamom,2015,41000,80000,39000,95.1219512195122
Mumbai,Cardamom,2016,41214,80000,38786,94.1087979812685
Gadhinglaj,Chillies(Red),2014,5444,42556,37112,681.704628949302
Mumbai,Cardamom,2015,53000,90000,37000,69.81132075471699
Mumbai,Cashewnuts,2015,60000,96923,36923,61.538333333333334
Gadhinglaj,Chillies(Red),2015,6233,42856,36623,587.5661800096262
Gadhinglaj,Chillies(Red),2015,7029,43157,36128,513.9849196187224
Khamgaon,Buffalo,2016,20000,56000,36000,180.0
Palus,Cow,2016,9000,45000,36000,400.0
Mumbai,Cardamom,2016,44286,78571,34285,77.41724246940342
Mumbai,Cashewnuts,2014,45826,79957,34131,74.4795530921311
Junnar (Bhlhe),Buffalo,2016,6000,40000,34000,566.6666666666666
Mumbai,Cashewnuts,2014,47667,80444,32777,68.76245620659995
Khamgaon,Buffalo,2014,12500,45000,32500,260.0
Anajngaon Surji,Chillies(Red),2015,8000,40500,32500,406.25
Malegaon (Washim),Bullack,2016,8000,40000,32000,400.0
Palus,Buffalo,2016,14000,45500,31500,225.0
Mumbai,Cardamom,2015,49762,80952,31190,62.67834894095896
Mumbai,Cashewnuts,2015,52118,83235,31117,59.70490041828159
Rahata,Pomegranate,2016,252,30563,30311,12028.174603174602
Khamgaon,Buffalo,2016,20000,50000,30000,150.0
Mumbai,Cashewnuts,2016,60000,90000,30000,50.0
Mumbai,Cashewnuts,2016,60000,90000,30000,50.0
Mumbai,Cashewnuts,2016,60000,90000,30000,50.0
Khamgaon,Buffalo,2015,10000,40000,30000,300.0
Junnar (Alephata),Cow,2016,30000,60000,30000,100.0
Gadhinglaj,Chillies(Red),2015,7813,37438,29625,379.1757327531038
Gadhinglaj,Chillies(Red),2015,6133,35267,29134,475.03668677645527
Gadhinglaj,Chillies(Red),2016,7071,36171,29100,411.54009333899023
Gadhinglaj,Chillies(Red),2015,8222,36978,28756,349.7445876915592
Mumbai,Cardamom,2015,58125,86250,28125,48.38709677419355
Gadhinglaj,Chillies(Red),2015,7578,35300,27722,365.8221166534706
Gadhinglaj,Chillies(Red),2016,7564,35244,27680,365.9439450026441
Mumbai,Cashewnuts,2015,58448,85948,27500,47.05036955926636
Palus,Buffalo,2016,18000,45500,27500,152.77777777777777
Mumbai,Cashewnuts,2016,61318,88727,27409,44.69976189699599
Mumbai,Cashewnuts,2015,57333,84667,27334,47.67585858057314
Mumbai,Cardamom,2015,42583,69583,27000,63.40558438813611
Mumbai,Cashewnuts,2016,66087,93043,26956,40.788657375883304
Kolhapur-Laxmipuri,Chillies(Red),2014,14133,40800,26667,188.68605391636595
Tasgaon,Bedana,2016,6183,32470,26287,425.1496037522238
Gadhinglaj,Chillies(Red),2014,6086,31986,25900,425.56687479461056
Sangli-Phale Bhajipalam,Mango,2016,23833,49395,25562,107.25464691813872
Junnar (Bhlhe),Buffalo,2016,15000,40000,25000,166.66666666666666
Khamgaon,Bullack,2014,5000,30000,25000,500.0
Junnar (Bhlhe),Bullack,2016,5000,30000,25000,500.0
Gadhinglaj,Chillies(Red),2016,7150,30913,23763,332.34965034965035
Rahata,Pomegranate,2016,250,23575,23325,9330.0
Mumbai,Cashewnuts,2016,65833,88750,22917,34.81080916865402
Kalamb (Os),Coriander (Dry),2014,9688,32563,22875,236.1168455821635
Umared,Lentil,2014,2525,25250,22725,900.0
Mumbai,Cashewnuts,2015,55333,78000,22667,40.96470460665426
Gadhinglaj,CHILLIES(RED),2016,8278,30833,22555,272.46919545784004
Mumbai,Cashewnuts,2015,58318,80000,21682,37.17891560067218
Pandharpur,Bedana,2015,3167,24567,21400,675.7183454373223
Pandharpur,Bedana,2015,4167,25500,21333,511.9510439164867
Mumbai,Cardamom,2014,88000,109231,21231,24.126136363636363
Mumbai,Cashewnuts,2015,63684,84737,21053,33.05853903649268
Anajngaon Surji,Chillies(Red),2016,8750,29750,21000,240.0
Gadhinglaj,Chillies(Red),2016,4500,25000,20500,455.55555555555554
Indapur-Bhigwan,Ghevda Seed,2014,4525,24756,20231,447.0939226519337
Mumbai,Cashewnuts,2016,80000,100000,20000,25.0
Kamthi,Garlic,2015,5333,25333,20000,375.0234389649353
Mumbai,Cashewnuts,2016,62727,82727,20000,31.884196597956223
Mumbai,Mango,2015,30250,50250,20000,66.11570247933884
Kamthi,Garlic,2016,5500,24667,19167,348.4909090909091
Sangali,Bedana,2015,11000,30040,19040,173.0909090909091
Kolhapur,Custard Apple,2016,764,19600,18836,2465.4450261780103
Gadhinglaj,Chillies(Red),2015,8700,27367,18667,214.5632183908046
Mumbai,Cashewnuts,2015,73037,91593,18556,25.406300915974096
Indapur,Pomegranate,2016,1963,19638,17675,900.4075394803872
Rahata,Pomegranate,2015,1050,18675,17625,1678.5714285714287
Gadhinglaj,Chillies(Red),2016,5500,23000,17500,318.1818181818182
Khamgaon,Bullack,2016,8000,25000,17000,212.5
Gadhinglaj,Chillies(Red),2014,6186,22686,16500,266.7313288069835
Mumbai,Mango,2015,17917,33833,15916,88.83183568677792
Sangali,Bedana,2014,11500,26925,15425,134.1304347826087
Sangali,Bedana,2014,14286,29600,15314,107.19585608287834
Sangali,Bedana,2014,12500,27800,15300,122.4
Sangali,Bedana,2014,11720,26920,15200,129.6928327645051
Rahata,Pomegranate,2015,1000,16188,15188,1518.8
Sangali,Bedana,2015,10222,25400,15178,148.4836626883193
Junnar (Alephata),Pomegranate,2016,2750,17800,15050,547.2727272727273
Khamgaon,Bullack,2016,10000,25000,15000,150.0
Khamgaon,Bullack,2016,10000,25000,15000,150.0
Kalyan,Coriander (Dry),2015,10000,25000,15000,150.0
Khamgaon,Bullack,2015,5000,20000,15000,300.0
Pandharpur,Pomegranate,2016,3409,18245,14836,435.20093869169847
Sangali,Bedana,2015,9750,24550,14800,151.7948717948718
Sangali,Turmeric,2015,7661,22451,14790,193.05573684897533
Indapur,POMEGRANATE,2016,1743,16443,14700,843.3734939759037
Rahata,Pomegranate,2016,250,14623,14373,5749.2
Sangali,Bedana,2015,9875,24175,14300,144.81012658227849
Solapur,Pomegranate,2016,784,14941,14157,1805.7397959183672
Khamgaon,He Buffalo,2016,6000,20000,14000,233.33333333333334
Gadhinglaj,Chillies(Red),2014,3000,17000,14000,466.6666666666667
Rahata,Pomegranate,2015,1500,15413,13913,927.5333333333333
Sangali,Turmeric,2015,7948,21851,13903,174.92450931051837
Indapur,Pomegranate,2016,1500,15360,13860,924.0
Sangli-Phale Bhajipalam,Mango,2016,16621,30270,13649,82.11900607665002
Rahata,Pomegranate,2016,832,14220,13388,1609.1346153846155
Pune,Jui,2014,46667,60000,13333,28.570510210641352
Rahata,Pomegranate,2015,1500,14767,13267,884.4666666666667
Sangali,Bedana,2015,9700,22940,13240,136.49484536082474
Solapur,Pomegranate,2015,558,13771,13213,2367.9211469534052
Mumbai,Mango,2015,10462,23673,13211,126.27604664500096
Sangali,Bedana,2015,9500,22525,13025,137.10526315789474
Kolhapur,Bullock Heart,2015,2000,15000,13000,650.0
Pimpalgaon Basawant,Pomegranate,2016,250,13036,12786,5114.4
Kamthi,Garlic,2016,7333,20000,12667,172.73966998499932
Mumbai,Coriander (Dry),2015,12000,24667,12667,105.55833333333334
Sangali,Bedana,2015,10000,22613,12613,126.13
Sangli-Phale Bhajipalam,Mango,2016,8554,21135,12581,147.07739069441197
Solapur,Pomegranate,2015,868,13432,12564,1447.4654377880183
Sangali,Bedana,2015,9375,21900,12525,133.6
Solapur,Pomegranate,2016,948,13404,12456,1313.9240506329113
Gadhinglaj,Chillies(Red),2016,8788,21200,12412,141.23805188893945
Rahata,Pomegranate,2016,238,12628,12390,5205.882352941177
Sangli-Phale Bhajipalam,CUSTARD APPLE,2016,1288,13500,12212,948.1366459627329
Kolhapur,Mango,2016,5000,17200,12200,244.0
Kamthi,Garlic,2015,2714,14857,12143,447.4207811348563
Rahata,Pomegranate,2015,1500,13595,12095,806.3333333333334
Kolhapur,Custard Apple,2015,658,12740,12082,1836.1702127659576
Solapur,Pomegranate,2016,539,12617,12078,2240.816326530612
Mumbai,Coriander (Dry),2015,10014,22068,12054,120.37147992810065
Kolhapur,CUSTARD APPLE,2016,455,12460,12005,2638.4615384615386
Kolhapur-Laxmipuri,LENTIL,2016,7500,19500,12000,160.0
Kolhapur-Laxmipuri,Lentil,2016,7500,19500,12000,160.0
Chalisgaon,Coriander  ,2016,1633,13594,11961,732.4556031843233
Junnar (Alephata),Pomegranate,2016,2500,14427,11927,477.08
Mumbai,Coriander (Dry),2015,12080,24000,11920,98.67549668874172
Sangali,Bedana,2015,9636,21509,11873,123.21502698215026
Sangali,Bedana,2015,9182,20936,11754,128.01132650838596
Kolhapur-Laxmipuri,Lentil,2016,6667,18413,11746,176.18119094045298
Rahata,Pomegranate,2016,1000,12640,11640,1164.0
Pimpalgaon Basawant,Pomegranate,2015,244,11856,11612,4759.016393442623
Kolhapur-Laxmipuri,Lentil,2016,7657,19238,11581,151.247224761656
Kolhapur,Custard Apple,2015,529,12075,11546,2182.608695652174
Khamgaon,Bullack,2016,8500,20000,11500,135.2941176470588
Pimpalgaon Basawant,Pomegranate,2016,250,11734,11484,4593.6
Indapur,Pomegranate,2016,2000,13464,11464,573.2
Lasalgaon,Pomegranate,2016,250,11714,11464,4585.6
Kurdwadi,Gram,2015,3467,14802,11335,326.93971733487166
Mumbai,Coriander (Dry),2015,10696,22000,11304,105.6843679880329
Kolhapur,Lemon,2016,2850,14150,11300,396.49122807017545
Indapur,Pomegranate,2015,2108,13400,11292,535.673624288425
Lasalgaon,Pomegranate,2016,246,11521,11275,4583.333333333333
Solapur,Pomegranate,2015,1159,12405,11246,970.3192407247627
Pandharpur,Pomegranate,2016,3045,14273,11228,368.735632183908
Kolhapur-Laxmipuri,Lentil,2016,6900,18109,11209,162.44927536231884
Mumbai,Cummin,2015,13667,24762,11095,81.18094680617546
Indapur,Pomegranate,2015,2264,13355,11091,489.8851590106007
Mumbai,Mango,2015,13773,24864,11091,80.52711827488565
Rahata,Pomegranate,2015,1409,12500,11091,787.1540099361249
Solapur,Pomegranate,2015,1109,12161,11052,996.5734896302976
Junnar (Alephata),Pomegranate,2016,2606,13656,11050,424.0214888718342
Rahata,POMEGRANATE,2016,292,11306,11014,3771.917808219178
Mumbai,FENNEL,2016,7000,18000,11000,157.14285714285714
Rahata,Pomegranate,2015,1000,11969,10969,1096.9
Nashik,Mango,2016,9568,20386,10818,113.06438127090301
Kolhapur,Garlic,2015,8409,19182,10773,128.11273635390654
Kolhapur,Lemon,2016,2500,13269,10769,430.76
Ramtek,Gram,2015,4100,14825,10725,261.5853658536585
Rahata,Pomegranate,2015,1458,12175,10717,735.0480109739369
Sangli-Phale Bhajipalam,Apple,2016,5109,15788,10679,209.0232922293991
Pune,Kagda,2014,22667,33333,10666,47.055190364847576
Indapur,Pomegranate,2015,2577,13223,10646,413.11602638727203
Mumbai,Coriander (Dry),2016,7091,17727,10636,149.99294880834861
Kolhapur,Custard Apple,2015,462,11060,10598,2293.939393939394
Indapur,Pomegranate,2014,2188,12725,10537,481.58135283363805
Kolhapur,Custard Apple,2016,420,10850,10430,2483.3333333333335
Rahuri,Pomegranate,2016,200,10625,10425,5212.5
Indapur,Pomegranate,2014,2056,12478,10422,506.9066147859922
Nashik,Garlic,2016,1977,12398,10421,527.1117855336369
Sangli-Phale Bhajipalam,Pomegranate,2016,1000,11400,10400,1040.0
Mumbai-Fruit Market,Mango,2016,4800,15200,10400,216.66666666666666
Indapur,Pomegranate,2015,1917,12300,10383,541.6275430359938
Solapur,Pomegranate,2014,970,11344,10374,1069.4845360824743
Solapur,Pomegranate,2014,1052,11425,10373,986.0266159695817
Gadhinglaj,Chillies(Red),2016,5500,15800,10300,187.27272727272728
Shegaon,Sesamum,2015,6507,16793,10286,158.07591824189333
Karanja,Black Gram,2016,8718,18975,10257,117.65313145216793
Indapur,Pomegranate,2015,2233,12475,10242,458.6654724585759
Kolhapur,Coriander  ,2015,4613,14840,10227,221.69954476479515
Kolhapur,Custard Apple,2016,700,10920,10220,1460.0
Indapur,Pomegranate,2016,1985,12200,10215,514.6095717884131
Nashik,Garlic,2016,1904,12098,10194,535.3991596638656
Mumbai,Coriander (Dry),2016,6167,16333,10166,164.84514350575645
Kolhapur,Mango,2016,3129,13282,10153,324.4806647491211
Rahata,Pomegranate,2016,1000,11132,10132,1013.2
Indapur,Pomegranate,2015,1571,11664,10093,642.4570337364736
Pimpalgaon Basawant,Pomegranate,2016,252,10300,10048,3987.3015873015875
Nashik,Garlic,2016,1971,12002,10031,508.9294774226281
Nashik,Garlic,2015,4519,14537,10018,221.6862137641071
Mumbai,CORIANDER (DRY),2016,6000,16000,10000,166.66666666666666
Junnar (Bhlhe),Bullack,2016,12500,22500,10000,80.0
Mumbai,Coriander (Dry),2016,6000,16000,10000,166.66666666666666
Mumbai,Coriander (Dry),2016,6000,16000,10000,166.66666666666666
Mumbai,Coriander (Dry),2016,6000,16000,10000,166.66666666666666
Korpana,Bullack,2016,15000,25000,10000,66.66666666666667
Junnar (Bhlhe),Bullack,2016,10000,20000,10000,100.0
Pune-Manjri,Green-Peas,2014,0,10000,10000,inf
Mumbai,Coriander (Dry),2016,6000,16000,10000,166.66666666666666
Khamgaon,Bullack,2015,10000,20000,10000,100.0
Junnar (Bhlhe),BUFFALO,2016,15000,25000,10000,66.66666666666667
Khamgaon,Bullack,2016,10000,20000,10000,100.0
Mumbai,Fennel,2016,10000,20000,10000,100.0
Mumbai,Coriander (Dry),2016,6000,16000,10000,166.66666666666666
Mumbai,Fennel,2016,9600,19600,10000,104.16666666666667
Mumbai,Fennel,2016,8182,18182,10000,122.21950623319482
Khamgaon,Bullack,2015,10000,20000,10000,100.0
Sangali,Bedana,2015,9000,18950,9950,110.55555555555556
Solapur,Pomegranate,2015,555,10485,9930,1789.1891891891892
Indapur,Pomegranate,2016,1917,11842,9925,517.73604590506
Pimpalgaon Basawant,Pomegranate,2015,244,10156,9912,4062.2950819672133
Mumbai,Fennel,2015,8952,18857,9905,110.64566577301161
Kolhapur,Apple,2016,3500,13403,9903,282.9428571428571
Solapur,Pomegranate,2014,1159,11059,9900,854.1846419327006
Sangli-Phale Bhajipalam,Apple,2016,6250,16082,9832,157.312
Rahata,Pomegranate,2015,1000,10760,9760,976.0
Sangali,Bedana,2016,10000,19736,9736,97.36
Rahata,Pomegranate,2016,1000,10713,9713,971.3
Sangamner,Pomegranate,2016,1000,10665,9665,966.5
Sangamner,Pomegranate,2016,981,10615,9634,982.0591233435271
Pune,Chillies(Red),2014,6370,16000,9630,151.1773940345369
Solapur,Matki,2016,5673,15288,9615,169.48704389212057
Rahata,Pomegranate,2014,1479,11067,9588,648.2758620689655
Sangli-Phale Bhajipalam,Apple,2016,6353,15932,9579,150.7791594522273
Sangli-Phale Bhajipalam,Pomegranate,2016,4191,13759,9568,228.29873538534954
Kolhapur-Laxmipuri,Lentil,2016,6712,16269,9557,142.38676996424314
Pune,Coriander (Dry),2014,10444,20000,9556,91.49751053236308
Mumbai,Fennel,2016,7556,17111,9555,126.45579671784013
Indapur,Pomegranate,2016,1077,10631,9554,887.0937790157845
Rahata,Pomegranate,2014,1396,10942,9546,683.810888252149
Sangli-Phale Bhajipalam,Apple,2016,6347,15868,9521,150.00787773751378
Rahata,Pomegranate,2016,1000,10512,9512,951.2
Indapur,Pomegranate,2016,1050,10550,9500,904.7619047619048
Pune,Custard Apple,2015,2167,11667,9500,438.39409321642825
Mumbai,Coriander (Dry),2015,8413,17853,9440,112.20729822893142
Barshi,Sesamum,2014,1075,10500,9425,876.7441860465116
Indapur,Pomegranate,2016,958,10367,9409,982.1503131524008
Kolhapur,Coriander  ,2016,5204,14511,9307,178.84319754035357
Rahata,Pomegranate,2014,1281,10563,9282,724.5901639344262
Mumbai,Pomegranate,2015,4760,14040,9280,194.9579831932773
Kamthi,Garlic,2016,6375,15625,9250,145.09803921568627
Indapur,Pomegranate,2016,1575,10775,9200,584.1269841269841
Rahata,Pomegranate,2015,1000,10146,9146,914.6
Kolhapur,APPLE,2016,2960,12090,9130,308.44594594594594
Mumbai,Mango,2015,8423,17462,9039,107.31330879734061
Tasgaon,Bedana,2015,6052,15085,9033,149.256444150694
Mumbai,Chillies(Red),2016,13000,22000,9000,69.23076923076923
Sangli-Phale Bhajipalam,Apple,2016,4219,13193,8974,212.704432329936
Kolhapur,Apple,2016,4647,13618,8971,193.04927910479879
Kolhapur,Apple,2015,2131,11095,8964,420.64758329422807
Indapur,Pomegranate,2015,1388,10338,8950,644.8126801152738
Indapur,Pomegranate,2015,1808,10754,8946,494.8008849557522
Rahata,Pomegranate,2016,1000,9928,8928,892.8
Pandharpur,Pomegranate,2016,2500,11371,8871,354.84
Kolhapur,Custard Apple,2015,374,9217,8843,2364.438502673797
Solapur,Pomegranate,2015,1021,9858,8837,865.5239960822723
Sangli-Phale Bhajipalam,Apple,2015,3655,12489,8834,241.69630642954857
Nagpur,Apple,2016,4570,13391,8821,193.01969365426694
Kalyan,Ladies Finger,2014,1200,10000,8800,733.3333333333334
Sangali,Bedana,2016,10000,18793,8793,87.93
Kolhapur,Apple,2016,2719,11459,8740,321.4417065097462
Pimpalgaon Basawant,Pomegranate,2015,250,8988,8738,3495.2
Kolhapur,Garlic,2016,5455,14182,8727,159.98166819431714
Solapur,Pomegranate,2016,403,9115,8712,2161.786600496278
Rahata,Pomegranate,2015,1026,9737,8711,849.0253411306043
Solapur,Pomegranate,2015,940,9646,8706,926.1702127659574
Solapur,POMEGRANATE,2016,558,9263,8705,1560.0358422939069
Sangamner,Pomegranate,2015,2381,11081,8700,365.39269214615706
Junnar (Alephata),Pomegranate,2016,3000,11696,8696,289.8666666666667
Pune,Chillies(Red),2014,7240,15933,8693,120.06906077348066
Rahuri,Mango,2016,317,9000,8683,2739.116719242902
Karad,Apple,2014,7833,16500,8667,110.64726158559938
Tasgaon,Bedana,2015,6334,15000,8666,136.8171771392485
Kolhapur-Laxmipuri,Lentil,2016,6492,15132,8640,133.08687615526802
Lasalgaon,Pomegranate,2016,237,8860,8623,3638.396624472574
Solapur,Pomegranate,2015,935,9550,8615,921.3903743315508
Sangamner,Pomegranate,2016,858,9460,8602,1002.5641025641025
Nashik,Mango,2016,11833,20417,8584,72.54288853207133
Mumbai,Chillies(Red),2016,8130,16696,8566,105.36285362853629
Sangli-Phale Bhajipalam,Apple,2016,5156,13719,8563,166.07835531419704
Mumbai,Coriander (Dry),2014,12889,21444,8555,66.37442780665684
Sangamner,Pomegranate,2016,643,9195,8552,1330.0155520995334
Mumbai,Pomegranate,2015,3335,11885,8550,256.3718140929535
Solapur,Pomegranate,2016,678,9178,8500,1253.6873156342183
Kolhapur,Pomegranate,2016,1500,10000,8500,566.6666666666666
Solapur,CHILLIES(RED),2016,3239,11689,8450,260.88298857672123
Gevrai,Pigeon Pea (Tur),2015,4636,13085,8449,182.24762726488353
Rahata,Pomegranate,2015,1150,9590,8440,733.9130434782609
Solapur,Pomegranate,2016,421,8858,8437,2004.038004750594
Tasgaon,Bedana,2016,6620,15013,8393,126.78247734138972
Kolhapur-Laxmipuri,Chillies(Red),2016,17875,26250,8375,46.85314685314685
Nagpur,Apple,2015,4315,12674,8359,193.71958285052145
Tasgaon,Bedana,2015,6506,14858,8352,128.37380879188441
Mumbai,Fennel,2015,7444,15778,8334,111.95593766792047
Jalgaon,Garlic,2016,3667,12000,8333,227.242977911099
Mumbai,Turmeric,2015,10000,18333,8333,83.33
Mumbai,Chillies(Red),2015,9000,17333,8333,92.58888888888889
Pimpalgaon Basawant,Pomegranate,2014,257,8567,8310,3233.463035019455
Pune-Manjri,Green-Peas,2014,0,8300,8300,inf
Kolhapur-Laxmipuri,Lentil,2016,5800,14092,8292,142.9655172413793
Solapur,Pomegranate,2016,487,8773,8286,1701.4373716632444
Pimpalgaon Basawant,Pomegranate,2014,250,8509,8259,3303.6
Sangali,Bedana,2016,9091,17336,8245,90.6940930590694
Tasgaon,Bedana,2015,6262,14500,8238,131.5554136058767
Pune,Chillies(Red),2014,7438,15625,8187,110.06991126646948
Mumbai,Coriander (Dry),2015,14000,22182,8182,58.44285714285714
Tasgaon,Bedana,2015,5833,14000,8167,140.01371506943255
Ahmednagar,Garlic,2016,6756,14889,8133,120.38188277087033
Nashik,Garlic,2016,2221,10345,8124,365.78117964880687
Rahuri,POMEGRANATE,2016,200,8311,8111,4055.5
Kolhapur,Pomegranate,2016,2000,10111,8111,405.55
Mumbai,Fennel,2015,9000,17105,8105,90.05555555555556
Kolhapur,Lemon,2016,1979,10083,8104,409.49974734714505
Sangamner,Pomegranate,2016,914,9015,8101,886.3238512035011
Sangamner,Pomegranate,2015,2424,10524,8100,334.15841584158414
Mumbai,Coriander (Dry),2015,12364,20455,8091,65.43998705920414
Latur,Tamarind,2016,7450,15525,8075,108.38926174496645
Mumbai,Cummin,2015,12929,21000,8071,62.42555495397943
Pimpalgaon Basawant,POMEGRANATE,2016,250,8312,8062,3224.8
Solapur,Pomegranate,2015,748,8792,8044,1075.4010695187167
Kamthi,Custard Apple,2014,2000,10000,8000,400.0
Kalyan,Shewanti,2016,12000,20000,8000,66.66666666666667
Mumbai,Fennel,2016,6000,14000,8000,133.33333333333334
Mumbai,Chillies(Red),2016,14000,22000,8000,57.142857142857146
Mumbai,Fennel,2016,6000,14000,8000,133.33333333333334
Indapur,Pomegranate,2014,2000,10000,8000,400.0
Tasgaon,Bedana,2015,6353,14328,7975,125.53124508106407
Kolhapur,Apple,2016,3423,11394,7971,232.86590709903592
Kolhapur,Coriander  ,2016,3500,11458,7958,227.37142857142857
Solapur,Pomegranate,2015,472,8423,7951,1684.5338983050847
Nashik,Cucumber,2015,1625,9563,7938,488.4923076923077
Sangali,Bedana,2016,9500,17438,7938,83.5578947368421
Indapur,Pomegranate,2016,1120,9050,7930,708.0357142857143
Nampur,Pomegranate,2016,926,8852,7926,855.939524838013
Nashik,Garlic,2016,2238,10162,7924,354.0661304736372
Solapur,Pomegranate,2016,528,8448,7920,1500.0
Mumbai,Chillies(Red),2016,7087,15000,7913,111.65514321998025
Solapur,Pomegranate,2016,454,8336,7882,1736.123348017621
Kolhapur-Laxmipuri,Chillies(Red),2016,17125,25000,7875,45.98540145985402
Indapur,Pomegranate,2015,1754,9623,7869,448.63169897377423
Mumbai,Coriander (Dry),2015,6000,13867,7867,131.11666666666667
Rahata,Pomegranate,2014,1435,9285,7850,547.0383275261324
Solapur,Pomegranate,2015,973,8773,7800,801.6443987667009
Indapur,Pomegranate,2015,1225,9025,7800,636.734693877551
Dhule,Chillies(Red),2015,3700,11500,7800,210.8108108108108
Kolhapur,Apple,2015,4058,11856,7798,192.1636274026614
Solapur,Lemon,2016,1090,8883,7793,714.954128440367
Sangli-Phale Bhajipalam,Apple,2016,4747,12500,7753,163.3242047609016
Solapur,Chillies(Red),2015,8592,16344,7752,90.22346368715084
Mumbai,Mango,2015,5500,13250,7750,140.9090909090909
Mumbai,Chillies(Red),2015,9417,17165,7748,82.27673356695338
Nashik,Garlic,2015,4625,12363,7738,167.30810810810812
Kamthi,Garlic,2014,2286,10000,7714,337.4453193350831
Nagpur,Apple,2016,3996,11704,7708,192.8928928928929
Sangamner,Pomegranate,2016,695,8390,7695,1107.1942446043165
Sangamner,Pomegranate,2016,765,8447,7682,1004.1830065359477
Nagpur,Apple,2016,5531,13212,7681,138.8718134152956
Pimpalgaon Basawant,Pomegranate,2015,250,7929,7679,3071.6
Solapur,Pomegranate,2014,1173,8835,7662,653.1969309462916
Sangali,Bedana,2016,10000,17650,7650,76.5
Tasgaon,Bedana,2015,6892,14539,7647,110.95473012188044
Dhule,Chillies(Red),2016,7767,15400,7633,98.2747521565598
Nampur,Pomegranate,2016,226,7848,7622,3372.566371681416
Rahuri,Pomegranate,2016,200,7813,7613,3806.5
Pimpalgaon Basawant,Pomegranate,2016,340,7929,7589,2232.0588235294117
Pimpalgaon Basawant,Pomegranate,2015,625,8202,7577,1212.32
Kolhapur-Laxmipuri,Lentil,2016,7165,14695,7530,105.09420795533845
Mumbai,Chillies(Red),2015,9381,16905,7524,80.20466901183242
Pune-Manjri,Ghevda,2016,0,7500,7500,inf
Pune,Garlic,2015,7773,15273,7500,96.48784253184098
Palus,Goats,2016,2500,10000,7500,300.0
Phaltan,Pomegranate,2015,1500,9000,7500,500.0
Indapur,Pomegranate,2015,1500,9000,7500,500.0
Pune,Chillies(Red),2015,4500,12000,7500,166.66666666666666
Kamthi,Garlic,2016,4920,12400,7480,152.03252032520325
Kolhapur-Malkapur,Coriander  ,2016,3267,10733,7466,228.52770125497398
Mumbai,Coriander (Dry),2015,7261,14717,7456,102.68558049855392
Sangamner,POMEGRANATE,2016,697,8147,7450,1068.8665710186513
Kolhapur,Pomegranate,2016,2357,9786,7429,315.18879932117096
Tasgaon,Bedana,2014,12806,20214,7408,57.847883804466655
Pune,Ghevda,2015,3729,11125,7396,198.33735585947974
Mumbai,Chillies(Red),2016,13391,20783,7392,55.20125457396759
Pune,Chillies(Red),2015,8125,15500,7375,90.76923076923077
Kolhapur,Apple,2016,5083,12452,7369,144.97344088136927
Kolhapur,Garlic,2016,5158,12526,7368,142.84606436603335
Sangali,Turmeric,2015,7580,14925,7345,96.89973614775725
Sangamner,Pomegranate,2016,724,8061,7337,1013.3977900552486
Kamthi,Garlic,2015,2667,10000,7333,274.9531308586427
Amarawati,Custard Apple,2016,6814,14143,7329,107.55796888758438
Solapur,Lemon,2016,226,7537,7311,3234.9557522123896
Pimpalgaon Basawant,Pomegranate,2014,250,7538,7288,2915.2
Kolhapur-Laxmipuri,Lentil,2015,8023,15304,7281,90.75158918110432
Kolhapur,Custard Apple,2016,560,7840,7280,1300.0
Sangamner,Pomegranate,2015,2077,9346,7269,349.97592681752525
Nashik,Pomegranate,2015,2500,9750,7250,290.0
Pune,Coriander (Dry),2015,10667,17889,7222,67.70413424580482
Kolhapur-Laxmipuri,Lentil,2016,6883,14104,7221,104.91064942612233
Tasgaon,Bedana,2016,6335,13548,7213,113.85951065509076
Nilanga,Pigeon Pea (Tur),2015,8262,15466,7204,87.19438392641007
Kolhapur,Apple,2016,7024,14226,7202,102.53416856492028
Pimpalgaon Basawant,Pomegranate,2015,250,7434,7184,2873.6
Kolhapur,Pomegranate,2015,2031,9213,7182,353.6189069423929
Tasgaon,Bedana,2015,8695,15868,7173,82.49568717653824
Phaltan,Pomegranate,2016,1479,8650,7171,484.85463150777554
Kolhapur,Apple,2016,5740,12904,7164,124.80836236933798
Sangli-Phale Bhajipalam,Mosambi,2015,3179,10333,7154,225.03932054105064
Kamthi,Garlic,2014,2889,10000,7111,246.1405330564209
Solapur,Pomegranate,2016,504,7608,7104,1409.5238095238096
Kamthi,Garlic,2016,4633,11722,7089,153.01100798618606
Chandrapur,Apple,2016,3190,10262,7072,221.69278996865205
Pimpalgaon Basawant,Pomegranate,2015,353,7414,7061,2000.2832861189802
Mumbai,Chillies(Red),2016,12000,19059,7059,58.825
Pune,Lemon,2016,875,7933,7058,806.6285714285714
Mumbai,Betelnuts,2014,29684,36737,7053,23.760274895566635
Mumbai,Turmeric,2015,10550,17600,7050,66.82464454976304
Kamthi,Custard Apple,2014,2835,9882,7047,248.57142857142858
Solapur,Chillies(Red),2016,5417,12461,7044,130.03507476462988
Sangamner,Pomegranate,2015,3522,10565,7043,199.97160704145372
Kolhapur,Pomegranate,2016,2154,9192,7038,326.7409470752089
Mumbai,Coriander (Dry),2014,13150,20167,7017,53.361216730038024
Solapur,Pomegranate,2015,772,7784,7012,908.2901554404145
Mumbai,Chillies(Red),2015,8000,15000,7000,87.5
Daryapur,Bullack,2015,25000,32000,7000,28.0
Pune,Chillies(Red),2015,8000,15000,7000,87.5
Mumbai,Tamarind,2016,8000,15000,7000,87.5
Mumbai,Tamarind,2016,8000,15000,7000,87.5
Mumbai,Chillies(Red),2016,12000,19000,7000,58.333333333333336
Aurangabad,Ground Nut Pods (Dry),2015,2375,9358,6983,294.0210526315789
Junnar (Alephata),POMEGRANATE,2016,3300,10270,6970,211.21212121212122
Atpadi,Pomegranate,2016,1520,8456,6936,456.3157894736842
Sangamner,Pomegranate,2015,2261,9196,6935,306.7226890756302
Ahmednagar,Tamarind,2016,6842,13767,6925,101.21309558608594
Chandrapur,APPLE,2016,2853,9765,6912,242.27129337539432
Mumbai,Coriander (Dry),2015,11800,18700,6900,58.47457627118644
Kolhapur,Pomegranate,2015,1800,8700,6900,383.3333333333333
Tasgaon,Bedana,2016,6303,13200,6897,109.42408376963351
Sangli-Phale Bhajipalam,Mango,2016,4881,11775,6894,141.24154886293792
Nampur,POMEGRANATE,2016,247,7128,6881,2785.8299595141702
Mumbai,Chillies(Red),2015,7875,14750,6875,87.3015873015873
Mumbai,Coriander (Dry),2015,7917,14792,6875,86.83844890741443
Kolhapur,Lemon,2015,1650,8500,6850,415.1515151515151
Sangali,Bedana,2016,9000,15850,6850,76.11111111111111
Pune-Manjri,Green-Peas,2015,813,7663,6850,842.5584255842558
Nashik,Apple,2016,9182,16018,6836,74.45001089087344
Nashik,Apple,2016,7575,14400,6825,90.0990099009901
Kolhapur,Garlic,2016,6190,13000,6810,110.01615508885298
Mumbai,Fennel,2015,8260,15067,6807,82.409200968523
Indapur,Pomegranate,2015,1292,8092,6800,526.3157894736842
Amarawati,Apple,2016,6000,12800,6800,113.33333333333333
Nashik,Apple,2016,11200,18000,6800,60.714285714285715
Pune-Pimpri,Coriander (Dry),2015,10800,17600,6800,62.96296296296296
Pune-Manjri,Green Chilli,2016,0,6800,6800,inf
Dhule,Chillies(Red),2015,4300,11091,6791,157.93023255813952
Pune,Garlic,2016,6043,12826,6783,112.24557339069999
Mumbai,Coriander (Dry),2014,13304,20087,6783,50.984666265784725
Mumbai,Cummin,2015,15000,21773,6773,45.153333333333336
Kolhapur,Apple,2015,2969,9734,6765,227.85449646345572
Nagpur,Apple,2015,3640,10396,6756,185.6043956043956
Pune,Coriander (Dry),2014,10750,17500,6750,62.7906976744186
Tasgaon,Bedana,2015,5713,12463,6750,118.15158410642394
Lasalgaon,POMEGRANATE,2016,250,7000,6750,2700.0
Pune-Manjri,Cluster Bean,2016,0,6750,6750,inf
Pimpalgaon Basawant,Pomegranate,2016,250,6982,6732,2692.8
Kolhapur,Math (Bhaji),2016,4846,11577,6731,138.89806025588115
Mumbai,Cummin,2015,17364,24091,6727,38.741073485372034
Sangli-Phale Bhajipalam,Orange,2016,3280,10000,6720,204.8780487804878
Mumbai,Chillies(Red),2016,12143,18857,6714,55.29111422218562
Pune,Coriander (Dry),2015,10000,16714,6714,67.14
Nagpur,Garlic,2016,4542,11250,6708,147.6882430647292
Kolhapur,Garlic,2015,4688,11375,6687,142.64078498293514
Amarawati,Garlic,2016,6071,12750,6679,110.01482457585242
Nashik,Apple,2016,9333,16000,6667,71.43469409621773
Pune,Coriander (Dry),2016,8111,14778,6667,82.1970163974849
Amarawati,Garlic,2016,5846,12500,6654,113.82141635306192
Kolhapur,Garlic,2016,3957,10609,6652,168.10715188273946
Mumbai,Turmeric,2014,8000,14644,6644,83.05
Amarawati-Fruit And Vegetables,Garlic,2016,6000,12643,6643,110.71666666666667
Mumbai,Chillies(Red),2015,8455,15091,6636,78.48610289769367
Atpadi,Pomegranate,2016,1917,8550,6633,346.0093896713615
Phaltan,Pomegranate,2016,1471,8103,6632,450.84976206662134
Sangamner,Pomegranate,2015,2257,8870,6613,292.9995569339832
Kurdwadi-Modnimb,Chillies(Red),2016,3000,9600,6600,220.0
Tasgaon,Bedana,2016,6529,13102,6573,100.6739163731046
Sangali,Turmeric,2015,7221,13793,6572,91.01232516271985
Sangamner,Pomegranate,2014,3250,9813,6563,201.93846153846152
Nashik,Apple,2016,8150,14700,6550,80.3680981595092
Sangamner,Pomegranate,2015,1281,7829,6548,511.1631537861046
Amarawati,Apple,2016,6923,13462,6539,94.45327170301893
Solapur,Chillies(Red),2015,4075,10600,6525,160.12269938650306
Mumbai,Cummin,2016,16348,22870,6522,39.89478835331539
Sangali,Bedana,2016,9889,16389,6500,65.72959854383659
Pune,Gulchadi,2014,18250,24750,6500,35.61643835616438
Kolhapur,Pomegranate,2015,1700,8200,6500,382.3529411764706
Kolhapur,Math (Bhaji),2016,3300,9800,6500,196.96969696969697
Pune,Chillies(Red),2014,7500,14000,6500,86.66666666666667
Mumbai,Pomegranate,2015,4815,11296,6481,134.60020768431983
Junnar (Alephata),Pomegranate,2016,3190,9669,6479,203.10344827586206
Mumbai,Coriander (Dry),2014,12476,18952,6476,51.90766271240782
Dhule,Chillies(Red),2016,5500,11950,6450,117.27272727272727
Phaltan,Pomegranate,2016,1474,7914,6440,436.9063772048847
Mumbai,Coriander (Dry),2016,4143,10571,6428,155.15327057687665
Mumbai,Fennel,2016,8947,15368,6421,71.7670727618196
Sangali,Bedana,2016,10000,16420,6420,64.2
Kolhapur-Laxmipuri,Lentil,2016,7825,14233,6408,81.89137380191693
Pimpalgaon Basawant,Pomegranate,2014,839,7243,6404,763.2896305125149
Kamthi,Custard Apple,2015,3075,9475,6400,208.130081300813
Pune-Manjri,Green-Peas,2015,0,6400,6400,inf
Kamthi,Garlic,2016,5200,11600,6400,123.07692307692308
Pune,Coriander (Dry),2015,11267,17667,6400,56.803053164107574
Amarawati,Apple,2016,7789,14184,6395,82.10296572088843
Pune,Coriander (Dry),2016,8705,15100,6395,73.46352670878805
Mehkar,Pigeon Pea (Tur),2016,7062,13454,6392,90.51260266213538
Mumbai,Apple,2016,2586,8976,6390,247.0997679814385
Latur,Tamarind,2016,6737,13124,6387,94.80480926228292
Solapur,Chillies(Red),2016,6960,13340,6380,91.66666666666667
Aurangabad,Garlic,2016,6125,12500,6375,104.08163265306122
Solapur,Chillies(Red),2016,7339,13705,6366,86.74206295135578
Pandharpur,Pomegranate,2015,2883,9246,6363,220.70759625390218
Nagpur,Pomegranate,2016,975,7338,6363,652.6153846153846
Pune,Green Gram,2015,7133,13492,6359,89.14902565540446
Mumbai,Mango,2016,17985,24335,6350,35.30720044481512
Sangola,Pomegranate,2016,938,7288,6350,676.9722814498934
Mumbai-Fruit Market,Apple,2016,2650,9000,6350,239.62264150943398
Kolhapur,Coriander  ,2016,2148,8495,6347,295.48417132216014
Rahuri,Pomegranate,2016,225,6570,6345,2820.0
Sangali,Turmeric,2015,5732,12073,6341,110.62456385205861
Sangamner,Pomegranate,2014,3722,10056,6334,170.17732401934444
Kalyan,Coriander (Dry),2016,8000,14333,6333,79.1625
Kalyan,Coriander (Dry),2016,7840,14160,6320,80.61224489795919
Aurangabad,Garlic,2016,7250,13563,6313,87.07586206896552
Tasgaon,Bedana,2016,5912,12194,6282,106.25845737483085
Kolhapur,Pomegranate,2015,1443,7717,6274,434.7886347886348
Amarawati-Fruit And Vegetables,Apple,2016,7091,13364,6273,88.46425045832746
Solapur,Chillies(Red),2016,6885,13158,6273,91.11111111111111
Mumbai,Chillies(Red),2015,7688,13960,6272,81.58168574401665
Solapur,Lemon,2016,217,6488,6271,2889.861751152074
Pune-Manjri,Walvad,2016,0,6267,6267,inf
Mumbai,Apple,2016,2745,9000,6255,227.86885245901638
Sangola,Pomegranate,2016,469,6719,6250,1332.6226012793177
Pimpalgaon Basawant,Pomegranate,2016,244,6484,6240,2557.377049180328
Bhiwapur,Orange,2016,3913,10138,6225,159.08510094556607
Tasgaon,Bedana,2016,6612,12836,6224,94.1318814277072
Sangamner,Pomegranate,2015,2130,8348,6218,291.92488262910797
Tasgaon,Bedana,2016,6227,12436,6209,99.71093624538301
Kolhapur,Lemon,2015,900,7100,6200,688.8888888888889
Kamthi,Ginger (Fresh),2014,2900,9100,6200,213.79310344827587
Indapur,Pomegranate,2014,1667,7867,6200,371.9256148770246
Armori-Desaiganj,Chillies(Red),2015,7000,13200,6200,88.57142857142857
Pimpalgaon Basawant,Pomegranate,2016,298,6496,6198,2079.8657718120803
Atpadi,POMEGRANATE,2016,1481,7670,6189,417.89331532748145
Kamthi,Garlic,2015,5273,11455,6182,117.23876351223213
Atpadi,Pomegranate,2016,2000,8177,6177,308.85
Kalyan,Apple,2015,7333,13500,6167,84.09927723987454
Tasgaon,Bedana,2015,13283,19449,6166,46.42023639238124
Mumbai,Coriander (Dry),2016,8000,14154,6154,76.925
Umared,Chillies(Red),2016,5350,11500,6150,114.95327102803738
Kolhapur,POMEGRANATE,2016,2364,8500,6136,259.5600676818951
Sangli-Phale Bhajipalam,Apple,2016,5019,11151,6132,122.17573221757323
Nashik,Garlic,2016,2190,8321,6131,279.95433789954336
Nagpur,Pomegranate,2016,1020,7144,6124,600.3921568627451
Kolhapur,Apple,2016,8571,14690,6119,71.39190292847975
Amarawati-Fruit And Vegetables,Garlic,2016,6035,12150,6115,101.32560066280033
Pandharpur,Pomegranate,2016,1805,7919,6114,338.72576177285316
Pimpalgaon Basawant,Pomegranate,2016,298,6410,6112,2051.006711409396
Tasgaon,Bedana,2015,11963,18067,6104,51.02399063779988
Rahuri,Green Chilli,2016,400,6500,6100,1525.0
Ahmednagar,Garlic,2016,7313,13406,6093,83.31738000820457
Nashik,Garlic,2016,3105,9191,6086,196.00644122383252
Pandharpur,POMEGRANATE,2016,1714,7800,6086,355.07584597432907
Kolhapur,Lemon,2016,1223,7304,6081,497.2199509403107
Sangali,Turmeric,2015,7481,13561,6080,81.27255714476674
Tasgaon,Bedana,2014,12600,18673,6073,48.198412698412696
Pimpalgaon Basawant,Pomegranate,2015,250,6313,6063,2425.2
Rahuri,Pomegranate,2016,200,6256,6056,3028.0
Mumbai,Coriander (Dry),2015,7789,13842,6053,77.71215817178071
Mumbai,Custard Apple,2016,3000,9050,6050,201.66666666666666
Shegaon,Thymol/Lovage,2015,8036,14084,6048,75.26132404181185
Pimpalgaon Basawant,Pomegranate,2016,262,6310,6048,2308.3969465648856
Mumbai,Chillies(Red),2015,8000,14045,6045,75.5625
Pune-Manjri,Cluster Bean,2015,1188,7231,6043,508.67003367003366
Chandrapur,Apple,2014,2687,8726,6039,224.74879047264608
Mumbai,Fennel,2016,4975,11013,6038,121.36683417085428
Aurangabad,Garlic,2016,3875,9900,6025,155.48387096774192
Sangli-Phale Bhajipalam,Pomegranate,2015,2038,8063,6025,295.63297350343476
Pimpalgaon Basawant,Pomegranate,2015,1026,7044,6018,586.5497076023391
Shegaon,Thymol/Lovage,2016,10000,16013,6013,60.13
Mumbai,Cummin,2016,15619,21619,6000,38.41475126448556
Lasalgaon-Vinchur,Green Gram,2015,3000,9000,6000,200.0
Mumbai,Cummin,2015,14000,20000,6000,42.857142857142854
Mumbai,Cummin,2015,13667,19667,6000,43.90136825931075
Sangali,Matki,2014,5567,11567,6000,107.77797736662475
Amarawati,Chillies(Red),2016,7333,13333,6000,81.82190099549979
Kamthi,Garlic,2015,4000,10000,6000,150.0
Karad,Apple,2016,20762,26762,6000,28.89895000481649
Kolhapur,Apple,2015,3717,9717,6000,161.42050040355124
Khamgaon,Male Goat,2014,2000,8000,6000,300.0
Kalyan (Cattle Market),Kalvad,2016,12000,18000,6000,50.0
Kamthi,Garlic,2014,2750,8750,6000,218.1818181818182
Mumbai,Cummin,2016,21364,27364,6000,28.084628346751543
Mumbai,CUMMIN,2016,14000,20000,6000,42.857142857142854
Pune,Coriander (Dry),2015,11000,17000,6000,54.54545454545455
Mumbai,Chillies(Red),2016,12045,18045,6000,49.813200498132005
Sangli-Phale Bhajipalam,Orange,2016,2000,8000,6000,300.0
Junnar,Garlic,2015,7000,13000,6000,85.71428571428571
Jalgaon,Garlic,2015,8000,14000,6000,75.0
Nagpur,Pomegranate,2016,1444,7439,5995,415.1662049861496
Sangali,Bedana,2016,10000,15989,5989,59.89
Mumbai,Custard Apple,2015,2833,8817,5984,211.22484998235086
Dhule,Chillies(Red),2015,5133,11100,5967,116.2478082992402
Pandharpur,Pomegranate,2015,1896,7854,5958,314.24050632911394
Kamthi,Wal Bhaji,2014,2711,8667,5956,219.69752858723717
Sangola,Pomegranate,2016,1715,7670,5955,347.23032069970844
Nandgaon,Ground Nut Pods (Dry),2015,3973,9925,5952,149.81122577397431
Sangamner,Pomegranate,2015,1362,7314,5952,437.0044052863436
Mehkar,Pigeon Pea (Tur),2015,4150,10101,5951,143.3975903614458
Tasgaon,Bedana,2016,6414,12362,5948,92.73464296850639
Pune-Manjri,Curry Leaves,2016,0,5942,5942,inf
Pune-Manjri,Cluster Bean,2015,1375,7313,5938,431.8545454545455
Sangli-Phale Bhajipalam,Pomegranate,2016,1155,7091,5936,513.939393939394
Bhiwapur,Gram,2016,4004,9938,5934,148.2017982017982
Kamthi,Methi (Bhaji),2015,2879,8810,5931,206.00903091351162
Solapur,Chillies(Red),2016,7073,13002,5929,83.8258164852255
Sangali,Turmeric,2016,9100,15011,5911,64.95604395604396
Satana,Pomegranate,2016,659,6569,5910,896.8133535660091
Nagpur,Lemon,2016,3428,9338,5910,172.40373395565928
Tasgaon,Bedana,2015,11843,17751,5908,49.886008612682595
Junnar-Otur,Green Chilli,2016,3300,9207,5907,179.0
Kolhapur,Garlic,2016,5000,10900,5900,118.0
Osmanabad,Garlic,2016,2350,8250,5900,251.06382978723406
Nashik,Apple,2016,9100,15000,5900,64.83516483516483
Kolhapur,Apple,2016,8400,14300,5900,70.23809523809524
Bhiwapur,Chillies(Red),2015,3200,9100,5900,184.375
Kolhapur,Custard Apple,2015,432,6323,5891,1363.6574074074074
Kolhapur,Lemon,2015,1783,7667,5884,330.00560852495795
Shegaon,Thymol/Lovage,2016,10175,16053,5878,57.76904176904177
Pune-Manjri,Green-Peas,2015,1246,7115,5869,471.02728731942216
Pune,Coriander (Dry),2015,11400,17250,5850,51.31578947368421
Nagpur,Garlic,2016,5550,11400,5850,105.4054054054054
Aurangabad,Mosambi,2015,2721,8568,5847,214.88423373759647
Nagpur,Garlic,2015,6822,12667,5845,85.67868660216945
Sangamner,Pomegranate,2016,788,6632,5844,741.6243654822335
Nampur,Pomegranate,2016,621,6463,5842,940.7407407407408
Chandrapur,Apple,2014,2164,8000,5836,269.68576709796673
Chandrapur,Pomegranate,2016,3400,9233,5833,171.55882352941177
Mumbai,Turmeric,2015,9556,15389,5833,61.040184177480114
Kamthi,Garlic,2016,8000,13833,5833,72.9125
Phaltan,Pomegranate,2016,1320,7135,5815,440.530303030303
Sangli-Phale Bhajipalam,Garlic,2016,4156,9969,5813,139.87006737247353
Malkapur,Chillies(Red),2015,5219,11031,5812,111.36232994826595
Sangamner,Pomegranate,2016,816,6623,5807,711.6421568627451
Pune-Manjri,Bitter Gourd,2016,0,5800,5800,inf
Armori,Chillies(Red),2016,9667,15467,5800,59.99793110582394
Bhiwapur,Chillies(Red),2016,5600,11400,5800,103.57142857142857
Nagpur,Garlic,2016,5500,11286,5786,105.2
Kolhapur,Coriander  ,2015,2800,8583,5783,206.53571428571428
Mumbai,Tamarind,2015,5891,11673,5782,98.14971991172976
Tasgaon,Bedana,2016,6221,12000,5779,92.89503295290146
Mumbai,Cummin,2015,16900,22678,5778,34.18934911242604
Amarawati,Chillies(Red),2016,7000,12773,5773,82.47142857142858
Karad,Apple,2016,18385,24154,5769,31.378841446831657
Nagpur,Pomegranate,2016,1455,7223,5768,396.426116838488
Solapur,Lemon,2014,581,6336,5755,990.5335628227194
Mumbai,Fennel,2015,13908,19662,5754,41.37187230371009
Kamthi,Mango,2015,3125,8875,5750,184.0
Rahuri,Pomegranate,2015,500,6250,5750,1150.0
Bhiwapur,Chillies(Red),2016,7000,12750,5750,82.14285714285714
Atpadi,Pomegranate,2016,1781,7525,5744,322.51544076361597
Sangali,Bedana,2016,9700,15440,5740,59.175257731958766
Amarawati,Garlic,2016,6525,12250,5725,87.73946360153256
Aurangabad,GARLIC,2016,6056,11778,5722,94.48480845442536
Kolhapur-Laxmipuri,Chillies(Red),2016,19280,25000,5720,29.66804979253112
Lohara,Pigeon Pea (Tur),2015,9022,14741,5719,63.38949235202838
Nashik,Apple,2016,5594,11313,5719,102.23453700393279
Mumbai,Apple,2016,2648,8365,5717,215.8987915407855
Aurangabad,Garlic,2016,6714,12429,5715,85.12064343163539
Kolhapur,Math (Bhaji),2015,4295,10007,5712,132.9918509895227
Pune,Garlic,2016,7308,13019,5711,78.14723590585659
Solapur,Mula Shenga,2014,300,6000,5700,1900.0
Aurangabad,Apple,2016,3300,9000,5700,172.72727272727272
Pimpalgaon Basawant,Pomegranate,2016,292,5985,5693,1949.6575342465753
Phaltan,POMEGRANATE,2016,1292,6979,5687,440.1702786377709
Nashik,Coriander  ,2016,2842,8527,5685,200.03518648838846
Kolhapur,Coriander  ,2015,1954,7633,5679,290.6345957011259
Rahuri,Pomegranate,2016,200,5875,5675,2837.5
Sangola,Pomegranate,2016,2054,7723,5669,275.99805258033103
Kamthi,Ginger (Fresh),2014,2667,8333,5666,212.44844394450695
Kamthi,Garlic,2015,4667,10333,5666,121.40561388472251
Kalyan,Coriander (Dry),2015,8667,14333,5666,65.37440867658937
Mumbai,Tamarind,2015,5667,11333,5666,99.9823539791777
Mumbai,Cummin,2015,14346,20000,5654,39.41168269901018
Amarawati,Chillies(Red),2016,7000,12654,5654,80.77142857142857
Karad,Apple,2014,5763,11406,5643,97.91775117126497
Kamthi,Garlic,2015,6273,11909,5636,89.84536904192571
Amarawati-Fruit And Vegetables,Garlic,2016,6500,12130,5630,86.61538461538461
Mumbai,Chillies(Red),2015,9036,14664,5628,62.28419654714475
Sangli-Phale Bhajipalam,Apple,2016,7500,13125,5625,75.0
Sangali,Matki,2015,6200,11821,5621,90.66129032258064
Satana,POMEGRANATE,2016,636,6246,5610,882.0754716981132
Mumbai,Cummin,2016,11391,17000,5609,49.24062856641208
Khamgaon,Chillies(Red),2016,6000,11600,5600,93.33333333333333
Kamthi,Dhemse,2014,1945,7545,5600,287.9177377892031
Amarawati,Gram,2015,4806,10403,5597,116.45859342488556
Mumbai,Spilt Pigeon Pea,2015,10537,16133,5596,53.10809528328746
Daryapur,Pigeon Pea (Tur),2015,4965,10561,5596,112.70896273917423
Kolhapur,Coriander  ,2015,2085,7671,5586,267.9136690647482
Pune,Coriander (Dry),2015,9583,15167,5584,58.26985286444746
Pandharpur,Pomegranate,2016,1300,6883,5583,429.46153846153845
Satana,Pomegranate,2016,498,6072,5574,1119.2771084337348
Nagpur,Pomegranate,2016,1061,6630,5569,524.8821866163996
Ahmednagar,Garlic,2016,5630,11196,5566,98.86323268206039
Sangamner,Pomegranate,2014,4813,10375,5562,115.56201953043839
Mumbai,Chillies(Red),2014,8600,14156,5556,64.6046511627907
Karad,Lemon,2016,6667,12222,5555,83.32083395830209
Mangalwedha,Brinjal,2014,962,6515,5553,577.2349272349272
Daryapur,Black Gram,2015,6050,11600,5550,91.73553719008264
Mumbai,Chillies(Red),2015,11273,16818,5545,49.18832608888495
Nashik,APPLE,2016,5814,11357,5543,95.33883728930168
Karad,Water Melon,2015,6260,11800,5540,88.49840255591054
Pimpalgaon Basawant,Pomegranate,2015,2180,7720,5540,254.12844036697248
Sangli-Phale Bhajipalam,Pomegranate,2015,1619,7155,5536,341.9394688079061
Mumbai-Fruit Market,Apple,2016,3586,9114,5528,154.15504740658116
Rahuri,Pomegranate,2015,215,5742,5527,2570.6976744186045
Mumbai,Betelnuts,2014,30095,35619,5524,18.355208506396412
Mumbai,Cummin,2016,11048,16571,5523,49.99094858797972
Kamthi,Garlic,2016,5480,11000,5520,100.72992700729927
Kolhapur,Pomegranate,2016,1486,7000,5514,371.06325706594885
Nashik,Apple,2016,6119,11619,5500,89.88396796862233
Shahada,Maize,2015,1213,6713,5500,453.4212695795548
Jalgaon,Pomegranate,2015,2250,7750,5500,244.44444444444446
Manchar,Green Chilli,2016,1000,6500,5500,550.0
Atpadi,Pomegranate,2014,1750,7250,5500,314.2857142857143
Daryapur,Buffalo,2015,23000,28500,5500,23.91304347826087
Manchar,Cluster Bean,2016,2000,7500,5500,275.0
Kamthi,Garlic,2016,3875,9375,5500,141.93548387096774
Kolhapur-Laxmipuri,Chillies(Red),2015,10000,15500,5500,55.0
Aurangabad,Garlic,2016,6155,11636,5481,89.04955320877336
Daryapur,Black Gram,2016,2111,7590,5479,259.545239223117
Pune,Garlic,2016,6045,11523,5478,90.62034739454094
Mumbai,Spilt Pigeon Pea,2016,6113,11587,5474,89.54686733191559
Kolhapur,Garlic,2015,2658,8132,5474,205.9443190368698
Mumbai-Fruit Market,Mango,2016,5331,10800,5469,102.58863252673045
Kalyan,Coriander (Dry),2016,7700,13167,5467,71.0
Nagpur,POMEGRANATE,2016,1260,6724,5464,433.6507936507937
Kamthi,Dhemse,2016,2257,7714,5457,241.78112538768278
Sangola,Pomegranate,2016,1709,7163,5454,319.13399648917493
Tasgaon,Bedana,2014,12791,18245,5454,42.6393557970448
Pune,Green-Peas,2016,4667,10119,5452,116.82022712663381
Mumbai,Pomegranate,2016,2542,7990,5448,214.3194335169158
Tasgaon,Bedana,2014,11800,17247,5447,46.16101694915254
Kamthi,Green Chilli,2016,2594,8032,5438,209.63762528912875
Nagpur,Pomegranate,2016,1170,6604,5434,464.44444444444446
Khamgaon,Chillies(Red),2015,5625,11050,5425,96.44444444444444
Amarawati-Fruit And Vegetables,GARLIC,2016,5614,11035,5421,96.56216601353758
Mumbai,Pomegranate,2016,2484,7904,5420,218.1964573268921
Atpadi,Pomegranate,2016,1667,7083,5416,324.89502099580085
Sangali,Turmeric,2016,9074,14487,5413,59.65395635882742
Satana,Pomegranate,2015,463,5873,5410,1168.4665226781858
Amarawati-Fruit And Vegetables,Apple,2016,6574,11983,5409,82.27867356251902
Nampur,Pomegranate,2016,247,5653,5406,2188.663967611336
Nagpur,Garlic,2015,6400,11800,5400,84.375
Amarawati,Chillies(Red),2016,7000,12400,5400,77.14285714285714
Pandharpur,Pomegranate,2014,1885,7277,5392,286.0477453580902
Pune-Manjri,Ladies Finger,2015,3864,9250,5386,139.38923395445136
Kolhapur-Laxmipuri,GRAM,2016,7367,12750,5383,73.06909189629428
Pandharpur,Pomegranate,2014,1388,6763,5375,387.2478386167147
Jalgaon,Garlic,2016,5750,11125,5375,93.47826086956522
Kolhapur,Pomegranate,2016,2000,7375,5375,268.75
Pune-Manjri,Walvad,2016,636,6009,5373,844.811320754717
Kolhapur,Mango,2016,1750,7122,5372,306.9714285714286
Aurangabad,Pomegranate,2016,831,6200,5369,646.0890493381468
Mumbai,Mango,2016,10633,16000,5367,50.47493651838616
Solapur,Chillies(Red),2015,3862,9222,5360,138.78819264629726
Kurdwadi-Modnimb,CHILLIES(RED),2016,3960,9320,5360,135.35353535353536
Junnar-Otur,Walvad,2016,2750,8100,5350,194.54545454545453
Armori-Desaiganj,Chillies(Red),2016,12250,17600,5350,43.673469387755105
Pune-Manjri,Green Chilli,2016,2500,7842,5342,213.68
Jalgaon,Pomegranate,2015,2833,8167,5334,188.28097423226262
Pune,Shewanti,2014,13333,18667,5334,40.00600015000375
Mumbai,Cummin,2016,13333,18667,5334,40.00600015000375
Aurangabad,Garlic,2016,6000,11333,5333,88.88333333333334
Mumbai,Turmeric,2015,10000,15333,5333,53.33
Mumbai,Pomegranate,2016,2900,8232,5332,183.86206896551724
Narkhed,Orange,2016,7443,12771,5328,71.58403869407498
Daryapur,BLACK GRAM,2016,2238,7552,5314,237.44414655942805
Kolhapur-Laxmipuri,Chillies(Red),2016,13729,19042,5313,38.6991040862408
Nagpur,Garlic,2016,5313,10625,5312,99.9811782420478
Chandrapur,POMEGRANATE,2016,3469,8781,5312,153.12770250792735
Murbad,Ghevda,2016,4178,9489,5311,127.11823839157492
Solapur,Ridge Gourd,2016,1284,6592,5308,413.3956386292835
Rahuri,Mango,2016,360,5667,5307,1474.1666666666667
Solapur,GARLIC,2016,6641,11946,5305,79.8825478090649
Kolhapur-Laxmipuri,Gram,2016,6212,11515,5303,85.36703155183515
Ausa,Coriander (Dry),2015,6351,11651,5300,83.45142497244528
Kolhapur-Laxmipuri,Gram,2016,7200,12500,5300,73.61111111111111
Nagpur,Apple,2015,7538,12831,5293,70.21756434067392
Mumbai,Cummin,2014,13000,18286,5286,40.66153846153846
Amarawati-Fruit And Vegetables,Apple,2016,5455,10727,5272,96.64527956003667
Pandharpur,Pomegranate,2015,2727,7995,5268,193.17931793179318
Pune,Coriander (Dry),2015,11633,16900,5267,45.27636895039973
Mumbai,Cummin,2016,19579,24842,5263,26.880841718167424
Ahmednagar,Chillies(Red),2016,8442,13692,5250,62.18905472636816
Kolhapur-Laxmipuri,Chillies(Red),2016,18667,23917,5250,28.124497776825415
Ahmednagar,Pomegranate,2015,1250,6500,5250,420.0
Kolhapur,Squash Gourd,2016,1317,6567,5250,398.6332574031891
Bhiwapur,Chillies(Red),2015,4500,9750,5250,116.66666666666667
Solapur,Garlic,2015,5233,10481,5248,100.28664246130327
Solapur,Chillies(Red),2016,6024,11272,5248,87.11819389110225
Atpadi,Pomegranate,2015,1909,7155,5246,274.8035620743845
Solapur,Garlic,2015,7646,12892,5246,68.6110384514779
Sangali,Turmeric,2014,5523,10767,5244,94.94839760999457
Pandharpur,Pomegranate,2015,2237,7468,5231,233.83996423781852
Kolhapur-Laxmipuri,Gram,2016,5558,10783,5225,94.00863620007196
Jalgaon,Pomegranate,2015,2350,7575,5225,222.3404255319149
Pune-Manjri,Walvad,2016,0,5225,5225,inf
Pune,Garlic,2015,6028,11250,5222,86.62906436629065
Kolhapur,Lemon,2015,1632,6853,5221,319.91421568627453
Solapur,Lemon,2015,346,5563,5217,1507.8034682080925
Daryapur,Black Gram,2016,7610,12826,5216,68.54139290407359
Pune,Coriander (Dry),2015,11929,17143,5214,43.70860927152318
Lasalgaon,Pomegranate,2014,801,6010,5209,650.3121098626716
Kamthi,Garlic,2015,5600,10800,5200,92.85714285714286
Mumbai,Spilt Pigeon Pea,2015,10636,15832,5196,48.85295223768334
Amarawati,Garlic,2016,2467,7660,5193,210.49858127280098
Khamgaon,Chillies(Red),2015,6000,11183,5183,86.38333333333334
Kolhapur,Apple,2015,8605,13776,5171,60.09296920395119
Umared,Chillies(Red),2015,3333,8500,5167,155.02550255025503
Kolhapur,Pomegranate,2015,1583,6750,5167,326.4055590650663
Solapur,Lemon,2016,543,5696,5153,948.9871086556169
Kolhapur,Garlic,2016,7600,12750,5150,67.76315789473684
Nashik,Coriander  ,2014,1217,6361,5144,422.6787181594084
Pune-Pimpri,Coriander (Dry),2016,11714,16857,5143,43.904729383643506
Kamthi,Methi (Bhaji),2015,3983,9125,5142,129.09866934471503
Sangli-Phale Bhajipalam,Garlic,2016,3233,8373,5140,158.98546241880607
Kolhapur,Pomegranate,2016,1909,7045,5136,269.0413829229963
Shegaon,Thymol/Lovage,2016,10607,15743,5136,48.42085415291788
Nagpur,Apple,2016,8708,13833,5125,58.853927423059254
Pune,Coriander (Dry),2016,9350,14475,5125,54.81283422459893
Sangamner,Pomegranate,2015,3375,8500,5125,151.85185185185185
Sangli-Phale Bhajipalam,Garlic,2016,3500,8625,5125,146.42857142857142
Armori-Desaiganj,Chillies(Red),2016,11500,16620,5120,44.52173913043478
Solapur,Lemon,2016,135,5246,5111,3785.925925925926
Pune,Garlic,2016,7174,12283,5109,71.21550041817675
Kolhapur-Laxmipuri,Gram,2016,7105,12211,5106,71.86488388458832
Kalyan,Apple,2015,7700,12800,5100,66.23376623376623
Jalgaon,Garlic,2015,5900,11000,5100,86.44067796610169
Ahmednagar,Chillies(Red),2016,6020,11120,5100,84.71760797342192
Pimpalgaon Basawant,Pomegranate,2015,493,5585,5092,1032.8600405679513
Sangli-Phale Bhajipalam,Garlic,2016,4636,9727,5091,109.81449525452977
Nashik,Garlic,2016,2721,7809,5088,186.99007717750828
Pune,Coriander (Dry),2016,9471,14559,5088,53.72188786822933
Kolhapur,Garlic,2016,4174,9261,5087,121.87350263536176
Ahmednagar,Garlic,2016,6417,11500,5083,79.21146953405018
Nagpur,GARLIC,2016,4655,9737,5082,109.17293233082707
Pune,Garlic,2015,2738,7814,5076,185.390796201607
Atpadi,Pomegranate,2015,1591,6664,5073,318.85606536769325
Kolhapur,Garlic,2015,2452,7524,5072,206.8515497553018
Sangola,Pomegranate,2015,1272,6335,5063,398.0345911949685
Nagpur,Garlic,2016,5056,10111,5055,99.98022151898734
Rahuri,Mango,2016,345,5398,5053,1464.6376811594203
Lasalgaon-Vinchur,GRAM,2016,3600,8651,5051,140.30555555555554
Mumbai,Cummin,2015,14955,20000,5045,33.73453694416583
Kolhapur-Laxmipuri,Chillies(Red),2016,12375,17417,5042,40.743434343434345
Pandharpur,Pomegranate,2016,1485,6527,5042,339.5286195286195
Pune,Coriander (Dry),2016,10265,15300,5035,49.05017048222114
Kamthi,Methi (Bhaji),2014,3967,9000,5033,126.87169145449963
Sangrampur-Varvatbakal,Gram,2015,2760,7786,5026,182.1014492753623
Pandharpur,Pomegranate,2015,2470,7495,5025,203.4412955465587
Shegaon,Thymol/Lovage,2015,9359,14371,5012,53.55272999252057
Ahmednagar,Chillies(Red),2016,7720,12725,5005,64.83160621761658
Zarijamini,Soybean,2015,2824,7826,5002,177.12464589235128
Kolhapur,Garlic,2016,4900,9900,5000,102.04081632653062
Kamthi,Capsicum,2016,4850,9850,5000,103.09278350515464
Mumbai,Turmeric,2015,7696,12696,5000,64.96881496881497
Nashik,Apple,2015,5600,10600,5000,89.28571428571429
Sangli-Phale Bhajipalam,Garlic,2015,3500,8500,5000,142.85714285714286
Kalyan (Cattle Market),Kalvad,2016,25000,30000,5000,20.0
Kalyan,Kagda,2016,16667,21667,5000,29.99940001199976
Nagpur,Garlic,2015,5000,10000,5000,100.0
Kolhapur,Pomegranate,2015,2000,7000,5000,250.0
Junnar (Bhlhe),MALE GOAT,2016,3000,8000,5000,166.66666666666666
Karad,Apple,2016,11667,16667,5000,42.85591840233136
Kolhapur,GARLIC,2016,7353,12353,5000,67.99945600435197
Amarawati,Chillies(Red),2016,7000,12000,5000,71.42857142857143
Jalgaon,Pomegranate,2014,2000,7000,5000,250.0
Amarawati-Fruit And Vegetables,Grapes,2016,2000,7000,5000,250.0
Kalyan (Cattle Market),Cow,2016,18000,23000,5000,27.77777777777778
Nagpur,Garlic,2016,5000,10000,5000,100.0
Nagpur,GARLIC,2016,5000,10000,5000,100.0
Amarawati,Chillies(Red),2016,7333,12333,5000,68.18491749624982
Kalyan,Mango,2016,10000,15000,5000,50.0
Armori-Desaiganj,Chillies(Red),2015,7000,12000,5000,71.42857142857143
Mumbai,CHILLIES(RED),2016,10000,15000,5000,50.0
Kalyan,Apple,2015,15000,20000,5000,33.333333333333336
Umared,Chillies(Red),2016,10000,15000,5000,50.0
Satara,Garlic,2015,7400,12400,5000,67.56756756756756
Mumbai,Cummin,2016,10000,15000,5000,50.0
Daryapur,Buffalo,2015,25000,30000,5000,20.0
Kalyan (Cattle Market),Cow,2016,18000,23000,5000,27.77777777777778
Pune-Manjri,Squash Gourd,2016,0,5000,5000,inf
Ahmednagar,Coriander (Dry),2015,7000,12000,5000,71.42857142857143
Nagpur,Garlic,2016,5000,10000,5000,100.0
Mumbai,Chillies(Red),2016,10000,15000,5000,50.0
Pune-Manjri,Shevga,2016,0,5000,5000,inf
Nagpur,Garlic,2016,5000,10000,5000,100.0
Pune,Garlic,2016,7000,12000,5000,71.42857142857143
Kamthi,Garlic,2014,3000,8000,5000,166.66666666666666
Sangamner,Pomegranate,2015,5000,10000,5000,100.0
Sangli-Phale Bhajipalam,Apple,2015,4375,9375,5000,114.28571428571429
Mumbai,Cummin,2016,10000,15000,5000,50.0
Satara,Garlic,2016,6286,11286,5000,79.54183900731785
Satara,Garlic,2016,6000,11000,5000,83.33333333333333
Nagpur,Garlic,2016,5000,10000,5000,100.0
Kolhapur,Garlic,2015,4100,9100,5000,121.95121951219512
Mumbai,Mustard,2014,4000,9000,5000,125.0
Karad,Mango,2015,10000,15000,5000,50.0
Naigaon,Black Gram,2016,2467,7453,4986,202.10782326712607
Mumbai,Fennel,2014,14231,19215,4984,35.02213477619282
Pune-Manjri,Pavtta,2015,1313,6294,4981,379.36024371667935
Sangli-Phale Bhajipalam,Pomegranate,2015,1500,6472,4972,331.46666666666664
Solapur,Chillies(Red),2015,4652,9623,4971,106.8572656921754
Amarawati,Apple,2016,4118,9088,4970,120.6896551724138
Kamthi,Mango,2016,2271,7235,4964,218.58212241303391
Solapur,Lemon,2015,353,5315,4962,1405.6657223796035
Manchar,Wal Papdi,2016,1250,6210,4960,396.8
Mumbai,SPILT PIGEON PEA,2016,6513,11467,4954,76.06325809918624
Armori-Desaiganj,Chillies(Red),2016,14075,19025,4950,35.16873889875666
Karad,Lemon,2016,4300,9250,4950,115.11627906976744
Malkapur,Chillies(Red),2015,4938,9888,4950,100.24301336573511
Manchar,Green Chilli,2016,2301,7246,4945,214.90656236418948
Pune,GARLIC,2016,6900,11840,4940,71.59420289855072
Mangalwedha,Green Chilli,2016,4254,9185,4931,115.91443347437706
Karad,Apple,2015,14615,19538,4923,33.684570646595965
Pandharpur,Green Chilli,2016,3724,8643,4919,132.08915145005372
Pune-Manjri,Green-Peas,2014,1382,6295,4913,355.49927641099856
Mumbai,Spilt Pigeon Pea,2016,9480,14392,4912,51.81434599156118
Mumbai,Fennel,2016,10000,14909,4909,49.09
Solapur,Chillies(Red),2015,3869,8776,4907,126.8286378909279
Vadgaon Peth,Tomato,2016,1800,6706,4906,272.55555555555554
Kolhapur,Pomegranate,2015,1563,6469,4906,313.8835572616763
Sangli-Phale Bhajipalam,Garlic,2015,3500,8400,4900,140.0
Bhiwapur,Chillies(Red),2016,6600,11500,4900,74.24242424242425
Palus,Goats,2016,2500,7400,4900,196.0
Nagpur,Garlic,2015,9229,14125,4896,53.05016794885687
Koregaon,Ghevda Seed,2015,3250,8143,4893,150.55384615384617
Mumbai,Apple,2015,2525,7417,4892,193.74257425742573
Kolhapur,Garlic,2015,4109,9000,4891,119.03139449987832
Mumbai,Tamarind,2016,4889,9778,4889,100.0
Dhule,Chillies(Red),2016,5152,10040,4888,94.87577639751552
Kolhapur,Coriander  ,2016,1600,6483,4883,305.1875
Mumbai,Cummin,2015,15248,20128,4880,32.00419727177335
Solapur,Chillies(Red),2015,4570,9447,4877,106.71772428884026
Amarawati-Fruit And Vegetables,Apple,2016,4123,9000,4877,118.28765462042202
Bhiwapur,Chillies(Red),2016,8375,13250,4875,58.208955223880594
Pune,Pomegranate,2015,1000,5875,4875,487.5
Mumbai,Spilt Pigeon Pea,2016,8814,13686,4872,55.27569775357386
Kolhapur,Mosambi,2015,1708,6577,4869,285.07025761124123
Ahmednagar,Chillies(Red),2015,6950,11813,4863,69.97122302158273
Kolhapur-Laxmipuri,Gram,2016,8167,13021,4854,59.434308803722296
Junnar-Otur,Green Chilli,2016,2326,7177,4851,208.5554600171969
Kamthi,Garlic,2015,2817,7667,4850,172.168974085907
Khamgaon,Chillies(Red),2015,5500,10350,4850,88.18181818181819
Kolhapur,Math (Bhaji),2016,2781,7622,4841,174.07407407407408
Karad,Apple,2016,8920,13760,4840,54.26008968609865
Sangali,Turmeric,2016,8900,13736,4836,54.337078651685395
Umared,Chillies(Red),2016,9000,13833,4833,53.7
Latur,Black Gram,2015,6750,11573,4823,71.45185185185186
Solapur,Garlic,2016,6861,11683,4822,70.28130010202594
Pune,Coriander (Dry),2016,8244,13063,4819,58.45463367297428
Aurangabad,Mango,2015,4181,9000,4819,115.25950729490552
Mumbai,RICE(PADDY-HUS),2016,4562,9381,4819,105.63349408154318
Mumbai,Tamarind,2015,3000,7818,4818,160.6
Kolhapur,Green-Peas,2015,2733,7550,4817,176.25320160995244
Pandharpur,Pomegranate,2016,1426,6242,4816,337.72791023842916
Dhule,Chillies(Red),2015,2906,7719,4813,165.6228492773572
Ulhasnagar,Other Vegetables,2016,2028,6840,4812,237.27810650887574
Kolhapur,Math (Bhaji),2015,4387,9193,4806,109.55094597674949
Pune-Manjri,Green-Peas,2015,0,4800,4800,inf
Umarga,Black Gram,2016,2897,7697,4800,165.68864342423197
Mumbai,Spilt Pigeon Pea,2016,9242,14042,4800,51.936810214239344
Mumbai,Fennel,2015,15400,20200,4800,31.16883116883117
Bhiwapur,Chillies(Red),2015,3000,7800,4800,160.0
Chikhali,Black Gram,2015,6091,10887,4796,78.73912329666722
Pandharpur,Pomegranate,2016,1484,6279,4795,323.1132075471698
Kolhapur,Shevga,2015,2563,7358,4795,187.0854467420991
Kolhapur,Lemon,2016,1221,6015,4794,392.62899262899265
Nagpur,Pomegranate,2015,2040,6828,4788,234.7058823529412
Sangamner,Pomegranate,2014,3217,8000,4783,148.67889337892447
Mumbai,Spilt Pigeon Pea,2016,8563,13338,4775,55.76316711432909
Kolhapur-Laxmipuri,Chillies(Red),2016,20000,24769,4769,23.845
Pimpalgaon Basawant,Pomegranate,2015,1446,6208,4762,329.3222683264177
Pune,Garlic,2015,2978,7739,4761,159.87239758226997
Mumbai,Fennel,2014,13040,17800,4760,36.50306748466258
Kolhapur,Chikoo,2015,350,5110,4760,1360.0
Nampur,Pomegranate,2016,262,5019,4757,1815.648854961832
Pandharpur,Pomegranate,2015,1217,5972,4755,390.7148726376335
Pune-Manjri,Ghosali(Bhaji),2015,0,4750,4750,inf
Pandharpur,Pomegranate,2014,1208,5958,4750,393.2119205298013
Bhiwapur,Chillies(Red),2015,4750,9500,4750,100.0
Chandrapur,Apple,2016,3000,7750,4750,158.33333333333334
Mumbai,Tamarind,2016,5000,9750,4750,95.0
Kolhapur,Apple,2015,9250,14000,4750,51.351351351351354
Rahuri,Pomegranate,2016,200,4946,4746,2373.0
Aurangabad,Pomegranate,2015,1284,6027,4743,369.39252336448595
Sangli-Phale Bhajipalam,Apple,2015,4349,9089,4740,108.99057254541273
Amarawati,Garlic,2015,8933,13667,4734,52.99451472069853
Jalgaon,Pomegranate,2015,2167,6900,4733,218.41255191508998
Sangola,Pomegranate,2014,976,5704,4728,484.42622950819674
Dondaicha,Gram,2016,5018,9746,4728,94.22080510163411
Jalgaon,Pomegranate,2014,2500,7225,4725,189.0
Ahmednagar,Onion,2015,1955,6680,4725,241.68797953964193
Kamthi,Custard Apple,2014,3112,7833,4721,151.7030848329049
Sindi (Selu),Gram,2016,2180,6900,4720,216.5137614678899
Pune,Coriander (Dry),2016,10736,15455,4719,43.954918032786885
Pune,Coriander (Dry),2016,7870,12587,4717,59.936467598475225
Nashik,Apple,2014,6174,10889,4715,76.3686426951733
Karad,Water Melon,2015,8278,12989,4711,56.909881613916404
Latur,Black Gram,2015,6586,11296,4710,71.51533556027938
Rahuri,Pomegranate,2016,193,4900,4707,2438.860103626943
Dhule,Chillies(Red),2015,3500,8200,4700,134.28571428571428
Chandrapur,Apple,2015,3400,8100,4700,138.23529411764707
Rahuri,CLUSTER BEAN,2016,300,5000,4700,1566.6666666666667
Sangrampur,Pigeon Pea (Tur),2015,4200,8900,4700,111.9047619047619
Nashik,Pomegranate,2014,1781,6481,4700,263.8966872543515
Palus,Male Lamb,2016,1700,6400,4700,276.47058823529414
Junnar-Otur,Green-Peas,2016,4250,8950,4700,110.58823529411765
Junnar-Otur,Green Chilli,2016,2000,6700,4700,235.0
Chandrapur,Mango,2016,950,5646,4696,494.3157894736842
Khamgaon,Chillies(Red),2014,4875,9563,4688,96.16410256410256
Junnar-Otur,Ghevda,2016,3750,8438,4688,125.01333333333334
Amarawati,Chillies(Red),2016,8895,13579,4684,52.65879707700956
Mumbai,Cummin,2014,14170,18852,4682,33.041637261820746
Lasalgaon,Green Gram,2016,3020,7700,4680,154.96688741721854
Pune,Garlic,2015,3288,7962,4674,142.15328467153284
Chandrapur,Pomegranate,2015,2686,7357,4671,173.90171258376768
Solapur,Lemon,2015,312,4982,4670,1496.7948717948718
Nandurbar,Thymol/Lovage,2015,9763,14432,4669,47.82341493393424
Jalgaon,Garlic,2016,5333,10000,4667,87.51171948246765
Jalgaon,GARLIC,2016,7000,11667,4667,66.67142857142858
Jalgaon,Pomegranate,2015,2167,6833,4666,215.3207198892478
Nagpur,Garlic,2016,4667,9333,4666,99.97857295907436
Mumbai,Custard Apple,2015,2667,7333,4666,174.95313085864268
Mumbai,Spilt Pigeon Pea,2016,6878,11539,4661,67.76679267228846
Kolhapur,Cluster Bean,2016,1638,6298,4660,284.4932844932845
Aurangabad,Pomegranate,2016,738,5396,4658,631.1653116531165
Shegaon,Thymol/Lovage,2016,10021,14670,4649,46.39257559125836
Pandharpur,Pomegranate,2015,1227,5873,4646,378.6471067644662
Kolhapur,Garlic,2016,2333,6979,4646,199.14273467638233
Deglur,Black Gram,2016,2771,7414,4643,167.5568386863948
Pune,Garlic,2016,5880,10520,4640,78.91156462585035
Kolhapur,Mosambi,2016,2107,6747,4640,220.21831988609398
Mumbai,Cummin,2014,13242,17874,4632,34.979610330765745
Karad,Apple,2016,19370,24000,4630,23.902942694889003
Nashik,Ginger (Fresh),2014,7218,11845,4627,64.10362981435301
Kolhapur,Coriander  ,2016,1248,5874,4626,370.6730769230769
Khalapur(Shil-Phata),Rice(Paddy-Hus),2016,2500,7125,4625,185.0
Kolhapur,Pomegranate,2016,1125,5750,4625,411.1111111111111
Sangamner,Pomegranate,2015,3375,8000,4625,137.03703703703704
Dhule,Chillies(Red),2015,4025,8650,4625,114.90683229813665
Jalgaon,Pomegranate,2016,1450,6075,4625,318.9655172413793
Mumbai,Garlic,2015,1891,6509,4618,244.20941300898994
Kolhapur,Chikoo,2015,481,5096,4615,959.4594594594595
Sangli-Phale Bhajipalam,Custard Apple,2016,625,5238,4613,738.08
Chandrapur,Pomegranate,2016,3158,7763,4605,145.82013932868904
Ahmednagar,Tomato,2016,995,5600,4605,462.8140703517588
Sangola,Pomegranate,2014,1106,5709,4603,416.1844484629295
Malegaon,Gram,2016,3500,8101,4601,131.45714285714286
Pune-Manjri,Walvad,2015,833,5433,4600,552.2208883553421
Satara,Garlic,2016,6800,11400,4600,67.6470588235294
Jalgaon,Apple,2016,4300,8900,4600,106.97674418604652
Nagpur,Garlic,2015,3962,8558,4596,116.0020191822312
Mangalwedha,Brinjal,2014,776,5372,4596,592.2680412371134
Satana,Pomegranate,2015,472,5061,4589,972.2457627118644
Sangli-Phale Bhajipalam,Pomegranate,2016,1318,5902,4584,347.79969650986345
Nagpur,Garlic,2016,4583,9167,4584,100.02181976871046
Ahmednagar,Garlic,2015,2250,6833,4583,203.6888888888889
Kolhapur,Mosambi,2016,1996,6574,4578,229.35871743486973
Kolhapur,Garlic,2015,4211,8789,4578,108.71526953217763
Pandharpur,Green Chilli,2016,2944,7520,4576,155.43478260869566
Mangalwedha,Brinjal,2014,620,5194,4574,737.741935483871
Kamthi,Coriander  ,2014,3476,8048,4572,131.53049482163405
Chandrapur-Ganjwad,Garlic,2015,13000,17556,4556,35.04615384615385
Solapur,Lemon,2016,287,4843,4556,1587.4564459930314
Sangola,Pomegranate,2015,1765,6321,4556,258.1303116147309
Pune-Manjri,Ghevda,2014,1667,6222,4555,273.24535092981404
Mangrulpeer,BLACK GRAM,2016,2679,7234,4555,170.02612915266891
Pune-Manjri,Cluster Bean,2015,2972,7525,4553,153.1965006729475
Babhulgaon,Pigeon Pea (Tur),2015,4151,8700,4549,109.58805107203084
Mumbai,Turmeric,2015,12227,16773,4546,37.18001145006952
Mumbai,Spilt Pigeon Pea,2016,9182,13727,4545,49.49901982138967
Pune,Coriander (Dry),2015,13091,17636,4545,34.71850889924376
Nagpur,Pomegranate,2015,1958,6500,4542,231.97139938712974
Karad,Apple,2016,21846,26385,4539,20.777258994781654
Sangli-Phale Bhajipalam,Pomegranate,2016,3340,7878,4538,135.8682634730539
Solapur,Custard Apple,2014,575,5113,4538,789.2173913043479
Mumbai,Apple,2015,2500,7037,4537,181.48
Pandharpur,Pomegranate,2015,2038,6575,4537,222.62021589793915
Malkapur,Pigeon Pea (Tur),2016,7972,12506,4534,56.87405920722529
Aurangabad,Garlic,2015,5400,9930,4530,83.88888888888889
Sangli-Phale Bhajipalam,POMEGRANATE,2016,2800,7320,4520,161.42857142857142
Sangli-Phale Bhajipalam,APPLE,2016,4375,8889,4514,103.17714285714285
Malkapur,CHILLIES(RED),2016,4013,8525,4512,112.43458759033142
Ambejogai,Pigeon Pea (Tur),2015,5634,10145,4511,80.06744763933263
Mangalwedha,Brinjal,2016,706,5211,4505,638.1019830028329
Pune-Manjri,Curry Leaves,2015,0,4500,4500,inf
Kolhapur,Green-Peas,2015,5583,10083,4500,80.60182697474477
Nashik,Apple,2014,6214,10714,4500,72.41712262632765
Pune-Manjri,Curry Leaves,2015,0,4500,4500,inf
Pune-Manjri,Curry Leaves,2015,0,4500,4500,inf
Pune-Manjri,Curry Leaves,2014,0,4500,4500,inf
Pune-Manjri,Curry Leaves,2015,0,4500,4500,inf
Pune-Manjri,Curry Leaves,2015,0,4500,4500,inf
Pune-Manjri,Curry Leaves,2014,0,4500,4500,inf
Pune-Manjri,Curry Leaves,2015,0,4500,4500,inf
Nashik,Apple,2015,6000,10500,4500,75.0
Pune-Manjri,Curry Leaves,2014,0,4500,4500,inf
Junnar-Otur,Bitter Gourd,2016,2000,6500,4500,225.0
Jalgaon,Pomegranate,2015,3167,7667,4500,142.0903062835491
Jalgaon,Garlic,2016,4833,9333,4500,93.10986964618249
Amarawati,Chillies(Red),2016,7000,11500,4500,64.28571428571429
Chandrapur,Apple,2015,4000,8500,4500,112.5
Pune,Bijli,2014,11000,15500,4500,40.90909090909091
Atpadi,Pomegranate,2015,2000,6500,4500,225.0
Jalgaon,Pomegranate,2016,3750,8250,4500,120.0
Pune-Manjri,Curry Leaves,2016,0,4500,4500,inf
Pune-Manjri,Curry Leaves,2015,0,4500,4500,inf
Junnar-Otur,Green-Peas,2016,3000,7500,4500,150.0
Pune-Manjri,Curry Leaves,2015,0,4500,4500,inf
Pune-Manjri,Curry Leaves,2015,0,4500,4500,inf
Pune-Manjri,Curry Leaves,2015,0,4500,4500,inf
Satara,Garlic,2015,5000,9500,4500,90.0
Pune-Manjri,Curry Leaves,2015,0,4500,4500,inf
Kalyan,Coriander (Dry),2016,7250,11750,4500,62.06896551724138
Amarawati,Apple,2016,5500,10000,4500,81.81818181818181
Pune-Manjri,Curry Leaves,2016,0,4500,4500,inf
Kolhapur,MOSAMBI,2016,3083,7583,4500,145.96172559195588
Umared,Chillies(Red),2015,4750,9250,4500,94.73684210526316
Kalyan,Apple,2015,7500,12000,4500,60.0
Khamgaon,Male Goat,2014,2500,7000,4500,180.0
Mumbai-Fruit Market,Litchi,2016,11500,16000,4500,39.130434782608695
Amarawati,Garlic,2015,6500,11000,4500,69.23076923076923
Pune-Manjri,Curry Leaves,2016,0,4500,4500,inf
Pune-Manjri,Curry Leaves,2015,0,4500,4500,inf
Osmanabad,Garlic,2016,2500,7000,4500,180.0
Kamthi,Guava,2014,2751,7250,4499,163.54053071610323
Pandharpur,Green Chilli,2015,1716,6213,4497,262.06293706293707
Solapur,Ridge Gourd,2016,1317,5808,4491,341.002277904328
Kolhapur,CHIKOO,2016,356,4842,4486,1260.112359550562
Nashik,Pomegranate,2014,2135,6620,4485,210.07025761124123
Mumbai,Fennel,2016,8870,13348,4478,50.4847801578354
Pune,Garlic,2015,3870,8348,4478,115.71059431524547
Pandharpur,Coriander  ,2015,625,5100,4475,716.0
Mumbai,Mango,2016,14380,18854,4474,31.112656467315716
Mumbai,Chillies(Red),2015,9327,13800,4473,47.95754261820521
Satana,Ground Nut Pods (Dry),2015,2175,6639,4464,205.24137931034483
Mumbai,Turmeric,2015,6769,11231,4462,65.91815630078298
Amarawati-Fruit And Vegetables,Garlic,2016,6630,11087,4457,67.22473604826546
Mumbai,Turmeric,2014,10347,14800,4453,43.036628974582
Sangli-Phale Bhajipalam,Garlic,2015,3500,7950,4450,127.14285714285714
Junnar-Otur,GREEN-PEAS,2016,4250,8700,4450,104.70588235294117
Khalapur(Shil-Phata),Rice(Paddy-Hus),2016,2457,6900,4443,180.83028083028083
Ahmednagar,Flower,2016,725,5167,4442,612.6896551724138
Amarawati-Fruit And Vegetables,Pomegranate,2016,3250,7688,4438,136.55384615384617
Kolhapur,Math (Bhaji),2015,2132,6570,4438,208.16135084427768
Kolhapur,Mango,2016,1248,5684,4436,355.44871794871796
Mumbai,Fennel,2014,13082,17509,4427,33.84039137746522
Solapur,Garlic,2015,2365,6791,4426,187.14587737843553
Mangrulpeer,Black Gram,2016,3219,7645,4426,137.49611680646163
Aurangabad,POMEGRANATE,2016,1106,5531,4425,400.09041591320073
Kolhapur,Math (Bhaji),2015,2629,7054,4425,168.3149486496767
Nashik,Garlic,2016,2125,6548,4423,208.14117647058825
Mumbai,Turmeric,2015,10891,15309,4418,40.565604627674226
Nashik,Pomegranate,2015,1917,6333,4416,230.35993740219092
Satana,Pomegranate,2015,478,4894,4416,923.8493723849373
Kolhapur,Mosambi,2016,1686,6100,4414,261.80308422301306
Malkapur,Black Gram,2015,7608,12021,4413,58.004731861198735
Pune,Garlic,2015,2800,7213,4413,157.60714285714286
Kolhapur-Laxmipuri,Gram,2016,8377,12786,4409,52.63220723409335
Satana,Pomegranate,2015,246,4654,4408,1791.8699186991869
Sangola,POMEGRANATE,2016,1498,5906,4408,294.25901201602136
Pune-Manjri,Curry Leaves,2014,0,4406,4406,inf
Kolhapur,Apple,2015,3565,7967,4402,123.47826086956522
Naigaon,BLACK GRAM,2016,2825,7225,4400,155.75221238938053
Nagpur,Pomegranate,2015,2104,6500,4396,208.93536121673003
Ahmednagar,Chillies(Red),2016,7925,12313,4388,55.369085173501574
Sangli-Phale Bhajipalam,Apple,2016,4208,8589,4381,104.11121673003802
Kamthi,Green Chilli,2016,3264,7643,4379,134.16053921568627
Ambad(Vadi Godri),Tamarind,2016,2350,6726,4376,186.2127659574468
Ahmednagar,Onion,2015,1450,5825,4375,301.7241379310345
Nashik,Pomegranate,2016,2795,7170,4375,156.52951699463327
Jalgaon,Garlic,2016,3050,7425,4375,143.44262295081967
Chandrapur,Apple,2015,2500,6875,4375,175.0
Khamgaon,Chillies(Red),2014,4750,9125,4375,92.10526315789474
Kolhapur,Pomegranate,2016,1750,6125,4375,250.0
Sangli-Phale Bhajipalam,Apple,2015,4375,8750,4375,100.0
Satara,Garlic,2016,7250,11625,4375,60.3448275862069
Sangola,Pomegranate,2015,1211,5581,4370,360.85879438480595
Pandharpur,Pomegranate,2015,1423,5791,4368,306.95713281799016
Chandrapur,Mango,2016,2706,7071,4365,161.30820399113082
Chikhali,Black Gram,2015,6000,10364,4364,72.73333333333333
Nashik,Apple,2016,7714,12071,4357,56.481721545242415
Nashik,Pomegranate,2015,3036,7393,4357,143.51119894598156
Sangli-Phale Bhajipalam,GARLIC,2016,5643,10000,4357,77.210703526493
Chandrapur,Pomegranate,2015,3429,7786,4357,127.06328375619714
Pune,Garlic,2015,4095,8452,4357,106.3980463980464
Solapur,Lemon,2014,360,4716,4356,1210.0
Solapur,Garlic,2016,6047,10400,4353,71.98610881428807
Pune,Garlic,2014,2050,6400,4350,212.1951219512195
Nagpur,Pomegranate,2016,1668,6018,4350,260.7913669064748
Kada,Onion,2015,100,4450,4350,4350.0
Solapur,Onion,2015,734,5081,4347,592.2343324250681
Mumbai,Brinjal,2016,4054,8400,4346,107.20276270350271
Kolhapur,Chikoo,2016,350,4686,4336,1238.857142857143
Umared,Chillies(Red),2015,4833,9167,4334,89.67515001034555
Jalgaon,Pomegranate,2015,2000,6333,4333,216.65
Umared,Chillies(Red),2015,3667,8000,4333,118.161985274066
Mumbai,Apple,2015,2475,6800,4325,174.74747474747474
Ahmednagar,Garlic,2016,7821,12143,4322,55.26147551464007
Kolhapur,Lemon,2016,2071,6393,4322,208.69145340415258
Pune,Garlic,2016,4864,9182,4318,88.77467105263158
Pune,Garlic,2015,4182,8500,4318,103.2520325203252
Kolhapur,Mosambi,2016,2008,6323,4315,214.89043824701196
Amarawati,Garlic,2016,6140,10455,4315,70.27687296416939
Sangli-Phale Bhajipalam,Pomegranate,2016,1357,5668,4311,317.68607221812823
Satana,Pomegranate,2016,830,5139,4309,519.156626506024
Mangalwedha,Brinjal,2014,537,4844,4307,802.0484171322161
Mumbai,Pomegranate,2015,4130,8435,4305,104.23728813559322
Mangalwedha,Brinjal,2016,572,4869,4297,751.2237762237762
Pune,Coriander (Dry),2016,9412,13706,4294,45.62260943476413
Kolhapur,Garlic,2015,1875,6167,4292,228.90666666666667
Mangalwedha,Tomato,2016,700,4988,4288,612.5714285714286
Kolhapur-Laxmipuri,Gram,2016,5128,9415,4287,83.59984399375975
Aurangabad,Pomegranate,2016,743,5030,4287,576.9851951547779
Amarawati-Fruit And Vegetables,Garlic,2016,6857,11143,4286,62.50546886393467
Pune,Garlic,2014,2167,6452,4285,197.7388094139363
Mangalwedha,Green Chilli,2016,3565,7848,4283,120.14025245441795
Kolhapur,Coriander  ,2016,1406,5688,4282,304.551920341394
Latur,Tamarind,2016,6038,10319,4281,70.90096058297449
Kamthi,Green Chilli,2016,2376,6655,4279,180.09259259259258
Satana,Pomegranate,2016,551,4826,4275,775.8620689655172
Pune,Garlic,2014,2542,6813,4271,168.01730920535013
Mumbai,Spilt Pigeon Pea,2015,12712,16981,4269,33.5824417872876
Nashik,Pomegranate,2016,3718,7985,4267,114.76600322754169
Satana,Pomegranate,2015,531,4798,4267,803.5781544256121
Sangli-Phale Bhajipalam,Chikoo,2016,3067,7333,4266,139.09357678513206
Khalapur(Shil-Phata),Rice(Paddy-Hus),2016,2463,6725,4262,173.04100690215185
Pune,Garlic,2016,4109,8370,4261,103.69919688488683
Mumbai-Fruit Market,APPLE,2016,4654,8915,4261,91.55565105285775
Sangli-Phale Bhajipalam,Chikoo,2016,1693,5950,4257,251.447135262847
Sangali,Matki,2015,7150,11406,4256,59.52447552447553
Solapur,Custard Apple,2015,614,4866,4252,692.5081433224756
Daryapur,Green Gram,2015,6578,10830,4252,64.639708117969
Jalgaon,Pomegranate,2014,2583,6833,4250,164.53735965931088
Atpadi,Pomegranate,2015,1750,6000,4250,242.85714285714286
Solapur,Garlic,2016,4973,9223,4250,85.46149205710839
Mumbai,Turmeric,2014,9950,14200,4250,42.71356783919598
Karad,Apple,2015,11125,15375,4250,38.20224719101124
Kalamb (Os),Pigeon Pea (Tur),2015,7954,12197,4243,53.344229318581846
Kolhapur,Garlic,2016,3120,7360,4240,135.89743589743588
Satana,Pomegranate,2016,267,4504,4237,1586.8913857677903
Pune-Manjri,Ghosali(Bhaji),2015,0,4235,4235,inf
Amarawati,Pomegranate,2016,3300,7533,4233,128.27272727272728
Mumbai,Turmeric,2016,6000,10231,4231,70.51666666666667
Mumbai,Fennel,2015,9864,14091,4227,42.852798053527984
Solapur,Ladies Finger,2016,718,4944,4226,588.5793871866296
Amarawati-Fruit And Vegetables,Garlic,2016,5500,9720,4220,76.72727272727273
Kamthi,Garlic,2015,3691,7909,4218,114.27797344892983
Tumsar,Pigeon Pea (Tur),2016,6535,10748,4213,64.46824789594491
Mumbai,Mustard,2014,4358,8568,4210,96.6039467645709
Kalvan,Ground Nut Pods (Dry),2015,3635,7844,4209,115.79092159559835
Ausa,Coriander (Dry),2015,7800,12001,4201,53.85897435897436
Ahmednagar,Coriander (Dry),2016,6800,11000,4200,61.76470588235294
Pune-Manjri,Ghosali(Bhaji),2014,0,4200,4200,inf
Kamthi,Onion,2015,3150,7350,4200,133.33333333333334
Aurangabad,Mango,2016,3127,7327,4200,134.31403901503037
Kolhapur,Math (Bhaji),2016,3100,7300,4200,135.48387096774192
Varud,Black Gram,2016,1201,5400,4199,349.62531223980017
Chakur,Coriander (Dry),2016,5301,9499,4198,79.19260516883607
Aurangabad,Custard Apple,2014,1357,5548,4191,308.8430361090641
Kolhapur,Lemon,2016,1000,5188,4188,418.8
Solapur,Garlic,2016,6604,10791,4187,63.40096910963053
Satana,Pomegranate,2015,427,4612,4185,980.0936768149883
Umared,Gram,2016,6116,10301,4185,68.4270765206017
Mumbai,Tamarind,2015,6545,10727,4182,63.896103896103895
Sangali,Turmeric,2015,5873,10055,4182,71.20721947897157
Kamthi,Ginger (Fresh),2015,3000,7182,4182,139.4
Atpadi,Pomegranate,2014,1753,5922,4169,237.82087849401026
Atpadi,Pomegranate,2015,1536,5703,4167,271.2890625
Sangli-Phale Bhajipalam,Garlic,2015,3500,7667,4167,119.05714285714286
Junnar (Narayangaon),Coriander  ,2014,1337,5502,4165,311.5183246073298
Mumbai,Garlic,2015,1836,6000,4164,226.79738562091504
Nagpur,Garlic,2016,2448,6609,4161,169.97549019607843
Akole,Onion,2015,1200,5361,4161,346.75
Pune-Manjri,Kanda Pat,2016,1589,5744,4155,261.4852108244179
Ahmednagar,Ladies Finger,2016,1065,5217,4152,389.85915492957747
Mangalwedha,Ridge Gourd,2016,1504,5654,4150,275.9308510638298
Pune-Manjri,Ghosali(Bhaji),2016,0,4150,4150,inf
Nagpur,Garlic,2015,4600,8750,4150,90.21739130434783
Pandharpur,Pomegranate,2015,1269,5408,4139,326.16233254531124
Sangli-Phale Bhajipalam,Pomegranate,2016,1315,5451,4136,314.52471482889734
Mumbai,Fennel,2015,14389,18521,4132,28.716380568489818
Nagpur,Pineapple,2016,1031,5163,4132,400.77594568380215
Kalyan,Garlic,2016,6250,10375,4125,66.0
Nagpur,Chillies(Red),2016,9375,13500,4125,44.0
Sangli-Phale Bhajipalam,Garlic,2016,3500,7625,4125,117.85714285714286
Jalgaon,Pomegranate,2016,4000,8125,4125,103.125
Mumbai,Rice(Paddy-Hus),2014,5800,9924,4124,71.10344827586206
Solapur,Ridge Gourd,2016,1217,5339,4122,338.70172555464256
Manchar,Cluster Bean,2016,1188,5307,4119,346.7171717171717
Brahmpuri,Paddy-Unhusked,2015,1941,6059,4118,212.15868109222052
Manchar,Green Chilli,2016,3880,7997,4117,106.1082474226804
Amarawati,Garlic,2016,5568,9682,4114,73.88649425287356
Manchar,Onion,2015,1966,6078,4112,209.1556459816887
Karad,Lemon,2016,2889,7000,4111,142.29837313949463
Satara,Garlic,2016,5889,10000,4111,69.80811682798438
Mumbai,Turmeric,2015,7833,11944,4111,52.483084386569644
Ahmednagar,Garlic,2015,8091,12200,4109,50.78482264244222
Mangalwedha,Brinjal,2016,435,4544,4109,944.5977011494252
Solapur,Garlic,2016,4054,8157,4103,101.2086827824371
Aurangabad,Mango,2016,6746,10846,4100,60.77675659650163
Armori-Desaiganj,Chillies(Red),2015,11500,15600,4100,35.65217391304348
Jalgaon,Pomegranate,2014,1600,5700,4100,256.25
Newasa-Ghodegaon,Onion,2015,1015,5115,4100,403.9408866995074
Jalgaon,Pomegranate,2015,1100,5200,4100,372.72727272727275
Mumbai,Cummin,2015,17250,21350,4100,23.768115942028984
Kalyan,Garlic,2015,4500,8600,4100,91.11111111111111
Kalvan,Onion,2015,953,5050,4097,429.9055613850997
Solapur,Chillies(Red),2015,8158,12255,4097,50.22064231429272
Kamthi,Methi (Bhaji),2015,2773,6864,4091,147.52975117201586
Kolhapur,Mosambi,2016,1473,5564,4091,277.7325186693822
Mumbai,Cummin,2016,16455,20545,4090,24.855666970525675
Pune-Manjri,Onion,2015,0,4090,4090,inf
Solapur,Garlic,2015,3298,7388,4090,124.01455427531837
Shegaon,Thymol/Lovage,2015,7142,11230,4088,57.23886866423971
Phaltan,Gram,2016,5167,9255,4088,79.11747629185214
Daryapur,Black Gram,2015,7166,11248,4082,56.96343845939157
Kamthi,Methi (Bhaji),2015,3089,7167,4078,132.01683392683717
Bhiwapur,Chillies(Red),2016,7300,11375,4075,55.821917808219176
Aurangabad,Mango,2015,1884,5958,4074,216.2420382165605
Mumbai,Spilt Pigeon Pea,2016,9536,13609,4073,42.711828859060404
Mumbai,Spilt Pigeon Pea,2016,8771,12842,4071,46.4143199179113
Khed,Farshi,2016,2306,6376,4070,176.49609713790113
Mumbai,Grapes,2015,4237,8307,4070,96.05853198017465
Nagpur,Apple,2015,6560,10628,4068,62.01219512195122
Jalgaon,Garlic,2016,3000,7067,4067,135.56666666666666
Lasur Station,Onion,2015,967,5033,4066,420.4756980351603
Karad,Apple,2016,17652,21717,4065,23.028552005438478
Kada,Onion,2015,825,4888,4063,492.4848484848485
Sangola,Pomegranate,2015,1017,5075,4058,399.0167158308751
Mumbai,Cummin,2015,15943,20000,4057,25.446904597629054
Solapur,GUAVA,2016,1626,5678,4052,249.20049200492005
Kolhapur,Brinjal,2016,1067,5119,4052,379.7563261480787
Kada,Onion,2015,700,4750,4050,578.5714285714286
Nagpur,Garlic,2016,4250,8300,4050,95.29411764705883
Mumbai,Turmeric,2015,7238,11286,4048,55.92705167173252
Mumbai,Turmeric,2015,6083,10125,4042,66.44747657405885
Solapur,Lemon,2016,171,4212,4041,2363.157894736842
Pandharpur,Pomegranate,2016,839,4878,4039,481.40643623361143
Aurangabad,Apple,2016,6000,10038,4038,67.3
Nagpur,Garlic,2015,4385,8423,4038,92.0866590649943
Sangli-Phale Bhajipalam,Custard Apple,2015,1161,5196,4035,347.5452196382429
Ahmednagar,GARLIC,2016,4200,8233,4033,96.02380952380952
Mumbai,Apple,2014,2478,6511,4033,162.75221953188054
Nagpur,Pomegranate,2016,2168,6200,4032,185.97785977859778
Ahmednagar,Green Chilli,2016,3980,8008,4028,101.20603015075378
Solapur,Onion,2015,969,4996,4027,415.5830753353973
Chandrapur,Apple,2016,3413,7439,4026,117.96073835335481
Kolhapur,Chikoo,2015,350,4375,4025,1150.0
Solapur,Garlic,2016,5986,10009,4023,67.20681590377548
Nagpur,Pineapple,2016,1500,5522,4022,268.1333333333333
Sangali,Matki,2016,7167,11187,4020,56.090414399330264
Pune,Garlic,2014,2000,6016,4016,200.8
Manchar,Cluster Bean,2016,1500,5510,4010,267.3333333333333
Malkapur,Chillies(Red),2016,2806,6814,4008,142.8367783321454
Latur,CORIANDER (DRY),2016,2745,6750,4005,145.9016393442623
Chandrapur,Grapes,2016,1927,5932,4005,207.83601453035806
Bhiwapur,Chillies(Red),2014,4000,8000,4000,100.0
Jalgaon,Garlic,2015,2250,6250,4000,177.77777777777777
Khamgaon,Male Lamb,2016,4000,8000,4000,100.0
Kamthi,Parwar,2015,1000,5000,4000,400.0
Nagpur,Garlic,2016,4471,8471,4000,89.46544397226572
Armori-Desaiganj,Chillies(Red),2016,11250,15250,4000,35.55555555555556
Satara,Garlic,2015,4667,8667,4000,85.70816370259267
Satara,Garlic,2015,6000,10000,4000,66.66666666666667
Pune-Manjri,Guava,2015,0,4000,4000,inf
Pune-Pimpri,PAVTTA,2016,2000,6000,4000,200.0
Mumbai,Coriander (Dry),2016,5000,9000,4000,80.0
Kolhapur,Ridge Gourd,2015,1000,5000,4000,400.0
Kolhapur,Pomegranate,2016,2000,6000,4000,200.0
Mumbai,Custard Apple,2015,4000,8000,4000,100.0
Mumbai,Tamarind,2016,4000,8000,4000,100.0
Kamthi,Wal Bhaji,2015,3125,7125,4000,128.0
Sangli-Phale Bhajipalam,Orange,2016,2000,6000,4000,200.0
Junnar,Garlic,2015,12000,16000,4000,33.333333333333336
Junnar (Bhlhe),Goats,2016,3000,7000,4000,133.33333333333334
Mumbai,Betelnuts,2016,24000,28000,4000,16.666666666666668
Pune-Pimpri,Green-Peas,2016,4000,8000,4000,100.0
Mumbai,Turmeric,2016,6000,10000,4000,66.66666666666667
Kalyan,Matki,2015,7000,11000,4000,57.142857142857146
Mumbai,Betelnuts,2016,24000,28000,4000,16.666666666666668
Mumbai,Betelnuts,2016,24000,28000,4000,16.666666666666668
Mumbai,Betelnuts,2016,24000,28000,4000,16.666666666666668
Amarawati,Garlic,2015,5000,9000,4000,80.0
Mumbai,Tamarind,2015,3000,7000,4000,133.33333333333334
Mumbai,Tamarind,2015,3611,7611,4000,110.77263915812794
Palus,Goats,2016,2500,6500,4000,160.0
Nashik,Apple,2015,8000,12000,4000,50.0
Aurangabad,Apple,2016,5000,9000,4000,80.0
Mumbai,TAMARIND,2016,4000,8000,4000,100.0
Sangli-Phale Bhajipalam,Orange,2016,2000,6000,4000,200.0
Nashik,Apple,2015,6667,10667,4000,59.9970001499925
Amarawati-Fruit And Vegetables,Apple,2016,3368,7368,4000,118.76484560570071
Mumbai,Turmeric,2016,5400,9400,4000,74.07407407407408
Kalyan,Coriander (Dry),2016,12000,16000,4000,33.333333333333336
Mumbai,Betelnuts,2015,30952,34952,4000,12.923235978288963
Jalgaon,Grapes,2016,4000,8000,4000,100.0
Mumbai-Fruit Market,Custard Apple,2016,3000,7000,4000,133.33333333333334
Chalisgaon,Gram,2016,5000,9000,4000,80.0
Jalgaon,Garlic,2016,6000,10000,4000,66.66666666666667
Kalyan,Coriander (Dry),2015,12000,16000,4000,33.333333333333336
Mumbai,Turmeric,2016,6000,10000,4000,66.66666666666667
Mumbai,Turmeric,2016,6000,10000,4000,66.66666666666667
Satara,Garlic,2016,6000,10000,4000,66.66666666666667
Mumbai,Turmeric,2016,6000,10000,4000,66.66666666666667
Mumbai,Turmeric,2016,6000,10000,4000,66.66666666666667
Kolhapur-Laxmipuri,Chillies(Red),2015,14000,18000,4000,28.571428571428573
Mumbai,Betelnuts,2015,28000,32000,4000,14.285714285714286
Mumbai,Turmeric,2016,6000,10000,4000,66.66666666666667
Kolhapur,Garlic,2015,2000,6000,4000,200.0
Mumbai,Turmeric,2016,6000,10000,4000,66.66666666666667
Amarawati-Fruit And Vegetables,Orange,2016,4000,8000,4000,100.0
Rahuri-Songaon,Cluster Bean,2016,2000,6000,4000,200.0
Mumbai,TURMERIC,2016,6000,10000,4000,66.66666666666667
Pune-Manjri,Green Chilli,2016,2500,6500,4000,160.0
Kalyan,Gulchadi,2016,16000,20000,4000,25.0
Kalvan,Onion,2015,1114,5111,3997,358.79712746858166
Mumbai,Apple,2015,2519,6515,3996,158.63437872171497
Kolhapur,Brinjal,2016,1004,4998,3994,397.80876494023903
Nashik,Pomegranate,2016,3140,7131,3991,127.10191082802548
Pandharpur,Pomegranate,2015,805,4795,3990,495.6521739130435
Pune-Manjri,Green Chilli,2015,361,4350,3989,1104.9861495844875
Nashik,Squash Gourd,2016,6127,10115,3988,65.08895054676024
Malkapur,Chillies(Red),2015,3525,7513,3988,113.13475177304964
Aurangabad,Garlic,2016,3700,7682,3982,107.62162162162163
Satana,Pomegranate,2015,254,4234,3980,1566.9291338582677
Pandharpur,Brinjal,2014,480,4460,3980,829.1666666666666
Khamgaon,Chillies(Red),2016,5140,9120,3980,77.43190661478599
Mumbai,Pomegranate,2016,2478,6457,3979,160.5730427764326
Karad,Mango,2016,12667,16646,3979,31.412331254440673
Pune-Manjri,Ghosali(Bhaji),2016,1268,5246,3978,313.7223974763407
Satana,Pomegranate,2016,244,4221,3977,1629.9180327868853
Chandrapur,Apple,2016,4194,8167,3973,94.73056747734859
Latur,Black Gram,2015,8352,12325,3973,47.56944444444444
Mumbai-Fruit Market,Pomegranate,2016,2464,6436,3972,161.2012987012987
Kolhapur,Water Melon,2016,272,4242,3970,1459.5588235294117
Solapur,Garlic,2015,3600,7568,3968,110.22222222222223
Nagpur,Pineapple,2016,1250,5218,3968,317.44
Atpadi,Pomegranate,2015,1500,5467,3967,264.46666666666664
Pandharpur,Pomegranate,2014,1167,5133,3966,339.8457583547558
Solapur,Bitter Gourd,2016,2769,6735,3966,143.22860238353195
Amarawati,Apple,2016,3367,7333,3966,117.79031779031779
Amarawati-Fruit And Vegetables,Garlic,2016,3536,7500,3964,112.10407239819004
Kamthi,Coriander  ,2016,2607,6571,3964,152.05216724204067
Nagpur,Garlic,2014,2704,6668,3964,146.5976331360947
Akole,Onion,2015,1182,5144,3962,335.19458544839256
Sangali,Turmeric,2016,8420,12380,3960,47.03087885985748
Karad,Apple,2016,16280,20240,3960,24.324324324324323
Ahmednagar,Garlic,2016,4500,8458,3958,87.95555555555555
Sangli-Phale Bhajipalam,Pomegranate,2016,1063,5021,3958,372.34242709313264
Nashik,Apple,2016,6000,9955,3955,65.91666666666667
Himayatnagar,Pigeon Pea (Tur),2016,8015,11966,3951,49.295071740486584
Amarawati,Black Gram,2016,8260,12210,3950,47.82082324455206
Solapur,Lemon,2015,330,4280,3950,1196.969696969697
Mumbai,Rice(Paddy-Hus),2014,5520,9467,3947,71.5036231884058
Manchar,Math (Bhaji),2015,505,4451,3946,781.3861386138614
Nagpur,Garlic,2015,4056,8000,3944,97.23865877712032
Solapur,Chillies(Red),2016,9410,13350,3940,41.87035069075451
Solapur,CLUSTER BEAN,2016,1275,5206,3931,308.3137254901961
Mumbai,Chillies(Red),2014,8557,12487,3930,45.92731097347201
Mumbai,Spilt Pigeon Pea,2015,10119,14048,3929,38.827947425634946
Nashik,POMEGRANATE,2016,2742,6669,3927,143.21663019693653
Kamthi,Ginger (Fresh),2015,3231,7154,3923,121.41751779634788
Lasalgaon,Green Gram,2014,4200,8122,3922,93.38095238095238
Sangali,Turmeric,2015,6556,10477,3921,59.8078096400244
Manchar,Cluster Bean,2016,2120,6041,3921,184.95283018867926
Solapur,Brinjal,2014,803,4723,3920,488.16936488169364
Sangrampur,Pigeon Pea (Tur),2015,5200,9120,3920,75.38461538461539
Bhiwapur,Chillies(Red),2016,7000,10917,3917,55.957142857142856
Atpadi,Pomegranate,2015,1667,5583,3916,234.9130173965207
Solapur,Chillies(Red),2014,6123,10038,3915,63.93924546790789
Ahmednagar,Tamarind,2016,6875,10789,3914,56.93090909090909
Sangali,Matki,2015,5853,9767,3914,66.87168973176149
Aurangabad,Custard Apple,2014,2353,6267,3914,166.34084147896303
Kolhapur,Tomato,2016,1340,5253,3913,292.0149253731343
Pune,Green Chilli,2016,4239,8152,3913,92.30950695918848
Atpadi,Pomegranate,2016,1520,5432,3912,257.36842105263156
Chandrapur-Ganjwad,Garlic,2014,3091,7000,3909,126.46392753154319
Mumbai,Fennel,2014,13435,17341,3906,29.073315965761072
Solapur,Chillies(Red),2014,6102,10007,3905,63.99541134054408
Mumbai,Turmeric,2014,10886,14790,3904,35.86257578541245
Nashik,Garlic,2016,2260,6163,3903,172.69911504424778
Khed,Green Chilli,2016,3894,7795,3901,100.17976373908577
Paithan,Gram,2016,4700,8601,3901,83.0
Khamgaon,Chillies(Red),2016,5867,9767,3900,66.47349582410091
Pune,Green-Peas,2015,6750,10650,3900,57.77777777777778
Kolhapur,Squash Gourd,2016,875,4775,3900,445.7142857142857
Chandrapur-Ganjwad,Garlic,2015,9100,13000,3900,42.857142857142854
Jalgaon,Pomegranate,2015,2975,6875,3900,131.0924369747899
Karanja,Black Gram,2016,6300,10200,3900,61.904761904761905
Indapur,Black Gram,2016,2800,6700,3900,139.28571428571428
Osmanabad,Squash Gourd,2016,2100,6000,3900,185.71428571428572
Sangali,Rice(Paddy-Hus),2016,1963,5858,3895,198.42078451349974
Ahmednagar,Cluster Bean,2016,3063,6958,3895,127.16291217760366
Ahmednagar,Squash Gourd,2016,3421,7316,3895,113.85559777842737
Solapur,Lemon,2015,308,4202,3894,1264.2857142857142
Solapur,Garlic,2015,2844,6736,3892,136.84950773558367
Shahada,Gram,2016,3866,7758,3892,100.67252974650802
Pune,Green-Peas,2014,4222,8111,3889,92.11274277593557
Sangola,Pomegranate,2016,461,4346,3885,842.7331887201735
Kolhapur,Capsicum,2016,2167,6052,3885,179.28011075219197
Aurangabad,Pomegranate,2014,890,4771,3881,436.0674157303371
Kolhapur-Laxmipuri,Green Peas (Dry),2016,2863,6742,3879,135.4872511351729
Mangalwedha,Brinjal,2015,563,4442,3879,688.98756660746
Kolhapur,Chikoo,2016,378,4255,3877,1025.6613756613756
Aurangabad,Garlic,2016,4750,8625,3875,81.57894736842105
Ramtek,Chillies(Red),2016,10250,14125,3875,37.80487804878049
Ahmednagar,Lemon,2016,2750,6625,3875,140.9090909090909
Umared,Chillies(Red),2015,5250,9125,3875,73.80952380952381
Satara,Garlic,2016,3313,7188,3875,116.96347721098702
Nagpur,Garlic,2016,2875,6750,3875,134.7826086956522
Solapur,Garlic,2016,6683,10558,3875,57.98294179260811
Chandrapur,Apple,2016,4500,8375,3875,86.11111111111111
Chandrapur,Apple,2016,4357,8229,3872,88.86848749139315
Sangrampur,Pigeon Pea (Tur),2015,4315,8185,3870,89.68713789107764
Aurangabad,Pomegranate,2015,935,4804,3869,413.7967914438503
Pandharpur,Pomegranate,2015,1696,5565,3869,228.125
Junnar-Otur,Farshi,2016,2679,6541,3862,144.15826801045165
Kolhapur,Chikoo,2016,339,4200,3861,1138.9380530973451
Nashik,Pomegranate,2016,2942,6802,3860,131.20326308633582
Jalgaon,Pomegranate,2016,2300,6160,3860,167.82608695652175
Nagpur,Pineapple,2016,1020,4880,3860,378.4313725490196
Chandrapur,Pomegranate,2015,2893,6750,3857,133.32181126857932
Kamthi,Coriander  ,2015,3537,7389,3852,108.9058524173028
Sangali,Green Gram,2015,5500,9350,3850,70.0
Junnar-Otur,Walvad,2016,3000,6843,3843,128.1
Aurangabad,Pomegranate,2015,1113,4952,3839,344.92362982929023
Mumbai,Garlic,2015,2426,6261,3835,158.07914262159935
Mumbai,Tamarind,2016,3833,7667,3834,100.02608922515002
Kolhapur,Math (Bhaji),2016,2927,6761,3834,130.98735907072088
Nagpur,Garlic,2016,2833,6667,3834,135.3335686551359
Pandharpur,Green Chilli,2016,3563,7397,3834,107.60595004209935
Sangali,Black Gram,2016,7833,11667,3834,48.946763692072004
Pune-Manjri,Ghosali(Bhaji),2014,267,4100,3833,1435.5805243445693
Amarawati,Black Gram,2016,7000,10833,3833,54.75714285714286
Mumbai,Betelnuts,2015,28000,31833,3833,13.689285714285715
Nagpur,Grapes,2016,3078,6909,3831,124.46393762183236
Pune,Lemon,2016,700,4527,3827,546.7142857142857
Dhule,Chillies(Red),2016,9550,13375,3825,40.05235602094241
Lasalgaon,Gram,2016,3648,7473,3825,104.85197368421052
Ghatanji,Cotton,2016,4233,8058,3825,90.36144578313252
Sangali,Turmeric,2014,5000,8825,3825,76.5
Pune-Manjri,Green Chilli,2016,2690,6514,3824,142.15613382899627
Pune,Coriander (Dry),2016,9471,13294,3823,40.36532573117939
Ahmednagar,Tamarind,2015,5486,9309,3823,69.68647466277798
Risod,Black Gram,2015,6720,10540,3820,56.845238095238095
Mumbai,Apple,2016,3184,7004,3820,119.9748743718593
Mumbai,Tamarind,2016,4000,7818,3818,95.45
Mumbai,Pomegranate,2016,2471,6286,3815,154.39093484419263
Mumbai,Apple,2016,2717,6530,3813,140.33860875966138
Karad,Lemon,2016,2313,6125,3812,164.80760916558583
Pune,Garlic,2015,2595,6405,3810,146.82080924855492
Atpadi,Pomegranate,2014,1750,5560,3810,217.71428571428572
Nagpur,PINEAPPLE,2016,1032,4841,3809,369.0891472868217
Nashik,Pomegranate,2015,2900,6708,3808,131.31034482758622
Sangali,Rice(Paddy-Hus),2015,1700,5500,3800,223.52941176470588
Pune-Pimpri,Chillies(Red),2015,12000,15800,3800,31.666666666666668
Satara,Garlic,2015,3400,7200,3800,111.76470588235294
Bhiwapur,Chillies(Red),2016,7800,11600,3800,48.717948717948715
Sangali,Rice(Paddy-Hus),2014,1800,5600,3800,211.11111111111111
Vaijapur,Onion,2015,1217,5017,3800,312.2432210353328
Sangali,Rice(Paddy-Hus),2015,1700,5500,3800,223.52941176470588
Solapur,Chillies(Red),2014,6486,10286,3800,58.5877274128893
Baramati,Green Gram,2014,4200,8000,3800,90.47619047619048
Rahuri,Orange,2016,200,4000,3800,1900.0
Nagpur,CHILLIES(RED),2016,7200,11000,3800,52.77777777777778
Kalyan,Matki,2015,6733,10533,3800,56.43843754641319
Chandur Bajar,Black Gram,2016,8000,11800,3800,47.5
Nashik,Pomegranate,2016,3276,7075,3799,115.96459096459097
Baramati,Onion,2015,1508,5305,3797,251.79045092838197
Pune-Manjri,Ghosali(Bhaji),2015,250,4046,3796,1518.4
Kolhapur-Laxmipuri,Green Peas (Dry),2016,3592,7384,3792,105.56792873051225
Pune-Moshi,Squash Gourd,2016,4209,8000,3791,90.06889997624138
Sangali,Rice(Paddy-Hus),2016,1906,5696,3790,198.8457502623295
Lasalgaon,Green Gram,2015,5711,9500,3789,66.34564874803011
Junnar (Narayangaon),Math (Bhaji),2014,2351,6137,3786,161.0378562313909
Nagpur,Garlic,2015,2157,5943,3786,175.52155771905424
Nagpur,Garlic,2015,4214,8000,3786,89.84337921214997
Amarawati-Fruit And Vegetables,Garlic,2016,4786,8571,3785,79.08483075637275
Aurangabad,Pomegranate,2015,1240,5024,3784,305.16129032258067
Dondaicha,Pigeon Pea (Tur),2015,4908,8690,3782,77.05786471067644
Mumbai,Cummin,2014,13491,17273,3782,28.033503817359723
Mumbai,Turmeric,2016,4688,8469,3781,80.65273037542661
Sangali,Turmeric,2015,6031,9809,3778,62.64301110926878
Ahmednagar,Garlic,2016,8444,12222,3778,44.74182851729039
Pusad,Spilt Pigeon Pea,2014,3005,6780,3775,125.62396006655574
Kolhapur,Math (Bhaji),2016,1552,5326,3774,243.1701030927835
Mumbai-Fruit Market,Apple,2016,4639,8411,3772,81.31062729036431
Aurangabad,Pomegranate,2014,1574,5343,3769,239.4536213468869
Junnar-Otur,Ghevda,2016,3375,7138,3763,111.4962962962963
Sangli-Phale Bhajipalam,Garlic,2016,3255,7018,3763,115.60675883256529
Mumbai,Chillies(Red),2014,9000,12762,3762,41.8
Ahmednagar,Chillies(Red),2016,8522,12283,3761,44.1328326683877
Pune,Green-Peas,2016,6120,9880,3760,61.43790849673203
Solapur,Brinjal,2016,717,4477,3760,524.4072524407252
Mumbai,Apple,2014,2704,6460,3756,138.90532544378698
Newasa-Ghodegaon,Onion,2015,1346,5100,3754,278.9004457652303
Sangali,Turmeric,2015,6729,10480,3751,55.74379551196314
Solapur,Custard Apple,2016,443,4194,3751,846.726862302483
Aurangabad,Garlic,2015,2617,6367,3750,143.29384791746276
Kolhapur-Malkapur,Squash Gourd,2016,2500,6250,3750,150.0
Sangli-Phale Bhajipalam,Pineapple,2016,416,4166,3750,901.4423076923077
Kamthi,Garlic,2016,6250,10000,3750,60.0
Anajngaon Surji,Chillies(Red),2015,6750,10500,3750,55.55555555555556
Amarawati,Pomegranate,2015,2500,6250,3750,150.0
Kamthi,GARLIC,2016,9250,13000,3750,40.54054054054054
Anajngaon Surji,Chillies(Red),2015,6250,10000,3750,60.0
Nashik,Capsicum,2015,875,4625,3750,428.57142857142856
Kamthi,Ginger (Fresh),2014,3250,7000,3750,115.38461538461539
Khamgaon,Pigeon Pea (Tur),2015,5980,9729,3749,62.69230769230769
Akluj,Garlic,2016,7653,11400,3747,48.961191689533514
Khamgaon,Black Gram,2015,7891,11634,3743,47.43378532505386
Nagpur,Pineapple,2016,1720,5460,3740,217.4418604651163
Mumbai,Betelnuts,2015,32426,36163,3737,11.524702399309197
Jalgaon,Pomegranate,2015,2433,6167,3734,153.47307850390465
Jalgaon,Pomegranate,2016,2433,6167,3734,153.47307850390465
Atpadi,Pomegranate,2016,1900,5633,3733,196.47368421052633
Kolhapur,Coriander  ,2016,2392,6125,3733,156.061872909699
Jalgaon,Pomegranate,2016,2100,5833,3733,177.76190476190476
Chandrapur-Ganjwad,Garlic,2014,2770,6500,3730,134.65703971119135
Nagpur,Garlic,2015,4333,8063,3730,86.08354488806832
Mumbai,Spilt Pigeon Pea,2016,6343,10071,3728,58.773451048399814
Satana,Pomegranate,2016,849,4576,3727,438.9870435806832
Khamgaon,CHILLIES(RED),2016,4900,8625,3725,76.0204081632653
Phaltan,Onion,2015,1325,5050,3725,281.1320754716981
Pune,Ghevda,2015,3700,7425,3725,100.67567567567568
Solapur,Chillies(Red),2014,5987,9707,3720,62.13462502087857
Chandrapur,Apple,2016,2920,6638,3718,127.32876712328768
Kolhapur,Chikoo,2016,404,4120,3716,919.8019801980198
Malkapur,Chillies(Red),2016,8686,12400,3714,42.7584618927009
Jalgaon,Apple,2016,5286,9000,3714,70.26106696935301
Nashik,CUSTARD APPLE,2016,1483,5194,3711,250.236008091706
Sangali,Rice(Paddy-Hus),2016,1897,5606,3709,195.5192409066948
Chandrapur,Apple,2015,2471,6176,3705,149.93929583164712
Lasalgaon-Vinchur,Gram,2016,4051,7752,3701,91.36015798568255
Nashik,Garlic,2015,2550,6250,3700,145.09803921568627
Indapur (Nimgaon Ketki),Chillies(Red),2016,4800,8500,3700,77.08333333333333
Chandrapur-Ganjwad,Garlic,2014,3700,7400,3700,100.0
Pune,Chillies(Red),2016,14175,17875,3700,26.102292768959437
Mumbai,BETELNUTS,2016,22285,25985,3700,16.603096253085035
Solapur,Green Chilli,2016,3278,6978,3700,112.87370347773032
Karad,Jaggery,2015,2400,6100,3700,154.16666666666666
Pandharpur,Pomegranate,2016,830,4530,3700,445.7831325301205
Anajngaon Surji,Chillies(Red),2016,7400,11100,3700,50.0
Solapur,Onion,2015,188,3887,3699,1967.5531914893618
Mangalwedha,Brinjal,2015,504,4200,3696,733.3333333333334
Mumbai,Cowpea,2015,4458,8154,3696,82.90713324360699
Sangali,Rice(Paddy-Hus),2016,2079,5768,3689,177.44107744107745
Kolhapur,Cluster Bean,2016,1779,5467,3688,207.30747611017426
Karad,Lemon,2016,2813,6500,3687,131.07003199431213
Pune-Manjri,Custard Apple,2015,1869,5554,3685,197.16425896201176
Chandrapur,Pomegranate,2014,1816,5500,3684,202.863436123348
Sangali,Turmeric,2016,8398,12080,3682,43.843772326744464
Sangola,Pomegranate,2015,2263,5939,3676,162.43923994697303
Kolhapur,Kanda Pat,2016,1400,5075,3675,262.5
Pune-Manjri,Kanda Pat,2016,2025,5700,3675,181.4814814814815
Mandhal,Chillies(Red),2016,5603,9278,3675,65.58986257362128
Daryapur,Pigeon Pea (Tur),2015,5373,9048,3675,68.39754327191513
Nagpur,Pineapple,2016,1211,4884,3673,303.3030553261767
Ahmednagar,Chillies(Red),2015,5284,8952,3668,69.41710825132475
Jalgaon,Garlic,2015,2000,5667,3667,183.35
Sangali,Rice(Paddy-Hus),2016,2000,5667,3667,183.35
Rahuri,Onion,2015,738,4405,3667,496.88346883468836
Osmanabad,Brinjal,2016,2500,6167,3667,146.68
Kalyan,Garlic,2015,4333,8000,3667,84.62958689129933
Ahmednagar,Green Chilli,2016,3333,7000,3667,110.02100210021003
Jalgaon,POMEGRANATE,2016,3167,6833,3666,115.75623618566466
Khamgaon,Chillies(Red),2015,4667,8333,3666,78.55153203342618
Mumbai,Rice(Paddy-Hus),2015,4440,8106,3666,82.56756756756756
Amarawati-Fruit And Vegetables,Apple,2016,3167,6833,3666,115.75623618566466
Mumbai-Onion And Potato Mkt,Garlic,2016,3935,7600,3665,93.13850063532402
Pune-Manjri,Ghosali(Bhaji),2015,0,3663,3663,inf
Ahmednagar,Flower,2016,638,4300,3662,573.9811912225705
Sangali,Lentil,2015,4040,7700,3660,90.5940594059406
Kamthi,Coriander  ,2016,2400,6060,3660,152.5
Sangali,Rice(Paddy-Hus),2016,2007,5665,3658,182.2620827105132
Sangli-Phale Bhajipalam,Garlic,2016,3105,6763,3658,117.80998389694042
Nagpur,Pomegranate,2016,2468,6120,3652,147.97406807131281
Mumbai,Betelnuts,2015,28650,32300,3650,12.739965095986038
Solapur,Tomato,2016,812,4462,3650,449.5073891625616
Sangali,Rice(Paddy-Hus),2016,1961,5609,3648,186.0275369709332
Sangola,Pomegranate,2015,1871,5518,3647,194.92250133618387
Mumbai,Grapes,2015,5000,8647,3647,72.94
Mumbai,Rice(Paddy-Hus),2014,5542,9189,3647,65.8065680259834
Pune-Manjri,Ghosali(Bhaji),2015,0,3646,3646,inf
Anajngaon Surji,Black Gram,2016,3111,6756,3645,117.1648987463838
Anajngaon Surji,BLACK GRAM,2016,2950,6595,3645,123.55932203389831
Vadgaon Peth,Ridge Gourd,2016,1700,5343,3643,214.2941176470588
Solapur,Ridge Gourd,2016,1021,4663,3642,356.7091087169442
Ahmednagar,Garlic,2016,3720,7360,3640,97.84946236559139
Udgir,Soybean,2016,3660,7300,3640,99.4535519125683
Kolhapur,Onion,2015,1729,5367,3638,210.41064198958935
Ulhasnagar,Other Cereals,2015,4382,8018,3636,82.97581013235965
Pandharpur,Tomato,2016,1108,4742,3634,327.97833935018053
Amarawati,Pomegranate,2016,3283,6917,3634,110.69144075540665
Jalna,Black Gram,2016,3879,7511,3632,93.63237947924723
Dhule,Chillies(Red),2016,4992,8619,3627,72.65625
Chandrapur,Mango,2016,783,4409,3626,463.0906768837803
Udgir,Tamarind,2015,3773,7398,3625,96.07739199575934
Osmanabad,Jambhul,2016,4825,8450,3625,75.12953367875647
Amarawati,Garlic,2015,4625,8250,3625,78.37837837837837
Jalgaon,Garlic,2015,4375,8000,3625,82.85714285714286
Shrirampur,Onion,2015,1675,5300,3625,216.4179104477612
Anajngaon Surji,Chillies(Red),2016,8625,12250,3625,42.028985507246375
Satara,Garlic,2016,3750,7375,3625,96.66666666666667
Aurangabad,Pomegranate,2014,1536,5160,3624,235.9375
Nashik,Mango,2016,3816,7438,3622,94.916142557652
Nagpur,Pomegranate,2015,1521,5142,3621,238.06706114398423
Kolhapur,Mosambi,2015,1329,4950,3621,272.4604966139955
Nandurbar,Thymol/Lovage,2014,9213,12832,3619,39.28145012482362
Kolhapur,Shevga,2015,2333,5950,3617,155.03643377625374
Pune-Manjri,Green Chilli,2016,5321,8938,3617,67.97594437135876
Sinner,Onion,2015,1211,4825,3614,298.4310487200661
Aurangabad,Garlic,2015,2850,6463,3613,126.7719298245614
Amarawati,Garlic,2016,3000,6611,3611,120.36666666666666
Karad,Lemon,2016,3222,6833,3611,112.07324643078833
Sangola,Pomegranate,2014,819,4425,3606,440.2930402930403
Solapur,Rice(Paddy-Hus),2014,2114,5719,3605,170.52980132450332
Ahmednagar,Cluster Bean,2016,2625,6229,3604,137.2952380952381
Kamthi,Green Peas (Dry),2014,3733,7333,3600,96.43718189124029
Khamgaon,Chillies(Red),2016,8500,12100,3600,42.35294117647059
Satara,Garlic,2016,6600,10200,3600,54.54545454545455
Rahuri-Vambori,Onion,2015,1417,5017,3600,254.05786873676783
Mumbai,Custard Apple,2015,2400,6000,3600,150.0
Aurangabad,Apple,2016,4442,8042,3600,81.0445745159838
Aurangabad,Apple,2014,5200,8800,3600,69.23076923076923
Armori-Desaiganj,Chillies(Red),2015,10500,14100,3600,34.285714285714285
Aurangabad,Fig,2014,4600,8200,3600,78.26086956521739
Aurangabad,Zendu,2015,1900,5500,3600,189.47368421052633
Kolhapur-Laxmipuri,Rice(Paddy-Hus),2014,1900,5500,3600,189.47368421052633
Solapur,Garlic,2015,3604,7199,3595,99.75027746947836
Solapur,Lemon,2016,113,3708,3595,3181.4159292035397
Phaltan,Onion,2015,1160,4753,3593,309.7413793103448
Kolhapur,Green Chilli,2016,4407,8000,3593,81.52938506920808
Hinganghat,Gram,2016,5663,9255,3592,63.429277767967505
Rahata,Onion,2015,1600,5192,3592,224.5
Sangli-Phale Bhajipalam,Garlic,2015,3727,7318,3591,96.35095250872016
Solapur,Chillies(Red),2015,6665,10255,3590,53.86346586646662
Pune,Green-Peas,2015,4205,7795,3590,85.37455410225921
Solapur,Rice(Paddy-Hus),2014,2173,5761,3588,165.1173492867004
Kolhapur,Chikoo,2015,428,4015,3587,838.0841121495328
Mumbai,Garlic,2014,1877,5462,3585,190.9962706446457
Kada,Onion,2015,250,3833,3583,1433.2
Pune,Green-Peas,2015,5056,8639,3583,70.86629746835443
Kolhapur,Capsicum,2016,1967,5550,3583,182.15556685307575
Sangola,Pomegranate,2014,851,4433,3582,420.9165687426557
Solapur,CUSTARD APPLE,2016,423,4004,3581,846.5721040189126
Nagpur,Pineapple,2016,1000,4580,3580,358.0
Aurangabad,Garlic,2016,3144,6722,3578,113.80407124681933
Ahmednagar,Green Chilli,2016,4731,8308,3577,75.60769393362925
Lasalgaon,Green Gram,2015,5970,9547,3577,59.916247906197654
Nashik,Apple,2015,5156,8733,3577,69.37548487199379
Kamthi,Mango,2016,2113,5688,3575,169.190724088973
Solapur,Rice(Paddy-Hus),2014,2160,5732,3572,165.37037037037038
Kamthi,Green-Peas,2014,4143,7714,3571,86.19357953174028
Lasalgaon,Sunflower,2015,1800,5370,3570,198.33333333333334
Phaltan,Gram,2016,3425,6994,3569,104.2043795620438
Kolhapur,Green Chilli,2016,2835,6401,3566,125.78483245149911
Kolhapur,Green Chilli,2016,4171,7733,3562,85.39918484775833
Mangalwedha,Brinjal,2015,470,4030,3560,757.4468085106383
Pandharpur,Chikoo,2014,800,4360,3560,445.0
Sangamner,Onion,2015,1708,5265,3557,208.2552693208431
Nagpur,Garlic,2015,4462,8019,3557,79.71761541909457
Loha,BLACK GRAM,2016,3400,6956,3556,104.58823529411765
Barshi,BLACK GRAM,2016,3267,6822,3555,108.81542699724518
Sangali,Rice(Paddy-Hus),2016,2032,5586,3554,174.9015748031496
Pune,Onion,2015,1429,4981,3552,248.56543037088872
Akkolkot,Black Gram,2015,8000,11550,3550,44.375
Osmanabad,Garlic,2016,4000,7550,3550,88.75
Kolhapur-Laxmipuri,Rice(Paddy-Hus),2014,2100,5650,3550,169.04761904761904
Kamthi,Coriander  ,2015,2779,6328,3549,127.70780856423174
Solapur,Rice(Paddy-Hus),2014,2115,5664,3549,167.80141843971631
Pandharpur,Brinjal,2014,595,4143,3548,596.3025210084033
Kolhapur,Mosambi,2015,1309,4855,3546,270.89381207028265
Ahmednagar,Onion,2015,700,4246,3546,506.57142857142856
Kolhapur,Chikoo,2016,350,3894,3544,1012.5714285714286
Solapur,Rice(Paddy-Hus),2016,2160,5698,3538,163.7962962962963
Solapur,Rice(Paddy-Hus),2015,2128,5662,3534,166.07142857142858
Chopda,Black Gram,2016,3297,6830,3533,107.15802244464665
Mumbai,Grapes,2016,1579,5111,3532,223.68587713742875
Nagpur,Pomegranate,2016,3415,6946,3531,103.39677891654466
Nashik,Brinjal,2014,1837,5366,3529,192.10669569951008
Amarawati,Pomegranate,2016,2421,5947,3526,145.6422965716646
Kolhapur-Laxmipuri,Rice(Paddy-Hus),2014,1931,5456,3525,182.54790264111858
Pune,Green-Peas,2016,3975,7500,3525,88.67924528301887
Mumbai,Tamarind,2014,6708,10233,3525,52.54919499105546
Mumbai,Apple,2015,3998,7521,3523,88.11905952976488
Solapur,Rice(Paddy-Hus),2015,2124,5647,3523,165.8662900188324
Kolhapur-Laxmipuri,Green Peas (Dry),2016,2879,6400,3521,122.29940951719347
Chandrapur,Apple,2016,2950,6470,3520,119.32203389830508
Mangalwedha,Brinjal,2015,448,3968,3520,785.7142857142857
Aurangabad,Mango,2016,4775,8292,3517,73.6544502617801
Kolhapur,CORIANDER ,2016,1823,5338,3515,192.81404278661546
Aurangabad,Garlic,2015,5414,8929,3515,64.92427041004802
Solapur,Rice(Paddy-Hus),2015,2143,5656,3513,163.92907139524033
Lohara,Black Gram,2016,4011,7516,3505,87.38469209673399
Karanja,Black Gram,2015,8148,11652,3504,43.004418262150224
Sangali,Pigeon Pea (Tur),2015,8000,11500,3500,43.75
Akluj,Pomegranate,2015,5000,8500,3500,70.0
Kolhapur-Laxmipuri,Green Peas (Dry),2014,4000,7500,3500,87.5
Jalgaon,Apple,2016,5000,8500,3500,70.0
Sangli-Phale Bhajipalam,Mosambi,2016,1273,4773,3500,274.9410840534171
Kolhapur,Shepu,2015,2100,5600,3500,166.66666666666666
Mumbai,Betelnuts,2015,26958,30458,3500,12.983158988055493
Jalgaon,Garlic,2016,4750,8250,3500,73.6842105263158
Jalgaon,Garlic,2016,6500,10000,3500,53.84615384615385
Junnar-Otur,Green Chilli,2015,500,4000,3500,700.0
Armori,Chillies(Red),2015,11000,14500,3500,31.818181818181817
Aurangabad,Apple,2016,6682,10182,3500,52.37952708769829
Amalner,Coriander (Dry),2016,4000,7500,3500,87.5
Mangrulpeer,Black Gram,2016,6000,9500,3500,58.333333333333336
Jalgaon,Mango,2016,3500,7000,3500,100.0
Amarawati,Chillies(Red),2015,6500,10000,3500,53.84615384615385
Kolhapur,Ridge Gourd,2015,1433,4933,3500,244.24284717376133
Manchar,Green Chilli,2016,1500,5000,3500,233.33333333333334
Amarawati,Chillies(Red),2015,7000,10500,3500,50.0
Barshi,Garlic,2016,4500,8000,3500,77.77777777777777
Karad,Lemon,2016,5000,8500,3500,70.0
Kamthi,Beet Root,2015,1250,4750,3500,280.0
Pune,Fig,2015,5000,8500,3500,70.0
Amarawati,Apple,2016,3318,6818,3500,105.48523206751055
Satara,Garlic,2015,3750,7250,3500,93.33333333333333
Satara,Garlic,2015,4000,7500,3500,87.5
Satara,Garlic,2015,4250,7750,3500,82.3529411764706
Rahata,Onion,2015,1718,5218,3500,203.72526193247964
Kolhapur-Laxmipuri,Green Peas (Dry),2015,2922,6422,3500,119.78097193702943
Nashik,Garlic,2015,2000,5500,3500,175.0
Bhiwapur,Chillies(Red),2014,3000,6500,3500,116.66666666666667
Rahuri,Ladies Finger,2015,1100,4600,3500,318.1818181818182
Jalgaon,Garlic,2015,2500,6000,3500,140.0
Bhiwapur,Chillies(Red),2016,6750,10250,3500,51.851851851851855
Karad,Apple,2015,8100,11600,3500,43.20987654320987
Pune,Zendu,2014,3250,6750,3500,107.6923076923077
Karad,Apple,2015,4100,7600,3500,85.36585365853658
Junnar-Otur,Wal Papdi,2016,4000,7500,3500,87.5
Solapur,Custard Apple,2015,642,4140,3498,544.8598130841121
Mumbai,Garlic,2016,5931,9428,3497,58.961389310402964
Pandharpur,Green Chilli,2016,3628,7125,3497,96.38919514884233
Mumbai,Rice(Paddy-Hus),2015,4754,8250,3496,73.5380732015145
Kolhapur,Mosambi,2015,1393,4888,3495,250.897343862168
Ahmednagar,Flower,2016,543,4036,3493,643.2780847145488
Daryapur,Black Gram,2016,7411,10903,3492,47.1191472136014
Mumbai,Chillies(Red),2014,9452,12941,3489,36.91282268303004
Satana,Pomegranate,2016,639,4127,3488,545.8528951486697
Umarga,BLACK GRAM,2016,4297,7783,3486,81.12636723295323
Nagpur,Apple,2016,7212,10696,3484,48.30837493067111
Solapur,Ladies Finger,2014,915,4398,3483,380.655737704918
Devala,GRAM,2016,4081,7563,3482,85.32222494486645
Chikhali,Black Gram,2016,6978,10460,3482,49.89968472341645
Pune,Squash Gourd,2016,2820,6300,3480,123.40425531914893
Pune,Coriander (Dry),2015,12778,16256,3478,27.21865706683362
Nashik,Pomegranate,2016,2366,5843,3477,146.95688926458158
Sangali,Matki,2016,6288,9765,3477,55.295801526717554
Hinganghat,GRAM,2016,4686,8162,3476,74.17840375586854
Lasalgaon,GRAM,2016,5420,8892,3472,64.0590405904059
Solapur,Rice(Paddy-Hus),2015,2142,5614,3472,162.09150326797385
Nashik,Pomegranate,2016,2817,6289,3472,123.25168619098332
Kolhapur,Shevga,2015,3083,6554,3471,112.58514433992865
Pandharpur,Onion,2015,1366,4837,3471,254.099560761347
Chandrapur,Pomegranate,2014,2646,6115,3469,131.10355253212396
Kamthi,Green Chilli,2016,2876,6345,3469,120.61891515994436
Kolhapur,Mosambi,2015,1620,5088,3468,214.07407407407408
Pune,Chillies(Red),2016,17500,20967,3467,19.81142857142857
Kada,Tamarind,2016,3667,7133,3466,94.51868011998909
Nagpur,Pomegranate,2015,1500,4965,3465,231.0
Ulhasnagar,Other Vegetables,2016,1731,5192,3461,199.9422299248989
Sangrampur-Varvatbakal,Pigeon Pea (Tur),2015,5500,8960,3460,62.90909090909091
Pandharpur,Brinjal,2016,515,3975,3460,671.8446601941747
Sangali,Matki,2015,5571,9029,3458,62.07144139292766
Kolhapur,Onion,2015,600,4057,3457,576.1666666666666
Amarawati-Fruit And Vegetables,APPLE,2016,4178,7635,3457,82.74293920536142
Mumbai,Tamarind,2015,6800,10255,3455,50.80882352941177
Sangali,Green Gram,2015,5909,9364,3455,58.47013030969707
Kolhapur-Malkapur,Capsicum,2016,1425,4878,3453,242.31578947368422
Barshi-Vairag,Black Gram,2016,3598,7050,3452,95.94219010561423
Barshi,Black Gram,2016,3961,7413,3452,87.14970966927544
Nashik,Coriander  ,2015,650,4100,3450,530.7692307692307
Chandrapur,Pomegranate,2015,4217,7667,3450,81.81171448897321
Dhule,Garlic,2016,3300,6750,3450,104.54545454545455
Junnar-Otur,Small Gourd,2016,200,3650,3450,1725.0
Jalgaon,Pomegranate,2016,2250,5700,3450,153.33333333333334
Mangrulpeer,Green Gram,2015,5001,8450,3449,68.96620675864827
Amarawati-Fruit And Vegetables,Pomegranate,2016,3333,6778,3445,103.36033603360336
Nagpur,Pineapple,2016,1262,4705,3443,272.82091917591123
Chandrapur-Ganjwad,Garlic,2016,9559,13000,3441,35.99748927712104
Sangali,Green Gram,2015,5960,9400,3440,57.718120805369125
Karad,Lemon,2016,7125,10563,3438,48.252631578947366
Kopargaon,Onion,2015,1588,5025,3437,216.43576826196474
Solapur,Rice(Paddy-Hus),2015,2108,5542,3434,162.90322580645162
Shirpur,Chillies(Red),2014,4167,7600,3433,82.38540916726662
Kolhapur,Coriander  ,2016,1155,4585,3430,296.969696969697
Mumbai,Fenugreek,2015,5000,8429,3429,68.58
Amarawati,Chillies(Red),2015,6571,10000,3429,52.183838076396285
Kolhapur,Brinjal,2016,1113,4536,3423,307.54716981132077
Sangali,RICE(PADDY-HUS),2016,2164,5586,3422,158.13308687615526
Solapur,Rice(Paddy-Hus),2016,2225,5646,3421,153.75280898876406
Sangli-Phale Bhajipalam,Garlic,2016,3000,6421,3421,114.03333333333333
Kolhapur,Shevga,2015,2467,5887,3420,138.62991487636805
Sinner,Soybean,2014,2666,6086,3420,128.28207051762942
Pune-Moshi,Ladies Finger,2016,1942,5360,3418,176.00411946446962
Shahapur,Cluster Bean,2016,4393,7807,3414,77.71454586842704
Pune,Parwar,2016,1500,4912,3412,227.46666666666667
Kolhapur,Spinach,2016,2013,5425,3412,169.49826130154
Akot,Thymol/Lovage,2016,11917,15329,3412,28.631366954770495
Mumbai,Garlic,2014,1858,5269,3411,183.58449946178686
Kolhapur,Cluster Bean,2016,3060,6470,3410,111.43790849673202
Pune-Manjri,Green Chilli,2016,6148,9556,3408,55.43266102797658
Amarawati,Garlic,2016,4619,8024,3405,73.71725481705997
Balapur,Pigeon Pea (Tur),2015,5375,8780,3405,63.348837209302324
Mumbai-Fruit Market,Apple,2016,4519,7923,3404,75.32639964593936
Ausa,Black Gram,2016,3670,7071,3401,92.67029972752043
Chalisgaon,Green Chilli,2016,2867,6267,3400,118.59086152772933
Nagpur,Ginger (Dry),2015,1800,5200,3400,188.88888888888889
Kalyan,Green Peas (Dry),2015,3600,7000,3400,94.44444444444444
Kolhapur-Laxmipuri,Rice(Paddy-Hus),2015,1992,5392,3400,170.68273092369478
Kalyan,Rice(Paddy-Hus),2016,1600,5000,3400,212.5
Pune,Green Chilli,2016,3775,7175,3400,90.06622516556291
Akluj,Garlic,2016,7711,11111,3400,44.09285436389573
Rahuri-Vambori,Onion,2015,345,3745,3400,985.5072463768116
Jalgaon,Pomegranate,2016,2933,6333,3400,115.92226389362428
Mangalwedha,Ladies Finger,2016,802,4200,3398,423.6907730673317
Kolhapur,Mosambi,2016,1969,5363,3394,172.3717623158964
Nashik,Green-Peas,2016,7320,10713,3393,46.35245901639344
Karad,LEMON,2016,2944,6333,3389,115.11548913043478
Karad,Lemon,2016,3111,6500,3389,108.93603342976535
Kolhapur,Apple,2015,10263,13651,3388,33.01178992497321
Solapur,Rice(Paddy-Hus),2015,2109,5495,3386,160.55002370791846
Kamthi,Coriander  ,2014,3115,6500,3385,108.6677367576244
Kamthi,Dhemse,2015,1538,4923,3385,220.09102730819245
Mumbai,Betelnuts,2014,28385,31769,3384,11.921789677646645
Osmanabad,Green Chilli,2016,4071,7454,3383,83.09997543601081
Solapur,Bitter Gourd,2016,3050,6432,3382,110.88524590163935
Amarawati-Fruit And Vegetables,Pomegranate,2016,2471,5853,3382,136.8676649129907
Solapur,Rice(Paddy-Hus),2016,2215,5596,3381,152.6410835214447
Sangli-Phale Bhajipalam,Apple,2015,3063,6438,3375,110.18609206660138
Pune,CORIANDER (DRY),2016,8825,12200,3375,38.243626062322946
Bhiwapur,Chillies(Red),2016,7500,10875,3375,45.0
Pune,Coriander (Dry),2015,10875,14250,3375,31.03448275862069
Bhiwapur,Chillies(Red),2015,4500,7875,3375,75.0
Nagpur,Lemon,2016,4669,8041,3372,72.22103234097237
Nagpur,Apple,2014,2937,6307,3370,114.74293496765407
Kolhapur,Mosambi,2016,3831,7200,3369,87.94048551292092
Kolhapur,Apple,2016,11289,14658,3369,29.843210204623972
Sangli-Phale Bhajipalam,Chikoo,2015,1800,5167,3367,187.05555555555554
Rahuri,Cluster Bean,2016,1700,5067,3367,198.05882352941177
Kamthi,Mint,2015,1500,4864,3364,224.26666666666668
Aurangabad,Pomegranate,2014,1152,4514,3362,291.84027777777777
Udgir,BLACK GRAM,2016,4089,7450,3361,82.1961359745659
Sangli-Phale Bhajipalam,Mosambi,2016,1722,5083,3361,195.18002322880372
Morshi,Chillies(Red),2016,9640,13000,3360,34.85477178423236
Kolhapur,Orange,2015,2780,6140,3360,120.86330935251799
Parbhani,Gram,2016,5879,9238,3359,57.135567273345806
Solapur,Rice(Paddy-Hus),2015,2107,5463,3356,159.27859515899382
Sangli-Phale Bhajipalam,Chikoo,2015,1000,4353,3353,335.3
Nagpur,Apple,2015,5385,8738,3353,62.26555246053853
Rahuri,CUSTARD APPLE,2016,200,3550,3350,1675.0
Manchar,Beet Root,2014,200,3550,3350,1675.0
Sangli-Phale Bhajipalam,Pomegranate,2016,1100,4450,3350,304.54545454545456
Dhule,Chillies(Red),2015,4276,7625,3349,78.32086061739943
Pune,Mango(Raw),2015,1000,4348,3348,334.8
Mumbai,Rice(Paddy-Hus),2014,6006,9352,3346,55.71095571095571
Mehkar,Black Gram,2015,7791,11136,3345,42.934154793993066
Devala,Gram,2016,5879,9224,3345,56.89743153597551
Kolhapur,Lemon,2015,609,3953,3344,549.0968801313629
Sangali,Green Gram,2015,5643,8986,3343,59.24153818890661
Kolhapur,Brinjal,2016,1181,4522,3341,282.89585097375107
Sangli-Phale Bhajipalam,Pomegranate,2016,1227,4568,3341,272.29013854930724
Rahuri-Vambori,Onion,2015,1667,5008,3341,200.41991601679663
Lasalgaon,Green Gram,2015,5317,8656,3339,62.7985706225315
Pune-Manjri,Ghosali(Bhaji),2015,1125,4463,3338,296.7111111111111
Khed,Cluster Bean,2016,2634,5972,3338,126.72741078208048
Mangalwedha,Cucumber,2016,546,3881,3335,610.8058608058608
Mumbai,Betelnuts,2016,25333,28667,3334,13.160699482887933
Satara,GARLIC,2016,7333,10667,3334,45.46570298649939
Satara,Garlic,2016,5444,8778,3334,61.2417340191036
Satara,Garlic,2015,2667,6000,3333,124.97187851518561
Kamthi,Green Peas (Dry),2015,2778,6111,3333,119.97840172786177
Osmanabad,Bitter Gourd,2016,2500,5833,3333,133.32
Aurangabad,Pomegranate,2016,1145,4477,3332,291.0043668122271
Sangali,Turmeric,2016,7577,10909,3332,43.97518806915666
Akluj,Garlic,2016,6270,9600,3330,53.110047846889955
Solapur,Rice(Paddy-Hus),2015,2113,5443,3330,157.5958353052532
Pathardi,Onion,2015,500,3829,3329,665.8
Mangalwedha,Ladies Finger,2016,919,4246,3327,362.0239390642002
Murum,Black Gram,2015,8561,11887,3326,38.8506015652377
Morshi,Chillies(Red),2016,9375,12694,3319,35.40266666666667
Ahmednagar,Cluster Bean,2016,2364,5682,3318,140.35532994923858
Mumbai,Grapes,2016,2725,6042,3317,121.72477064220183
Solapur,Garlic,2016,4267,7583,3316,77.7126786969768
Manchar,Green Chilli,2016,3174,6489,3315,104.44234404536861
Kolhapur,Lemon,2015,1000,4313,3313,331.3
Nagpur,Chillies(Red),2016,10188,13500,3312,32.50883392226148
Amarawati,Pomegranate,2015,2688,6000,3312,123.21428571428571
Akot,Thymol/Lovage,2016,13264,16575,3311,24.962303980699637
Phaltan,Gram,2016,3425,6733,3308,96.58394160583941
Sangli-Phale Bhajipalam,CHIKOO,2016,3615,6923,3308,91.5076071922545
Solapur,Rice(Paddy-Hus),2015,2114,5421,3307,156.4333017975402
Kalyan,Garlic,2016,7414,10721,3307,44.60480172646345
Sangali,Green Gram,2015,5938,9244,3306,55.67531155271135
Sangali,Turmeric,2015,7385,10691,3306,44.76641841570751
Junnar-Otur,Green Chilli,2016,2147,5453,3306,153.98230088495575
Sinner,Onion,2015,1321,4626,3305,250.1892505677517
Khamgaon,Pigeon Pea (Tur),2015,7570,10873,3303,43.6327608982827
Yeola,Onion,2015,1539,4840,3301,214.48992852501624
Pune-Manjri,Coriander  ,2015,2050,5350,3300,160.97560975609755
Pune-Manjri,Ghosali(Bhaji),2015,652,3952,3300,506.13496932515335
Aurangabad,Apple,2015,5200,8500,3300,63.46153846153846
Kolhapur,Shevga,2015,2450,5750,3300,134.69387755102042
Indapur-Bhigwan,Matki,2014,2000,5300,3300,165.0
Junnar-Otur,Ginger (Dry),2016,1500,4800,3300,220.0
Mumbai,Grapes,2016,1513,4813,3300,218.10971579643092
Aurangabad,Pomegranate,2016,1000,4300,3300,330.0
Pune-Manjri,Ghosali(Bhaji),2015,0,3300,3300,inf
Aurangabad,Apple,2014,4500,7800,3300,73.33333333333333
Malkapur,Pigeon Pea (Tur),2015,6177,9473,3296,53.35923587502024
Solapur,Rice(Paddy-Hus),2016,2216,5509,3293,148.60108303249098
Chandrapur,Pomegranate,2016,3042,6333,3291,108.1854043392505
Kolhapur,Chikoo,2016,385,3675,3290,854.5454545454545
Mumbai,Fenugreek,2015,8590,11880,3290,38.30034924330617
Kolhapur,Coriander  ,2015,1508,4798,3290,218.16976127320956
Atpadi,Pomegranate,2016,1500,4788,3288,219.2
Kolhapur,Math (Bhaji),2016,1826,5113,3287,180.01095290251916
Mumbai,Spilt Pigeon Pea,2015,8381,11667,3286,39.207731774251286
Sangali,Turmeric,2015,7170,10455,3285,45.81589958158996
Nandurbar,Thymol/Lovage,2016,10900,14184,3284,30.128440366972477
Nashik,Pomegranate,2016,2805,6083,3278,116.86274509803921
Karad,Lemon,2016,2222,5500,3278,147.52475247524754
Khed,Green Chilli,2016,3397,6673,3276,96.43803355902267
Solapur,Ladies Finger,2016,752,4026,3274,435.3723404255319
Sangli-Phale Bhajipalam,Mango,2016,2670,5944,3274,122.62172284644194
Rahata,Garlic,2016,4727,8000,3273,69.24053310767928
Sangamner,Onion,2015,1571,4844,3273,208.3386378103119
Aurangabad,Apple,2015,4636,7909,3273,70.59965487489215
Ahmednagar,Lemon,2016,2227,5500,3273,146.9690166142793
Kolhapur-Laxmipuri,Gram,2016,4421,7692,3271,73.98778556887582
Kolhapur,Lemon,2016,1000,4269,3269,326.9
Jalgaon,Pomegranate,2015,2067,5333,3266,158.0067731011127
Mangrulpeer,Black Gram,2016,10249,13513,3264,31.847009464337983
Ahmednagar,Green Chilli,2016,3152,6413,3261,103.45812182741116
Pune,Chillies(Red),2015,12350,15610,3260,26.39676113360324
Pune-Manjri,Ghosali(Bhaji),2016,1750,5010,3260,186.28571428571428
Nashik,Garlic,2015,1980,5240,3260,164.64646464646464
Jalgaon,BLACK GRAM,2016,4298,7558,3260,75.84923220102374
Solapur,Guava,2016,2380,5640,3260,136.9747899159664
Pune,Green-Peas,2015,4920,8180,3260,66.26016260162602
Kolhapur,Mango,2015,1007,4265,3258,323.53525322740813
Chandrapur-Ganjwad,Garlic,2014,3644,6900,3256,89.3523600439078
Malegaon,Matki,2015,4300,7552,3252,75.62790697674419
Mumbai,Garlic,2015,6576,9828,3252,49.45255474452555
Kalyan,Apple,2016,7250,10500,3250,44.827586206896555
Junnar (Narayangaon),Coriander  ,2016,1501,4751,3250,216.52231845436376
Amarawati,Chillies(Red),2015,6750,10000,3250,48.148148148148145
Kamthi,Garlic,2015,4000,7250,3250,81.25
Khamgaon,Male Goat,2015,2750,6000,3250,118.18181818181819
Pune,Coriander (Dry),2015,7375,10625,3250,44.067796610169495
Rahuri,Apple,2016,5250,8500,3250,61.904761904761905
Aurangabad,Apple,2016,5125,8375,3250,63.41463414634146
Nagpur,Pineapple,2016,1654,4904,3250,196.49334945586457
Amarawati,Garlic,2016,7000,10250,3250,46.42857142857143
Kolhapur-Laxmipuri,Rice(Paddy-Hus),2015,2000,5250,3250,162.5
Rahuri,Green Chilli,2016,5750,9000,3250,56.52173913043478
Balapur,BLACK GRAM,2016,3575,6825,3250,90.9090909090909
Manchar,Farshi,2014,1000,4250,3250,325.0
Bhiwapur,Chillies(Red),2016,6000,9250,3250,54.166666666666664
Sangli-Phale Bhajipalam,Onion,2015,1276,4525,3249,254.62382445141066
Sinner,GRAM,2016,4715,7962,3247,68.86532343584305
Akluj,Garlic,2016,8324,11571,3247,39.007688611244596
Mumbai,Garlic,2016,6404,9650,3246,50.687070580886946
Mumbai,Rice(Paddy-Hus),2015,3932,7178,3246,82.55340793489319
Aurangabad,Pomegranate,2015,1807,5053,3246,179.63475373547317
Karanja,BLACK GRAM,2016,4105,7349,3244,79.02557856272838
Nashik,Pomegranate,2016,3050,6293,3243,106.32786885245902
Kurdwadi-Modnimb,Black Gram,2016,3856,7097,3241,84.05082987551867
Ahmednagar,Tamarind,2016,6989,10229,3240,46.35856345686078
Nagpur,Ginger (Fresh),2016,2262,5500,3238,143.14765694076038
Mangrulpeer,Pigeon Pea (Tur),2015,6586,9824,3238,49.16489523231096
Mumbai,Garlic,2014,2481,5714,3233,130.31035872632003
Solapur,Rice(Paddy-Hus),2015,2124,5356,3232,152.16572504708097
Solapur,Onion,2015,195,3427,3232,1657.4358974358975
Shrirampur,Onion,2015,1656,4888,3232,195.16908212560386
Pune-Manjri,Ghevda,2015,1313,4544,3231,246.07768469154607
Nagpur,Pomegranate,2015,1500,4730,3230,215.33333333333334
Mumbai,Rice(Paddy-Hus),2015,4559,7786,3227,70.7830664619434
Kolhapur,Bitter Gourd,2016,2447,5674,3227,131.87576624438088
Sangli-Phale Bhajipalam,Mosambi,2016,1444,4667,3223,223.1994459833795
Mangalwedha,Brinjal,2015,567,3789,3222,568.2539682539683
Solapur,Cluster Bean,2016,1956,5178,3222,164.72392638036808
Sangali,Matki,2015,5611,8833,3222,57.422919265728034
Mangalwedha,Bitter Gourd,2016,1795,5015,3220,179.38718662952647
Chandrapur,Grapes,2016,2100,5320,3220,153.33333333333334
Mumbai,Grapes,2016,1707,4927,3220,188.63503222026947
Jalgaon,Garlic,2016,6000,9220,3220,53.666666666666664
Nashik,Brinjal,2014,2170,5389,3219,148.34101382488478
Mangalwedha,Brinjal,2016,559,3778,3219,575.8497316636851
Amarawati-Fruit And Vegetables,POMEGRANATE,2016,3640,6855,3215,88.32417582417582
Baramati,Onion,2015,1868,5083,3215,172.10920770877945
Gondiya,Tamarind,2016,3663,6877,3214,87.74228774228774
Mumbai,Tamarind,2015,5619,8833,3214,57.19878982025271
Sangli-Phale Bhajipalam,Orange,2016,1857,5071,3214,173.07485191168553
Pune-Manjri,Ghosali(Bhaji),2014,375,3588,3213,856.8
Pune-Manjri,Raddish,2016,1311,4522,3211,244.92753623188406
Sangali,Matki,2015,5760,8970,3210,55.729166666666664
Aurangabad,Custard Apple,2016,1655,4864,3209,193.89728096676737
Khalapur(Shil-Phata),Rice(Paddy-Hus),2016,2308,5517,3209,139.0381282495667
Ahmednagar,Tomato,2016,821,4029,3208,390.7429963459196
Kolhapur,Lemon,2016,1236,4444,3208,259.546925566343
Solapur,Ladies Finger,2015,817,4025,3208,392.65605875153
Mangalwedha,Cucumber,2016,500,3708,3208,641.6
Mumbai,Pomegranate,2015,4500,7708,3208,71.28888888888889
Nagpur,Ginger (Fresh),2016,2388,5594,3206,134.25460636515913
Solapur,Custard Apple,2014,474,3679,3205,676.1603375527426
Sangli-Phale Bhajipalam,Mosambi,2016,1068,4273,3205,300.0936329588015
Latur,GRAM,2016,6793,9997,3204,47.16620050051524
Jamner-Neri,Black Gram,2015,4866,8070,3204,65.8446362515413
Solapur,Chillies(Red),2016,10346,13550,3204,30.968490237773054
Ahmednagar,Brinjal,2016,1350,4550,3200,237.03703703703704
Sangali,Matki,2015,5700,8900,3200,56.14035087719298
Satara,Garlic,2015,3800,7000,3200,84.21052631578948
Kolhapur-Laxmipuri,Green Peas (Dry),2015,2962,6162,3200,108.03511141120865
Chandrapur-Ganjwad,Garlic,2016,5045,8245,3200,63.429137760158575
Nashik,Ginger (Fresh),2015,2100,5300,3200,152.38095238095238
Nashik,Ghosali(Bhaji),2016,2731,5931,3200,117.1731966312706
Sangali,Green Gram,2015,5556,8756,3200,57.59539236861051
Chandrapur-Ganjwad,Garlic,2015,4500,7700,3200,71.11111111111111
Mumbai,Mustard,2015,4800,8000,3200,66.66666666666667
Pune,Pavtta,2016,3400,6600,3200,94.11764705882354
Junnar-Otur,Cluster Bean,2016,2083,5279,3196,153.43254920787325
Shegaon,Thymol/Lovage,2015,8278,11473,3195,38.59627929451558
Sangola,Pomegranate,2015,2018,5211,3193,158.22596630327055
Jamner,Black Gram,2015,4928,8121,3193,64.79301948051948
Hanegaon,Black Gram,2016,4290,7482,3192,74.4055944055944
Nagpur,Orange,2016,1173,4364,3191,272.0375106564365
Indapur-Bhigwan,Ghevda Seed,2016,4559,7750,3191,69.9934196095635
Solapur,Cluster Bean,2015,2641,5830,3189,120.74971601666036
Osmanabad,Green Chilli,2016,6688,9875,3187,47.65251196172249
Sangali,Turmeric,2014,5000,8182,3182,63.64
Pandharpur,Onion,2015,482,3664,3182,660.1659751037345
Shirpur,Sesamum,2014,7225,10406,3181,44.02768166089965
Aurangabad,Apple,2014,4893,8071,3178,64.94992846924177
Nagpur,Grapes,2016,2812,5988,3176,112.94452347083926
Mumbai,Garlic,2016,4075,7250,3175,77.91411042944786
Chikhali,Black Gram,2016,6900,10070,3170,45.94202898550725
Nashik,Custard Apple,2016,1908,5077,3169,166.0901467505241
Ahmednagar,Cluster Bean,2016,4333,7500,3167,73.09023771059313
Satara,Garlic,2015,3000,6167,3167,105.56666666666666
Kolhapur,Squash Gourd,2015,900,4067,3167,351.8888888888889
Amarawati-Fruit And Vegetables,Apple,2016,4167,7333,3166,75.9779217662587
Armori,Chillies(Red),2015,9167,12333,3166,34.53692592996618
Mumbai,Small Gourd,2016,2157,5319,3162,146.59248956884562
Kalamb (Os),BLACK GRAM,2016,3720,6878,3158,84.89247311827957
Sangli-Phale Bhajipalam,Garlic,2016,3053,6211,3158,103.43924009171307
Malkapur,Chillies(Red),2016,6531,9688,3157,48.338692390139336
Kolhapur-Malkapur,Tomato,2016,1094,4250,3156,288.48263254113346
Pune,Green Chilli,2016,2484,5640,3156,127.05314009661836
Kolhapur,Water Melon,2016,183,3337,3154,1723.4972677595629
Kalyan,Grapes,2015,6192,9346,3154,50.93669250645995
Solapur,Lemon,2016,387,3540,3153,814.7286821705426
Satana,Pomegranate,2016,1088,4239,3151,289.6139705882353
Pune,Ladies Finger,2015,1825,4975,3150,172.6027397260274
Kej,Tamarind,2016,3350,6500,3150,94.02985074626865
Pathardi,Onion,2015,500,3650,3150,630.0
Nashik,Brinjal,2015,1100,4250,3150,286.3636363636364
Mumbai,Apple,2015,4889,8037,3148,64.38944569441604
Sangli-Phale Bhajipalam,MOSAMBI,2016,3059,6206,3147,102.87675711016672
Chandvad,Zendu,2015,833,3975,3142,377.19087635054024
Khamgaon,Black Gram,2015,7585,10725,3140,41.397495056031644
Kolhapur,Lemon,2015,1045,4182,3137,300.1913875598086
Mandhal,Chillies(Red),2016,6142,9278,3136,51.058287202865515
Chandrapur,Grapes,2016,1711,4847,3136,183.28462887200467
Mumbai,Cowpea,2015,4633,7767,3134,67.64515432764946
Dhule,Onion,2015,1168,4302,3134,268.32191780821915
Pune-Manjri,Ghosali(Bhaji),2015,385,3519,3134,814.025974025974
Nagpur,Garlic,2014,3146,6279,3133,99.58677685950413
Pune-Manjri,Ghevda,2015,2610,5740,3130,119.92337164750958
Nandurbar,Gram,2016,4554,7683,3129,68.70882740447958
Malegaon,Onion,2015,1513,4641,3128,206.74157303370785
Solapur,Rice(Paddy-Hus),2016,2125,5252,3127,147.1529411764706
Kalyan,Garlic,2016,5142,8269,3127,60.81291326332166
Kolhapur,Naspatti ,2015,10000,13125,3125,31.25
Mumbai,Tamarind,2015,3125,6250,3125,100.0
Satara,Garlic,2015,4375,7500,3125,71.42857142857143
Kolhapur,Lemon,2016,1125,4250,3125,277.77777777777777
Kamthi,Garlic,2015,3625,6750,3125,86.20689655172414
Ahmednagar,Bitter Gourd,2016,3083,6204,3121,101.23256568277651
Aurangabad,Pomegranate,2015,1463,4584,3121,213.32877648667122
Daryapur,Green Gram,2014,3900,7021,3121,80.02564102564102
Nagpur,Apple,2015,4380,7500,3120,71.23287671232876
Kolhapur,Math (Bhaji),2015,2888,6008,3120,108.03324099722991
Jamkhed,Onion,2015,489,3606,3117,637.4233128834355
Pune-Manjri,Curry Leaves,2016,1385,4500,3115,224.90974729241879
Nandurbar,Thymol/Lovage,2015,9441,12555,3114,32.98379408960915
Nashik,Coriander  ,2016,3060,6173,3113,101.73202614379085
Nagpur,Ginger (Fresh),2015,1908,5020,3112,163.1027253668763
Kamthi,Ginger (Fresh),2015,1889,5000,3111,164.69031233456855
Amarawati-Fruit And Vegetables,Pomegranate,2016,2333,5444,3111,133.34762108872695
Sangli-Phale Bhajipalam,Orange,2016,1222,4333,3111,254.58265139116202
Khamgaon,Pigeon Pea (Tur),2015,6781,9892,3111,45.87818905766111
Pune,Chillies(Red),2016,16120,19229,3109,19.286600496277917
Kopargaon,Onion,2015,1531,4638,3107,202.93925538863488
Satana,Pomegranate,2016,1294,4400,3106,240.0309119010819
Kolhapur,Kanda Pat,2015,2319,5425,3106,133.9370418283743
Mumbai,Tamarind,2014,6158,9263,3105,50.42221500487171
Nagpur,Garlic,2014,2646,5750,3104,117.30914588057445
Pandharpur,Green Chilli,2016,3355,6457,3102,92.45901639344262
Karad,Apple,2015,6450,9550,3100,48.06201550387597
Manwat,Pigeon Pea (Tur),2015,6751,9851,3100,45.91912309287513
Kolhapur,Green-Peas,2015,2224,5324,3100,139.3884892086331
Nagpur,Garlic,2014,2860,5960,3100,108.39160839160839
Aurangabad,Garlic,2015,2789,5889,3100,111.15095016134815
Indapur-Bhigwan,Pigeon Pea (Tur),2015,5840,8940,3100,53.082191780821915
Nagpur,Garlic,2016,1923,5023,3100,161.2064482579303
Armori,Chillies(Red),2016,15650,18750,3100,19.808306709265175
Solapur,Rice(Paddy-Hus),2016,2216,5314,3098,139.8014440433213
Karanja,Black Gram,2015,7632,10728,3096,40.56603773584906
Pune,Garlic,2016,4000,7095,3095,77.375
Sangli-Phale Bhajipalam,Garlic,2016,3000,6094,3094,103.13333333333334
Aurangabad,Apple,2014,5188,8281,3093,59.6183500385505
Pune,Ladies Finger,2016,1328,4420,3092,232.83132530120483
Satana,GRAM,2016,5559,8651,3092,55.621514660910236
Baramati,Gram,2016,5970,9062,3092,51.79229480737018
Mumbai,Betelnuts,2015,28909,32000,3091,10.692171987962226
Malegaon,GRAM,2016,6150,9239,3089,50.22764227642276
Mumbai,Tamarind,2014,6400,9488,3088,48.25
Ahmednagar,Tamarind,2015,5562,8650,3088,55.519597267170084
Solapur,Rice(Paddy-Hus),2015,2108,5193,3085,146.3472485768501
Amarawati,Pomegranate,2016,2194,5278,3084,140.5651777575205
Kolhapur,Onion,2015,541,3623,3082,569.6857670979667
Mangalwedha,Brinjal,2015,364,3444,3080,846.1538461538462
Mangalwedha,Brinjal,2016,506,3585,3079,608.498023715415
Aurangabad,Apple,2015,5269,8346,3077,58.39817802239514
Nagpur,Apple,2014,4019,7096,3077,76.56133366509081
Mumbai,Pomegranate,2015,6000,9077,3077,51.28333333333333
Nashik,Ghevda,2016,2852,5923,3071,107.6788218793829
Kamthi,Bitter Gourd,2015,2230,5300,3070,137.66816143497758
Balapur,Black Gram,2016,3920,6990,3070,78.31632653061224
Ahmednagar,Tamarind,2015,5052,8120,3068,60.72842438638163
Kolhapur,Green Chilli,2016,3060,6128,3068,100.26143790849673
Ahmednagar,Ginger (Fresh),2015,2333,5400,3067,131.46163737676812
Kolhapur,Squash Gourd,2016,1167,4233,3066,262.7249357326478
Pune,Cluster Bean,2016,2565,5630,3065,119.49317738791423
Kolhapur-Laxmipuri,Green Peas (Dry),2015,2950,6014,3064,103.86440677966101
Malegaon,Onion,2015,1266,4328,3062,241.86413902053712
Solapur,Guava,2016,1340,4400,3060,228.3582089552239
Mumbai,Chikoo,2015,1615,4675,3060,189.47368421052633
Nagpur,Garlic,2015,1731,4788,3057,176.60311958405546
Shrirampur,Onion,2015,1114,4171,3057,274.4165170556553
Nashik,Capsicum,2014,2753,5810,3057,111.04249909189974
Atpadi,Pomegranate,2016,1700,4756,3056,179.76470588235293
Solapur,Brinjal,2016,828,3883,3055,368.96135265700485
Karjat (Raigad),Rice(Paddy-Hus),2016,2000,5055,3055,152.75
Kolhapur,Mosambi,2016,4418,7473,3055,69.14893617021276
Mumbai,Garlic,2015,4050,7104,3054,75.4074074074074
Mandhal,Chillies(Red),2015,4390,7444,3054,69.56719817767653
Pune-Manjri,Ghevda,2015,731,3785,3054,417.78385772913816
Chandrapur,Grapes,2015,2789,5842,3053,109.46575833632126
Mumbai,Tamarind,2015,3316,6368,3052,92.03860072376357
Lasalgaon-Vinchur,Gram,2016,5867,8918,3051,52.0027271177774
Pune-Moshi,Brinjal,2016,1719,4770,3051,177.4869109947644
Mumbai,Rice(Paddy-Hus),2015,5300,8351,3051,57.56603773584906
Pune,Turmeric,2014,7550,10600,3050,40.397350993377486
Solapur,Garlic,2015,2360,5410,3050,129.23728813559322
Ahmednagar,Onion,2015,340,3390,3050,897.0588235294117
Malkapur,Pigeon Pea (Tur),2015,6113,9162,3049,49.87731064943563
Umared,GRAM,2016,5746,8794,3048,53.04559693699965
Ahmednagar,Cluster Bean,2016,2095,5143,3048,145.4892601431981
Tasgaon,Tamarind,2016,6104,9152,3048,49.93446920052425
Sangali,Black Gram,2015,7510,10557,3047,40.572569906790946
Chandrapur,Apple,2016,3225,6272,3047,94.48062015503876
Kolhapur,Capsicum,2016,1387,4434,3047,219.68276856524875
Sangali,Matki,2016,5807,8853,3046,52.45393490614775
Nagpur,Garlic,2015,2896,5942,3046,105.17955801104972
Ahmednagar,Flower,2015,643,3686,3043,473.2503888024883
Bhiwapur,Orange,2016,2083,5125,3042,146.03936629860777
Pune,Onion,2015,986,4027,3041,308.41784989858013
Malkapur,Pigeon Pea (Tur),2015,7270,10311,3041,41.829436038514444
Akot,Black Gram,2016,8557,11598,3041,35.53815589575786
Mandhal,Chillies(Red),2016,6676,9717,3041,45.55122828040743
Pune,Cluster Bean,2016,2865,5904,3039,106.07329842931937
Kolhapur,Bitter Gourd,2016,2750,5788,3038,110.47272727272727
Solapur,Rice(Paddy-Hus),2015,2121,5158,3037,143.18717586044318
Kolhapur-Laxmipuri,Green Peas (Dry),2016,3200,6236,3036,94.875
Rahata,Garlic,2015,8643,11679,3036,35.12669212079139
Amarawati,Black Gram,2016,7262,10298,3036,41.806664830625174
Mumbai,Tamarind,2014,6059,9094,3035,50.090774055124605
Solapur,RICE(PADDY-HUS),2016,2265,5300,3035,133.99558498896246
Kalyan,Rice(Paddy-Hus),2016,2733,5767,3034,111.0135382363703
Shirpur,Sesamum,2014,8291,11325,3034,36.59389699674346
Pune,Shevga,2015,3833,6867,3034,79.15470910513957
Pandharpur,Onion,2015,1654,4686,3032,183.31318016928657
Nagpur,Garlic,2016,1808,4838,3030,167.58849557522123
Osmanabad,Lemon,2016,2293,5321,3028,132.05407762756215
Akluj,Garlic,2015,8789,11816,3027,34.44077824553419
Nagpur,Pomegranate,2015,2077,5104,3027,145.739046701974
Daryapur,Black Gram,2015,7036,10062,3026,43.007390562819786
Pune-Manjri,Guava,2015,469,3494,3025,644.9893390191897
Akot,Thymol/Lovage,2015,7271,10296,3025,41.6036308623298
Aurangabad,FIG,2016,3200,6225,3025,94.53125
Lasur Station,Onion,2015,1275,4300,3025,237.2549019607843
Mangalwedha,Ladies Finger,2016,700,3723,3023,431.85714285714283
Kolhapur,Math (Bhaji),2015,2291,5314,3023,131.9511130510694
Sinner,Onion,2015,423,3445,3022,714.4208037825059
Karjat (Raigad),RICE(PADDY-HUS),2016,2000,5022,3022,151.1
Sangamner,Tomato,2016,1238,4260,3022,244.10339256865913
Solapur,Garlic,2016,3157,6178,3021,95.6921127652835
Dudhani,Black Gram,2014,3641,6662,3021,82.9717110683878
Risod,Turmeric,2016,6767,9787,3020,44.62834343135806
Pune,GREEN-PEAS,2016,5120,8140,3020,58.984375
Sangali,Green Gram,2014,5538,8556,3018,54.49620801733478
Nagpur,Ginger (Fresh),2016,2400,5417,3017,125.70833333333333
Nagpur,Pomegranate,2015,2100,5116,3016,143.61904761904762
Aurangabad,Melon,2016,1945,4959,3014,154.96143958868893
Lasalgaon,Green Gram,2014,4951,7963,3012,60.83619470813977
Nashik,Green-Peas,2014,4778,7789,3011,63.01799916282964
Pandharpur,Brinjal,2016,489,3499,3010,615.5419222903886
Karjat (Raigad),Rice(Paddy-Hus),2016,2000,5010,3010,150.5
Kamthi,Coriander  ,2014,3564,6571,3007,84.37149270482604
Jamkhed,Onion,2015,1183,4189,3006,254.09974640743872
Bhiwapur,Chillies(Red),2015,3020,6023,3003,99.43708609271523
Solapur,Lemon,2015,227,3230,3003,1322.907488986784
Kolhapur-Malkapur,Squash Gourd,2016,2000,5000,3000,150.0
Kolhapur,Plum,2015,3500,6500,3000,85.71428571428571
Ahmednagar,Green Peas (Dry),2015,3000,6000,3000,100.0
Pune,Turmeric,2015,10500,13500,3000,28.571428571428573
Amarawati-Fruit And Vegetables,Garlic,2016,2333,5333,3000,128.58979854264896
Kolhapur,Green-Peas,2016,5000,8000,3000,60.0
Ramtek,Chillies(Red),2016,9000,12000,3000,33.333333333333336
Mumbai,Fennel,2015,13391,16391,3000,22.403106564110224
Satara,Garlic,2015,2600,5600,3000,115.38461538461539
Aurangabad,Green-Peas,2016,7000,10000,3000,42.857142857142854
Umared,Chillies(Red),2014,4000,7000,3000,75.0
Osmanabad,Shevga,2015,4750,7750,3000,63.1578947368421
Mumbai,Custard Apple,2015,3000,6000,3000,100.0
Lonar,Green Gram,2016,5200,8200,3000,57.69230769230769
Pune-Pimpri,Coriander (Dry),2016,10000,13000,3000,30.0
Sangali,Matki,2016,7135,10135,3000,42.04625087596356
Umared,Chillies(Red),2015,6500,9500,3000,46.15384615384615
Satara,Garlic,2015,2000,5000,3000,150.0
Osmanabad,Green Chilli,2016,4000,7000,3000,75.0
Pune-Manjri,Pavtta,2015,500,3500,3000,600.0
Kalyan,Guava,2015,3000,6000,3000,100.0
Ahmednagar,Cluster Bean,2015,2750,5750,3000,109.0909090909091
Sailu,Pigeon Pea (Tur),2015,7000,10000,3000,42.857142857142854
Satara,Garlic,2014,2000,5000,3000,150.0
Kalyan,Garlic,2015,4000,7000,3000,75.0
Nashik,Ginger (Fresh),2015,1900,4900,3000,157.89473684210526
Dhule,Garlic,2016,5000,8000,3000,60.0
Kamthi,Dhemse,2015,2000,5000,3000,150.0
Aurangabad,Fig,2015,5000,8000,3000,60.0
Satara,Garlic,2014,2000,5000,3000,150.0
Sangrampur,Black Gram,2015,8000,11000,3000,37.5
Pune-Pimpri,Cluster Bean,2016,4000,7000,3000,75.0
Chandrapur-Ganjwad,Green Chilli,2016,2667,5667,3000,112.4859392575928
Pune,Coriander (Dry),2014,12500,15500,3000,24.0
Kalyan,Apple,2015,4000,7000,3000,75.0
Mumbai,Garlic,2014,2792,5792,3000,107.44985673352436
Chandrapur-Ganjwad,Other Vegetables,2016,2000,5000,3000,150.0
Mumbai,Betelnuts,2015,28000,31000,3000,10.714285714285714
Junnar (Narayangaon),Math (Bhaji),2016,1001,4001,3000,299.7002997002997
Sangali,Coriander (Dry),2015,8833,11833,3000,33.96354579418091
Nilanga,Black Gram,2015,8500,11500,3000,35.294117647058826
Kolhapur-Laxmipuri,GREEN PEAS (DRY),2016,3200,6200,3000,93.75
Sangali,Chillies(Red),2016,11500,14500,3000,26.08695652173913
Amarawati-Fruit And Vegetables,Apple,2016,5000,8000,3000,60.0
Kalyan,Custard Apple,2014,1000,4000,3000,300.0
Kalyan,Apple,2016,9500,12500,3000,31.57894736842105
Amarawati-Fruit And Vegetables,Pomegranate,2016,2000,5000,3000,150.0
Pune-Manjri,Nolkol,2016,0,3000,3000,inf
Vadgaon Peth,Pavtta,2016,4000,7000,3000,75.0
Pune-Manjri,Nolkol,2016,0,3000,3000,inf
Nashik,Mosambi,2016,2250,5250,3000,133.33333333333334
Ahmednagar,Garlic,2015,4400,7400,3000,68.18181818181819
Kamthi,Coriander  ,2015,2320,5320,3000,129.31034482758622
Mumbai,Apple,2015,5000,8000,3000,60.0
Satara,Garlic,2014,2000,5000,3000,150.0
Junnar-Otur,Bottle Gourd,2015,1000,4000,3000,300.0
Balapur,Pigeon Pea (Tur),2015,6150,9150,3000,48.78048780487805
Buldhana,Black Gram,2016,10000,13000,3000,30.0
Osmanabad,Lemon,2015,2000,5000,3000,150.0
Satara,Garlic,2014,2000,5000,3000,150.0
Pune-Manjri,Beet Root,2016,0,3000,3000,inf
Sangali,Black Gram,2016,8000,11000,3000,37.5
Kamthi,Dhemse,2014,2000,5000,3000,150.0
Pune,Green-Peas,2016,4273,7273,3000,70.20828457758016
Kalyan,Banana,2016,4000,7000,3000,75.0
Aurangabad,Custard Apple,2016,3000,6000,3000,100.0
Satara,Garlic,2016,7000,10000,3000,42.857142857142854
Pune-Manjri,Beet Root,2016,0,3000,3000,inf
Pune-Manjri,Beet Root,2015,0,3000,3000,inf
Satara,Garlic,2014,2000,5000,3000,150.0
Mumbai,Grapes,2016,1500,4500,3000,200.0
Sangali,Black Gram,2016,7667,10667,3000,39.128733533324635
Nagpur,Chillies(Red),2016,9480,12480,3000,31.645569620253166
Satara,Garlic,2014,2000,5000,3000,150.0
Sangli-Phale Bhajipalam,Mosambi,2016,1286,4286,3000,233.28149300155522
Kolhapur-Laxmipuri,Chillies(Red),2014,15000,18000,3000,20.0
Rahuri-Songaon,Ladies Finger,2016,1750,4750,3000,171.42857142857142
Kamthi,Green Peas (Dry),2016,2000,5000,3000,150.0
Malkapur,Chillies(Red),2014,4600,7600,3000,65.21739130434783
Anajngaon Surji,He Buffalo,2016,9000,12000,3000,33.333333333333336
Amarawati-Fruit And Vegetables,Orange,2016,3500,6500,3000,85.71428571428571
Manchar,Garlic,2016,6000,9000,3000,50.0
Indapur-Bhigwan,CHILLIES(RED),2016,6000,9000,3000,50.0
Sangli-Phale Bhajipalam,Mosambi,2016,1000,4000,3000,300.0
Pune-Pimpri,Pavtta,2016,4000,7000,3000,75.0
Satara,Garlic,2015,5000,8000,3000,60.0
Jalgaon,Garlic,2015,3375,6375,3000,88.88888888888889
Satara,Garlic,2015,3000,6000,3000,100.0
Kolhapur-Laxmipuri,Green Peas (Dry),2016,3200,6200,3000,93.75
Pen,Rice(Paddy-Hus),2015,3500,6500,3000,85.71428571428571
Jalgaon,Pomegranate,2016,1875,4875,3000,160.0
Barshi,Pomegranate,2016,3500,6500,3000,85.71428571428571
Kalyan,Coriander (Dry),2015,11250,14250,3000,26.666666666666668
Sinner,Ground Nut Pods (Dry),2015,2501,5500,2999,119.91203518592563
Sangola,Pomegranate,2015,2458,5456,2998,121.96908055329536
Nashik,Tomato,2016,2746,5743,2997,109.14056809905317
Mangalwedha,Brinjal,2016,456,3450,2994,656.578947368421
Chandvad,Onion,2015,1547,4537,2990,193.27731092436974
Junnar-Otur,Capsicum,2016,2750,5739,2989,108.69090909090909
Nagpur,Grapes,2016,2860,5848,2988,104.47552447552448
Akot,Thymol/Lovage,2016,12795,15783,2988,23.35287221570926
Solapur,Ridge Gourd,2015,1130,4116,2986,264.24778761061947
Solapur,Green Chilli,2016,3406,6389,2983,87.5807398708162
Kolhapur,Ladies Finger,2015,1167,4150,2983,255.61268209083119
Latur,Green Gram,2016,6520,9500,2980,45.70552147239264
Pune-Manjri,Guava,2015,222,3200,2978,1341.4414414414414
Dhule,Onion,2015,1077,4053,2976,276.32311977715875
Junnar-Otur,Capsicum,2016,2229,5205,2976,133.5127860026918
Nandgaon,Onion,2015,1440,4415,2975,206.59722222222223
Yeola,Onion,2015,1743,4716,2973,170.56798623063682
Kalyan,Garlic,2015,4395,7368,2973,67.64505119453925
Kolhapur-Laxmipuri,Rice(Paddy-Hus),2015,1986,4957,2971,149.59718026183282
Sangamner,Onion,2015,1179,4149,2970,251.9083969465649
Solapur,Ladies Finger,2014,1117,4087,2970,265.8907788719785
Mumbai,Apple,2014,3704,6673,2969,80.15658747300216
Gangapur,Onion,2015,1288,4256,2968,230.43478260869566
Ahmednagar,Ladies Finger,2016,908,3875,2967,326.7621145374449
Solapur,Cluster Bean,2016,1446,4412,2966,205.11756569847856
Ahmednagar,Brinjal,2016,918,3882,2964,322.87581699346407
Kamthi,Green Chilli,2015,1685,4648,2963,175.84569732937686
Mangalwedha,Brinjal,2015,352,3315,2963,841.7613636363636
Mumbai,Apple,2015,5269,8231,2962,56.215600683241604
Pune-Manjri,Ghosali(Bhaji),2015,192,3154,2962,1542.7083333333333
Solapur,Chillies(Red),2016,10292,13253,2961,28.76991838321026
Ahmednagar,Lemon,2016,2368,5326,2958,124.91554054054055
Solapur,Lemon,2015,343,3300,2957,862.0991253644315
Pune,Cluster Bean,2016,2870,5826,2956,102.99651567944251
Mumbai,Spilt Pigeon Pea,2015,9227,12182,2955,32.025577110653515
Nashik,Capsicum,2016,5254,8208,2954,56.223829463266085
Dhule,Chillies(Red),2016,3481,6433,2952,84.80321746624533
Pen,Rice(Paddy-Hus),2015,3550,6500,2950,83.09859154929578
Pen,Rice(Paddy-Hus),2015,3550,6500,2950,83.09859154929578
Pune-Manjri,Guava,2016,0,2950,2950,inf
Barshi,Onion,2015,283,3233,2950,1042.4028268551237
Gevrai,Soybean,2014,2777,5727,2950,106.22974432841195
Pune-Manjri,Green-Peas,2015,1033,3983,2950,285.5759922555663
Pune,Chillies(Red),2016,13316,16263,2947,22.1312706518474
Kolhapur,Math (Bhaji),2015,3132,6079,2947,94.09323116219667
Kolhapur-Laxmipuri,Green Peas (Dry),2016,3333,6278,2945,88.35883588358836
Malkapur,Chillies(Red),2015,7080,10025,2945,41.59604519774011
Sangali,Matki,2016,6594,9538,2944,44.64664846830452
Nashik,Capsicum,2014,2710,5653,2943,108.59778597785977
Mumbai,Mustard,2014,4324,7267,2943,68.06197964847364
Sangali,Turmeric,2014,5009,7952,2943,58.754242363745256
Kalyan,Garlic,2015,10167,13110,2943,28.94659191501918
Solapur,Rice(Paddy-Hus),2016,2239,5181,2942,131.39794551138903
Akole,Onion,2015,780,3720,2940,376.9230769230769
Karad,Apple,2016,7120,10060,2940,41.29213483146067
Nagpur,Lemon,2016,4018,6958,2940,73.17073170731707
Ulhasnagar,Rice(Paddy-Hus),2015,3763,6703,2940,78.1291522721233
Solapur,Cluster Bean,2016,1671,4610,2939,175.88270496708557
Ahmednagar,Garlic,2015,5625,8563,2938,52.23111111111111
Pune-Manjri,Ghosali(Bhaji),2014,313,3250,2937,938.3386581469648
Kolhapur,Brinjal,2016,1098,4035,2937,267.4863387978142
Mumbai,Turmeric,2015,10456,13391,2935,28.07000765110941
Pune,Green Peas (Dry),2015,2430,5365,2935,120.78189300411523
Daryapur,GRAM,2016,6400,9334,2934,45.84375
Ahmednagar,Ladies Finger,2016,1067,4000,2933,274.88284910965325
Sangli-Phale Bhajipalam,Chikoo,2015,1267,4200,2933,231.49171270718233
Pune,Ghevda,2016,3409,6341,2932,86.00762687004986
Pune,Green-Peas,2015,4932,7864,2932,59.44849959448499
Pune,Garlic,2015,2104,5035,2931,139.30608365019012
Aurangabad,Pomegranate,2016,1246,4175,2929,235.07223113964687
Malkapur,Chillies(Red),2016,7843,10771,2928,37.33265332143313
Sangali,Green Gram,2014,5540,8467,2927,52.83393501805054
Nashik,Garlic,2015,2925,5850,2925,100.0
Mangalwedha,Green Chilli,2016,2450,5375,2925,119.38775510204081
Solapur,Ridge Gourd,2015,1138,4063,2925,257.0298769771529
Chandur Bajar,Black Gram,2016,3625,6549,2924,80.66206896551724
Newasa-Ghodegaon,Onion,2015,846,3769,2923,345.5082742316785
Manchar,Onion,2015,1126,4049,2923,259.5914742451155
Solapur,Rice(Paddy-Hus),2016,2143,5066,2923,136.39757349510032
Sangola,Pomegranate,2015,1880,4802,2922,155.4255319148936
Kamthi,Lemon,2015,1830,4750,2920,159.56284153005464
Mumbai-Fruit Market,Apple,2016,5224,8144,2920,55.895865237366
Aurangabad,Pomegranate,2015,963,3881,2918,303.01142263759084
Mangalwedha,Tomato,2016,526,3443,2917,554.5627376425856
Sangli-Phale Bhajipalam,Mosambi,2016,1333,4250,2917,218.82970742685671
Kalyan,Matki,2016,6250,9167,2917,46.672
Ahmednagar,CLUSTER BEAN,2016,1583,4500,2917,184.27037271004423
Ahmednagar,Squash Gourd,2016,1229,4143,2914,237.1033360455655
Sangali,Matki,2015,5900,8814,2914,49.389830508474574
Shegaon,Thymol/Lovage,2015,7915,10829,2914,36.8161718256475
Kolhapur-Laxmipuri,Rice(Paddy-Hus),2016,2243,5157,2914,129.91529201961657
Phaltan,Gram,2016,3425,6338,2913,85.05109489051095
Sangli-Phale Bhajipalam,Custard Apple,2016,625,3538,2913,466.08
Nagpur,Pomegranate,2015,1500,4412,2912,194.13333333333333
Mumbai,Ladies Finger,2014,1674,4585,2911,173.89486260454004
Chandrapur,Pomegranate,2016,2367,5278,2911,122.98267849598648
Shahada,Gram,2016,4591,7502,2911,63.40666521455021
Pune,Ghevda,2015,2140,5048,2908,135.88785046728972
Kurdwadi-Modnimb,BLACK GRAM,2016,3434,6341,2907,84.65346534653466
Amarawati,Apple,2016,3813,6719,2906,76.21295567794388
Aurangabad,Pomegranate,2015,1395,4300,2905,208.2437275985663
Sinner,Gram,2016,6605,9507,2902,43.93641180923543
Sangola,Pomegranate,2016,525,3427,2902,552.7619047619048
Pune-Manjri,Ghevda,2016,0,2900,2900,inf
Kolhapur-Laxmipuri,Rice(Paddy-Hus),2016,2077,4977,2900,139.62445835339432
Kamthi,Ginger (Fresh),2016,2100,5000,2900,138.0952380952381
Solapur,Cluster Bean,2015,1850,4750,2900,156.75675675675674
Akluj,Chillies(Red),2016,4200,7100,2900,69.04761904761905
Solapur,Rice(Paddy-Hus),2016,2214,5114,2900,130.98464317976513
Pandharpur,Onion,2015,250,3150,2900,1160.0
Khamgaon,Chillies(Red),2015,5100,8000,2900,56.86274509803921
Chikhali,Sesamum,2016,4000,6900,2900,72.5
Rahuri,Ladies Finger,2016,400,3300,2900,725.0
Sangali,Pigeon Pea (Tur),2015,6100,9000,2900,47.540983606557376
Osmanabad,Ladies Finger,2015,1600,4500,2900,181.25
Osmanabad,Ginger (Fresh),2015,1600,4500,2900,181.25
Nashik,Green Chilli,2015,2629,5529,2900,110.3081019399011
Indapur-Bhigwan,Cowpea,2016,2700,5600,2900,107.4074074074074
Purna,Turmeric,2015,7200,10100,2900,40.27777777777778
Baramati,Ground Nut Pods (Dry),2015,2500,5400,2900,116.0
Sangali,Coriander (Dry),2016,8000,10900,2900,36.25
Dondaicha,Gram,2016,4733,7630,2897,61.20853581238115
Solapur,Ladies Finger,2015,1535,4431,2896,188.6644951140065
Mumbai,Rice(Paddy-Hus),2015,4709,7605,2896,61.49925674240816
Kolhapur,Orange,2016,5950,8843,2893,48.621848739495796
Pune,Onion,2015,1867,4758,2891,154.84734868773432
Kamthi,Chavli (Pala),2016,1205,4095,2890,239.83402489626556
Sangli-Phale Bhajipalam,Orange,2016,1333,4222,2889,216.7291822955739
Sangali,MATKI,2016,5889,8778,2889,49.05756495160469
Aurangabad,Pomegranate,2015,1575,4463,2888,183.36507936507937
Phaltan,Gram,2016,5334,8222,2888,54.143232095988004
Akot,Thymol/Lovage,2016,14356,17244,2888,20.11702424073558
Lasalgaon,Green Gram,2014,5417,8304,2887,53.295181834964005
Satana,Gram,2016,6305,9192,2887,45.78905630452022
Mumbai,Rice(Paddy-Hus),2016,4816,7702,2886,59.92524916943522
Nagpur,GINGER (FRESH),2016,2000,4886,2886,144.3
Daryapur,Black Gram,2016,6450,9333,2883,44.69767441860465
Aurangabad,Pomegranate,2015,1517,4400,2883,190.0461437046803
Solapur,Chillies(Red),2015,9855,12736,2881,29.233891425672248
Kolhapur,Coriander  ,2016,1144,4025,2881,251.83566433566435
Kalvan,Onion,2015,905,3786,2881,318.3425414364641
Solapur,Custard Apple,2014,803,3683,2880,358.65504358655045
Kamthi,Ginger (Fresh),2016,2323,5200,2877,123.84847180370211
Kalamb (Os),Black Gram,2016,4522,7398,2876,63.60017691287041
Osmanabad,Bitter Gourd,2016,1125,4000,2875,255.55555555555554
Ahmednagar,Green Peas (Dry),2016,1500,4375,2875,191.66666666666666
Pune,Shevga,2015,4188,7063,2875,68.64851957975168
Jalgaon,Garlic,2015,2425,5300,2875,118.55670103092784
Sailu,Sorgum(Jawar),2016,1327,4202,2875,216.65410700828937
Kolhapur-Malkapur,Squash Gourd,2016,1125,4000,2875,255.55555555555554
Solapur,Tomato,2015,442,3316,2874,650.2262443438914
Indapur-Bhigwan,BLACK GRAM,2016,3601,6475,2874,79.8111635656762
Nagpur,Garlic,2015,1654,4527,2873,173.70012091898428
Nagpur,Garlic,2015,1827,4700,2873,157.25232621784346
Solapur,Ladies Finger,2016,880,3752,2872,326.3636363636364
Jamkhed,Onion,2015,367,3239,2872,782.5613079019074
Kolhapur,Brinjal,2015,1170,4040,2870,245.2991452991453
Nagpur,Apple,2016,7597,10466,2869,37.76490720021061
Dhule,GRAM,2016,5993,8861,2868,47.85583180377107
Ahmednagar,Ladies Finger,2016,912,3780,2868,314.4736842105263
Sangola,Pomegranate,2015,2250,5117,2867,127.42222222222222
Sangali,Pigeon Pea (Tur),2015,6833,9700,2867,41.95814429972194
Amarawati,Apple,2015,3533,6400,2867,81.1491650155675
Kamthi,Coriander  ,2015,3000,5867,2867,95.56666666666666
Kamthi,Carrot,2014,2633,5500,2867,108.88720091150779
Sangli-Phale Bhajipalam,Pomegranate,2015,1062,3928,2866,269.86817325800376
Kolhapur,Ladies Finger,2016,1075,3940,2865,266.51162790697674
Ulhasnagar,Rice(Paddy-Hus),2016,3270,6135,2865,87.61467889908256
Aurangabad,CUSTARD APPLE,2016,1200,4065,2865,238.75
Nashik,Pomegranate,2016,2721,5585,2864,105.25542080117604
Katol,Ground Nut Pods (Dry),2014,1842,4706,2864,155.48317046688382
Ahmednagar,Bitter Gourd,2016,2364,5227,2863,121.1082910321489
Pune,Cluster Bean,2015,2523,5386,2863,113.47602061038447
Pune,Chillies(Red),2016,18864,21727,2863,15.177056827820186
Kamthi,Bitter Gourd,2016,2023,4885,2862,141.47305981216016
Karad,Jaggery,2016,2670,5532,2862,107.19101123595506
Pune,Cluster Bean,2015,2940,5800,2860,97.27891156462584
Pune,Tomato,2016,1856,4716,2860,154.0948275862069
Sangali,Green Gram,2015,5780,8640,2860,49.48096885813149
Umarga,Black Gram,2015,8168,11028,2860,35.01469147894221
Solapur,Garlic,2015,2036,4895,2859,140.42239685658154
Pune-Manjri,Ghevda,2015,2217,5074,2857,128.86783942264321
Chandrapur,Grapes,2015,2422,5278,2856,117.91907514450867
Solapur,Rice(Paddy-Hus),2016,2218,5073,2855,128.71956717763751
Barshi,Black Gram,2015,8650,11505,2855,33.005780346820806
Nanded,Turmeric,2016,7872,10727,2855,36.26778455284553
Mandhal,Chillies(Red),2016,6134,8988,2854,46.52755135311379
Solapur,Brinjal,2014,652,3506,2854,437.73006134969324
Solapur,Ladies Finger,2015,624,3476,2852,457.05128205128204
Kolhapur,Brinjal,2015,1000,3850,2850,285.0
Kamthi,Ginger (Fresh),2015,3450,6300,2850,82.6086956521739
Pune-Manjri,Custard Apple,2016,4485,7333,2848,63.500557413600895
Amarawati,Black Gram,2016,7818,10666,2848,36.42875415707342
Nashik,Mango,2016,3153,6000,2847,90.29495718363464
Kamthi,Green Chilli,2015,2253,5100,2847,126.36484687083887
Kolhapur-Laxmipuri,Rice(Paddy-Hus),2016,2175,5021,2846,130.8505747126437
Vadgaon Peth,Bitter Gourd,2016,1269,4115,2846,224.27107959022854
Pune,Onion,2015,944,3789,2845,301.3771186440678
Nashik,Wal Papdi,2016,7441,10286,2845,38.23410831877436
Kolhapur-Laxmipuri,Chillies(Red),2015,14667,17511,2844,19.39046839844549
Sangali,Matki,2015,5589,8433,2844,50.88566827697262
Sangli-Phale Bhajipalam,Grapes,2016,1080,3924,2844,263.3333333333333
Pune-Manjri,Ridge Gourd,2014,3188,6031,2843,89.17816813048934
Karad,MOSAMBI,2016,5940,8780,2840,47.81144781144781
Mangalwedha,Brinjal,2015,404,3244,2840,702.9702970297029
Mumbai,Rice(Paddy-Hus),2016,4379,7218,2839,64.832153459694
Ahmednagar,Cluster Bean,2016,2045,4882,2837,138.7286063569682
Ahmednagar,Tamarind,2015,5215,8050,2835,54.36241610738255
Ulhasnagar,Rice(Paddy-Hus),2016,3600,6435,2835,78.75
Amarawati,Garlic,2015,4333,7167,2834,65.40503115624279
Pune,Shevga,2015,3976,6810,2834,71.27766599597585
Sangli-Phale Bhajipalam,Chikoo,2015,722,3555,2833,392.38227146814404
Bhiwapur,Chillies(Red),2014,3000,5833,2833,94.43333333333334
Jalgaon,Pomegranate,2015,2667,5500,2833,106.22422197225347
Sangamner,Onion,2015,800,3631,2831,353.875
Pune-Manjri,Ghosali(Bhaji),2016,1785,4615,2830,158.54341736694678
Pune-Manjri,Pavtta,2014,3136,5964,2828,90.17857142857143
Solapur,Cluster Bean,2015,3500,6327,2827,80.77142857142857
Sangali,Matki,2014,5167,7993,2826,54.69324559705825
Dondaicha,Green Gram,2015,5000,7825,2825,56.5
Amarawati,Garlic,2016,3559,6382,2823,79.32003371733633
Pune,Cluster Bean,2015,1748,4571,2823,161.49885583524028
Nagpur,Ginger (Fresh),2014,3740,6560,2820,75.40106951871658
Mangalwedha,Ladies Finger,2015,752,3572,2820,375.0
Kolhapur,Ginger (Fresh),2015,2769,5588,2819,101.80570603105815
Amalner,Coriander (Dry),2016,7833,10650,2817,35.96323247797778
Pandharpur,Green Chilli,2014,683,3500,2817,412.4450951683748
Nashik,Lemon,2016,3983,6800,2817,70.72558373085614
Pune,Green-Peas,2014,4211,7026,2815,66.84872951792923
Pune-Manjri,Ghosali(Bhaji),2015,750,3563,2813,375.06666666666666
Mangalwedha,Brinjal,2015,339,3152,2813,829.7935103244838
Pune,Turmeric,2016,12163,14975,2812,23.11929622625997
Kolhapur,Cluster Bean,2016,3188,6000,2812,88.20577164366374
Akluj,Garlic,2016,9688,12500,2812,29.025598678777868
Pune,Cluster Bean,2015,3119,5929,2810,90.09297851875601
Pen,Rice(Paddy-Hus),2015,3550,6360,2810,79.15492957746478
Kolhapur-Laxmipuri,RICE(PADDY-HUS),2016,2100,4910,2810,133.8095238095238
Latur,Pigeon Pea (Tur),2015,9831,12641,2810,28.583053605940393
Lasalgaon,Gram,2016,4756,7565,2809,59.06223717409588
Mangalwedha,Ladies Finger,2016,677,3485,2808,414.77104874446087
Sangali,Green Gram,2015,5538,8346,2808,50.70422535211268
Malkapur,Pigeon Pea (Tur),2015,6719,9526,2807,41.777050156273255
Akluj,Garlic,2015,4308,7115,2807,65.15784586815228
Mangalwedha,Cucumber,2016,433,3239,2806,648.0369515011547
Amarawati-Fruit And Vegetables,Garlic,2016,3194,6000,2806,87.85222291797119
Aurangabad,Pomegranate,2015,800,3605,2805,350.625
Sangli-Phale Bhajipalam,Pomegranate,2015,838,3642,2804,334.60620525059664
Kolhapur-Laxmipuri,Rice(Paddy-Hus),2016,2100,4903,2803,133.47619047619048
Bhiwapur,Chillies(Red),2014,2723,5525,2802,102.90121189864121
Satara,Garlic,2016,5267,8067,2800,53.161192329599395
Kalyan,Garlic,2016,4000,6800,2800,70.0
Lonar,Black Gram,2015,9000,11800,2800,31.11111111111111
Mumbai,Betelnuts,2015,28500,31300,2800,9.824561403508772
Kolhapur,Coriander  ,2015,1050,3850,2800,266.6666666666667
Kalyan,Rice(Paddy-Hus),2015,1900,4700,2800,147.3684210526316
Osmanabad,Kharbuj,2016,1000,3800,2800,280.0
Ahmednagar,Chillies(Red),2015,5700,8500,2800,49.12280701754386
Kolhapur,Raddish,2015,3550,6350,2800,78.87323943661971
Chandrapur,Pomegranate,2016,2300,5100,2800,121.73913043478261
Pune,Green-Peas,2016,5080,7880,2800,55.118110236220474
Kurdwadi-Modnimb,Wheat(Husked),2016,1651,4450,2799,169.5336159903089
Nashik,Garlic,2014,2524,5321,2797,110.81616481774961
Kolhapur,Ladies Finger,2016,1615,4412,2797,173.1888544891641
Osmanabad,Lemon,2015,2194,4990,2796,127.43846855059253
Mangalwedha,Ridge Gourd,2016,900,3696,2796,310.6666666666667
Mumbai-Fruit Market,Apple,2016,5364,8160,2796,52.12527964205817
Nashik,GREEN-PEAS,2016,6290,9085,2795,44.43561208267091
Kolhapur-Laxmipuri,Rice(Paddy-Hus),2016,2100,4895,2795,133.0952380952381
Chandrapur,Pomegranate,2015,2118,4912,2794,131.91690273843247
Nashik,Mango,2016,2027,4818,2791,137.69116921558955
Solapur,Brinjal,2014,663,3454,2791,420.9653092006033
Pune,Green-Peas,2014,3063,5854,2791,91.11981717270649
Pune-Manjri,Bitter Gourd,2016,3410,6200,2790,81.81818181818181
Kolhapur-Laxmipuri,Rice(Paddy-Hus),2016,2088,4877,2789,133.5727969348659
Aurangabad,Ginger (Fresh),2015,2056,4844,2788,135.60311284046693
Lasalgaon,Black Gram,2015,6051,8838,2787,46.05850272682201
Daryapur,Green Gram,2014,5526,8313,2787,50.4343105320304
Nanded,Turmeric,2015,6893,9676,2783,40.374292760771795
Chandrapur,Pomegranate,2016,2125,4908,2783,130.96470588235294
Latur,Pigeon Pea (Tur),2015,8625,11407,2782,32.255072463768116
Pen,Rice(Paddy-Hus),2014,3550,6331,2781,78.33802816901408
Mumbai-Onion And Potato Mkt,Garlic,2016,5052,7833,2781,55.04750593824228
Pune,Ghevda,2016,4280,7060,2780,64.95327102803738
Balapur,Black Gram,2015,8020,10800,2780,34.66334164588529
Nagpur,Apple,2015,3896,6675,2779,71.32956878850102
Chandrapur,Grapes,2015,3500,6278,2778,79.37142857142857
Solapur,Ladies Finger,2014,534,3312,2778,520.2247191011236
Pune,CHILLIES(RED),2016,20361,23139,2778,13.643730661558862
Amarawati-Fruit And Vegetables,Pomegranate,2016,2444,5222,2778,113.66612111292963
Kamthi,Ginger (Fresh),2016,2111,4889,2778,131.59639981051635
Mangalwedha,Brinjal,2016,487,3265,2778,570.4312114989733
Latur,Black Gram,2014,3644,6421,2777,76.20746432491767
Pandharpur,Green Chilli,2016,1952,4727,2775,142.16188524590163
Sangli-Phale Bhajipalam,Orange,2016,1136,3909,2773,244.10211267605635
Pune-Manjri,Guava,2015,455,3227,2772,609.2307692307693
Ahmednagar,Green Peas (Dry),2016,4143,6914,2771,66.88390055515328
Pune-Manjri,Custard Apple,2015,2050,4821,2771,135.17073170731706
Parola,Pigeon Pea (Tur),2016,5400,8171,2771,51.31481481481482
Kamthi,Dhemse,2015,2943,5714,2771,94.15562351342167
Atpadi,Pomegranate,2015,1450,4220,2770,191.0344827586207
Ahmednagar,Green Peas (Dry),2016,2154,4923,2769,128.55153203342618
Osmanabad,Tomato,2016,2271,5037,2766,121.79656538969617
Sangola,Pomegranate,2016,1390,4155,2765,198.9208633093525
Pune,Lemon,2016,640,3404,2764,431.875
Mumbai,Rice(Paddy-Hus),2016,4187,6951,2764,66.0138524002866
Kalyan,Garlic,2016,8271,11035,2764,33.41796638858663
Ahmednagar,Lemon,2016,1571,4333,2762,175.8115849777212
Rahuri,Tomato,2016,1440,4200,2760,191.66666666666666
Junnar-Otur,Small Gourd,2016,1945,4705,2760,141.90231362467867
Solapur,Garlic,2015,1932,4691,2759,142.80538302277432
Katol,Ground Nut Pods (Dry),2015,3431,6190,2759,80.4138735062664
Nagpur,Apple,2015,4000,6758,2758,68.95
Nashik,Cabbage,2016,1183,3941,2758,233.1360946745562
Solapur,Custard Apple,2015,927,3684,2757,297.41100323624596
Kurdwadi-Modnimb,Onion,2015,261,3015,2754,1055.1724137931035
Lasalgaon,Gram,2016,3016,5770,2754,91.3129973474801
Sangali,Pigeon Pea (Tur),2015,7750,10500,2750,35.483870967741936
Pune-Manjri,Guava,2015,0,2750,2750,inf
Sangali,Coriander (Dry),2014,8750,11500,2750,31.428571428571427
Anajngaon Surji,Chillies(Red),2016,5375,8125,2750,51.16279069767442
Ahmednagar,Flower,2016,625,3375,2750,440.0
Nagpur,Apple,2016,3947,6697,2750,69.67316949581961
Malegaon,Onion,2015,598,3348,2750,459.86622073578593
Morshi,Chillies(Red),2016,10500,13250,2750,26.19047619047619
Chandrapur,Mango,2015,1050,3800,2750,261.9047619047619
Pune,Tuljapuri,2014,3500,6250,2750,78.57142857142857
Karad,Pomegranate,2014,3450,6200,2750,79.71014492753623
Pune,Double Bee,2014,2250,5000,2750,122.22222222222223
Pune,Double Bee,2016,2500,5250,2750,110.0
Pandharpur,Coriander  ,2014,1000,3750,2750,275.0
Pune,Turmeric,2015,11917,14667,2750,23.076277586640934
Nashik,Capsicum,2015,2656,5406,2750,103.53915662650603
Kolhapur,Mosambi,2016,1956,4704,2748,140.49079754601226
Kolhapur,Math (Bhaji),2016,1488,4235,2747,184.61021505376345
Kalyan,Custard Apple,2015,2657,5400,2743,103.23673315769665
Solapur,Cucumber,2016,362,3104,2742,757.4585635359116
Deglur,Black Gram,2015,9563,12305,2742,28.673010561539265
Solapur,Ladies Finger,2015,792,3533,2741,346.0858585858586
Malkapur,Black Gram,2015,7368,10107,2739,37.1742671009772
Sangali,Matki,2016,7317,10056,2739,37.43337433374334
Nagpur,Chillies(Red),2016,10522,13261,2739,26.031172780840144
Kolhapur,Coriander  ,2015,930,3667,2737,294.3010752688172
Kolhapur,LEMON,2016,819,3556,2737,334.1880341880342
Chandrapur-Ganjwad,Garlic,2015,6582,9318,2736,41.56791248860529
Osmanabad,Capsicum,2016,3373,6109,2736,81.11473465757486
Malkapur,Black Gram,2015,8263,10998,2735,33.099358586469805
Pune,Green Peas (Dry),2014,3080,5815,2735,88.7987012987013
Kolhapur-Laxmipuri,Rice(Paddy-Hus),2016,2029,4763,2734,134.74618038442583
Kurdwadi-Modnimb,Gram,2016,4442,7176,2734,61.54885186852769
Sangli-Phale Bhajipalam,Grapes,2016,1106,3840,2734,247.1971066907776
Barshi,Onion,2015,313,3046,2733,873.1629392971246
Pune-Manjri,Onion,2015,1200,3933,2733,227.75
Mumbai,Tamarind,2015,7000,9733,2733,39.042857142857144
Shirpur,BLACK GRAM,2016,3998,6731,2733,68.35917958979489
Pandharpur,Ladies Finger,2015,1100,3833,2733,248.45454545454547
Pune-Manjri,Methi (Bhaji),2015,1745,4473,2728,156.3323782234957
Solapur,Chikoo,2015,893,3620,2727,305.37513997760357
Kolhapur,Capsicum,2016,1465,4191,2726,186.07508532423208
Jamkhed,Onion,2015,1550,4275,2725,175.80645161290323
Nagpur,Grapes,2016,3168,5892,2724,85.98484848484848
Daryapur,Black Gram,2015,7187,9911,2724,37.90176707944901
Pune-Manjri,Custard Apple,2016,2765,5487,2722,98.44484629294756
Majalgaon,Pigeon Pea (Tur),2015,6394,9114,2720,42.53988113856741
Ahmednagar,Squash Gourd,2016,1600,4320,2720,170.0
Ulhasnagar,Rice(Paddy-Hus),2016,3022,5739,2717,89.9073461283918
Jalna-Badnapur,Black Gram,2016,4283,7000,2717,63.43684333411161
Pen,Rice(Paddy-Hus),2014,3533,6250,2717,76.90348146051514
Mangalwedha,Cucumber,2015,668,3384,2716,406.58682634730536
Pen,Rice(Paddy-Hus),2015,3520,6236,2716,77.1590909090909
Kamthi,Beet Root,2015,1714,4429,2715,158.40140023337221
Kalvan,Soybean,2015,3590,6304,2714,75.59888579387187
Manmad,Onion,2015,1964,4678,2714,138.18737270875764
Pune-Manjri,Ridge Gourd,2015,3129,5843,2714,86.73697666986257
Rahata,Onion,2015,700,3413,2713,387.57142857142856
Pandharpur,Brinjal,2015,529,3241,2712,512.6654064272212
Kolhapur,Cluster Bean,2015,1900,4611,2711,142.68421052631578
Mangalwedha,Cucumber,2015,541,3252,2711,501.1090573012939
Ulhasnagar,Other Vegetables,2015,2895,5605,2710,93.60967184801382
Pathari,Gram,2016,3434,6142,2708,78.85847408270239
Nagpur,Pomegranate,2015,1596,4304,2708,169.67418546365914
Sangali,Green Gram,2015,6450,9158,2708,41.98449612403101
Paranda,Onion,2015,275,2982,2707,984.3636363636364
Solapur,Lemon,2014,333,3040,2707,812.9129129129129
Aurangabad,Garlic,2014,1414,4121,2707,191.44271570014143
Kolhapur,Shevga,2016,2587,5294,2707,104.63857750289911
Mumbai,Betelnuts,2014,30126,32832,2706,8.98227444732125
Kamthi,Onion,2015,2647,5353,2706,102.2289384208538
Pune,Green Peas (Dry),2015,2465,5170,2705,109.73630831643003
Sangli-Phale Bhajipalam,Onion,2015,2069,4773,2704,130.6911551474142
Satana,Ground Nut Pods (Dry),2015,3307,6009,2702,81.70547323858482
Osmanabad,Green Chilli,2016,3400,6100,2700,79.41176470588235
Rahuri,Bitter Gourd,2016,633,3333,2700,426.54028436018956
Kamthi,Bitter Gourd,2016,1930,4630,2700,139.89637305699483
Umared,Other Pulses,2016,10203,12903,2700,26.462805057336077
Nashik,Brinjal,2015,1671,4371,2700,161.57989228007182
Osmanabad,Mango,2015,1350,4050,2700,200.0
Pune-Manjri,Coriander  ,2015,1364,4064,2700,197.94721407624633
Chandrapur,Pomegranate,2016,3825,6525,2700,70.58823529411765
Ahmednagar,Coriander (Dry),2016,6900,9600,2700,39.130434782608695
Rahuri,Other Vegetables,2016,800,3500,2700,337.5
Karad,Garlic,2015,3150,5850,2700,85.71428571428571
Kamthi,Mint,2014,2300,5000,2700,117.3913043478261
Loha,Green Gram,2014,5751,8451,2700,46.948356807511736
Sakri,Ground Nut Pods (Dry),2015,2996,5695,2699,90.086782376502
Ambad(Vadi Godri),Gram,2016,6301,9000,2699,42.8344707189335
Pune-Manjri,Ghosali(Bhaji),2015,853,3550,2697,316.17819460726844
Mumbai,Split Black Gram,2015,13156,15852,2696,20.492550927333536
Pune,Cluster Bean,2016,2355,5050,2695,114.43736730360934
Manchar,Coriander  ,2015,879,3572,2693,306.37087599544935
Sangli-Phale Bhajipalam,Mosambi,2016,1190,3881,2691,226.1344537815126
Nanded,Turmeric,2015,6306,8995,2689,42.64192832223279
Solapur,Cucumber,2016,269,2958,2689,999.6282527881041
Malegaon,Matki,2016,5217,7905,2688,51.52386428982174
Pune,Cluster Bean,2016,2917,5604,2687,92.1151868357902
Mumbai,Rice(Paddy-Hus),2016,4149,6836,2687,64.76259339599903
Aurangabad,Pomegranate,2016,995,3681,2686,269.9497487437186
Pune,Ginger (Fresh),2016,1029,3712,2683,260.7385811467444
Khed,Farshi,2016,3803,6486,2683,70.54956613200105
Nashik,Capsicum,2016,4675,7358,2683,57.3903743315508
Pune,Ghevda,2016,2545,5227,2682,105.38310412573674
Pandharpur,Green Chilli,2016,3140,5822,2682,85.4140127388535
Mumbai,Rice(Paddy-Hus),2016,4196,6876,2680,63.870352716873214
Kamthi,Green Chilli,2015,1720,4400,2680,155.8139534883721
Karad,GARLIC,2016,7800,10480,2680,34.35897435897436
Akluj,GARLIC,2016,7289,9968,2679,36.75401289614488
Mangalwedha,Brinjal,2016,440,3119,2679,608.8636363636364
Kamthi,Capsicum,2015,1750,4429,2679,153.0857142857143
Karjat (Raigad),Rice(Paddy-Hus),2016,2000,4678,2678,133.9
Pune,Pavtta,2015,2882,5559,2677,92.88688410825816
Khed,Cluster Bean,2016,2241,4918,2677,119.45560017849175
Kamthi,Green Chilli,2015,3129,5806,2677,85.55449025247682
Mangalwedha,Ladies Finger,2015,1054,3731,2677,253.98481973434536
Pandharpur,Green Chilli,2015,1858,4535,2677,144.07965554359527
Ambejogai,Gram,2015,3787,6464,2677,70.68919989437549
Aurangabad,Apple,2015,4738,7414,2676,56.479527226677924
Pandharpur,Brinjal,2014,420,3095,2675,636.9047619047619
Pandharpur,Chikoo,2016,475,3150,2675,563.1578947368421
Kalyan,Rice(Paddy-Hus),2016,2075,4750,2675,128.9156626506024
Sangli-Phale Bhajipalam,Mosambi,2015,1196,3870,2674,223.57859531772576
Achalpur,Pigeon Pea (Tur),2015,6314,8987,2673,42.33449477351916
Katol,Ground Nut Pods (Dry),2016,2605,5278,2673,102.61036468330134
Nashik,MOSAMBI,2016,1691,4364,2673,158.07214665878178
Chikhali,Black Gram,2016,6797,9470,2673,39.326173311755184
Pune,Ladies Finger,2015,1468,4140,2672,182.01634877384197
Kamthi,Capsicum,2015,1588,4260,2672,168.2619647355164
Kolhapur-Laxmipuri,Rice(Paddy-Hus),2016,2029,4700,2671,131.64120256283883
Mangalwedha,Tomato,2015,396,3065,2669,673.989898989899
Shirpur,Matki,2016,4881,7550,2669,54.68141774226593
Junnar-Otur,Small Gourd,2016,1563,4231,2668,170.6973768394114
Rahuri,Flower,2015,600,3267,2667,444.5
Mumbai,Fenugreek,2015,5000,7667,2667,53.34
Ahmednagar,Green Chilli,2016,2333,5000,2667,114.31633090441491
Rahuri-Songaon,Cluster Bean,2016,3333,6000,2667,80.01800180018002
Ahmednagar,Cluster Bean,2016,4833,7500,2667,55.183116076970826
Solapur,Cluster Bean,2015,1106,3773,2667,241.13924050632912
Chandrapur,Pomegranate,2016,2000,4667,2667,133.35
Rahuri,Brinjal,2015,500,3167,2667,533.4
Kamthi,Ginger (Fresh),2015,2333,5000,2667,114.31633090441491
Aurangabad,Apple,2015,5000,7667,2667,53.34
Satara,Garlic,2015,1944,4611,2667,137.19135802469137
Anajngaon Surji,CHILLIES(RED),2016,5667,8333,2666,47.04429151226398
Umarga,Green Gram,2014,3745,6411,2666,71.18825100133512
Kamthi,Ginger (Fresh),2015,2556,5222,2666,104.30359937402191
Satara,Garlic,2015,2667,5333,2666,99.96250468691413
Nashik,Cluster Bean,2016,3988,6653,2665,66.82547642928786
Solapur,Ladies Finger,2015,1658,4321,2663,160.6151990349819
Nagpur,Pomegranate,2015,1515,4177,2662,175.7095709570957
Akola,Black Gram,2016,8881,11542,2661,29.962842022294787
Pune,Cluster Bean,2016,2800,5460,2660,95.0
Sangola,Pomegranate,2016,1794,4454,2660,148.27201783723524
Osmanabad,Green Chilli,2016,3480,6140,2660,76.4367816091954
Vasai,Rice(Paddy-Hus),2016,1871,4530,2659,142.116515232496
Nampur,Pomegranate,2016,105,2763,2658,2531.4285714285716
Solapur,Cluster Bean,2016,1135,3792,2657,234.09691629955947
Solapur,Cluster Bean,2016,1340,3996,2656,198.2089552238806
Kolhapur,Mosambi,2015,3225,5880,2655,82.32558139534883
Mangalwedha,Brinjal,2016,348,3002,2654,762.6436781609195
Akole,Onion,2015,150,2802,2652,1768.0
Nagpur,Chillies(Red),2016,8652,11304,2652,30.651872399445214
Ulhasnagar,Rice(Paddy-Hus),2016,3015,5667,2652,87.96019900497512
Shirpur,Pigeon Pea (Tur),2016,4976,7628,2652,53.29581993569132
Katol,Ground Nut Pods (Dry),2015,3348,6000,2652,79.21146953405018
Baramati,Onion,2015,533,3184,2651,497.3733583489681
Kolhapur,Onion,2015,2400,5050,2650,110.41666666666667
Sinner,Gram,2016,4500,7150,2650,58.888888888888886
Lasalgaon,SUNFLOWER,2016,3201,5851,2650,82.78662917838176
Manchar,Cluster Bean,2014,1250,3900,2650,212.0
Akluj,Chillies(Red),2016,2900,5550,2650,91.37931034482759
Ahmednagar,Garlic,2015,4500,7150,2650,58.888888888888886
Lasalgaon,Black Gram,2015,7356,10006,2650,36.025013594344756
Ramtek,Garlic,2016,6850,9500,2650,38.68613138686131
Ahmednagar,Custard Apple,2015,1100,3750,2650,240.9090909090909
Pen,Rice(Paddy-Hus),2015,3536,6183,2647,74.85859728506787
Pune,Ladies Finger,2016,1500,4146,2646,176.4
Solapur,Lemon,2016,314,2959,2645,842.3566878980891
Nandgaon,Soybean,2015,3496,6141,2645,75.65789473684211
Kolhapur,Ladies Finger,2015,933,3578,2645,283.4941050375134
Latur,Black Gram,2016,5183,7827,2644,51.01292687632645
Pandharpur,Green Chilli,2015,1900,4544,2644,139.1578947368421
Pune,Ginger (Fresh),2014,2526,5170,2644,104.6714172604909
Amarawati-Fruit And Vegetables,Custard Apple,2016,2889,5533,2644,91.51955694011768
Ulhasnagar,Rice(Paddy-Hus),2016,3150,5793,2643,83.9047619047619
Kolhapur,Grapes,2016,1607,4250,2643,164.46795270690728
Solapur,Garlic,2016,3046,5688,2642,86.73670387393302
Pune-Manjri,Chavli (Shenga ),2014,0,2642,2642,inf
Kalyan,Garlic,2016,6518,9159,2641,40.518563976679964
Pimpalgaon Basawant,Onion,2015,2123,4763,2640,124.35233160621762
Akluj,Garlic,2016,8240,10880,2640,32.03883495145631
Nashik,Cluster Bean,2016,2889,5528,2639,91.34648667358948
Ulhasnagar,Rice(Paddy-Hus),2016,3135,5773,2638,84.14673046251994
Chikhali,Black Gram,2016,5658,8295,2637,46.60657476139979
Kalyan,Garlic,2015,2836,5473,2637,92.98307475317348
Aurangabad,Melon,2016,1533,4167,2634,171.81996086105676
Kolhapur,Ladies Finger,2016,1115,3748,2633,236.14349775784754
Pune,Garlic,2015,2026,4658,2632,129.9111549851925
Pune,Shevga,2014,4043,6674,2631,65.07543903042296
Sangli-Phale Bhajipalam,Pineapple,2016,234,2864,2630,1123.931623931624
Nandurbar,Thymol/Lovage,2015,11813,14442,2629,22.255142639464996
Sangali,Black Gram,2015,5991,8618,2627,43.84910699382407
Ahmednagar,Cluster Bean,2016,4250,6875,2625,61.76470588235294
Khamgaon,Chillies(Red),2016,6625,9250,2625,39.62264150943396
Nashik,Capsicum,2015,1750,4375,2625,150.0
Nandura,Black Gram,2015,8792,11417,2625,29.856687898089174
Akluj,Garlic,2015,3813,6438,2625,68.84343036978757
Shirpur,Sesamum,2015,4693,7317,2624,55.91306200724483
Dhule,Chillies(Red),2015,3783,6405,2622,69.31007137192704
Mumbai,Grapes,2015,3619,6238,2619,72.36805747444045
Newasa-Ghodegaon,Onion,2015,409,3027,2618,640.0977995110024
Jalgaon,Coriander  ,2015,2005,4623,2618,130.57356608478804
Ahmednagar,Flower,2016,518,3136,2618,505.4054054054054
Chandrapur,Pomegranate,2015,2000,4617,2617,130.85
Kamthi,Bitter Gourd,2016,2024,4640,2616,129.2490118577075
Karad,Apple,2015,5769,8385,2616,45.345813832553304
Sangali,Green Gram,2015,6150,8760,2610,42.4390243902439
Karjat (Raigad),Rice(Paddy-Hus),2016,2000,4609,2609,130.45
Chandrapur,Grapes,2016,1891,4500,2609,137.9693283976732
Pune-Manjri,Cluster Bean,2014,3986,6593,2607,65.4039136979428
Akluj,Onion,2015,2082,4688,2606,125.16810758885687
Varud-Rajura Bazar,Gram,2016,6728,9333,2605,38.71878715814506
Sangli-Phale Bhajipalam,Custard Apple,2016,816,3419,2603,318.9950980392157
Sangali,Matki,2016,6112,8712,2600,42.539267015706805
Anajngaon Surji,Chillies(Red),2015,9000,11600,2600,28.88888888888889
Kille Dharur,Pigeon Pea (Tur),2015,6357,8957,2600,40.899795501022496
Kannad,Onion,2015,1400,4000,2600,185.71428571428572
Kolhapur,Orange,2015,6175,8775,2600,42.10526315789474
Ahmednagar,Carrot,2015,1000,3600,2600,260.0
Nashik,Cluster Bean,2016,3344,5944,2600,77.7511961722488
Kamthi,Carrot,2015,1650,4250,2600,157.57575757575756
Mangalwedha,Ladies Finger,2016,509,3109,2600,510.8055009823183
Mumbai,Green Peas (Dry),2016,2400,5000,2600,108.33333333333333
Indapur (Nimgaon Ketki),Gram,2016,4000,6600,2600,65.0
Chalisgaon,Cowpea,2016,2100,4700,2600,123.80952380952381
Mumbai,Cowpea,2016,4916,7516,2600,52.888527257933276
Solapur,Lemon,2015,258,2858,2600,1007.7519379844962
Lasalgaon,Gram,2016,6033,8632,2599,43.07972816177689
Pune-Moshi,Cluster Bean,2016,3198,5797,2599,81.26954346466542
Kolhapur,Green Chilli,2016,3374,5972,2598,77.00059276822762
Mangalwedha,Ridge Gourd,2015,960,3558,2598,270.625
Shahada,Gram,2016,4571,7169,2598,56.83657842922774
Dhule,Chillies(Red),2015,3293,5891,2598,78.8946249620407
Lasalgaon,Sesamum,2015,9562,12160,2598,27.170048107090565
Pune-Moshi,Tomato,2016,2203,4800,2597,117.88470267816614
Solapur,Cucumber,2016,381,2978,2597,681.6272965879265
Pandharpur,Green Chilli,2016,2515,5110,2595,103.18091451292247
Sangola,Pomegranate,2015,2031,4626,2595,127.76957163958642
Sangli-Phale Bhajipalam,Mosambi,2016,1143,3738,2595,227.03412073490813
Solapur,Cluster Bean,2015,2540,5133,2593,102.08661417322834
Satana,Ground Nut Pods (Dry),2016,3780,6373,2593,68.5978835978836
Nashik,Coriander  ,2016,1271,3863,2592,203.933910306845
Sangli-Phale Bhajipalam,Onion,2015,664,3255,2591,390.21084337349396
Phaltan,Green Chilli,2016,7091,9682,2591,36.53927513749824
Manchar,Onion,2015,2663,5253,2590,97.25873075478783
Nandgaon,Green Gram,2014,5741,8331,2590,45.1140916216687
Kolhapur,Brinjal,2015,530,3120,2590,488.6792452830189
Sangli-Phale Bhajipalam,Pineapple,2016,550,3139,2589,470.72727272727275
Rahuri,Onion,2015,215,2804,2589,1204.1860465116279
Aurangabad,Ginger (Fresh),2014,1944,4533,2589,133.179012345679
Chandvad,Ladies Finger,2016,2906,5494,2588,89.05712319339298
Nashik,Orange,2016,1562,4150,2588,165.68501920614597
Solapur,Cluster Bean,2015,1662,4250,2588,155.71600481347772
Kolhapur,Ladies Finger,2016,1210,3798,2588,213.88429752066116
Shegaon,Thymol/Lovage,2015,8175,10763,2588,31.65749235474006
Sangrampur,Pigeon Pea (Tur),2015,3650,6238,2588,70.9041095890411
Junnar,Onion,2015,2563,5150,2587,100.93640265314085
Mangalwedha,Cucumber,2015,407,2993,2586,635.3808353808354
Pune,Shevga,2015,3457,6043,2586,74.80474399768586
Lonar,Soybean,2016,3769,6354,2585,68.58583178561953
Latur,Black Gram,2016,6785,9370,2585,38.09874723655122
Mangalwedha,Ridge Gourd,2016,1350,3935,2585,191.4814814814815
Sangali,Matki,2016,6389,8974,2585,40.46016591015808
Pune-Manjri,Methi (Bhaji),2015,1605,4189,2584,160.99688473520249
Satana,Onion,2015,2347,4931,2584,110.09799744354495
Akluj,Chillies(Red),2016,5667,8250,2583,45.5796717840127
Solapur,Ridge Gourd,2015,1218,3800,2582,211.98686371100163
Nashik,Garlic,2014,2281,4863,2582,113.19596668128014
Pune-Manjri,Custard Apple,2014,1538,4119,2581,167.81534460338102
Pimpalgaon Basawant,Tomato,2015,1244,3825,2581,207.475884244373
Pimpalgaon Basawant,Tomato,2014,982,3563,2581,262.8309572301426
Pen,Rice(Paddy-Hus),2015,3492,6072,2580,73.88316151202748
Mumbai,Garlic,2015,3735,6315,2580,69.07630522088354
Nilanga,Green Gram,2014,4001,6580,2579,64.45888527868033
Pune,Chillies(Red),2016,12878,15456,2578,20.018636434228917
Ulhasnagar,Rice(Paddy-Hus),2016,3349,5926,2577,76.9483427888922
Pune,Small Gourd,2016,1500,4077,2577,171.8
Solapur,Tomato,2016,386,2962,2576,667.3575129533679
Jalgaon,Garlic,2015,3500,6075,2575,73.57142857142857
Jalgaon,Garlic,2015,2800,5375,2575,91.96428571428571
Chandur Bajar,Black Gram,2015,9050,11625,2575,28.45303867403315
Osmanabad,Ladies Finger,2014,1550,4125,2575,166.1290322580645
Solapur,Ladies Finger,2016,452,3025,2573,569.2477876106195
Sangali,Green Gram,2016,6121,8693,2572,42.01927789576867
Jamner,Green Gram,2015,5604,8176,2572,45.89578872234119
Kolhapur,Cluster Bean,2016,2262,4834,2572,113.70468611847922
Amarawati-Fruit And Vegetables,Pomegranate,2016,1964,4536,2572,130.9572301425662
Dhule,Gram,2016,7016,9588,2572,36.659064994298745
Satara,Garlic,2015,2571,5143,2572,100.03889537145079
Pandharpur,Green Chilli,2014,1557,4129,2572,165.18946692357096
Mumbai,Betelnuts,2015,27429,30000,2571,9.373291042327464
Sangali,Chillies(Red),2016,13143,15714,2571,19.561743894088107
Mumbai,Rice(Paddy-Hus),2016,4492,7063,2571,57.235084594835264
Amarawati-Fruit And Vegetables,Apple,2016,3286,5857,2571,78.24102251978088
Mumbai,Fenugreek,2015,7112,9682,2570,36.136107986501685
Solapur,Ridge Gourd,2014,1100,3670,2570,233.63636363636363
Sangali,Matki,2015,5660,8230,2570,45.40636042402827
Kopargaon,Onion,2015,706,3275,2569,363.8810198300283
Kolhapur,Shepu,2015,3383,5950,2567,75.87939698492463
Sakri,Ground Nut Pods (Dry),2016,3170,5736,2566,80.94637223974763
Chandvad,Brinjal,2016,1284,3850,2566,199.8442367601246
Pune-Manjri,Ghevda,2015,2006,4572,2566,127.91625124626121
Kamthi,Wal Bhaji,2014,2017,4583,2566,127.21864154685176
Solapur,Bitter Gourd,2016,1825,4390,2565,140.54794520547946
Kamthi,Dhemse,2015,1845,4409,2564,138.97018970189703
Mumbai,Spilt Pigeon Pea,2015,8379,10942,2563,30.588375701157656
Ahmednagar,Ghevda,2016,2000,4563,2563,128.15
Udgir,Tamarind,2015,3460,6022,2562,74.04624277456648
Solapur,Ridge Gourd,2016,617,3179,2562,415.2350081037277
Pune-Moshi,Ghosali(Bhaji),2016,2787,5348,2561,91.89092213850017
Ahmednagar,Ghosali(Bhaji),2015,980,3540,2560,261.2244897959184
Khed,Cluster Bean,2016,2282,4842,2560,112.18229623137599
Pune,Shevga,2015,3288,5846,2558,77.79805352798054
Pune,Shevga,2016,3577,6135,2558,71.51244059267543
Kolhapur-Laxmipuri,Green Peas (Dry),2015,3086,5643,2557,82.85806869734284
Pimpalgaon Basawant,Tomato,2015,530,3087,2557,482.45283018867923
Nashik,Coriander  ,2014,750,3307,2557,340.93333333333334
Mumbai,Rice(Paddy-Hus),2015,4346,6902,2556,58.812701334560515
Solapur,LADIES FINGER,2016,602,3158,2556,424.5847176079734
Aurangabad,Garlic,2016,2667,5222,2555,95.8005249343832
Shahada,Black Gram,2016,3956,6510,2554,64.56016177957532
Amarawati,Apple,2016,3447,6000,2553,74.06440382941689
Manchar,Coriander  ,2015,277,2829,2552,921.2996389891697
Rahuri-Vambori,Ground Nut Pods (Dry),2015,2596,5147,2551,98.26656394453005
Kolhapur,Cucumber,2016,1029,3579,2550,247.8134110787172
Junnar-Otur,Farshi,2016,1730,4280,2550,147.39884393063585
Nashik,Cluster Bean,2014,2805,5353,2548,90.83778966131908
Mumbai,Cowpea,2015,5568,8114,2546,45.72557471264368
Daryapur,Pigeon Pea (Tur),2015,6320,8866,2546,40.28481012658228
Karad,Apple,2015,8273,10818,2545,30.76272210806237
Pune-Manjri,Chavli (Shenga ),2015,575,3120,2545,442.60869565217394
Vaijapur,Onion,2015,1022,3567,2545,249.0215264187867
Nagpur,LEMON,2016,3353,5897,2544,75.87235311661199
Shirpur,Black Gram,2016,4621,7165,2544,55.0530188270937
Kolhapur,Pineapple,2016,603,3147,2544,421.8905472636816
Phaltan,Onion,2015,833,3377,2544,305.4021608643457
Kamthi,Capsicum,2016,2648,5190,2542,95.99697885196375
Mumbai,Rice(Paddy-Hus),2016,4276,6817,2541,59.42469597754911
Kolhapur-Laxmipuri,Rice(Paddy-Hus),2016,2067,4608,2541,122.93178519593614
Pen,Rice(Paddy-Hus),2015,3230,5771,2541,78.6687306501548
Washim,Black Gram,2016,8933,11473,2540,28.433896787193554
Pandharpur,Brinjal,2014,430,2970,2540,590.6976744186046
Ulhasnagar,Rice(Paddy-Hus),2016,3324,5863,2539,76.38387484957882
Pune-Pimpri,Green Chilli,2016,3538,6077,2539,71.76370830977953
Lasalgaon,Gram,2015,2647,5185,2538,95.88213071401587
Jalgaon,Ginger (Fresh),2014,3177,5715,2538,79.88668555240793
Mangalwedha,Ladies Finger,2015,537,3074,2537,472.43947858472995
Kamthi,Bitter Gourd,2015,2018,4554,2536,125.66897918731418
Mumbai,Garlic,2016,2822,5357,2535,89.82990786676116
Solapur,Ladies Finger,2015,668,3202,2534,379.34131736526945
Sangali,Lentil,2015,4689,7222,2533,54.02004691831947
Nashik,Cluster Bean,2016,3467,6000,2533,73.06028266512836
Solapur,Ridge Gourd,2014,1035,3567,2532,244.63768115942028
Shirpur,Black Gram,2015,8467,10998,2531,29.892523916381244
Kolhapur,Orange,2016,2733,5263,2530,92.57226491035492
Ahmednagar,Cluster Bean,2016,1235,3765,2530,204.8582995951417
Pune-Manjri,Coriander  ,2016,2356,4885,2529,107.34295415959252
Nashik,Cluster Bean,2016,2324,4853,2529,108.8209982788296
Mangalwedha,Cucumber,2015,524,3052,2528,482.44274809160305
Kolhapur,Chikoo,2016,428,2956,2528,590.6542056074767
Pune-Manjri,Raddish,2015,1243,3771,2528,203.37892196299276
Karad,Jaggery,2015,2300,4828,2528,109.91304347826087
Kolhapur,Brinjal,2015,586,3114,2528,431.3993174061433
Sangli-Phale Bhajipalam,Mosambi,2015,1500,4028,2528,168.53333333333333
Pune-Manjri,Custard Apple,2015,1842,4368,2526,137.13355048859935
Pune,Cluster Bean,2015,3132,5658,2526,80.65134099616859
Junnar-Otur,Cluster Bean,2016,1900,4426,2526,132.94736842105263
Shirpur,Sesamum,2015,4117,6642,2525,61.33106631042021
Barshi,Turmeric,2015,7401,9926,2525,34.11701121470072
Kamthi,Ginger (Fresh),2016,2325,4850,2525,108.60215053763442
Solapur,Lemon,2015,250,2774,2524,1009.6
Sangali,Black Gram,2015,7119,9643,2524,35.454417755302714
Osmanabad,Brinjal,2014,1162,3686,2524,217.2117039586919
Kolhapur,Mosambi,2015,2910,5433,2523,86.70103092783505
Kamthi,Bitter Gourd,2015,3048,5571,2523,82.7755905511811
Jalgaon,Coriander  ,2015,3295,5818,2523,76.57056145675266
Kamthi,Chavli (Shenga ),2015,2365,4887,2522,106.6384778012685
Pen,Rice(Paddy-Hus),2016,3550,6071,2521,71.01408450704226
Solapur,Cluster Bean,2014,1987,4508,2521,126.8746854554605
Mumbai,Green Peas (Dry),2016,2454,4975,2521,102.73023634881825
Solapur,Ladies Finger,2016,900,3421,2521,280.1111111111111
Kolhapur,Cucumber,2016,821,3342,2521,307.0645554202192
Mangalwedha,Cucumber,2016,500,3019,2519,503.8
Osmanabad,CLUSTER BEAN,2016,1983,4500,2517,126.92889561270802
Pandharpur,Green Chilli,2015,1892,4408,2516,132.98097251585622
Manchar,Cluster Bean,2016,1592,4107,2515,157.97738693467338
Yeola,Onion,2015,1087,3602,2515,231.3707451701932
Sangrampur-Varvatbakal,Pigeon Pea (Tur),2016,6204,8718,2514,40.522243713733076
Pune-Manjri,Custard Apple,2015,436,2950,2514,576.605504587156
Kamthi,Carrot,2014,2557,5071,2514,98.31834180680485
Kolhapur,Tomato,2016,748,3262,2514,336.096256684492
Solapur,Cucumber,2016,492,3004,2512,510.5691056910569
Karanja,Black Gram,2016,4972,7484,2512,50.52292839903459
Mumbai,Grapes,2015,3013,5525,2512,83.37205443079986
Manmad,Onion,2015,1945,4457,2512,129.1516709511568
Nanded,Turmeric,2015,8113,10622,2509,30.925674842844817
Daryapur,Black Gram,2016,4375,6883,2508,57.325714285714284
Lasur Station,Onion,2015,550,3058,2508,456.0
Nagpur,Apple,2016,3462,5969,2507,72.41478913922587
Vadgaon Peth,Green Chilli,2016,3400,5907,2507,73.73529411764706
Pimpalgaon (B)-Saykheda,Onion,2015,2042,4549,2507,122.77179236043095
Solapur,Onion,2015,426,2933,2507,588.4976525821596
Pen,Rice(Paddy-Hus),2015,3550,6056,2506,70.59154929577464
Phaltan,GRAM,2016,6950,9456,2506,36.05755395683453
Nashik,Coriander  ,2014,495,3000,2505,506.06060606060606
Pen,RICE(PADDY-HUS),2016,3550,6053,2503,70.50704225352112
Jamner-Neri,Green Gram,2015,5634,8136,2502,44.40894568690096
Pen,Rice(Paddy-Hus),2016,3550,6052,2502,70.47887323943662
Nilanga,GRAM,2016,5500,8001,2501,45.472727272727276
Malegaon,Ground Nut Pods (Dry),2015,4100,6601,2501,61.0
Pune,Mango(Raw),2016,2750,5250,2500,90.9090909090909
Pen,Rice(Paddy-Hus),2016,3550,6050,2500,70.4225352112676
Pandharpur,Capsicum,2015,1500,4000,2500,166.66666666666666
Osmanabad,Ladies Finger,2015,1500,4000,2500,166.66666666666666
Jalgaon,Pomegranate,2016,2333,4833,2500,107.15816545220746
Pune-Pimpri,Ghevda,2016,3500,6000,2500,71.42857142857143
Mangrulpeer,Pigeon Pea (Tur),2015,8000,10500,2500,31.25
Kamthi,Guava,2015,2000,4500,2500,125.0
Amarawati,Apple,2016,3861,6361,2500,64.75006475006475
Nashik,Pineapple,2016,2000,4500,2500,125.0
Manchar,Ground Nut Pods (Dry),2016,2000,4500,2500,125.0
Amarawati,Chillies(Red),2015,8000,10500,2500,31.25
Pune,Turmeric,2015,10500,13000,2500,23.80952380952381
Pen,Rice(Paddy-Hus),2016,3550,6050,2500,70.4225352112676
Kamthi,Wal Bhaji,2016,2000,4500,2500,125.0
Pune-Pimpri,Turmeric,2016,11000,13500,2500,22.727272727272727
Amarawati-Fruit And Vegetables,Grapes,2016,2000,4500,2500,125.0
Sangali,Matki,2016,6300,8800,2500,39.682539682539684
Shrirampur,Garlic,2016,6900,9400,2500,36.231884057971016
Amalner,Black Gram,2016,8500,11000,2500,29.41176470588235
Karad,Orange,2015,2500,5000,2500,100.0
Jalgaon,Garlic,2015,3500,6000,2500,71.42857142857143
Junnar-Otur,Ghevda,2015,500,3000,2500,500.0
Rahuri,Cluster Bean,2016,3500,6000,2500,71.42857142857143
Manchar,Wal Papdi,2014,2000,4500,2500,125.0
Akluj,Chikoo,2016,2000,4500,2500,125.0
Mumbai,Spilt Pigeon Pea,2015,8000,10500,2500,31.25
Brahmpuri,Male Lamb,2015,2500,5000,2500,100.0
Jalgaon,Apple,2015,5000,7500,2500,50.0
Amarawati-Fruit And Vegetables,Pomegranate,2016,2000,4500,2500,125.0
Nashik,Mosambi,2016,2000,4500,2500,125.0
Palus,Ladies Finger,2015,3500,6000,2500,71.42857142857143
Nashik,Mosambi,2016,2214,4714,2500,112.91779584462512
Nagpur,Pomegranate,2014,2085,4585,2500,119.9040767386091
Manchar,Ladies Finger,2014,967,3467,2500,258.5315408479835
Ahmednagar,Bitter Gourd,2016,2625,5125,2500,95.23809523809524
Kolhapur,Cluster Bean,2015,2500,5000,2500,100.0
Satara,Garlic,2015,3500,6000,2500,71.42857142857143
Akole,Hilda,2015,5000,7500,2500,50.0
Pen,Rice(Paddy-Hus),2016,3550,6050,2500,70.4225352112676
Pune,Double Bee,2015,3500,6000,2500,71.42857142857143
Pen,Rice(Paddy-Hus),2016,3550,6050,2500,70.4225352112676
Bhiwapur,Orange,2015,2000,4500,2500,125.0
Osmanabad,Shevga,2015,5000,7500,2500,50.0
Nagpur,Apple,2014,4000,6500,2500,62.5
Kamthi,Ginger (Fresh),2014,3167,5667,2500,78.93905904641616
Sangali,Coriander (Dry),2015,7000,9500,2500,35.714285714285715
Sangali,Coriander (Dry),2015,9500,12000,2500,26.31578947368421
Manchar,Ghevda,2016,1500,4000,2500,166.66666666666666
Osmanabad,Mango,2016,2250,4750,2500,111.11111111111111
Pune-Pimpri,Small Gourd,2016,1500,4000,2500,166.66666666666666
Rahuri-Songaon,Ladies Finger,2016,1000,3500,2500,250.0
Anajngaon Surji,Chillies(Red),2014,7250,9750,2500,34.48275862068966
Pen,Rice(Paddy-Hus),2015,3550,6050,2500,70.4225352112676
Pune,Green Chilli,2015,1974,4474,2500,126.64640324214793
Pune,Ridge Gourd,2016,2000,4500,2500,125.0
Jalgaon,Mosambi,2016,1833,4333,2500,136.3884342607747
Ahmednagar,Bitter Gourd,2015,1100,3600,2500,227.27272727272728
Akot,Thymol/Lovage,2016,10000,12500,2500,25.0
Vai,Green-Peas,2014,3500,6000,2500,71.42857142857143
Chandrapur,Garlic,2015,2500,5000,2500,100.0
Ahmednagar,Black Gram,2015,3750,6250,2500,66.66666666666667
Kolhapur,Grapes,2015,1500,4000,2500,166.66666666666666
Kurdwadi,Soybean,2015,2400,4900,2500,104.16666666666667
Rahuri,Grapes,2016,861,3361,2500,290.36004645760744
Vadgaon Peth,Pavtta,2016,1000,3500,2500,250.0
Pune,Ladies Finger,2015,1810,4310,2500,138.12154696132598
Nashik,Green-Peas,2015,1750,4250,2500,142.85714285714286
Nagpur,Chillies(Red),2016,11000,13500,2500,22.727272727272727
Pen,Rice(Paddy-Hus),2015,3550,6050,2500,70.4225352112676
Ramtek,CHILLIES(RED),2016,7000,9500,2500,35.714285714285715
Pen,Rice(Paddy-Hus),2015,3550,6050,2500,70.4225352112676
Osmanabad,Shevga,2015,2000,4500,2500,125.0
Junnar-Otur,Chavli (Shenga ),2016,1828,4328,2500,136.76148796498907
Akot,Thymol/Lovage,2015,7825,10325,2500,31.94888178913738
Jalna,Pomegranate,2016,1500,4000,2500,166.66666666666666
Pen,Rice(Paddy-Hus),2014,3550,6050,2500,70.4225352112676
Amarawati,Pomegranate,2015,1750,4250,2500,142.85714285714286
Pen,Rice(Paddy-Hus),2014,3550,6050,2500,70.4225352112676
Chandur Bajar,BLACK GRAM,2016,2856,5353,2497,87.42997198879551
Mumbai,Grapes,2015,3465,5961,2496,72.03463203463204
Majalgaon,Pigeon Pea (Tur),2016,6554,9048,2494,38.05309734513274
Dound,Cowpea,2016,5525,8018,2493,45.12217194570136
Solapur,Brinjal,2016,640,3133,2493,389.53125
Sangali,Wheat(Unhusked),2015,3413,5906,2493,73.04424260181658
Nashik,Squash Gourd,2016,3194,5687,2493,78.05259862241704
Solapur,Capsicum,2016,2065,4558,2493,120.72639225181598
Solapur,Cluster Bean,2014,1196,3688,2492,208.36120401337791
Dhule,CHILLIES(RED),2016,2933,5425,2492,84.96420047732697
Pune,Bitter Gourd,2016,2388,4880,2492,104.35510887772195
Nagpur,Pomegranate,2014,2004,4496,2492,124.35129740518963
Nashik,Cluster Bean,2014,2535,5026,2491,98.26429980276134
Basmat,Turmeric,2014,6668,9158,2490,37.34253149370126
Solapur,Custard Apple,2016,1250,3740,2490,199.2
Solapur,Chillies(Red),2015,10267,12756,2489,24.242719392227524
Phaltan,Gram,2016,5156,7644,2488,48.2544608223429
Pune,CLUSTER BEAN,2016,2012,4500,2488,123.65805168986084
Osmanabad,Shevga,2016,3013,5500,2487,82.54231662794557
Mumbai,Garlic,2016,2937,5423,2486,84.64419475655431
Pune,Ladies Finger,2015,1455,3941,2486,170.8591065292096
Pune,Green Chilli,2015,2115,4600,2485,117.49408983451536
Chikhali,Pigeon Pea (Tur),2015,6900,9385,2485,36.01449275362319
Solapur,Ridge Gourd,2015,807,3290,2483,307.6827757125155
Osmanabad,Shevga,2015,3119,5600,2481,79.54472587367746
Sangola,Pomegranate,2016,1917,4398,2481,129.42097026604068
Mumbai,Green Peas (Dry),2016,2400,4880,2480,103.33333333333333
Kamthi,Carrot,2015,1920,4400,2480,129.16666666666666
Nashik,Ground Nut Pods (Dry),2014,2746,5226,2480,90.31318281136198
Solapur,Cluster Bean,2014,2128,4607,2479,116.49436090225564
Solapur,Ladies Finger,2016,754,3233,2479,328.7798408488064
Baramati,GRAM,2016,6417,8896,2479,38.63175938912264
Daryapur,Green Gram,2015,5694,8172,2478,43.51949420442571
Jalgaon,Coriander  ,2014,2571,5048,2477,96.34383508362505
Sangali,Chillies(Red),2015,8231,10708,2477,30.093548779006195
Mandhal,Chillies(Red),2016,5522,7999,2477,44.856935892792464
Lasalgaon-Vinchur,GREEN GRAM,2016,2400,4876,2476,103.16666666666667
Khamgaon,Pigeon Pea (Tur),2015,6768,9244,2476,36.5839243498818
Khamgaon,Chillies(Red),2016,9113,11588,2475,27.159003621200483
Nashik,Cluster Bean,2014,2750,5225,2475,90.0
Pune,Green Peas (Dry),2014,3206,5681,2475,77.19900187149095
Akot,Thymol/Lovage,2015,7875,10350,2475,31.428571428571427
Morshi,Chillies(Red),2016,6476,8951,2475,38.218035824583076
Phaltan,Gram,2015,3175,5650,2475,77.95275590551181
Kurdwadi-Modnimb,Onion,2015,231,2706,2475,1071.4285714285713
Aurangabad,APPLE,2016,6125,8600,2475,40.40816326530612
Vasai,Rice(Paddy-Hus),2016,1844,4318,2474,134.1648590021692
Mumbai,Grapes,2015,2683,5157,2474,92.21021244875139
Nagpur,Pomegranate,2014,2089,4563,2474,118.42987075155577
Pathari,Pigeon Pea (Tur),2016,5162,7636,2474,47.92716001549787
Solapur,Brinjal,2015,562,3035,2473,440.0355871886121
Sangli-Phale Bhajipalam,Orange,2016,1053,3526,2473,234.8528015194682
Kolhapur,Tomato,2015,764,3237,2473,323.6910994764398
Nagpur,Onion,2015,1919,4392,2473,128.86920270974466
Lasalgaon,Black Gram,2014,2825,5297,2472,87.50442477876106
Amarawati,Garlic,2015,2778,5250,2472,88.98488120950324
Pune,Ladies Finger,2014,1460,3932,2472,169.31506849315068
Kolhapur,Cucumber,2016,969,3440,2471,255.00515995872033
Mumbai,Green Peas (Dry),2014,3531,6000,2469,69.92353440951572
Latur,Green Gram,2014,5742,8210,2468,42.98153953326367
Pune,Turmeric,2016,10633,13100,2467,23.201354274428667
Lasalgaon,Gram,2016,5187,7654,2467,47.56121071910545
Nashik,Green-Peas,2016,5000,7467,2467,49.34
Rahuri-Vambori,Onion,2015,200,2667,2467,1233.5
Kamthi,Wal Bhaji,2015,2000,4467,2467,123.35
Kalyan,Matki,2016,6167,8633,2466,39.987027728230906
Solapur,Garlic,2014,2392,4858,2466,103.09364548494983
Pandharpur,Brinjal,2015,505,2971,2466,488.3168316831683
Kalyan,Garlic,2015,5067,7533,2466,48.66785079928952
Pune,Green-Peas,2016,2886,5350,2464,85.37768537768538
Vadgaon Peth,Green Chilli,2016,3893,6357,2464,63.29309016182892
Umared,Rice(Paddy-Hus),2014,2000,4463,2463,123.15
Sangali,Lentil,2014,4088,6550,2462,60.22504892367906
Kamthi,Bitter Gourd,2015,2538,5000,2462,97.00551615445232
Pune,Cluster Bean,2014,2252,4714,2462,109.32504440497335
Kamthi,Mango,2015,3577,6038,2461,68.80067095331283
Mumbai,Rice(Paddy-Hus),2016,4798,7259,2461,51.292205085452274
Jamner,Green Gram,2015,6008,8467,2459,40.92876165113182
Mumbai,Garlic,2015,4528,6987,2459,54.3065371024735
Pune,Cluster Bean,2016,1882,4341,2459,130.65887353878853
Daryapur,Pigeon Pea (Tur),2015,5054,7512,2458,48.634744756628415
Karjat (Raigad),Rice(Paddy-Hus),2014,2000,4458,2458,122.9
Pune,Garlic,2016,3348,5804,2456,73.35722819593788
Satana,Onion,2015,2169,4625,2456,113.2319041032734
Sangli-Phale Bhajipalam,Chikoo,2016,1000,3455,2455,245.5
Kamthi,Bitter Gourd,2015,1878,4333,2455,130.7241746538871
Mumbai,Rice(Paddy-Hus),2015,4160,6615,2455,59.01442307692308
Solapur,Lemon,2015,369,2823,2454,665.040650406504
Solapur,Ridge Gourd,2015,1090,3544,2454,225.13761467889907
Amarawati-Fruit And Vegetables,Pomegranate,2016,1591,4045,2454,154.24261470773098
Chalisgaon,Black Gram,2016,7500,9953,2453,32.70666666666666
Mangalwedha,Ladies Finger,2016,940,3392,2452,260.8510638297872
Kolhapur,Tomato,2016,619,3070,2451,395.96122778675283
Osmanabad,Ridge Gourd,2015,1800,4250,2450,136.11111111111111
Mangalwedha,Ladies Finger,2015,731,3181,2450,335.15731874145007
Malkapur,Sesamum,2015,6300,8750,2450,38.888888888888886
Osmanabad,Bitter Gourd,2015,1300,3750,2450,188.46153846153845
Osmanabad,Cluster Bean,2014,1550,4000,2450,158.06451612903226
Indapur-Bhigwan,Sesamum,2015,4800,7250,2450,51.041666666666664
Chikhali,Black Gram,2016,5900,8350,2450,41.52542372881356
Solapur,Cluster Bean,2016,3415,5862,2447,71.65446559297219
Kamthi,Methi (Bhaji),2014,2318,4765,2447,105.56514236410699
Parner,Onion,2015,2615,5062,2447,93.5755258126195
Nanded,Turmeric,2016,7750,10197,2447,31.574193548387097
Sangali,Green Gram,2015,5727,8173,2446,42.70997031604679
Amarawati,Grapes,2016,2722,5167,2445,89.82365907421014
Kolhapur,Ladies Finger,2015,1155,3600,2445,211.6883116883117
Khalapur(Shil-Phata),Other Cereals,2016,6694,9138,2444,36.51030773827308
Mumbai,Rice(Paddy-Hus),2015,4186,6630,2444,58.38509316770186
Pune,Ladies Finger,2015,1462,3905,2443,167.0998632010944
Ahmednagar,Brinjal,2016,529,2971,2442,461.6257088846881
Mangalwedha,Ridge Gourd,2015,681,3122,2441,358.44346549192363
Junnar-Otur,Ground Nut Pods (Dry),2016,1794,4235,2441,136.06465997770346
Shegaon,Thymol/Lovage,2015,7069,9510,2441,34.531051068043574
Mumbai,Rice(Paddy-Hus),2016,4416,6857,2441,55.27626811594203
Kolhapur,BOR,2016,337,2778,2441,724.3323442136499
Indapur,Onion,2015,264,2704,2440,924.2424242424242
Kalyan,Matki,2016,6090,8530,2440,40.06568144499179
Karad,APPLE,2016,7800,10240,2440,31.28205128205128
Sinner,Onion,2015,237,2677,2440,1029.535864978903
Sangli-Phale Bhajipalam,Chikoo,2015,800,3239,2439,304.875
Solapur,Cluster Bean,2015,1021,3460,2439,238.88344760039178
Kolhapur-Laxmipuri,Gram,2016,4646,7085,2439,52.49677141627206
Solapur,Brinjal,2016,467,2905,2438,522.0556745182013
Narkhed,Orange,2014,6700,9138,2438,36.38805970149254
Kamthi,Ginger (Fresh),2015,3938,6375,2437,61.884205180294565
Mangrulpeer,Black Gram,2015,9182,11618,2436,26.5301677194511
Atpadi,Pomegranate,2016,1469,3904,2435,165.75901974132063
Nanded,Turmeric,2016,7607,10042,2435,32.00999079794926
Sangrampur,Pigeon Pea (Tur),2015,4136,6570,2434,58.849129593810446
Pune,Ladies Finger,2014,1595,4029,2434,152.60188087774296
Indapur-Bhigwan,Chillies(Red),2015,8033,10467,2434,30.300012448649323
Malkapur,Green Gram,2015,6716,9149,2433,36.22692078618225
Kolhapur,Ladies Finger,2016,1238,3671,2433,196.52665589660742
Pandharpur,Ladies Finger,2014,900,3333,2433,270.3333333333333
Solapur,Brinjal,2014,606,3036,2430,400.990099009901
Barshi,Black Gram,2015,7635,10065,2430,31.827111984282908
Pune-Moshi,Green Chilli,2016,5321,7750,2429,45.64931403871453
Chandvad,Onion,2015,1967,4396,2429,123.48754448398577
Pune,Double Bee,2015,2857,5286,2429,85.01925096254813
Kamthi,Methi (Bhaji),2014,2476,4905,2429,98.10177705977382
Balapur,Green Gram,2015,6140,8568,2428,39.54397394136808
Sangli-Phale Bhajipalam,Mosambi,2015,1143,3571,2428,212.42344706911635
Dhule,Gram,2016,4854,7281,2427,50.0
Aurangabad,Grapes,2016,2350,4777,2427,103.27659574468085
Chikhali,Green Gram,2014,3694,6121,2427,65.70113697888468
Rahata,Tomato,2016,2085,4512,2427,116.40287769784173
Kolhapur,Shevga,2015,2779,5205,2426,87.29758906081324
Mumbai,Green Peas (Dry),2014,3426,5852,2426,70.8114419147694
Kolhapur,Green Chilli,2016,2044,4470,2426,118.68884540117416
Aurangabad,Garlic,2014,1900,4325,2425,127.63157894736842
Sangli-Phale Bhajipalam,Onion,2015,600,3025,2425,404.1666666666667
Pune,Shevga,2014,2825,5250,2425,85.84070796460178
Lonar,Black Gram,2015,6769,9194,2425,35.82508494607771
Kolhapur-Laxmipuri,Rice(Paddy-Hus),2016,2170,4595,2425,111.75115207373273
Kolhapur,Mosambi,2016,2875,5300,2425,84.34782608695652
Nira-Saswad,GRAM,2016,5720,8145,2425,42.39510489510489
Mandhal,Chillies(Red),2016,6005,8429,2424,40.366361365528725
Nagpur,GRAPES,2016,4476,6900,2424,54.15549597855228
Vasai,Rice(Paddy-Hus),2016,1832,4256,2424,132.31441048034935
Ausa,Gram,2016,6420,8843,2423,37.741433021806856
Pune,Mango(Raw),2016,2808,5231,2423,86.28917378917379
Dondaicha,CHILLIES(RED),2016,1115,3537,2422,217.21973094170403
Osmanabad,Wheat(Husked),2016,1945,4367,2422,124.52442159383034
Jalgaon,Coriander  ,2014,2300,4722,2422,105.30434782608695
Mangalwedha,Cucumber,2015,704,3126,2422,344.03409090909093
Ashti-Karanja,Gram,2016,3796,6217,2421,63.77766069546892
Pune,Green Peas (Dry),2014,2532,4953,2421,95.61611374407583
Sangli-Phale Bhajipalam,Mosambi,2016,3868,6289,2421,62.59048603929679
Nashik,Lemon,2016,3367,5788,2421,71.9037719037719
Solapur,Brinjal,2015,525,2946,2421,461.14285714285717
Dhule,Chillies(Red),2014,4144,6564,2420,58.397683397683394
Kolhapur,Mosambi,2015,3640,6060,2420,66.48351648351648
Mumbai,Rice(Paddy-Hus),2016,4480,6900,2420,54.017857142857146
Jalgaon,Mango,2016,3147,5567,2420,76.89863361931998
Ratanagari,Green Chilli,2016,3500,5920,2420,69.14285714285714
Mangalwedha,Cucumber,2015,496,2915,2419,487.7016129032258
Shirpur,Green Gram,2014,4530,6949,2419,53.39955849889625
Sangali,Green Gram,2014,5055,7473,2418,47.833827893175076
Ahmednagar,Green Chilli,2015,2000,4417,2417,120.85
Kolhapur-Laxmipuri,Gram,2015,5361,7778,2417,45.0848722253311
Ahmednagar,Brinjal,2016,542,2958,2416,445.75645756457567
Nashik,CLUSTER BEAN,2016,2667,5083,2416,90.58867641544806
Kolhapur,MATH (BHAJI),2016,1750,4164,2414,137.94285714285715
Lasur Station,Onion,2015,457,2871,2414,528.2275711159738
Pune-Manjri,Cluster Bean,2015,3065,5478,2413,78.72756933115824
Pathari,Gram,2016,2967,5380,2413,81.32794068082238
Katol,Ground Nut Pods (Dry),2014,2226,4639,2413,108.40071877807726
Pune,Mango(Raw),2016,3059,5471,2412,78.84929715593331
Vasai,Rice(Paddy-Hus),2016,1836,4248,2412,131.37254901960785
Pathari,Safflower,2016,0,2411,2411,inf
Khamgaon,Black Gram,2015,7912,10323,2411,30.472699696663295
Pune-Pimpri,Green Chilli,2015,2889,5300,2411,83.45448251990308
Kurdwadi-Modnimb,Black Gram,2016,4871,7281,2410,49.47649353315541
Mehkar,Pigeon Pea (Tur),2015,7833,10242,2409,30.75450019149751
Bhiwapur,Chillies(Red),2015,2832,5240,2408,85.02824858757062
Solapur,Green Chilli,2016,1572,3980,2408,153.18066157760813
Jalgaon,Black Gram,2016,4704,7111,2407,51.16921768707483
Koregaon,Ghevda Seed,2014,3225,5631,2406,74.6046511627907
Nagpur,Grapes,2016,4024,6429,2405,59.76640159045726
Pune,Ginger (Fresh),2014,2125,4530,2405,113.17647058823529
Solapur,Cluster Bean,2016,1056,3460,2404,227.65151515151516
Majalgaon,Green Gram,2014,3992,6396,2404,60.22044088176353
Junnar-Otur,Ghevda,2016,2131,4535,2404,112.81088690755514
Pune-Manjri,Coriander  ,2015,1029,3429,2400,233.23615160349854
Kamthi,Amla,2015,600,3000,2400,400.0
Karjat (Raigad),Rice(Paddy-Hus),2016,2000,4400,2400,120.0
Karjat (Raigad),Rice(Paddy-Hus),2016,2000,4400,2400,120.0
Karjat (Raigad),Rice(Paddy-Hus),2015,2000,4400,2400,120.0
Chandrapur,Grapes,2016,2177,4577,2400,110.24345429490124
Kamthi,Amla,2015,600,3000,2400,400.0
Kamthi,Kanda Pat,2015,1800,4200,2400,133.33333333333334
Nira-Saswad,Gram,2016,5525,7925,2400,43.43891402714932
Kamthi,Bitter Gourd,2016,1850,4250,2400,129.72972972972974
Karjat (Raigad),Rice(Paddy-Hus),2016,2000,4400,2400,120.0
Karjat (Raigad),Rice(Paddy-Hus),2016,2000,4400,2400,120.0
Karjat (Raigad),Rice(Paddy-Hus),2016,2000,4400,2400,120.0
Karjat (Raigad),Rice(Paddy-Hus),2015,2000,4400,2400,120.0
Akluj,Onion,2015,1363,3763,2400,176.0821716801174
Osmanabad,Bitter Gourd,2015,600,3000,2400,400.0
Osmanabad,Ginger (Fresh),2016,1850,4250,2400,129.72972972972974
Indapur-Bhigwan,Cowpea,2014,2000,4400,2400,120.0
Karjat (Raigad),Rice(Paddy-Hus),2015,2000,4400,2400,120.0
Karjat (Raigad),Rice(Paddy-Hus),2015,2000,4400,2400,120.0
Kamthi,Amla,2014,600,3000,2400,400.0
Karjat (Raigad),Rice(Paddy-Hus),2014,2000,4400,2400,120.0
Karjat (Raigad),Rice(Paddy-Hus),2015,2000,4400,2400,120.0
Karjat (Raigad),Rice(Paddy-Hus),2014,2000,4400,2400,120.0
Karjat (Raigad),Rice(Paddy-Hus),2015,2000,4400,2400,120.0
Karjat (Raigad),Rice(Paddy-Hus),2014,2000,4400,2400,120.0
Manchar,Squash Gourd,2016,600,3000,2400,400.0
Karjat (Raigad),Rice(Paddy-Hus),2016,2000,4400,2400,120.0
Ahmednagar,Bitter Gourd,2016,2500,4900,2400,96.0
Karjat (Raigad),Rice(Paddy-Hus),2015,2000,4400,2400,120.0
Lasalgaon-Vinchur,Black Gram,2016,4217,6617,2400,56.91249703580745
Chandrapur,Grapes,2015,2933,5333,2400,81.82748039549949
Shrirampur,Garlic,2016,5400,7800,2400,44.44444444444444
Amarawati,Pomegranate,2016,2675,5075,2400,89.7196261682243
Karjat (Raigad),Rice(Paddy-Hus),2015,2000,4400,2400,120.0
Karjat (Raigad),Rice(Paddy-Hus),2015,2000,4400,2400,120.0
Kamthi,Papai,2014,600,3000,2400,400.0
Kolhapur-Malkapur,Brinjal,2016,725,3125,2400,331.0344827586207
Lasalgaon-Niphad,Black Gram,2016,4301,6701,2400,55.80097651708905
Aurangabad,Tamarind,2016,4000,6400,2400,60.0
Ratanagari,Green Chilli,2016,5100,7500,2400,47.05882352941177
Kolhapur,Carrot,2016,1050,3450,2400,228.57142857142858
Kamthi,Green Chilli,2015,1833,4233,2400,130.9328968903437
Umared,Rice(Paddy-Hus),2014,2000,4400,2400,120.0
Nashik,Green Chilli,2015,2400,4800,2400,100.0
Kamthi,Orange,2015,600,3000,2400,400.0
Karad,Mosambi,2016,6620,9020,2400,36.25377643504532
Kamthi,Green-Peas,2015,1933,4333,2400,124.15933781686498
Kamthi,Orange,2015,600,3000,2400,400.0
Kamthi,Ginger (Fresh),2015,1900,4300,2400,126.3157894736842
Kamthi,Mosambi,2015,600,3000,2400,400.0
Khalapur(Shil-Phata),Rice(Paddy-Hus),2016,2000,4400,2400,120.0
Amarawati,Apple,2015,3067,5467,2400,78.25236387349202
Kannad,GRAM,2016,5000,7400,2400,48.0
Kolhapur,Shevga,2016,1330,3728,2398,180.30075187969925
Nashik,Pomegranate,2015,2071,4469,2398,115.78947368421052
Aurangabad,Fig,2014,4178,6574,2396,57.34801340354237
Solapur,Ladies Finger,2016,808,3204,2396,296.53465346534654
Pune-Manjri,Ladies Finger,2015,3261,5657,2396,73.47439435755904
Pune-Manjri,Ghosali(Bhaji),2016,2605,5000,2395,91.93857965451056
Pune,Ginger (Fresh),2014,2225,4620,2395,107.64044943820225
Shrirampur,Onion,2015,713,3106,2393,335.62412342215987
Kamthi,Capsicum,2015,1644,4037,2393,145.5596107055961
Sangli-Phale Bhajipalam,ORANGE,2016,1888,4281,2393,126.74788135593221
Devala,Onion,2015,2244,4636,2392,106.59536541889483
Mumbai,COWPEA,2016,5148,7540,2392,46.464646464646464
Nashik,Ladies Finger,2015,1727,4119,2392,138.50607990735378
Mangalwedha,Brinjal,2016,340,2732,2392,703.5294117647059
Nashik,Squash Gourd,2015,2911,5303,2392,82.17107523187907
Amalner,Coriander (Dry),2015,6442,8833,2391,37.11580254579323
Devala,Gram,2015,3105,5496,2391,77.0048309178744
Pune-Manjri,Cluster Bean,2015,4117,6508,2391,58.076269128005826
Solapur,Cucumber,2015,408,2798,2390,585.7843137254902
Anajngaon Surji,GRAM,2016,6930,9320,2390,34.487734487734485
Pune-Manjri,Methi (Bhaji),2016,1887,4277,2390,126.65606783253843
Pune,Ladies Finger,2015,1389,3778,2389,171.99424046076314
Karad,Apple,2015,5000,7389,2389,47.78
Nashik,Green Chilli,2016,6254,8642,2388,38.183562519987206
Kolhapur,Capsicum,2015,1045,3432,2387,228.42105263157896
Shirpur,Pigeon Pea (Tur),2016,6445,8832,2387,37.03646237393328
Jalgaon,Green Chilli,2016,3696,6083,2387,64.58333333333333
Kolhapur,Bitter Gourd,2016,2373,4759,2386,100.54782975136958
Sangamner,Tomato,2014,2038,4423,2385,117.02649656526006
Osmanabad,Wheat(Husked),2015,1530,3914,2384,155.81699346405227
Sakri,Ground Nut Pods (Dry),2016,3730,6114,2384,63.9142091152815
Shirpur,Onion,2015,1582,3966,2384,150.69532237673832
Nashik,Lemon,2016,3170,5554,2384,75.20504731861199
Pen,Rice(Paddy-Hus),2016,3448,5831,2383,69.11252900232019
Kamthi,Onion,2015,609,2991,2382,391.13300492610836
Kolhapur,Capsicum,2016,1412,3794,2382,168.69688385269123
Mangalwedha,Cucumber,2016,523,2904,2381,455.2581261950287
Solapur,Ridge Gourd,2016,1193,3573,2380,199.49706621961442
Murum,Black Gram,2016,5379,7759,2380,44.24614240565161
Kalyan,Custard Apple,2015,2180,4560,2380,109.1743119266055
Kolhapur-Laxmipuri,Green Peas (Dry),2016,3355,5734,2379,70.9090909090909
Sangli-Phale Bhajipalam,Chikoo,2016,1100,3479,2379,216.27272727272728
Chandrapur,Apple,2015,2237,4616,2379,106.34778721502012
Kolhapur-Malkapur,Brinjal,2016,878,3256,2378,270.8428246013667
Umarga,Black Gram,2015,7058,9435,2377,33.678095777840745
Solapur,Ladies Finger,2016,608,2985,2377,390.95394736842104
Newasa-Ghodegaon,Onion,2015,438,2815,2377,542.6940639269407
Kamthi,Bitter Gourd,2016,2336,4712,2376,101.71232876712328
Mangrulpeer,Green Gram,2015,5750,8125,2375,41.30434782608695
Akluj,Garlic,2015,3781,6156,2375,62.814070351758794
Ahmednagar,Capsicum,2015,1000,3375,2375,237.5
Pune-Manjri,Squash Gourd,2016,3396,5771,2375,69.93521790341579
Yeola,GRAM,2016,5149,7524,2375,46.125461254612546
Akluj,Chillies(Red),2016,4625,7000,2375,51.351351351351354
Solapur,Ridge Gourd,2016,1269,3642,2373,186.99763593380615
Pandharpur,Tomato,2016,646,3019,2373,367.3374613003096
Ramtek,Garlic,2016,9991,12364,2373,23.751376238614753
Lasalgaon,Gram,2016,4328,6700,2372,54.80591497227357
Kamthi,Flower,2016,2105,4477,2372,112.68408551068883
Mumbai,Small Gourd,2014,1444,3816,2372,164.26592797783934
Pandharpur,Tomato,2016,831,3203,2372,285.439229843562
Mumbai,Green Peas (Dry),2014,3371,5742,2371,70.33521210323346
Pen,Rice(Paddy-Hus),2016,3437,5808,2371,68.98457957521094
Taloda,Shepa,2015,7980,10350,2370,29.69924812030075
Kurdwadi,Onion,2015,390,2760,2370,607.6923076923077
Sangali,Turmeric,2016,7780,10150,2370,30.46272493573265
Sangali,Green Gram,2016,6333,8702,2369,37.40723195957682
Latur,Green Gram,2014,5770,8139,2369,41.05719237435009
Pune,Ladies Finger,2016,1380,3748,2368,171.59420289855072
Akot,Black Gram,2016,4841,7209,2368,48.91551332369345
Nashik,Bitter Gourd,2016,3974,6341,2367,59.56215400100654
Pune-Manjri,Guava,2015,750,3117,2367,315.6
Malkapur,Green Gram,2015,5008,7375,2367,47.26437699680511
Loha,Black Gram,2015,9233,11600,2367,25.6363045597314
Nagpur,Chillies(Red),2015,7371,9738,2367,32.11233211233211
Rahuri,Green Chilli,2016,1517,3883,2366,155.96572181938035
Vasai,Rice(Paddy-Hus),2016,1932,4298,2366,122.46376811594203
Sangli-Phale Bhajipalam,Orange,2015,1045,3409,2364,226.2200956937799
Mumbai,Fenugreek,2015,8000,10364,2364,29.55
Solapur,Brinjal,2016,300,2663,2363,787.6666666666666
Kolhapur-Laxmipuri,Gram,2015,5353,7716,2363,44.143470950868675
Solapur,Mula Shenga,2015,2263,4625,2362,104.37472381794079
Mumbai,Chikoo,2015,1355,3717,2362,174.31734317343174
Kurdwadi,Onion,2015,1213,3575,2362,194.72382522671063
Kamthi,Ginger (Fresh),2016,2340,4700,2360,100.85470085470085
Pune,Brinjal,2016,1668,4028,2360,141.48681055155876
Mumbai-Fruit Market,Mango,2016,2200,4560,2360,107.27272727272727
Kolhapur,Water Melon,2016,242,2602,2360,975.2066115702479
Pathardi,Onion,2015,809,3168,2359,291.5945611866502
Amarawati-Fruit And Vegetables,Apple,2016,3808,6167,2359,61.9485294117647
Pune,Ginger (Fresh),2015,1517,3875,2358,155.43836519446276
Solapur,Cucumber,2015,520,2878,2358,453.46153846153845
Pune-Moshi,Green Chilli,2016,5071,7429,2358,46.49970420035496
Mumbai,Apple,2015,7143,9500,2357,32.99734005319893
Kamthi,Green Chilli,2014,2929,5286,2357,80.4711505633322
Kurdwadi-Modnimb,Pigeon Pea (Tur),2016,5329,7686,2357,44.229686620379056
Solapur,Green Chilli,2016,2560,4916,2356,92.03125
Osmanabad,Lemon,2015,1583,3939,2356,148.83133291219204
Pune-Manjri,Coriander  ,2015,917,3272,2355,256.8157033805889
Solapur,Cluster Bean,2015,1353,3708,2355,174.05764966740577
Mumbai,Garlic,2015,2188,4542,2354,107.58683729433272
Pune-Manjri,Ghevda,2015,1542,3896,2354,152.65888456549936
Chandrapur,Pomegranate,2016,2240,4593,2353,105.04464285714286
Atpadi,Pomegranate,2014,1565,3918,2353,150.3514376996805
Akluj,Onion,2015,2200,4553,2353,106.95454545454545
Nashik,ORANGE,2016,1284,3637,2353,183.25545171339564
Hingoli,Black Gram,2015,7997,10350,2353,29.423533825184442
Sangli-Phale Bhajipalam,Orange,2015,1000,3353,2353,235.3
Amarawati-Fruit And Vegetables,Mango,2016,3406,5758,2352,69.05460951262478
Dhamangaon-Rly,BLACK GRAM,2016,3600,5952,2352,65.33333333333333
Vasai,Rice(Paddy-Hus),2016,1854,4205,2351,126.80690399137
Narkhed,Orange,2016,2000,4350,2350,117.5
Ahmednagar,Bitter Gourd,2016,2750,5100,2350,85.45454545454545
Amarawati,Garlic,2015,3300,5650,2350,71.21212121212122
Jamner,Black Gram,2015,5650,8000,2350,41.5929203539823
Satara,Onion,2015,2538,4888,2350,92.5925925925926
Aurangabad,Fig,2015,4100,6450,2350,57.31707317073171
Osmanabad,Mango,2015,1450,3800,2350,162.06896551724137
Osmanabad,BLACK GRAM,2016,3651,6000,2349,64.33853738701725
Mangrulpeer,Pigeon Pea (Tur),2015,7293,9641,2348,32.19525572466749
Latur,Green Gram,2014,4867,7215,2348,48.24327100883501
Solapur,Cluster Bean,2016,1339,3687,2348,175.3547423450336
Lasalgaon,Gram,2016,6980,9327,2347,33.62464183381089
Shegaon,Thymol/Lovage,2016,9703,12050,2347,24.188395341646913
Mumbai,Green-Peas,2016,5115,7462,2347,45.88465298142717
Kurdwadi-Modnimb,Onion,2015,1626,3971,2345,144.21894218942188
Sangrampur-Varvatbakal,Pigeon Pea (Tur),2016,5517,7860,2343,42.46873300706906
Ramtek,Chillies(Red),2016,6657,9000,2343,35.19603424966201
Yeola,Gram,2016,6842,9185,2343,34.244372990353696
Akola,RICE(PADDY-HUS),2016,3110,5453,2343,75.33762057877813
Mumbai,Split Black Gram,2016,14458,16800,2342,16.19864434914926
Mangalwedha,Ridge Gourd,2015,1627,3969,2342,143.94591272280272
Mangalwedha,Ridge Gourd,2015,1581,3923,2342,148.13409234661606
Pune,Ginger (Fresh),2015,1332,3673,2341,175.75075075075074
Kamthi,Green Chilli,2016,1927,4267,2340,121.43227815256876
Karjat (Raigad),Rice(Paddy-Hus),2015,1951,4290,2339,119.88723731419785
Malkapur,Pigeon Pea (Tur),2015,6554,8892,2338,35.67287152883735
Junnar,Onion,2015,2250,4588,2338,103.91111111111111
Ahmednagar,Ladies Finger,2015,938,3275,2337,249.14712153518124
Karjat (Raigad),Rice(Paddy-Hus),2015,2000,4336,2336,116.8
Nandurbar,Thymol/Lovage,2016,12293,14629,2336,19.00268445456764
Pen,Rice(Paddy-Hus),2016,3411,5747,2336,68.48431545001466
Kalyan,Garlic,2016,7274,9609,2335,32.100632389331864
Risod,GRAM,2016,6528,8863,2335,35.76899509803921
Kalyan,Gram,2016,6333,8667,2334,36.85457129322596
Mangalwedha,Tomato,2016,466,2800,2334,500.85836909871244
Kamthi,Squash Gourd,2015,2333,4667,2334,100.04286326618089
Ahmednagar,Cabbage,2016,554,2888,2334,421.2996389891697
Vadgaon Peth,Green-Peas,2016,2333,4667,2334,100.04286326618089
Ahmednagar,Ghosali(Bhaji),2016,1333,3667,2334,175.09377344336085
Pandharpur,Green Chilli,2015,2144,4478,2334,108.86194029850746
Pune-Pimpri,Ghevda,2015,2333,4667,2334,100.04286326618089
Kamthi,Ginger (Fresh),2015,2250,4583,2333,103.68888888888888
Jalna,Pomegranate,2014,1500,3833,2333,155.53333333333333
Chandrapur,Grapes,2014,4667,7000,2333,49.98928647953718
Amarawati-Fruit And Vegetables,Pomegranate,2016,2000,4333,2333,116.65
Pune,Terda,2014,3667,6000,2333,63.621488955549495
Kalyan,Apple,2016,7667,10000,2333,30.429111777748794
Jalgaon,MOSAMBI,2016,2667,5000,2333,87.47656542932134
Kolhapur,Orange,2016,5717,8050,2333,40.8081161448312
Kalyan,Matki,2016,6000,8333,2333,38.88333333333333
Pune-Manjri,Squash Gourd,2016,5690,8023,2333,41.00175746924429
Ulhasnagar,Other Cereals,2016,2667,5000,2333,87.47656542932134
Rahata,Onion,2015,636,2968,2332,366.6666666666667
Kolhapur,Cluster Bean,2015,2177,4509,2332,107.1198897565457
Kolhapur-Laxmipuri,Gram,2016,5110,7442,2332,45.63600782778865
Ahmednagar,Ladies Finger,2016,720,3050,2330,323.6111111111111
Beed,Black Gram,2015,8621,10951,2330,27.027027027027028
Osmanabad,Ladies Finger,2016,1538,3867,2329,151.4304291287386
Chandrapur,Orange,2016,509,2836,2327,457.17092337917484
Kamthi,Capsicum,2014,2809,5136,2327,82.84086863652546
Amarawati,Black Gram,2016,7019,9346,2327,33.15287077931329
Solapur,Ladies Finger,2015,991,3318,2327,234.8133198789102
Mangalwedha,Ridge Gourd,2016,1230,3556,2326,189.10569105691056
Ahmednagar,Garlic,2015,4000,6325,2325,58.125
Pune,Squash Gourd,2016,2325,4650,2325,100.0
Kolhapur,Coriander  ,2016,861,3185,2324,269.9186991869919
Sangali,Chillies(Red),2015,8100,10423,2323,28.679012345679013
Kamthi,Coriander  ,2015,2548,4871,2323,91.16954474097331
Chandur Bajar,Black Gram,2015,8600,10922,2322,27.0
Solapur,Cucumber,2015,417,2739,2322,556.8345323741007
Devala,Onion,2015,2090,4412,2322,111.10047846889952
Solapur,Garlic,2014,2021,4342,2321,114.8441365660564
Osmanabad,Green Chilli,2015,1340,3660,2320,173.13432835820896
Pune,Small Gourd,2016,1300,3620,2320,178.46153846153845
Kolhapur-Laxmipuri,Green Peas (Dry),2016,3796,6115,2319,61.090621707060066
Ahmednagar,Cluster Bean,2015,3818,6136,2318,60.7124148768989
Vadgaon Peth,Brinjal,2014,1725,4042,2317,134.31884057971016
Sangali,Matki,2016,6544,8861,2317,35.40647921760391
Kamthi,Methi (Bhaji),2015,2267,4583,2316,102.16144684605204
Ahmedpur,Black Gram,2016,4585,6901,2316,50.51254089422029
Kannad,Ginger (Fresh),2015,1628,3944,2316,142.26044226044226
Sangrampur,Black Gram,2016,4871,7186,2315,47.52617532334223
Pandharpur,Tomato,2015,663,2977,2314,349.01960784313724
Kolhapur,Brinjal,2015,702,3016,2314,329.6296296296296
Amarawati,Pomegranate,2016,3344,5656,2312,69.13875598086125
Pune,Turmeric,2014,8188,10500,2312,28.236443575964827
Vadgaon Peth,Ridge Gourd,2016,3313,5625,2312,69.78569272562632
Kolhapur,Ladies Finger,2016,1426,3737,2311,162.0617110799439
Karjat (Raigad),Rice(Paddy-Hus),2015,1975,4286,2311,117.0126582278481
Kamthi,Lemon,2016,1689,4000,2311,136.82652457075193
Kolhapur,Brinjal,2016,613,2923,2310,376.8352365415987
Pune-Manjri,Cluster Bean,2015,3958,6267,2309,58.33754421424962
Pune,Brinjal,2014,1524,3833,2309,151.50918635170603
Solapur,Onion,2014,112,2421,2309,2061.6071428571427
Nandgaon,Ground Nut Pods (Dry),2015,3197,5506,2309,72.22395996246482
Aurangabad,Green Chilli,2016,4465,6773,2308,51.69092945128779
Nagpur,Apple,2014,3921,6229,2308,58.8625350675848
Karanja,Gram,2016,7094,9401,2307,32.52043980828869
Amarawati,Black Gram,2016,4568,6875,2307,50.503502626970224
Solapur,Ridge Gourd,2015,1080,3387,2307,213.61111111111111
Hinganghat,Pigeon Pea (Tur),2016,7100,9406,2306,32.478873239436616
Solapur,Cucumber,2015,347,2652,2305,664.2651296829971
Pune-Manjri,Ridge Gourd,2015,2476,4780,2304,93.05331179321486
Bhiwapur,CHILLIES(RED),2016,5100,7402,2302,45.13725490196079
Malegaon,Green Gram,2016,4850,7152,2302,47.4639175257732
Karad,Garlic,2014,2900,5200,2300,79.3103448275862
Kolhapur-Malkapur,Capsicum,2016,700,3000,2300,328.57142857142856
Aurangabad,Mosambi,2015,1556,3856,2300,147.81491002570695
Vasai,Rice(Paddy-Hus),2016,1913,4213,2300,120.23000522739153
Kolhapur-Malkapur,Ladies Finger,2016,700,3000,2300,328.57142857142856
Kamthi,Guava,2014,2006,4306,2300,114.65603190428713
Ahmednagar,Cluster Bean,2015,1200,3500,2300,191.66666666666666
Osmanabad,Brinjal,2015,1303,3603,2300,176.51573292402148
Pune-Manjri,Pavtta,2015,2865,5165,2300,80.27923211169285
Pune-Manjri,Methi (Bhaji),2015,1900,4200,2300,121.05263157894737
Jalgaon,Custard Apple,2016,2300,4600,2300,100.0
Kamthi,Kanda Pat,2016,1700,4000,2300,135.2941176470588
Barshi,Tamarind,2016,6754,9054,2300,34.05389398874741
Rahuri,Onion,2015,200,2500,2300,1150.0
Ahmednagar,Green Chilli,2015,1500,3800,2300,153.33333333333334
Mumbai,Cowpea,2014,4700,7000,2300,48.93617021276596
Karad,Jaggery,2016,2513,4812,2299,91.48428173497811
Nashik,Brinjal,2014,1596,3895,2299,144.04761904761904
Malkapur,Gram,2016,7396,9694,2298,31.070849107625744
Mumbai,Rice(Paddy-Hus),2015,4220,6518,2298,54.45497630331754
Pachora,Black Gram,2016,4439,6735,2296,51.723361117368775
Hingoli,Turmeric,2015,7500,9795,2295,30.6
Shahada,Black Gram,2015,8045,10340,2295,28.52703542573027
Pune,Ladies Finger,2016,1375,3670,2295,166.9090909090909
Chandrapur-Ganjwad,Garlic,2016,6580,8875,2295,34.878419452887535
Pen,Rice(Paddy-Hus),2016,3372,5667,2295,68.06049822064057
Sangali,Green Gram,2016,6350,8644,2294,36.125984251968504
Lasalgaon-Niphad,Onion,2015,2048,4341,2293,111.962890625
Navapur,Flower,2016,2708,5000,2292,84.63810930576071
Solapur,Capsicum,2016,1688,3980,2292,135.781990521327
Palus,Tomato,2016,2168,4460,2292,105.71955719557195
Pune,Small Gourd,2016,1383,3675,2292,165.72668112798266
Kalyan,Garlic,2015,6500,8792,2292,35.261538461538464
Ahmednagar,Ghosali(Bhaji),2016,3167,5458,2291,72.33975371013578
Mumbai,Chikoo,2015,1396,3687,2291,164.11174785100286
Pune-Manjri,Raddish,2015,1145,3436,2291,200.0873362445415
Ahmednagar,Tomato,2015,900,3190,2290,254.44444444444446
Nashik,Cluster Bean,2016,2947,5237,2290,77.70614183915846
Mangalwedha,Ladies Finger,2016,2311,4600,2289,99.048031155344
Amarawati,Pomegranate,2016,1711,4000,2289,133.78141437755698
Kamthi,Carrot,2015,2156,4444,2288,106.12244897959184
Osmanabad,Flower,2016,2270,4557,2287,100.7488986784141
Solapur,Green Chilli,2016,2162,4449,2287,105.78168362627197
Mangalwedha,Cucumber,2014,871,3158,2287,262.5717566016074
Pune-Pimpri,Tomato,2016,2970,5257,2287,77.003367003367
Solapur,Lemon,2014,200,2487,2287,1143.5
Sangrampur-Varvatbakal,Pigeon Pea (Tur),2016,6446,8733,2287,35.47936704933292
Kamthi,Wal Bhaji,2015,1857,4143,2286,123.10177705977382
Vasai,Rice(Paddy-Hus),2015,1738,4024,2286,131.53049482163405
Parner,Onion,2015,2346,4631,2285,97.3998294970162
Kolhapur,Orange,2015,4796,7081,2285,47.643869891576315
Osmanabad,Brinjal,2015,1233,3517,2284,185.23925385239255
Ahmednagar,Green Chilli,2015,1883,4167,2284,121.29580456718003
Osmanabad,Capsicum,2016,2758,5042,2284,82.81363306744018
Navapur,Tomato,2016,2330,4614,2284,98.02575107296137
Kurdwadi-Modnimb,Gram,2016,6605,8888,2283,34.564723694171086
Solapur,Garlic,2015,1622,3905,2283,140.75215782983972
Nagpur,Apple,2015,3139,5422,2283,72.73016884358076
Pune-Manjri,Guava,2016,1125,3408,2283,202.93333333333334
Junnar-Otur,Cluster Bean,2016,1667,3950,2283,136.9526094781044
Pune,Green-Peas,2016,3370,5652,2282,67.71513353115726
Nashik,Ghevda,2014,2409,4691,2282,94.72810294728103
Solapur,Onion,2014,103,2384,2281,2214.5631067961167
Tumsar,Lentil,2015,3300,5581,2281,69.12121212121212
Nanded,Turmeric,2014,5892,8173,2281,38.71350984385607
Kolhapur-Malkapur,Squash Gourd,2016,1620,3900,2280,140.74074074074073
Mangalwedha,Green Chilli,2016,4012,6292,2280,56.82951146560319
Kamthi,Bitter Gourd,2016,2520,4800,2280,90.47619047619048
Aurangabad,Pomegranate,2016,1256,3536,2280,181.52866242038218
Kamthi,Zendu,2014,2120,4400,2280,107.54716981132076
Satara,Green-Peas,2015,8453,10733,2280,26.972672423991483
Khamgaon,Black Gram,2016,7425,9703,2278,30.68013468013468
Kolhapur,Cucumber,2015,875,3153,2278,260.34285714285716
Khed,Cluster Bean,2016,2378,4656,2278,95.79478553406224
Ahmednagar,Ladies Finger,2016,1444,3722,2278,157.7562326869806
Kolhapur-Laxmipuri,Gram,2015,5352,7629,2277,42.544843049327355
Aurangabad,Mango,2015,1756,4033,2277,129.66970387243737
Chikhali,Black Gram,2016,7023,9300,2277,32.42204186245194
Junnar-Otur,Maize(Corn.),2016,1556,3833,2277,146.33676092544988
Pandharpur,Brinjal,2016,490,2767,2277,464.6938775510204
Pune-Manjri,Methi (Bhaji),2014,1376,3653,2277,165.4796511627907
Akola,Pigeon Pea (Tur),2015,8694,10971,2277,26.19047619047619
Daryapur,Green Gram,2015,6543,8819,2276,34.78526669723369
Osmanabad,Green Chilli,2015,1513,3788,2275,150.36351619299404
Ahmednagar,Green Chilli,2016,2025,4300,2275,112.34567901234568
Solapur,Bitter Gourd,2015,1769,4043,2274,128.5472018089316
Lasalgaon,Onion,2015,2342,4616,2274,97.09649871904355
Mangalwedha,Bitter Gourd,2015,1033,3307,2274,220.135527589545
Kamthi,Cucumber,2014,2411,4684,2273,94.27623392783077
Kolhapur,Cucumber,2016,755,3028,2273,301.05960264900665
Nandgaon Khandeshwar,Pigeon Pea (Tur),2015,7169,9441,2272,31.692007253452363
Mumbai,Rice(Paddy-Hus),2015,4473,6744,2271,50.77129443326626
Nashik,Capsicum,2014,2408,4679,2271,94.31063122923588
Kolhapur,Cluster Bean,2016,2216,4487,2271,102.48194945848375
Solapur,Bitter Gourd,2014,1204,3474,2270,188.53820598006644
Sangli-Phale Bhajipalam,BOR,2016,2306,4576,2270,98.438855160451
Mumbai,Rice(Paddy-Hus),2015,4143,6412,2269,54.76707699734492
Dhule,Ground Nut Pods (Dry),2015,3215,5484,2269,70.57542768273717
Solapur,Ridge Gourd,2015,708,2977,2269,320.48022598870057
Malkapur,Pigeon Pea (Tur),2015,5037,7305,2268,45.02680166765932
Osmanabad,Lemon,2015,1233,3500,2267,183.86050283860502
Lasalgaon-Vinchur,Soybean,2015,1520,3787,2267,149.14473684210526
Indapur-Bhigwan,Sesamum,2015,6200,8467,2267,36.564516129032256
Junnar-Otur,Cluster Bean,2016,1433,3700,2267,158.19958129797627
Jalna,Green Gram,2016,4412,6678,2266,51.359927470534906
Nashik,Coriander  ,2016,2267,4533,2266,99.9558888398765
Vasai,Rice(Paddy-Hus),2015,1881,4147,2266,120.46783625730994
Aurangabad,Grapes,2016,2735,5000,2265,82.81535648994516
Pune,Ladies Finger,2016,1313,3578,2265,172.50571210967252
Jalgaon,Coriander  ,2016,2368,4632,2264,95.60810810810811
Mumbai,Fenugreek,2015,8589,10853,2264,26.359296774944696
Kamthi,Mint,2014,2789,5053,2264,81.1760487629975
Sangamner,Onion,2015,625,2888,2263,362.08
Anajngaon Surji,Chillies(Red),2016,8375,10638,2263,27.02089552238806
Kalmeshwar,Cotton,2016,4072,6335,2263,55.57465618860511
Solapur,Onion,2015,120,2382,2262,1885.0
Ambejogai,Black Gram,2015,6588,8850,2262,34.3351548269581
Pune,Ghevda,2014,2190,4452,2262,103.28767123287672
Nashik,Mosambi,2016,1591,3853,2262,142.1747328724073
Nashik,Ghevda,2016,6597,8858,2261,34.27315446415037
Vasai,RICE(PADDY-HUS),2016,2098,4359,2261,107.76930409914203
Mumbai,Green Peas (Dry),2014,3231,5492,2261,69.97833488084184
Dudhani,Green Gram,2015,4350,6610,2260,51.95402298850575
Chopda,Green Gram,2014,4511,6771,2260,50.09975615162935
Sangali,Green Gram,2015,6200,8460,2260,36.45161290322581
Jalgaon,Mango,2015,2253,4512,2259,100.26631158455393
Ahmednagar,Cabbage,2016,688,2946,2258,328.19767441860466
Daryapur,Green Gram,2015,6018,8274,2256,37.48753738783649
Jalna,Green Gram,2014,4879,7134,2255,46.21848739495798
Kamthi,Green Chilli,2014,3304,5556,2252,68.15980629539952
Solapur,Cucumber,2016,380,2632,2252,592.6315789473684
Mehkar,Gram,2014,1992,4244,2252,113.05220883534136
Jalna,Gram,2016,7290,9541,2251,30.877914951989027
Indapur,Green Gram,2015,6200,8451,2251,36.306451612903224
Manchar,Walvad,2014,1500,3750,2250,150.0
Vasai,Rice(Paddy-Hus),2015,1536,3786,2250,146.484375
Khed,Farshi,2016,5755,8005,2250,39.096437880104254
Ratanagari,Green-Peas,2016,3500,5750,2250,64.28571428571429
Rahuri,GUAVA,2016,250,2500,2250,900.0
Karad,Jaggery,2015,2300,4550,2250,97.82608695652173
Indapur-Bhigwan,Black Gram,2016,4250,6500,2250,52.94117647058823
Kolhapur,Cucumber,2015,667,2917,2250,337.3313343328336
Satara,Garlic,2014,2250,4500,2250,100.0
Pune,Turmeric,2016,12821,15071,2250,17.54933312534124
Ahmednagar,Onion,2014,100,2350,2250,2250.0
Kada,BLACK GRAM,2016,5100,7350,2250,44.11764705882353
Sangali,Coriander (Dry),2014,9250,11500,2250,24.324324324324323
Barshi,Pomegranate,2016,2750,5000,2250,81.81818181818181
Sangali,Coriander (Dry),2014,9000,11250,2250,25.0
Pune-Manjri,Cluster Bean,2016,6500,8750,2250,34.61538461538461
Akluj,Garlic,2014,3750,6000,2250,60.0
Shirpur,Chillies(Red),2014,6750,9000,2250,33.333333333333336
Chandrapur,Mosambi,2016,3083,5333,2250,72.98086279597794
Jalgaon,Apple,2015,4750,7000,2250,47.36842105263158
Anajngaon Surji,Chillies(Red),2015,9000,11250,2250,25.0
Pune-Manjri,Raddish,2015,2000,4250,2250,112.5
Risod,Pigeon Pea (Tur),2015,7435,9685,2250,30.26227303295225
Jalgaon,Apple,2014,5500,7750,2250,40.90909090909091
Jalgaon,Coriander  ,2016,2350,4600,2250,95.74468085106383
Mumbai,Betelnuts,2015,31875,34125,2250,7.0588235294117645
Vadgaon Peth,Cluster Bean,2015,1500,3750,2250,150.0
Anajngaon Surji,Chillies(Red),2015,9000,11250,2250,25.0
Kamthi,Bitter Gourd,2015,2750,5000,2250,81.81818181818181
Akot,Thymol/Lovage,2016,13000,15250,2250,17.307692307692307
Amarawati,Pomegranate,2015,2500,4750,2250,90.0
Manwat,Pigeon Pea (Tur),2015,7533,9782,2249,29.855303332005843
Nagpur,Lemon,2016,3577,5826,2249,62.87391668996366
Aurangabad,Pomegranate,2016,1504,3752,2248,149.46808510638297
Pune,Green-Peas,2015,3305,5553,2248,68.01815431164901
Pune-Manjri,Cluster Bean,2016,4552,6800,2248,49.384885764499124
Amarawati,Black Gram,2015,7069,9316,2247,31.78667421134531
Nashik,Methi (Bhaji),2014,1036,3282,2246,216.7953667953668
Solapur,Ridge Gourd,2015,805,3050,2245,278.88198757763973
Nashik,Wal Papdi,2016,4156,6399,2243,53.97016361886429
Junnar-Otur,Green-Peas,2016,2417,4660,2243,92.80099296648739
Nashik,Coriander  ,2016,682,2925,2243,328.8856304985337
Nashik,Capsicum,2015,2268,4511,2243,98.89770723104057
Indapur,Onion,2015,175,2417,2242,1281.142857142857
Pune,SHEVGA,2016,3540,5780,2240,63.27683615819209
Pune-Manjri,Ghevda,2014,1500,3740,2240,149.33333333333334
Aurangabad,Custard Apple,2014,1430,3670,2240,156.64335664335664
Kolhapur,Shevga,2015,1746,3986,2240,128.29324169530355
Dhule,Ground Nut Pods (Dry),2015,3054,5294,2240,73.3464309102816
Ahmednagar,LADIES FINGER,2016,900,3140,2240,248.88888888888889
Manchar,Coriander  ,2015,543,2783,2240,412.5230202578269
Sinner,Onion,2015,402,2641,2239,556.9651741293533
Pune,Cluster Bean,2015,1928,4167,2239,116.13070539419087
Sangli-Phale Bhajipalam,Orange,2016,1036,3273,2237,215.9266409266409
Pune,Ginger (Fresh),2015,1486,3723,2237,150.53835800807536
Sangli-Phale Bhajipalam,Custard Apple,2015,338,2575,2237,661.8343195266273
Pune-Manjri,Ridge Gourd,2015,3461,5697,2236,64.60560531638255
Mumbai,Cowpea,2014,4732,6968,2236,47.252747252747255
Pune,Dhemse,2016,1200,3436,2236,186.33333333333334
Mumbai,Ladies Finger,2014,1460,3696,2236,153.15068493150685
Pandharpur,Green Chilli,2015,1578,3813,2235,141.63498098859316
Manchar,Cluster Bean,2016,2034,4269,2235,109.88200589970502
Mumbai,Cowpea,2016,4757,6991,2234,46.96237124237965
Nagpur,Grapes,2016,2462,4696,2234,90.73923639317628
Manchar,Ground Nut Pods (Dry),2016,3456,5690,2234,64.64120370370371
Mehkar,Pigeon Pea (Tur),2015,7700,9934,2234,29.01298701298701
Shrigonda,BLACK GRAM,2016,4700,6933,2233,47.51063829787234
Osmanabad,Bitter Gourd,2016,1961,4194,2233,113.87047424783273
Jalgaon,Custard Apple,2015,2850,5083,2233,78.35087719298245
Rahuri,Brinjal,2016,500,2733,2233,446.6
Pune-Manjri,Ladies Finger,2015,3750,5983,2233,59.54666666666667
Pune,LADIES FINGER,2016,1388,3620,2232,160.80691642651297
Vasai,Rice(Paddy-Hus),2016,2096,4328,2232,106.4885496183206
Solapur,Cucumber,2014,506,2738,2232,441.10671936758894
Dondaicha-Sindkheda,Gram,2016,7433,9664,2231,30.01479886990448
Mumbai,Cowpea,2016,5165,7396,2231,43.1945788964182
Kolhapur,Cluster Bean,2016,1452,3683,2231,153.65013774104682
Chandrapur,Mango,2016,1423,3654,2231,156.7814476458187
Shirpur,Green Gram,2014,5471,7702,2231,40.77865106927435
Sakri,Ground Nut Pods (Dry),2016,4000,6230,2230,55.75
Mangalwedha,Brinjal,2015,404,2633,2229,551.7326732673267
Sangli-Phale Bhajipalam,Custard Apple,2016,1000,3229,2229,222.9
Karad,Apple,2016,6729,8958,2229,33.12527864467231
Dondaicha,Gram,2016,3869,6097,2228,57.585939519255625
Sakri,Ground Nut Pods (Dry),2014,2286,4514,2228,97.46281714785651
Ahmednagar,Cluster Bean,2015,3682,5909,2227,60.483432916892994
Kalamb (Os),Gram,2016,6843,9069,2226,32.52959228408593
Pune,Shevga,2014,3850,6075,2225,57.79220779220779
Khamgaon,Chillies(Red),2016,7250,9475,2225,30.689655172413794
Pune,Green Chilli,2016,2083,4308,2225,106.81709073451752
Kamthi,Chavli (Shenga ),2014,1776,4000,2224,125.22522522522523
Nashik,Kanda Pat,2016,2790,5013,2223,79.6774193548387
Mangalwedha,Cucumber,2015,481,2704,2223,462.1621621621622
Pune,Brinjal,2015,1327,3550,2223,167.52072343632253
Nashik,Wal Papdi,2016,5696,7919,2223,39.02738764044944
Akluj,Bitter Gourd,2016,3218,5441,2223,69.08017402113114
Pimpalgaon (B)-Saykheda,Onion,2015,2002,4225,2223,111.03896103896103
Sangli-Phale Bhajipalam,Pineapple,2016,479,2701,2222,463.8830897703549
Narkhed,Orange,2014,8000,10222,2222,27.775
Nashik,Brinjal,2015,2713,4934,2221,81.8650939918909
Baramati,Onion,2015,700,2921,2221,317.2857142857143
Sangrampur,Pigeon Pea (Tur),2015,4329,6550,2221,51.305151305151306
Akot,Black Gram,2015,8915,11136,2221,24.91306786315199
Pune-Moshi,Bitter Gourd,2016,4262,6482,2220,52.088221492257155
Junnar,Onion,2015,3200,5420,2220,69.375
Kolhapur-Laxmipuri,Sorgum(Jawar),2014,1625,3844,2219,136.55384615384617
Solapur,Custard Apple,2015,733,2952,2219,302.72851296043655
Vasai,Onion,2015,3273,5491,2218,67.76657500763825
Solapur,Bitter Gourd,2015,1158,3376,2218,191.53713298791018
Mumbai,Garlic,2015,5673,7891,2218,39.09747928785475
Junnar (Narayangaon),Coriander  ,2016,884,3101,2217,250.79185520361992
Pandharpur,Brinjal,2016,500,2717,2217,443.4
Pune-Manjri,Brinjal,2014,2615,4831,2216,84.74187380497132
Khamgaon,Black Gram,2015,7027,9243,2216,31.535505905791947
Balapur,Pigeon Pea (Tur),2015,8117,10333,2216,27.30072686953308
Kurdwadi,Onion,2015,273,2489,2216,811.7216117216117
Karad,Pomegranate,2014,2571,4786,2215,86.15324776351615
Pune,Mango(Raw),2016,1962,4177,2215,112.89500509683995
Pathari,Soybean,2016,1504,3719,2215,147.27393617021278
Pune,Green Peas (Dry),2015,2595,4810,2215,85.35645472061657
Kolhapur-Malkapur,Squash Gourd,2016,1071,3286,2215,206.81605975723622
Aurangabad,Garlic,2015,3729,5943,2214,59.372485921158486
Pune,Double Bee,2016,2250,4464,2214,98.4
Vasai,Rice(Paddy-Hus),2015,1927,4141,2214,114.8936170212766
Pune-Manjri,Green-Peas,2015,2186,4400,2214,101.28087831655992
Jalgaon,Custard Apple,2014,3159,5373,2214,70.08547008547009
Dudhani,Black Gram,2016,5635,7849,2214,39.29015084294588
Kolhapur,Cucumber,2016,737,2950,2213,300.2713704206242
Junnar-Otur,Ghevda,2016,2300,4513,2213,96.21739130434783
Rahuri,Brinjal,2016,225,2438,2213,983.5555555555555
Ahmednagar,Lemon,2016,1250,3463,2213,177.04
Pune-Manjri,Ladies Finger,2014,2806,5018,2212,78.83107626514611
Jalgaon,Coriander  ,2016,2871,5083,2212,77.04632532218739
Mangalwedha,Ladies Finger,2015,2420,4632,2212,91.40495867768595
Mangalwedha,Ladies Finger,2015,493,2704,2211,448.47870182555783
Sangali,Green Gram,2016,5784,7995,2211,38.226141078838175
Solapur,Cluster Bean,2016,2825,5036,2211,78.26548672566372
Dudhani,Black Gram,2014,3013,5223,2210,73.34882177231995
Solapur,Brinjal,2016,413,2623,2210,535.1089588377724
Kamthi,Onion,2015,632,2842,2210,349.6835443037975
Jalgaon,Jambhul,2015,3790,6000,2210,58.31134564643799
Pune-Pimpri,Green Chilli,2015,2619,4829,2210,84.38335242458953
Ahmednagar,Flower,2015,1382,3591,2209,159.84081041968162
Ahmednagar,Onion,2015,500,2707,2207,441.4
Mangalwedha,Ladies Finger,2015,567,2774,2207,389.2416225749559
Akola,Black Gram,2016,9869,12075,2206,22.352821967777892
Daryapur,Gram,2016,7411,9617,2206,29.76656321683983
Kolhapur-Laxmipuri,Sorgum(Jawar),2016,1950,4155,2205,113.07692307692308
Ahmednagar,Lemon,2016,1136,3341,2205,194.10211267605635
Dhule,Onion,2015,492,2697,2205,448.1707317073171
Solapur,Garlic,2015,2309,4514,2205,95.49588566478995
Risod,Turmeric,2016,6000,8205,2205,36.75
Osmanabad,Green Chilli,2016,2835,5040,2205,77.77777777777777
Kolhapur,Ladies Finger,2016,887,3091,2204,248.47801578354003
Aurangabad,MOSAMBI,2016,2719,4923,2204,81.05921294593601
Khamgaon,Pigeon Pea (Tur),2015,7189,9393,2204,30.657949645291417
Akole,Onion,2015,611,2814,2203,360.55646481178394
Umarga,Green Gram,2014,5051,7254,2203,43.61512571767967
Kamthi,Bitter Gourd,2014,2589,4789,2200,84.97489378138278
Vadgaon Peth,Green Chilli,2016,3950,6150,2200,55.69620253164557
Washim,Turmeric,2016,6000,8200,2200,36.666666666666664
Nashik,Custard Apple,2016,2200,4400,2200,100.0
Kolhapur-Laxmipuri,Sorgum(Jawar),2014,1700,3900,2200,129.41176470588235
Sangali,Lentil,2014,3800,6000,2200,57.89473684210526
Osmanabad,Ginger (Fresh),2015,2400,4600,2200,91.66666666666667
Indapur-Bhigwan,Sesamum,2015,8800,11000,2200,25.0
Vasai,Rice(Paddy-Hus),2014,1600,3800,2200,137.5
Sangrampur-Varvatbakal,Black Gram,2015,7833,10033,2200,28.086301544746586
Dondaicha,Pigeon Pea (Tur),2015,3100,5300,2200,70.96774193548387
Nashik,Ghevda,2016,4052,6252,2200,54.29417571569595
Hingoli,Turmeric,2015,8500,10700,2200,25.88235294117647
Rahuri,Ground Nut Pods (Dry),2016,3433,5633,2200,64.08389163996505
Junnar-Otur,Chavli (Shenga ),2016,1625,3825,2200,135.3846153846154
Babhulgaon,Gram,2016,5100,7300,2200,43.13725490196079
Jalgaon,Ginger (Fresh),2015,2216,4416,2200,99.27797833935018
Jalna,Black Gram,2016,8800,11000,2200,25.0
Karad,Garlic,2016,8360,10560,2200,26.31578947368421
Kolhapur-Malkapur,Coriander  ,2016,550,2750,2200,400.0
Rahuri-Songaon,Brinjal,2016,600,2800,2200,366.6666666666667
Kamthi,Sweet Potato,2015,2300,4500,2200,95.65217391304348
Jamner-Neri,Black Gram,2015,5567,7767,2200,39.518591701095744
Ahmednagar,Ladies Finger,2015,1300,3500,2200,169.23076923076923
Pune,Wal Papdi,2016,2100,4300,2200,104.76190476190476
Pune-Pimpri,Green Chilli,2015,2600,4800,2200,84.61538461538461
Mumbai,Cowpea,2015,5000,7200,2200,44.0
Rahuri,Tomato,2015,300,2500,2200,733.3333333333334
Pune,Dhemse,2015,1000,3200,2200,220.0
Rahuri,Tomato,2016,467,2667,2200,471.09207708779445
Jalgaon,Lemon,2016,3172,5372,2200,69.35687263556116
Akkolkot,Pigeon Pea (Tur),2015,11001,13200,2199,19.989091900736298
Shrirampur,Onion,2015,633,2831,2198,347.2353870458136
Lasalgaon-Vinchur,Green Gram,2016,3389,5587,2198,64.85688993803483
Pune,Small Gourd,2016,1445,3641,2196,151.97231833910035
Udgir,Black Gram,2016,5392,7587,2195,40.70845697329377
Latur,Black Gram,2016,5764,7957,2193,38.04649548924358
Kalamb (Os),GRAM,2016,5609,7802,2193,39.0978784096987
Jalgaon,Grapes,2016,3007,5200,2193,72.92983039574327
Rahata,Green Chilli,2015,3500,5692,2192,62.628571428571426
Ramtek,Chillies(Red),2016,8083,10275,2192,27.11864406779661
Khalapur(Shil-Phata),Other Pulses,2016,6783,8975,2192,32.31608432846823
Pune,Turmeric,2016,11808,14000,2192,18.56368563685637
Barshi-Vairag,Black Gram,2016,5001,7192,2191,43.81123775244951
Pune,Pavtta,2016,4857,7048,2191,45.110150298538194
Amarawati,Black Gram,2016,6774,8964,2190,32.32949512843224
Kolhapur,Capsicum,2016,1128,3318,2190,194.14893617021278
Lasalgaon,Green Gram,2015,5740,7929,2189,38.13588850174216
Pune-Manjri,Methi (Bhaji),2016,2078,4267,2189,105.34167468719923
Nashik,Capsicum,2015,2356,4545,2189,92.91171477079796
Pune-Pimpri,Green Chilli,2016,4275,6463,2188,51.1812865497076
Kurdwadi-Modnimb,GRAM,2016,5860,8048,2188,37.33788395904437
Pune,Ladies Finger,2016,1177,3364,2187,185.81138487680545
Osmanabad,Shevga,2015,3688,5875,2187,59.300433839479396
Pune-Manjri,Green Chilli,2015,2827,5014,2187,77.36116024053767
Vasai,Rice(Paddy-Hus),2015,1906,4093,2187,114.74291710388248
Sangali,Chillies(Red),2016,13107,15293,2186,16.67811093308919
Nandura,Pigeon Pea (Tur),2015,8831,11015,2184,24.731061034990375
Pimpalgaon Basawant,Onion,2015,2088,4272,2184,104.59770114942529
Pune,Green Chilli,2016,3579,5763,2184,61.02263202011735
Satana,Onion,2015,974,3158,2184,224.2299794661191
Ahmednagar,Lemon,2016,1139,3322,2183,191.6593503072871
Sakri,Ground Nut Pods (Dry),2015,3450,5633,2183,63.27536231884058
Nagpur,Lemon,2016,3850,6032,2182,56.675324675324674
Dhule,Ground Nut Pods (Dry),2016,3519,5701,2182,62.006251776072745
Aurangabad,Grapes,2015,2482,4664,2182,87.9129734085415
Solapur,Cucumber,2015,482,2664,2182,452.6970954356847
Akot,Thymol/Lovage,2016,10910,13090,2180,19.98166819431714
Basmat,Gram,2014,5800,7980,2180,37.58620689655172
Osmanabad,Squash Gourd,2016,1529,3709,2180,142.57684761281882
Osmanabad,Ginger (Fresh),2016,1720,3900,2180,126.74418604651163
Nagpur,Chillies(Red),2015,6000,8180,2180,36.333333333333336
Chandrapur,Jambhul,2016,1205,3385,2180,180.91286307053943
Manchar,Coriander  ,2014,344,2523,2179,633.4302325581396
Khamgaon,Black Gram,2016,5068,7245,2177,42.95580110497237
Jalgaon,Mango,2015,2182,4359,2177,99.77085242896425
Pune,Ghevda,2015,2857,5033,2176,76.16380819040953
Sangli-Phale Bhajipalam,Pineapple,2015,1273,3449,2176,170.93479968578163
Vasai,Rice(Paddy-Hus),2015,1691,3866,2175,128.622117090479
Pune-Manjri,Walvad,2015,1500,3675,2175,145.0
Pune-Manjri,Methi (Bhaji),2014,925,3100,2175,235.13513513513513
Pune,Green Chilli,2016,3261,5435,2174,66.66666666666667
Kamthi,Bitter Gourd,2015,2937,5111,2174,74.02110997616616
Solapur,Onion,2016,108,2282,2174,2012.962962962963
Pune,Ginger (Fresh),2015,1957,4130,2173,111.0373019928462
Ahmednagar,Tomato,2016,521,2693,2172,416.89059500959695
Sangli-Phale Bhajipalam,Custard Apple,2015,640,2812,2172,339.375
Mumbai,Fenugreek,2014,7886,10057,2171,27.5297996449404
Kamthi,Green Chilli,2015,1775,3946,2171,122.30985915492958
Kamthi,Parwar,2014,1829,4000,2171,118.69874248223073
Pune-Manjri,Cluster Bean,2016,3686,5857,2171,58.89853499728703
Kalvan,Onion,2015,677,2848,2171,320.6794682422452
Sangali,Matki,2014,4929,7100,2171,44.04544532359505
Nashik,Methi (Bhaji),2016,2085,4255,2170,104.07673860911271
Dondaicha-Sindkheda,GRAM,2016,7126,9296,2170,30.451866404715126
Mangalwedha,Bitter Gourd,2016,730,2900,2170,297.26027397260276
Ahmednagar,Ladies Finger,2015,1400,3570,2170,155.0
Jalgaon,Coriander  ,2015,2455,4625,2170,88.39103869653768
Chandrapur,Apple,2016,2869,5038,2169,75.60125479261066
Solapur,Brinjal,2015,355,2524,2169,610.9859154929577
Chopda,Sesamum,2015,5225,7394,2169,41.51196172248804
Nagpur,Grapes,2015,2946,5115,2169,73.62525458248473
Malegaon,Matki,2016,4927,7095,2168,44.00243555916379
Daryapur,Black Gram,2016,8980,11148,2168,24.142538975501115
Nashik,Mosambi,2016,1765,3933,2168,122.8328611898017
Mumbai,Cowpea,2016,5164,7332,2168,41.98295894655306
Kamthi,Cluster Bean,2014,2050,4217,2167,105.70731707317073
Lonand,Gram,2016,5500,7667,2167,39.4
Ahmednagar,Ghevda,2015,2583,4750,2167,83.89469608981804
Kolhapur-Laxmipuri,Chillies(Red),2015,13500,15667,2167,16.05185185185185
Pune,Cluster Bean,2015,2452,4619,2167,88.3768352365416
Manchar,CLUSTER BEAN,2016,1000,3167,2167,216.7
Osmanabad,Flower,2016,1833,4000,2167,118.2214948172395
Pune,Wal Bhaji,2016,2000,4167,2167,108.35
Kolhapur-Malkapur,Ladies Finger,2016,1300,3467,2167,166.69230769230768
Pathardi,Onion,2015,400,2567,2167,541.75
Balapur,GRAM,2016,6000,8167,2167,36.11666666666667
Kolhapur-Laxmipuri,Rice(Paddy-Hus),2015,2044,4211,2167,106.01761252446184
Kolhapur,Wal Bhaji,2016,2833,5000,2167,76.49135192375573
Nagpur,Apple,2016,6864,9031,2167,31.57051282051282
Nagpur,Pomegranate,2014,2038,4204,2166,106.28066732090285
Sangali,Pigeon Pea (Tur),2016,7667,9833,2166,28.250945611060388
Nashik,Carrot,2014,3117,5283,2166,69.48989412897016
Jalgaon,Apple,2014,5667,7833,2166,38.2212811011117
Pune,Mango(Raw),2015,3667,5833,2166,59.067357512953365
Kamthi,Bitter Gourd,2015,2042,4208,2166,106.07247796278159
Kolhapur,Cucumber,2016,856,3022,2166,253.0373831775701
Amarawati,Sesamum,2015,8278,10444,2166,26.1657405170331
Aurangabad,Ginger (Fresh),2015,814,2979,2165,265.970515970516
Chandvad,Tomato,2016,1179,3344,2165,183.63019508057675
Pune,Green Peas (Dry),2015,2736,4900,2164,79.09356725146199
Katol,GRAM,2016,6761,8923,2162,31.977518118621507
Ulhasnagar,Other Vegetables,2016,1000,3162,2162,216.2
Chandrapur-Ganjwad,Green Chilli,2016,2165,4326,2161,99.81524249422633
Satara,Green Chilli,2015,2587,4748,2161,83.53304986470816
Sangrampur,Ground Nut Pods (Dry),2016,3311,5472,2161,65.2672908486862
Kamthi,Capsicum,2015,2035,4196,2161,106.19164619164619
Junnar,Onion,2015,1800,3961,2161,120.05555555555556
Solapur,Onion,2015,235,2396,2161,919.5744680851063
Kolhapur,Cluster Bean,2016,2471,4631,2160,87.41400242816674
Kamthi,Kanda Pat,2016,1840,4000,2160,117.3913043478261
Aurangabad,Mosambi,2016,2408,4568,2160,89.70099667774086
Sangali,Matki,2014,5142,7300,2158,41.968105795410345
Kolhapur-Laxmipuri,Sorgum(Jawar),2016,1748,3906,2158,123.45537757437071
Mumbai,Small Gourd,2016,1621,3778,2157,133.06600863664406
Lasalgaon,Gram,2016,5753,7910,2157,37.4934816617417
Jalgaon,Lemon,2016,2086,4243,2157,103.40364333652924
Vadgaon Peth,Brinjal,2016,1557,3714,2157,138.53564547206165
Pune-Manjri,Raddish,2016,2100,4256,2156,102.66666666666667
Kolhapur,Shevga,2016,1811,3967,2156,119.05024848150194
Kolhapur,ORANGE,2016,1598,3753,2155,134.8560700876095
Aurangabad,Mango,2015,1615,3769,2154,133.374613003096
Nagpur,Apple,2015,3354,5508,2154,64.22182468694096
Kamthi,Parwar,2015,1346,3500,2154,160.02971768202082
Mumbai,Green Peas (Dry),2016,3032,5184,2152,70.97625329815304
Kamthi,Ladies Finger,2014,2668,4820,2152,80.65967016491754
Vasai,Rice(Paddy-Hus),2014,1600,3750,2150,134.375
Rahata,Tomato,2016,1073,3223,2150,200.37278657968312
Pune-Manjri,Guava,2015,0,2150,2150,inf
Pune,Ridge Gourd,2016,2800,4950,2150,76.78571428571429
Lasalgaon,GROUND NUT PODS (DRY),2016,2638,4788,2150,81.50113722517058
Ahmednagar,Capsicum,2016,3111,5261,2150,69.10961105753776
Mangalwedha,Ridge Gourd,2016,431,2581,2150,498.8399071925754
Osmanabad,Ginger (Fresh),2016,1900,4050,2150,113.15789473684211
Sangli-Phale Bhajipalam,Mosambi,2015,1000,3150,2150,215.0
Kille Dharur,Pigeon Pea (Tur),2015,7501,9651,2150,28.662844954006133
Osmanabad,Flower,2015,900,3050,2150,238.88888888888889
Mohol,Pigeon Pea (Tur),2015,4000,6150,2150,53.75
Osmanabad,Lemon,2016,2619,4769,2150,82.09240168003055
Kada,Onion,2015,550,2700,2150,390.90909090909093
Pandharpur,Ladies Finger,2014,1950,4100,2150,110.25641025641026
Nashik,Ginger (Fresh),2015,1917,4067,2150,112.15440792905582
Sangrampur-Varvatbakal,Pigeon Pea (Tur),2015,6010,8160,2150,35.77371048252912
Vai,Turmeric,2015,8750,10900,2150,24.571428571428573
Chandrapur-Ganjwad,Garlic,2016,9444,11594,2150,22.765777213045318
Nandurbar,Black Gram,2016,5039,7188,2149,42.64735066481445
Akkolkot,Black Gram,2016,5500,7649,2149,39.07272727272727
Sangli-Phale Bhajipalam,Chikoo,2016,940,3088,2148,228.51063829787233
Pandharpur,Tomato,2015,359,2505,2146,597.7715877437325
Kolhapur-Laxmipuri,Green Peas (Dry),2016,2992,5138,2146,71.72459893048128
Latur,Green Gram,2014,5402,7547,2145,39.707515734912995
Sangali,Matki,2015,5755,7900,2145,37.27193744569939
Pune-Manjri,Ridge Gourd,2015,3895,6040,2145,55.070603337612326
Osmanabad,Bitter Gourd,2015,1556,3700,2144,137.7892030848329
Pune-Pimpri,Turmeric,2016,11143,13286,2143,19.231804720452303
Pune,Squash Gourd,2016,2857,5000,2143,75.00875043752188
Karad,Garlic,2015,3286,5429,2143,65.2160681679854
Amarawati,Black Gram,2016,7183,9325,2142,29.820409299735488
Majalgaon,Pigeon Pea (Tur),2016,5889,8030,2141,36.35591781287145
Aurangabad,Lemon,2016,3363,5504,2141,63.663395777579545
Pune,Cluster Bean,2014,2620,4760,2140,81.6793893129771
Pune-Manjri,Methi (Bhaji),2016,1730,3870,2140,123.69942196531792
Karad,Grapes,2015,2667,4806,2139,80.20247469066366
Nagpur,Grapes,2015,3308,5446,2138,64.63119709794438
Pune,Turmeric,2016,11818,13955,2137,18.082585885936705
Ahmednagar,Brinjal,2015,773,2909,2136,276.32600258732214
Kolhapur,Shevga,2016,1377,3513,2136,155.119825708061
Karad,Grapes,2015,2591,4727,2136,82.43921265920494
Nagpur,Grapes,2015,3008,5144,2136,71.01063829787235
Ausa,GRAM,2016,5464,7599,2135,39.07393850658858
Barshi,Green Chilli,2016,3055,5190,2135,69.88543371522096
Kolhapur,Capsicum,2015,911,3046,2135,234.35784851811198
Kolhapur,Papai,2016,245,2380,2135,871.4285714285714
Aurangabad,Ginger (Fresh),2016,1133,3267,2134,188.3495145631068
Nashik,Ginger (Fresh),2016,3710,5844,2134,57.52021563342318
Osmanabad,Green Chilli,2015,1100,3233,2133,193.9090909090909
Palus,Brinjal,2016,2367,4500,2133,90.11406844106465
Dondaicha-Sindkheda,Matki,2016,4682,6815,2133,45.55745407945322
Nashik,Ghosali(Bhaji),2016,3492,5624,2132,61.05383734249714
Kolhapur-Laxmipuri,Sorgum(Jawar),2015,1681,3813,2132,126.82926829268293
Kolhapur-Laxmipuri,Green Peas (Dry),2016,3811,5943,2132,55.94332196273944
Chandvad,Brinjal,2016,1270,3402,2132,167.8740157480315
Kolhapur,Green Chilli,2016,2598,4730,2132,82.06312548113934
Devala,Gram,2016,5215,7346,2131,40.86289549376798
Shahada,Black Gram,2015,6904,9035,2131,30.86616454229432
Nashik,Pomegranate,2015,446,2577,2131,477.80269058295966
Balapur,Pigeon Pea (Tur),2015,4690,6820,2130,45.41577825159915
Palus,Brinjal,2016,2680,4810,2130,79.4776119402985
Barshi,Tamarind,2016,6938,9068,2130,30.700490054770828
Nanded,Turmeric,2015,6139,8267,2128,34.6636259977195
Lasalgaon-Vinchur,Soybean,2015,1642,3770,2128,129.59805115712547
Vasai,Rice(Paddy-Hus),2015,1947,4075,2128,109.29635336414998
Kolhapur,Brinjal,2016,561,2689,2128,379.32263814616755
Pandharpur,Ladies Finger,2015,815,2942,2127,260.9815950920245
Devala,Gram,2016,5163,7290,2127,41.19697850087159
Katol,Ground Nut Pods (Dry),2015,3058,5184,2126,69.52256376716808
Solapur,Lemon,2015,170,2296,2126,1250.5882352941176
Pandharpur,Chikoo,2014,900,3025,2125,236.11111111111111
Sangali,Pigeon Pea (Tur),2015,5000,7125,2125,42.5
Pandharpur,Chikoo,2015,340,2465,2125,625.0
Pune,Green Peas (Dry),2015,2645,4770,2125,80.34026465028356
Pune,Wal Bhaji,2016,2125,4250,2125,100.0
Purna,Turmeric,2016,5963,8088,2125,35.63642461848063
Pandharpur,Ladies Finger,2015,1100,3225,2125,193.1818181818182
Akole,Gram,2016,5875,8000,2125,36.170212765957444
Pachora,Sesamum,2015,3775,5900,2125,56.29139072847682
Chandrapur-Ganjwad,Garlic,2015,3938,6063,2125,53.961401726764855
Ahmednagar,Ghosali(Bhaji),2015,1500,3625,2125,141.66666666666666
Osmanabad,Green Chilli,2015,2000,4124,2124,106.2
Khed-Chakan,Green Chilli,2016,4138,6262,2124,51.3291445142581
Aurangabad,Mosambi,2015,2281,4404,2123,93.07321350284963
Kolhapur,Cucumber,2015,891,3014,2123,238.2716049382716
Khed,Cabbage,2016,1065,3188,2123,199.34272300469485
Mukhed,Black Gram,2015,9011,11134,2123,23.560093219398514
Kurdwadi-Modnimb,Onion,2015,2231,4354,2123,95.15912147019274
Pune-Manjri,Chavli (Shenga ),2014,975,3096,2121,217.53846153846155
Katol,Ground Nut Pods (Dry),2015,3568,5689,2121,59.44506726457399
Ahmednagar,Bitter Gourd,2016,880,3000,2120,240.9090909090909
Amarawati,Sesamum,2015,8319,10438,2119,25.47181151580719
Chopda,Green Gram,2014,5429,7548,2119,39.031129121385156
Pandharpur,Capsicum,2014,1406,3525,2119,150.7112375533428
Solapur,Cucumber,2016,450,2569,2119,470.8888888888889
Akluj,Garlic,2016,5595,7714,2119,37.87310098302056
Nanded,Turmeric,2015,7120,9239,2119,29.76123595505618
Nashik,Brinjal,2016,3630,5748,2118,58.34710743801653
Kolhapur,Chikoo,2016,595,2713,2118,355.96638655462186
Solapur,Onion,2014,111,2228,2117,1907.2072072072071
Kej,Coriander (Dry),2016,3500,5617,2117,60.48571428571429
Pune,Green-Peas,2015,2875,4992,2117,73.63478260869566
Balapur,Pigeon Pea (Tur),2015,5633,7750,2117,37.58210545002663
Malkapur,Pigeon Pea (Tur),2015,5169,7286,2117,40.95569742696846
Kamthi,Kanda Pat,2014,1516,3632,2116,139.5778364116095
Sangrampur-Varvatbakal,Black Gram,2016,5467,7583,2116,38.704957014816166
Jintur,Black Gram,2016,3956,6072,2116,53.48837209302326
Vasai,Rice(Paddy-Hus),2015,1975,4091,2116,107.13924050632912
Junnar-Otur,Ground Nut Pods (Dry),2016,2167,4283,2116,97.64651592062759
Kolhapur,Green Chilli,2015,1065,3181,2116,198.68544600938966
Sangali,Black Gram,2015,6752,8867,2115,31.32405213270142
Kolhapur-Laxmipuri,Sorgum(Jawar),2015,1720,3835,2115,122.96511627906976
Pune,Green Peas (Dry),2015,3308,5423,2115,63.93591293833132
Nashik,Squash Gourd,2016,4247,6362,2115,49.79985872380504
Aurangabad,Fig,2015,3029,5143,2114,69.79201056454275
Aurangabad,Ginger (Fresh),2015,825,2938,2113,256.1212121212121
Vadgaon Peth,Ridge Gourd,2016,2647,4759,2112,79.7884397431054
Sangali,Black Gram,2015,7553,9665,2112,27.962399046736397
Sengaon,Black Gram,2015,8386,10498,2112,25.18483186262819
Osmanabad,Ridge Gourd,2015,1888,4000,2112,111.86440677966101
Pune,Cluster Bean,2016,2468,4580,2112,85.57536466774717
Jalgaon Jamod-Aasalgaon,Black Gram,2016,4513,6625,2112,46.7981387103922
Kolhapur,Ladies Finger,2016,715,2826,2111,295.24475524475525
Latur,Gram,2016,7599,9710,2111,27.779971048822212
Amarawati,Pomegranate,2016,2250,4361,2111,93.82222222222222
Ahmednagar,Green Chilli,2016,2111,4222,2111,100.0
Anajngaon Surji,Chillies(Red),2016,7510,9620,2110,28.095872170439414
Aurangabad,Green Chilli,2015,2370,4480,2110,89.0295358649789
Murtizapur,BLACK GRAM,2016,5208,7317,2109,40.495391705069125
Pandharpur,Brinjal,2016,500,2609,2109,421.8
Kamthi,Onion,2015,800,2909,2109,263.625
Pune,Small Gourd,2015,1321,3429,2108,159.57607872823618
Majalgaon,Pigeon Pea (Tur),2016,6031,8139,2108,34.95274415519814
Ulhasnagar,Other Vegetables,2016,1975,4083,2108,106.73417721518987
Kolhapur,Shevga,2016,1417,3525,2108,148.7649964714185
Pune,Double Bee,2015,2214,4321,2107,95.16711833785004
Mangalwedha,Green Chilli,2015,2304,4411,2107,91.44965277777777
Jalgaon,Onion,2015,2128,4235,2107,99.01315789473684
Jalgaon,Coriander  ,2016,2635,4742,2107,79.96204933586338
Kalyan,Green-Peas,2015,7113,9219,2106,29.607760438633488
Mumbai,Tamarind,2015,2105,4211,2106,100.04750593824228
Ulhasnagar,Rice(Paddy-Hus),2016,3364,5470,2106,62.60404280618312
Aurangabad,Shevga,2015,3129,5235,2106,67.3058485139022
Solapur,Garlic,2014,2256,4361,2105,93.30673758865248
Vaijapur,Onion,2015,889,2994,2105,236.78290213723284
Manchar,Ground Nut Pods (Dry),2016,2772,4877,2105,75.93795093795094
Solapur,Brinjal,2015,504,2608,2104,417.46031746031747
Karad,Mosambi,2016,4167,6271,2104,50.491960643148545
Mangalwedha,GRAM,2016,6167,8270,2103,34.100859413004706
Kolhapur,Capsicum,2015,1313,3416,2103,160.16755521706017
Mehkar,Pigeon Pea (Tur),2015,7167,9269,2102,29.32886842472443
Dondaicha,Matki,2015,5800,7901,2101,36.224137931034484
Indapur-Bhigwan,Cowpea,2015,4000,6101,2101,52.525
Indapur,Gram,2016,7250,9351,2101,28.979310344827585
Chandrapur-Ganjwad,GARLIC,2016,10292,12392,2100,20.404197434900894
Nashik,Ghevda,2015,2000,4100,2100,105.0
Vadgaon Peth,Brinjal,2016,1650,3750,2100,127.27272727272727
Indapur,BLACK GRAM,2016,4000,6100,2100,52.5
Kolhapur-Laxmipuri,Gr.Nut Kernels,2014,5600,7700,2100,37.5
Jalgaon,Mosambi,2015,1250,3350,2100,168.0
Kolhapur,KANDA PAT,2016,2100,4200,2100,100.0
Akluj,SHEVGA,2016,4170,6270,2100,50.35971223021583
Kalyan,Grapes,2016,4400,6500,2100,47.72727272727273
Kamthi,Parwar,2014,1900,4000,2100,110.52631578947368
Manchar,Cucumber,2016,800,2900,2100,262.5
Ahmednagar,Flower,2015,700,2800,2100,300.0
Kolhapur,Shepu,2015,2800,4900,2100,75.0
Manchar,Brinjal,2014,500,2600,2100,420.0
Pachora,Green Gram,2015,5000,7100,2100,42.0
Amarawati,Onion,2015,3750,5850,2100,56.0
Mangaon(Bhadav),Nachani,2015,1275,3375,2100,164.7058823529412
Nashik,Green Chilli,2015,2133,4233,2100,98.45288326300985
Osmanabad,Flower,2016,1858,3958,2100,113.02475780409041
Rahata,Garlic,2016,8300,10400,2100,25.301204819277107
Kada,Onion,2015,125,2225,2100,1680.0
Kolhapur,Spinach,2015,2100,4200,2100,100.0
Rahuri,Ground Nut Pods (Dry),2016,4000,6100,2100,52.5
Ahmednagar,Ghosali(Bhaji),2015,950,3050,2100,221.05263157894737
Sangli-Phale Bhajipalam,Chikoo,2016,1000,3100,2100,210.0
Chandur Bajar,Pigeon Pea (Tur),2015,8000,10100,2100,26.25
Nashik,Coriander  ,2016,2066,4166,2100,101.6456921587609
Rahuri,Brinjal,2016,550,2650,2100,381.8181818181818
Amarawati,Garlic,2015,2500,4600,2100,84.0
Kolhapur,Shepu,2016,4550,6650,2100,46.15384615384615
Osmanabad,Flower,2016,3350,5450,2100,62.6865671641791
Nashik,Orange,2014,900,3000,2100,233.33333333333334
Pune-Manjri,Coriander  ,2016,300,2400,2100,700.0
Indapur,Chillies(Red),2016,7500,9600,2100,28.0
Latur,Green Gram,2015,5001,7100,2099,41.97160567886423
Sangli-Phale Bhajipalam,Pineapple,2016,208,2306,2098,1008.6538461538462
Aurangabad,Onion,2015,602,2700,2098,348.5049833887043
Beed,Black Gram,2015,7840,9938,2098,26.760204081632654
Lasalgaon-Niphad,GRAM,2016,6407,8505,2098,32.74543468081786
Pune-Manjri,Chavli (Shenga ),2015,489,2586,2097,428.83435582822085
Pimpalgaon Basawant,Tomato,2015,499,2596,2097,420.2404809619238
Kolhapur,Cluster Bean,2016,1017,3113,2096,206.09636184857425
Osmanabad,Lemon,2016,1836,3932,2096,114.16122004357298
Shahada,Green Gram,2015,5877,7973,2096,35.6644546537349
Satana,Ground Nut Pods (Dry),2015,4221,6316,2095,49.63278843875859
Pune,Green Chilli,2015,1935,4030,2095,108.2687338501292
Kolhapur,Mango,2015,1365,3459,2094,153.4065934065934
Ahmednagar,Onion,2015,367,2461,2094,570.5722070844687
Osmanabad,Green Chilli,2016,3128,5222,2094,66.94373401534527
Mumbai,Split Black Gram,2015,13638,15731,2093,15.346825047660948
Kolhapur,Green Chilli,2015,1396,3489,2093,149.92836676217766
Shrirampur,Gram,2016,6546,8638,2092,31.958447907118853
Pune-Moshi,Green Chilli,2016,3733,5825,2092,56.040717921242965
Latur,Green Gram,2015,7154,9246,2092,29.242381884260553
Dudhani,Green Gram,2014,5195,7287,2092,40.269489894128974
Sangali,Matki,2015,5545,7636,2091,37.70964833183048
Lonar,Black Gram,2016,7140,9231,2091,29.285714285714285
Nira-Saswad,Gram,2016,4525,6615,2090,46.187845303867405
Malkapur,Green Gram,2015,5225,7314,2089,39.98086124401914
Phaltan,Onion,2015,800,2888,2088,261.0
Mumbai,Mosambi,2015,1000,3088,2088,208.8
Nagpur,Grapes,2015,3981,6069,2088,52.44913338357197
Ahmednagar,Onion,2015,130,2218,2088,1606.1538461538462
Taloda,Gram,2015,2923,5011,2088,71.43345877523093
Solapur,CUCUMBER,2016,406,2494,2088,514.2857142857143
Manmad,Green Gram,2014,5851,7938,2087,35.66911639036062
Mumbai,Green-Peas,2015,5870,7957,2087,35.55366269165247
Sangrampur-Varvatbakal,Gram,2016,7421,9507,2086,28.10941921573912
Mumbai,Green Peas (Dry),2015,3014,5100,2086,69.21035169210352
Lasur Station,Gram,2016,7052,9138,2086,29.580260918888257
Babhulgaon,Pigeon Pea (Tur),2015,7115,9201,2086,29.318341531974703
Lasur Station,Pigeon Pea (Tur),2014,3951,6036,2085,52.771450265755504
Jalgaon,Mango,2016,2823,4908,2085,73.85759829968119
Vadgaon Peth,BRINJAL,2016,926,3011,2085,225.16198704103672
Akluj,Onion,2015,1336,3421,2085,156.062874251497
Kamthi,Amla,2014,1129,3214,2085,184.6767050487157
Karad,Mosambi,2015,3083,5167,2084,67.5964969185858
Majalgaon,Pigeon Pea (Tur),2015,6362,8446,2084,32.75699465576863
Kalyan,Matki,2016,6033,8117,2084,34.54334493618432
Nashik,Mosambi,2015,2067,4150,2083,100.774068698597
Indapur-Bhigwan,Gram,2016,5625,7708,2083,37.03111111111111
Khamgaon,Chillies(Red),2014,6850,8933,2083,30.40875912408759
Kolhapur,Naspatti ,2015,9167,11250,2083,22.72281007963347
Nashik,Wal Papdi,2016,4488,6571,2083,46.4126559714795
Kamthi,Ginger (Fresh),2015,2250,4333,2083,92.57777777777778
Pune-Manjri,Custard Apple,2015,1428,3511,2083,145.86834733893556
Satara,Garlic,2016,3500,5583,2083,59.51428571428571
Mumbai,Orange,2015,1000,3081,2081,208.1
Mangalwedha,Bitter Gourd,2015,2886,4967,2081,72.1067221067221
Malegaon,Green Gram,2015,6195,8276,2081,33.59160613397901
Nashik,Bitter Gourd,2016,3254,5334,2080,63.921327596803934
Kamthi,Custard Apple,2015,2320,4400,2080,89.65517241379311
Nashik,Ghosali(Bhaji),2016,5420,7500,2080,38.37638376383764
Akole,Onion,2015,294,2374,2080,707.4829931972789
Akot,Pigeon Pea (Tur),2015,6815,8894,2079,30.506236243580336
Kolhapur,Math (Bhaji),2016,1925,4003,2078,107.94805194805195
Pune-Manjri,Shepu,2016,1911,3989,2078,108.7388801674516
Rahuri,Onion,2015,206,2283,2077,1008.252427184466
Mumbai,Fenugreek,2014,8108,10185,2077,25.61667488899852
Nandgaon,Gram,2016,2001,4077,2076,103.74812593703149
Kalamb (Os),Black Gram,2015,9213,11289,2076,22.53337675024422
Chalisgaon,Sunflower,2015,3100,5176,2076,66.96774193548387
Mangalwedha,Cucumber,2016,616,2692,2076,337.012987012987
Kamthi,Orange,2015,925,3000,2075,224.32432432432432
Pune,Ladies Finger,2015,1078,3152,2074,192.39332096474953
Pune,Green Peas (Dry),2014,2833,4907,2074,73.20861277797388
Jamner-Neri,Green Gram,2015,5860,7933,2073,35.37542662116041
Solapur,Lemon,2015,208,2280,2072,996.1538461538462
Kej,BLACK GRAM,2016,4259,6331,2072,48.64991782108476
Pune-Manjri,Brinjal,2016,2935,5006,2071,70.56218057921636
Umarga,GRAM,2016,6002,8073,2071,34.50516494501833
Chandrapur-Ganjwad,Garlic,2016,8905,10976,2071,23.256597417181357
Kamthi,Orange,2014,1576,3647,2071,131.40862944162436
Mehkar,Soybean,2015,3166,5236,2070,65.38218572331017
Pune-Manjri,Ridge Gourd,2015,3188,5258,2070,64.93099121706399
Mangrulpeer,Black Gram,2015,8571,10640,2069,24.13954031034885
Mumbai,Garlic,2015,5085,7154,2069,40.68829891838742
Karanja,Sesamum,2014,6425,8494,2069,32.202334630350194
Pandharpur,Green Chilli,2014,1423,3492,2069,145.39704848910753
Pune-Manjri,Brinjal,2014,1837,3905,2068,112.57485029940119
Pune-Manjri,Ridge Gourd,2015,3355,5423,2068,61.63934426229508
Jalgaon,Brinjal,2016,905,2973,2068,228.50828729281767
Osmanabad,Ladies Finger,2015,933,3000,2067,221.5434083601286
Pandharpur,Ladies Finger,2015,1933,4000,2067,106.93222969477496
Mangalwedha,Bitter Gourd,2015,1215,3281,2066,170.0411522633745
Shegaon,Black Gram,2015,8828,10894,2066,23.40280924331672
Pune-Manjri,CLUSTER BEAN,2016,3821,5886,2065,54.04344412457472
Sangali,TURMERIC,2016,7064,9129,2065,29.23272933182333
Pune,Squash Gourd,2016,2652,4717,2065,77.8657616892911
Kolhapur,Shevga,2016,2169,4234,2065,95.20516366989396
Nagpur,Ginger (Fresh),2015,2783,4848,2065,74.200503054258
Pune-Manjri,Green Chilli,2015,2200,4263,2063,93.77272727272727
Kamthi,Onion,2015,1764,3827,2063,116.9501133786848
Ratanagari,Green Chilli,2016,3188,5250,2062,64.68005018820577
Mumbai,Chillies(Red),2015,9092,11154,2062,22.67927848658161
Pune,Green Peas (Dry),2015,2846,4908,2062,72.4525650035137
Nashik,Ladies Finger,2014,2030,4092,2062,101.57635467980296
Aurangabad,Ginger (Fresh),2014,1813,3875,2062,113.73414230557087
Pune,Dhemse,2016,1308,3369,2061,157.56880733944953
Malegaon,Gram,2015,3100,5160,2060,66.45161290322581
Amarawati,Apple,2015,3780,5840,2060,54.4973544973545
Morshi,CHILLIES(RED),2016,7240,9300,2060,28.45303867403315
Pandharpur,Green Chilli,2015,1095,3155,2060,188.12785388127853
Solapur,Brinjal,2015,436,2496,2060,472.4770642201835
Kamthi,Cluster Bean,2015,1040,3100,2060,198.07692307692307
Pune,Green Peas (Dry),2015,2586,4645,2059,79.62103634957464
Jintur,Turmeric,2015,6161,8220,2059,33.41989936698588
Malkapur,Pigeon Pea (Tur),2015,4847,6906,2059,42.47988446461729
Karad,Mango,2015,5235,7294,2059,39.33142311365807
Latur,Black Gram,2015,7287,9346,2059,28.255797996432
Pune-Manjri,Cluster Bean,2014,4676,6735,2059,44.033361847733104
Pune-Manjri,Walvad,2016,3442,5500,2058,59.79081929110982
Narkhed,Orange,2014,9100,11158,2058,22.615384615384617
Pune-Manjri,Methi (Bhaji),2015,1243,3300,2057,165.4867256637168
Pune-Manjri,Methi (Bhaji),2016,1200,3257,2057,171.41666666666666
Amarawati,Sesamum,2015,8475,10531,2056,24.25958702064897
Aurangabad,Ginger (Fresh),2015,1011,3067,2056,203.3630069238378
Paithan,Mosambi,2016,1173,3229,2056,175.2770673486786
Ahmednagar,Bitter Gourd,2015,1778,3833,2055,115.5793025871766
Pandharpur,Capsicum,2014,778,2833,2055,264.1388174807198
Karad,Apple,2015,7067,9122,2055,29.07881703693222
Sangali,Chillies(Red),2015,8213,10267,2054,25.00913186411786
Dondaicha,Ground Nut Pods (Dry),2015,3125,5179,2054,65.728
Pandharpur,Green Chilli,2015,2027,4081,2054,101.33201776023681
Aurangabad,Grapes,2016,2921,4975,2054,70.3183841150291
Pune,Shevga,2014,2446,4500,2054,83.9738348323794
Solapur,Ridge Gourd,2015,795,2848,2053,258.23899371069183
Udgir,Tamarind,2015,4369,6422,2053,46.99015793087663
Pune-Pimpri,Green Chilli,2015,2919,4971,2052,70.29804727646454
Pune,Carrot,2014,708,2760,2052,289.8305084745763
Sangola,Pomegranate,2015,1730,3781,2051,118.55491329479769
Hinganghat,Pigeon Pea (Tur),2015,7281,9332,2051,28.169207526438676
Devala,Ground Nut Pods (Dry),2015,2100,4150,2050,97.61904761904762
Pandharpur,Ghevda,2014,1100,3150,2050,186.36363636363637
Pune-Moshi,Chavli (Shenga ),2016,1950,4000,2050,105.12820512820512
Kalyan,GARLIC,2016,7967,10017,2050,25.731140956445337
Nashik,Papai,2016,700,2750,2050,292.85714285714283
Sangrampur,Black Gram,2016,4700,6750,2050,43.61702127659574
Kannad,Onion,2015,983,3033,2050,208.54526958290947
Manchar,LADIES FINGER,2016,1100,3150,2050,186.36363636363637
Kamthi,Green-Peas,2015,2350,4400,2050,87.23404255319149
Devala,Ground Nut Pods (Dry),2015,3505,5555,2050,58.48787446504993
Sangrampur-Varvatbakal,Black Gram,2015,6500,8550,2050,31.53846153846154
Pune,Turmeric,2016,12170,14220,2050,16.84470008216927
Nagpur,Pomegranate,2015,1950,4000,2050,105.12820512820512
Manchar,Onion,2015,1438,3486,2048,142.42002781641168
Katol,Ground Nut Pods (Dry),2016,3160,5207,2047,64.77848101265823
Satana,Onion,2015,1690,3737,2047,121.12426035502959
Kopargaon,Gram,2016,6667,8714,2047,30.703464826758662
Kopargaon,Onion,2015,711,2758,2047,287.9043600562588
Manchar,Ghevda,2014,2253,4300,2047,90.8566355969818
Pune,Green-Peas,2015,3643,5690,2047,56.189953335163324
Hinganghat,Gram,2016,5491,7537,2046,37.26097250045529
Aurangabad,Custard Apple,2015,1404,3450,2046,145.72649572649573
Aurangabad,Pomegranate,2016,1258,3304,2046,162.63910969793324
Ahmednagar,Flower,2015,636,2682,2046,321.6981132075472
Lasalgaon,Gram,2015,3403,5449,2046,60.12342051131355
Solapur,Cluster Bean,2016,955,3000,2045,214.13612565445027
Umared,Pigeon Pea (Tur),2016,6217,8262,2045,32.89367862313013
Mangalwedha,Cucumber,2014,968,3012,2044,211.15702479338842
Ahmednagar,Onion,2014,145,2189,2044,1409.655172413793
Kamthi,Cluster Bean,2015,2567,4611,2044,79.62602259446825
Jamkhed,Onion,2015,350,2394,2044,584.0
Nashik,Methi (Bhaji),2016,2763,4807,2044,73.97756062251176
Lasalgaon,Ground Nut Pods (Dry),2016,2396,4439,2043,85.26711185308848
Pune,Ginger (Fresh),2015,1316,3358,2042,155.16717325227964
Aurangabad,Jambhul,2016,5750,7792,2042,35.51304347826087
Pune,Ghevda,2015,2553,4595,2042,79.9843321582452
Pandharpur,Capsicum,2015,1014,3055,2041,201.28205128205127
Rahuri-Vambori,Gram,2016,6933,8974,2041,29.438915332467907
Pandharpur,Brinjal,2015,500,2540,2040,408.0
Nanded,Turmeric,2015,6844,8884,2040,29.807130333138517
Nashik,Bitter Gourd,2015,2129,4169,2040,95.81963363081259
Solapur,CHIKOO,2016,800,2840,2040,255.0
Sangali,Turmeric,2016,6769,8809,2040,30.13739104742207
Varora,Pigeon Pea (Tur),2015,6300,8340,2040,32.38095238095238
Mumbai,Apple,2014,3820,5860,2040,53.403141361256544
Sangali,Black Gram,2015,4860,6900,2040,41.97530864197531
Osmanabad,Shevga,2016,3400,5440,2040,60.0
Kolhapur,Cucumber,2015,761,2800,2039,267.9369250985545
Jamkhed,Onion,2015,228,2267,2039,894.2982456140351
Mumbai-Fruit Market,Pomegranate,2016,3215,5254,2039,63.421461897356146
Karad,Pomegranate,2015,2538,4577,2039,80.33884948778565
Junnar-Otur,Ladies Finger,2016,1619,3658,2039,125.9419394688079
Karmala,Gram,2016,4550,6588,2038,44.79120879120879
Rahata,Onion,2015,831,2869,2038,245.24669073405536
Sangali,Turmeric,2016,7345,9383,2038,27.746766507828454
Kamthi,Lemon,2015,1713,3750,2037,118.91418563922942
Kalyan,Garlic,2016,4263,6300,2037,47.783251231527096
Yeola,Gram,2016,4141,6178,2037,49.19101666264187
Manchar,Coriander  ,2014,382,2418,2036,532.9842931937172
Nandgaon,Green Gram,2015,5892,7928,2036,34.55532926001358
Pune,Tomato,2016,1232,3268,2036,165.25974025974025
Karad,Apple,2015,3950,5986,2036,51.54430379746835
Mumbai-Onion And Potato Mkt,Garlic,2016,3255,5291,2036,62.54992319508449
Ahmedpur,Gram,2015,3493,5529,2036,58.28800458058975
Pune,Mango(Raw),2016,1084,3120,2036,187.8228782287823
Mumbai,Cowpea,2014,4816,6852,2036,42.27574750830565
Osmanabad,Green Chilli,2015,2155,4191,2036,94.47795823665894
Pune-Moshi,Ghevda,2016,4100,6135,2035,49.63414634146341
Junnar-Otur,Farshi,2016,1375,3410,2035,148.0
Nashik,Ghevda,2016,6262,8297,2035,32.49760459916959
Chandur Bajar,Pigeon Pea (Tur),2015,6960,8995,2035,29.238505747126435
Jalgaon,Lemon,2016,2974,5009,2035,68.42636180228648
Sangrampur-Varvatbakal,BLACK GRAM,2016,4389,6423,2034,46.34313055365687
Pune-Manjri,Cluster Bean,2016,3983,6017,2034,51.06703489831785
Chandrapur-Ganjwad,Garlic,2015,5400,7433,2033,37.648148148148145
Sangli-Phale Bhajipalam,Chikoo,2016,1067,3100,2033,190.53420805998127
Rahuri,Bitter Gourd,2015,2267,4300,2033,89.67798853109836
Aurangabad,Mosambi,2016,1617,3650,2033,125.72665429808286
Dhule,Ground Nut Pods (Dry),2015,2780,4813,2033,73.12949640287769
Kolhapur-Laxmipuri,Sorgum(Jawar),2015,1712,3744,2032,118.69158878504673
Khamgaon,Pigeon Pea (Tur),2015,5388,7419,2031,37.69487750556793
Mehkar,GRAM,2016,6598,8629,2031,30.782055168232798
Kamthi,Wal Bhaji,2014,1719,3750,2031,118.15008726003491
Osmanabad,Brinjal,2015,970,3000,2030,209.27835051546393
Kamthi,Green Chilli,2015,2585,4615,2030,78.52998065764024
Umared,Pigeon Pea (Tur),2016,6729,8759,2030,30.167929855847824
Bhivandi,Other Vegetables,2016,1630,3660,2030,124.5398773006135
Mangalwedha,Brinjal,2015,285,2315,2030,712.280701754386
Sangli-Phale Bhajipalam,Chikoo,2016,1083,3113,2030,187.44228993536473
Kolhapur,Brinjal,2015,472,2500,2028,429.66101694915255
Pune,Green Chilli,2014,2243,4271,2028,90.41462327240303
Pune,Brinjal,2014,1300,3328,2028,156.0
Nanded,Turmeric,2015,8557,10585,2028,23.69989482295197
Nashik,Coriander  ,2016,802,2829,2027,252.7431421446384
Solapur,Chikoo,2014,615,2642,2027,329.5934959349593
Kolhapur,Capsicum,2016,1860,3887,2027,108.97849462365592
Aurangabad,Grapes,2016,3104,5130,2026,65.27061855670104
Ahmednagar,Capsicum,2016,2842,4868,2026,71.2878254750176
Nashik,Mosambi,2016,1538,3563,2025,131.66449934980494
Vasai,Onion,2015,2796,4821,2025,72.42489270386267
Jalgaon,Ginger (Fresh),2015,2185,4210,2025,92.67734553775743
Pune,Shevga,2015,2625,4650,2025,77.14285714285714
Umared,Rice(Paddy-Hus),2014,2000,4025,2025,101.25
Rahuri,Chikoo,2015,925,2950,2025,218.9189189189189
Malkapur,Green Gram,2015,5750,7775,2025,35.21739130434783
Akhadabalapur,Pigeon Pea (Tur),2015,5800,7825,2025,34.91379310344828
Ahmednagar,Flower,2016,471,2495,2024,429.723991507431
Latur,Black Gram,2015,5532,7556,2024,36.58712942877802
Sangli-Phale Bhajipalam,Pineapple,2016,208,2231,2023,972.5961538461538
Chandur Bajar,Pigeon Pea (Tur),2015,5475,7498,2023,36.949771689497716
Kamthi,Bitter Gourd,2014,2644,4667,2023,76.51285930408471
Karad,Grapes,2016,5591,7614,2023,36.18315149347165
Mumbai,Cowpea,2015,5000,7023,2023,40.46
Akole,Onion,2014,200,2222,2022,1011.0
Pune-Manjri,Ladies Finger,2015,2674,4696,2022,75.6170531039641
Rahuri,Onion,2014,167,2189,2022,1210.7784431137725
Mangalwedha,Ridge Gourd,2014,2208,4229,2021,91.53079710144928
Shirpur,Soybean,2015,1661,3681,2020,121.61348585189644
Pune-Manjri,Ladies Finger,2014,2180,4200,2020,92.66055045871559
Mumbai,Green-Peas,2015,7280,9300,2020,27.747252747252748
Bhiwapur,Chillies(Red),2015,2290,4310,2020,88.20960698689956
Khalapur(Shil-Phata),Other Pulses,2016,6950,8970,2020,29.06474820143885
Nashik,Ginger (Fresh),2015,2540,4560,2020,79.5275590551181
Dhule,Black Gram,2016,5169,7189,2020,39.079125556200424
Osmanabad,Tomato,2016,1577,3596,2019,128.0279010779962
Aurangabad,Ginger (Fresh),2015,875,2894,2019,230.74285714285713
Nanded,Turmeric,2015,6513,8532,2019,30.999539382772916
Lasalgaon-Niphad,Onion,2015,2384,4401,2017,84.60570469798658
Solapur,Guava,2016,1700,3717,2017,118.6470588235294
Solapur,Ladies Finger,2015,561,2577,2016,359.3582887700535
Malkapur,Black Gram,2016,9167,11183,2016,21.991927566270316
Bhiwapur,Chillies(Red),2015,1656,3672,2016,121.73913043478261
Nagpur,Orange,2015,1532,3548,2016,131.59268929503915
Sangrampur-Varvatbakal,Black Gram,2016,4908,6924,2016,41.075794621026894
Jalna,Black Gram,2015,9300,11314,2014,21.655913978494624
Murum,Black Gram,2015,7900,9914,2014,25.49367088607595
Kurdwadi-Modnimb,Gram,2016,4359,6372,2013,46.180316586373024
Umared,RICE(PADDY-HUS),2016,2000,4013,2013,100.65
Kamthi,Capsicum,2016,2187,4200,2013,92.04389574759945
Pusad,Black Gram,2015,7490,9503,2013,26.875834445927904
Akluj,Garlic,2016,5456,7469,2013,36.895161290322584
Kada (Ashti),Black Gram,2016,5250,7263,2013,38.34285714285714
Nandura,Pigeon Pea (Tur),2015,6967,8980,2013,28.893354384957657
Pusad,Green Gram,2015,6615,8627,2012,30.415721844293273
Nashik,Mosambi,2016,1113,3125,2012,180.7726864330638
Osmanabad,Tomato,2016,1313,3325,2012,153.23686214775324
Tuljapur,Black Gram,2015,8972,10983,2011,22.41417744092733
Kalvan,Ground Nut Pods (Dry),2014,3373,5384,2011,59.620515861251114
Pune-Manjri,Custard Apple,2014,1878,3889,2011,107.08200212992546
Barshi-Vairag,Sorgum(Jawar),2016,1828,3838,2010,109.9562363238512
Dudhani,BLACK GRAM,2016,5839,7849,2010,34.423702688816576
Solapur,Cluster Bean,2015,828,2838,2010,242.7536231884058
Manchar,Pavtta,2014,2500,4510,2010,80.4
Pune,Shevga,2016,1668,3677,2009,120.44364508393285
Shirpur,Onion,2015,2100,4109,2009,95.66666666666667
Kamthi,Mint,2015,1229,3238,2009,163.46623270951994
Kolhapur,Pineapple,2016,575,2583,2008,349.2173913043478
Daryapur,Black Gram,2015,6912,8920,2008,29.050925925925927
Pune-Manjri,Coriander  ,2014,1200,3208,2008,167.33333333333334
Sangali,Green Gram,2014,5229,7235,2006,38.362975712373306
Mumbai,Mosambi,2015,1060,3065,2005,189.1509433962264
Pune,Double Bee,2016,2159,4164,2005,92.86706808707736
Malegaon,Ground Nut Pods (Dry),2016,4404,6409,2005,45.526793823796545
Parner,Onion,2015,1079,3083,2004,185.72752548656163
Ahmednagar,Ghosali(Bhaji),2016,1313,3317,2004,152.62757044935262
Kalyan,Garlic,2014,3275,5275,2000,61.06870229007634
Kalyan,Custard Apple,2016,5000,7000,2000,40.0
Vadgaon Peth,Carrot,2014,2000,4000,2000,100.0
Junnar-Otur,Ghosali(Bhaji),2016,1000,3000,2000,200.0
Karad,Garlic,2015,3000,5000,2000,66.66666666666667
Pune-Manjri,Squash Gourd,2015,4375,6375,2000,45.714285714285715
Nashik,Pineapple,2016,1500,3500,2000,133.33333333333334
Vadgaon Peth,Ginger (Fresh),2014,5000,7000,2000,40.0
Junnar-Otur,Pavtta,2016,3000,5000,2000,66.66666666666667
Karad,Garlic,2015,3500,5500,2000,57.142857142857146
Pune-Manjri,Ridge Gourd,2016,5000,7000,2000,40.0
Kolhapur,Wood Apple,2015,500,2500,2000,400.0
Rahuri-Songaon,Capsicum,2016,3333,5333,2000,60.006000600060005
Ratanagari,MAIZE(CORN.),2016,2000,4000,2000,100.0
Karad,Garlic,2015,3000,5000,2000,66.66666666666667
Jalgaon,Mango,2015,2500,4500,2000,80.0
Pune,Ground Nut Pods (Dry),2016,3000,5000,2000,66.66666666666667
Pune,Ground Nut Pods (Dry),2016,3000,5000,2000,66.66666666666667
Kalyan,Chandani,2016,10000,12000,2000,20.0
Akluj,GOATS,2016,4500,6500,2000,44.44444444444444
Manchar,Ghevda,2014,2000,4000,2000,100.0
Manchar,Potato,2014,500,2500,2000,400.0
Osmanabad,Grapes,2016,1016,3016,2000,196.8503937007874
Nashik,Pineapple,2015,1850,3850,2000,108.10810810810811
Pandharpur,Chikoo,2016,325,2325,2000,615.3846153846154
Kolhapur,Bitter Gourd,2015,750,2750,2000,266.6666666666667
Mumbai,Cowpea,2015,4583,6583,2000,43.63953742090334
Sangrampur-Varvatbakal,BANANA,2016,4000,6000,2000,50.0
Kamthi,Ginger (Fresh),2016,3000,5000,2000,66.66666666666667
Rahuri,Ground Nut Pods (Dry),2016,3100,5100,2000,64.51612903225806
Ahmednagar,Brinjal,2016,625,2625,2000,320.0
Sangali,Horse Gram,2015,2000,4000,2000,100.0
Sangali,Horse Gram,2015,2000,4000,2000,100.0
Junnar,Garlic,2016,1500,3500,2000,133.33333333333334
Junnar (Alephata),CUSTARD APPLE,2016,2000,4000,2000,100.0
Karad,Green-Peas,2015,4833,6833,2000,41.38216428719222
Mumbai-Fruit Market,Litchi,2016,8500,10500,2000,23.529411764705884
Pune,Ground Nut Pods (Dry),2016,3000,5000,2000,66.66666666666667
Junnar,Garlic,2016,7000,9000,2000,28.571428571428573
Jalgaon,Apple,2015,5000,7000,2000,40.0
Mumbai-Fruit Market,MANGO,2016,1500,3500,2000,133.33333333333334
Mumbai,Cowpea,2015,4877,6877,2000,41.00881689563256
Mumbai,Cowpea,2015,4952,6952,2000,40.38772213247173
Akluj,Chillies(Red),2016,5333,7333,2000,37.50234389649353
Barshi,Shevga,2016,3000,5000,2000,66.66666666666667
Shrirampur,Garlic,2016,6000,8000,2000,33.333333333333336
Mumbai,Cowpea,2015,5000,7000,2000,40.0
Kamthi,Dhemse,2016,1800,3800,2000,111.11111111111111
Pune-Pimpri,Capsicum,2015,1750,3750,2000,114.28571428571429
Mumbai,Cowpea,2015,4710,6710,2000,42.46284501061571
Sangli-Phale Bhajipalam,Orange,2015,2000,4000,2000,100.0
Barshi,POMEGRANATE,2016,3000,5000,2000,66.66666666666667
Pune-Manjri,RIDGE GOURD,2016,1500,3500,2000,133.33333333333334
Junnar,Garlic,2016,7000,9000,2000,28.571428571428573
Kamthi,GREEN PEAS (DRY),2016,3300,5300,2000,60.60606060606061
Kalyan,Garlic,2014,3500,5500,2000,57.142857142857146
Kalyan,Sesamum,2016,9000,11000,2000,22.22222222222222
Ratanagari,Maize(Corn.),2016,3625,5625,2000,55.172413793103445
Chandrapur,Grapes,2015,2833,4833,2000,70.5965407695023
Pune,Ladies Finger,2016,1413,3413,2000,141.54281670205236
Kolhapur,SQUASH GOURD,2016,500,2500,2000,400.0
Osmanabad,Kharbuj,2016,1000,3000,2000,200.0
Palus,Pavtta,2016,3500,5500,2000,57.142857142857146
Indapur-Bhigwan,Pigeon Pea (Tur),2015,4750,6750,2000,42.10526315789474
Nagpur,Chillies(Red),2015,5500,7500,2000,36.36363636363637
Nagpur,Chillies(Red),2015,6208,8208,2000,32.21649484536083
Chandvad,Cucumber,2016,0,2000,2000,inf
Osmanabad,Shevga,2015,2250,4250,2000,88.88888888888889
Nagpur,Chillies(Red),2015,6500,8500,2000,30.76923076923077
Nagpur,Chillies(Red),2015,5881,7881,2000,34.007821799013776
Nagpur,Chillies(Red),2015,8000,10000,2000,25.0
Nagpur,Chillies(Red),2015,6854,8854,2000,29.180040852057193
Yawal,Coriander (Dry),2015,7000,9000,2000,28.571428571428573
Nagpur,Chillies(Red),2015,5500,7500,2000,36.36363636363637
Kamthi,Capsicum,2015,3045,5045,2000,65.68144499178982
Sangli-Phale Bhajipalam,Chikoo,2016,1000,3000,2000,200.0
Gadhinglaj,Chillies(Red),2015,20000,22000,2000,10.0
Vadgaon Peth,Green-Peas,2016,3000,5000,2000,66.66666666666667
Bhivandi,Male Goat,2016,4500,6500,2000,44.44444444444444
Rahuri,Bitter Gourd,2016,3500,5500,2000,57.142857142857146
Kalyan,Garlic,2015,2500,4500,2000,80.0
Amarawati,Pomegranate,2016,2154,4154,2000,92.85051067780873
Ratanagari,Maize(Corn.),2014,2750,4750,2000,72.72727272727273
Ahmednagar,Ghevda,2015,2667,4667,2000,74.99062617172854
Satana,Horse Gram,2014,1500,3500,2000,133.33333333333334
Navapur,Black Gram,2015,9000,11000,2000,22.22222222222222
Junnar-Otur,Small Gourd,2015,1000,3000,2000,200.0
Pune-Moshi,Pavtta,2016,4000,6000,2000,50.0
Pune-Pimpri,Shevga,2016,2000,4000,2000,100.0
Khamgaon,Male Lamb,2016,2000,4000,2000,100.0
Kamthi,Ladies Finger,2015,3000,5000,2000,66.66666666666667
Kalyan,Gram,2015,8000,10000,2000,25.0
Solapur,Chillies(Red),2015,10322,12322,2000,19.37608990505716
Kalyan,Coriander (Dry),2015,21000,23000,2000,9.523809523809524
Ahmednagar,Flower,2016,500,2500,2000,400.0
Pune,Walvad,2015,2167,4167,2000,92.29349330872174
Nagpur,Chillies(Red),2015,5500,7500,2000,36.36363636363637
Nagpur,Chillies(Red),2016,8042,10042,2000,24.86943546381497
Osmanabad,Beet Root,2015,1000,3000,2000,200.0
Mumbai,Chavli (Shenga ),2015,4800,6800,2000,41.666666666666664
Kalyan,Gr.Nut Kernels,2016,6000,8000,2000,33.333333333333336
Pathardi,Pigeon Pea (Tur),2016,4901,6901,2000,40.807998367680064
Morshi,Chillies(Red),2016,10000,12000,2000,20.0
Mumbai,Betelnuts,2016,28000,30000,2000,7.142857142857143
Mumbai,Betelnuts,2016,28000,30000,2000,7.142857142857143
Mumbai,Betelnuts,2016,28000,30000,2000,7.142857142857143
Mumbai,Betelnuts,2016,28000,30000,2000,7.142857142857143
Akole,GRAM,2016,5500,7500,2000,36.36363636363637
Akole,Gram,2016,5000,7000,2000,40.0
Satara,Garlic,2016,3000,5000,2000,66.66666666666667
Satara,Garlic,2016,3000,5000,2000,66.66666666666667
Akole,Hilda,2016,5000,7000,2000,40.0
Akole,Hilda,2016,5000,7000,2000,40.0
Kalyan,Indian Bean,2016,4333,6333,2000,46.157396722824835
Akole,Hilda,2016,5000,7000,2000,40.0
Akole,Hilda,2016,5000,7000,2000,40.0
Pune-Pimpri,Green-Peas,2015,2000,4000,2000,100.0
Pune-Pimpri,Green-Peas,2015,4000,6000,2000,50.0
Kalyan,Gr.Nut Kernels,2016,7000,9000,2000,28.571428571428573
Ahmednagar,Green Chilli,2015,1167,3167,2000,171.3796058269066
Ahmednagar,Green Chilli,2015,1833,3833,2000,109.11074740861974
Nagpur,Chillies(Red),2015,7000,9000,2000,28.571428571428573
Solapur,Apple,2016,400,2400,2000,500.0
Nagpur,Chillies(Red),2015,7438,9438,2000,26.888948642108094
Kolhapur-Laxmipuri,Chillies(Red),2014,14000,16000,2000,14.285714285714286
Pune-Pimpri,Turmeric,2015,11833,13833,2000,16.901884560128455
Kamthi,Kanda Pat,2015,1778,3778,2000,112.4859392575928
Ulhasnagar,Green Gram,2016,8000,10000,2000,25.0
Jalgaon,Apple,2014,5500,7500,2000,36.36363636363637
Ratanagari,Bitter Gourd,2016,4000,6000,2000,50.0
Ulhasnagar,Other Cereals,2016,2000,4000,2000,100.0
Ulhasnagar,Other Cereals,2016,2000,4000,2000,100.0
Ulhasnagar,Other Cereals,2016,2000,4000,2000,100.0
Pune,Small Gourd,2016,1475,3475,2000,135.59322033898306
Rahata,Green Chilli,2016,5643,7643,2000,35.4421407052986
Yawal,Coriander (Dry),2016,7000,9000,2000,28.571428571428573
Yawal,Black Gram,2016,5000,7000,2000,40.0
Yawal,Black Gram,2016,5000,7000,2000,40.0
Jalgaon,Mosambi,2016,2000,4000,2000,100.0
Kalyan,Sesamum,2015,14000,16000,2000,14.285714285714286
Ahmednagar,Bitter Gourd,2015,1350,3350,2000,148.14814814814815
Kalyan,Sesamum,2015,8000,10000,2000,25.0
Kamthi,Ginger (Fresh),2015,3000,5000,2000,66.66666666666667
Chandrapur-Ganjwad,Coriander  ,2015,2300,4300,2000,86.95652173913044
Nashik,Wal Papdi,2014,1945,3945,2000,102.82776349614396
Chandrapur,Naspatti ,2014,5000,7000,2000,40.0
Rahuri,Other Vegetables,2016,1500,3500,2000,133.33333333333334
Jamkhed,Onion,2014,133,2133,2000,1503.7593984962407
Mumbai,Tamarind,2016,2000,4000,2000,100.0
Mumbai,Tamarind,2016,2000,4000,2000,100.0
Kalyan,Orange,2015,8000,10000,2000,25.0
Kalyan,Mosambi,2015,4000,6000,2000,50.0
Pune-Moshi,Green-Peas,2016,6139,8139,2000,32.57859586251833
Vadgaon Peth,Cluster Bean,2016,1000,3000,2000,200.0
Jalgaon,Tomato,2016,3385,5385,2000,59.084194977843424
Rahata,Cluster Bean,2016,2000,4000,2000,100.0
Kamthi,Green Peas (Dry),2015,3000,5000,2000,66.66666666666667
Korpana,Male Lamb,2015,3000,5000,2000,66.66666666666667
Korpana,Goats,2016,3000,5000,2000,66.66666666666667
Mumbai,Cowpea,2014,4830,6830,2000,41.40786749482402
Pune-Moshi,Ladies Finger,2016,2675,4675,2000,74.76635514018692
Kamthi,Kanda Pat,2015,4000,6000,2000,50.0
Phaltan,Onion,2015,500,2500,2000,400.0
Kamthi,Cluster Bean,2015,3667,5667,2000,54.540496318516496
Kamthi,Zendu,2015,3000,5000,2000,66.66666666666667
Osmanabad,Grapes,2015,600,2600,2000,333.3333333333333
Kolhapur-Malkapur,Cluster Bean,2016,2000,4000,2000,100.0
Kolhapur-Malkapur,Cluster Bean,2016,1000,3000,2000,200.0
Yawal,Coriander (Dry),2016,6500,8500,2000,30.76923076923077
Kalyan,Aster,2016,6200,8200,2000,32.25806451612903
Manchar,Green-Peas,2016,2500,4500,2000,80.0
Osmanabad,Green Chilli,2015,2500,4500,2000,80.0
Kamthi,Beet Root,2014,2000,4000,2000,100.0
Junnar-Otur,Carrot,2016,1000,3000,2000,200.0
Kalyan,Grapes,2015,6000,8000,2000,33.333333333333336
Amalner,Cowpea,2016,3000,5000,2000,66.66666666666667
Paithan,Wheat(Husked),2014,1485,3485,2000,134.68013468013467
Mumbai,Tamarind,2016,2000,4000,2000,100.0
Chandrapur-Ganjwad,Garlic,2015,3000,5000,2000,66.66666666666667
Chandrapur-Ganjwad,Garlic,2015,7000,9000,2000,28.571428571428573
Khamgaon,Sheep,2015,1000,3000,2000,200.0
Manchar,Pavtta,2016,1000,3000,2000,200.0
Sillod,Green Gram,2015,6000,8000,2000,33.333333333333336
Umared,Chillies(Red),2016,8000,10000,2000,25.0
Umared,Chillies(Red),2016,12500,14500,2000,16.0
Sangali,Pigeon Pea (Tur),2016,7500,9500,2000,26.666666666666668
Sangali,Pigeon Pea (Tur),2016,6000,8000,2000,33.333333333333336
Patan,Cucumber,2016,2000,4000,2000,100.0
Pune,Capsicum,2016,3250,5250,2000,61.53846153846154
Sillod,Black Gram,2015,10000,12000,2000,20.0
Pune-Manjri,Methi (Bhaji),2015,900,2900,2000,222.22222222222223
Yawal,Coriander (Dry),2016,7000,9000,2000,28.571428571428573
Nagpur,Chillies(Red),2016,7842,9842,2000,25.50369803621525
Amarawati-Fruit And Vegetables,CUSTARD APPLE,2016,3528,5528,2000,56.68934240362812
Ahmednagar,Mosambi,2015,1250,3250,2000,160.0
Osmanabad,Ladies Finger,2016,1500,3500,2000,133.33333333333334
Mumbai,Mosambi,2015,1000,3000,2000,200.0
Lasur Station,Onion,2015,200,2200,2000,1000.0
Jafrabad,Green Gram,2015,6000,8000,2000,33.333333333333336
Shrirampur,Garlic,2015,5000,7000,2000,40.0
Nagpur,Ginger (Fresh),2016,2000,4000,2000,100.0
Ahmednagar,Ghosali(Bhaji),2016,2333,4333,2000,85.72653236176596
Chandrapur,Garlic,2016,9500,11500,2000,21.05263157894737
Sangali,Chillies(Red),2016,10300,12300,2000,19.41747572815534
Sangali,Coriander (Dry),2015,10000,12000,2000,20.0
Ratanagari,Cluster Bean,2016,3500,5500,2000,57.142857142857146
Mahagaon,GRAM,2016,4750,6750,2000,42.10526315789474
Pune,Dhemse,2016,2000,4000,2000,100.0
Kamthi,Squash Gourd,2015,2000,4000,2000,100.0
Vadgaon Peth,Ghevda,2016,2500,4500,2000,80.0
Anajngaon Surji,Chillies(Red),2014,7600,9600,2000,26.31578947368421
Sangali,Chillies(Red),2016,13000,15000,2000,15.384615384615385
Sangali,Black Gram,2016,8167,10167,2000,24.488796375658136
Pune-Pimpri,Capsicum,2016,2000,4000,2000,100.0
Bhivandi,Male Goat,2016,5500,7500,2000,36.36363636363637
Pune,Ridge Gourd,2015,1833,3833,2000,109.11074740861974
Chandrapur,Ground Nut Pods (Dry),2016,2500,4500,2000,80.0
Sangali,Chillies(Red),2015,10000,12000,2000,20.0
Pune-Pimpri,Green Chilli,2015,3250,5250,2000,61.53846153846154
Chalisgaon,Matki,2016,4000,6000,2000,50.0
Anajngaon Surji,Chillies(Red),2016,9000,11000,2000,22.22222222222222
Kamthi,Karvand,2016,2000,4000,2000,100.0
Kamthi,LEAFY VEGETABLE,2016,5000,7000,2000,40.0
Chandrapur,Chikoo,2016,2500,4500,2000,80.0
Sillod-Bharadi,Black Gram,2015,10000,12000,2000,20.0
Kamthi,Methi (Bhaji),2015,1683,3683,2000,118.83541295306001
Sillod-Bharadi,Green Gram,2015,6000,8000,2000,33.333333333333336
Kamthi,Wal Bhaji,2014,3572,5571,1999,55.963045912653975
Nashik,Ghevda,2014,2589,4588,1999,77.21127848590189
Solapur,LEMON,2016,108,2106,1998,1850.0
Shirpur,Sesamum,2016,3514,5511,1997,56.82982356289129
Kolhapur,Capsicum,2015,1136,3132,1996,175.70422535211267
Chalisgaon,Black Gram,2015,6690,8685,1995,29.820627802690584
Mangrulpeer,Gram,2016,6372,8367,1995,31.30885122410546
Nashik,Squash Gourd,2016,2859,4854,1995,69.77964323189927
Gevrai,Green Gram,2014,4305,6300,1995,46.34146341463415
Pune,Ridge Gourd,2014,2024,4019,1995,98.56719367588933
Kamthi,Ginger (Fresh),2016,2513,4507,1994,79.34739355352168
Amarawati,Grapes,2016,2218,4212,1994,89.90081154192967
Jalgaon,Lemon,2015,2728,4722,1994,73.09384164222874
Pandharpur,Capsicum,2015,790,2783,1993,252.27848101265823
Mangalwedha,Ladies Finger,2015,1338,3331,1993,148.95366218236174
Kolhapur,Cluster Bean,2016,768,2761,1993,259.5052083333333
Osmanabad,Brinjal,2016,1195,3188,1993,166.77824267782427
Jalna,Sorgum(Jawar),2014,1187,3179,1992,167.81802864363942
Nagpur,Apple,2015,2681,4673,1992,74.3006340917568
Mumbai,Split Black Gram,2016,13596,15587,1991,14.64401294498382
Murbad,Tomato,2016,5610,7600,1990,35.47237076648841
Osmanabad,Ginger (Fresh),2015,1870,3860,1990,106.41711229946524
Kamthi,Green Peas (Dry),2015,1835,3825,1990,108.44686648501363
Umared,Rice(Paddy-Hus),2016,2000,3988,1988,99.4
Solapur,Bitter Gourd,2016,3440,5428,1988,57.7906976744186
Nashik,Wal Papdi,2014,1650,3638,1988,120.48484848484848
Pune,Cluster Bean,2015,1491,3478,1987,133.26626425217975
Kamthi,Green Chilli,2016,1880,3867,1987,105.69148936170212
Chikhali,Pigeon Pea (Tur),2015,5426,7413,1987,36.61997788426097
Sonpeth,Green Gram,2014,4537,6523,1986,43.77341855851885
Solapur,Cluster Bean,2015,733,2719,1986,270.9413369713506
Akola,Black Gram,2015,8547,10533,1986,23.236223236223235
Mumbai,Fennel,2015,14800,16786,1986,13.41891891891892
Shahada,Gram,2016,5109,7095,1986,38.872577803875515
Nagpur,Ginger (Fresh),2016,2082,4068,1986,95.38904899135447
Lonar,Black Gram,2015,6814,8800,1986,29.14587613736425
Pune,Brinjal,2015,924,2910,1986,214.93506493506493
Mangalwedha,Cucumber,2015,393,2378,1985,505.089058524173
Kolhapur-Laxmipuri,Sorgum(Jawar),2015,1755,3740,1985,113.1054131054131
Kalyan,Matki,2016,6333,8317,1984,31.327964629717354
Vadgaon Peth,Cluster Bean,2016,2072,4056,1984,95.75289575289575
Osmanabad,Brinjal,2015,1333,3317,1984,148.8372093023256
Chikhali,Gram,2016,7116,9100,1984,27.880831928049467
Nandgaon,Onion,2015,990,2974,1984,200.40404040404042
Rahuri-Vambori,Onion,2015,492,2475,1983,403.0487804878049
Kamthi,Mint,2014,2626,4609,1983,75.51408987052551
Khamgaon,Green Gram,2014,4570,6552,1982,43.36980306345733
Pune-Manjri,Bitter Gourd,2016,3650,5632,1982,54.3013698630137
Rahata,Green Chilli,2016,4045,6027,1982,48.99876390605686
Daryapur,Pigeon Pea (Tur),2015,8433,10415,1982,23.502905253172063
Akluj,Shevga,2016,2000,3982,1982,99.1
Kamthi,Orange,2015,619,2600,1981,320.032310177706
Nagpur,Chillies(Red),2014,5038,7019,1981,39.32115919015482
Pune,Green Chilli,2016,1869,3850,1981,105.99250936329588
Lonand,Onion,2015,1188,3169,1981,166.75084175084174
Mangalwedha,Ladies Finger,2015,512,2492,1980,386.71875
Nandgaon,Green Gram,2015,6295,8275,1980,31.453534551231137
Sangrampur,Gram,2015,2300,4280,1980,86.08695652173913
Nagpur,Apple,2016,9005,10985,1980,21.987784564131037
Rahata,Onion,2015,536,2515,1979,369.2164179104478
Sangli-Phale Bhajipalam,Custard Apple,2015,625,2604,1979,316.64
Khamgaon,Ground Nut Pods (Dry),2016,3529,5508,1979,56.078209124397844
Mumbai,Mosambi,2015,1017,2996,1979,194.59193706981318
Mangalwedha,Bitter Gourd,2015,2296,4274,1978,86.14982578397212
Kolhapur,Brinjal,2016,483,2461,1978,409.5238095238095
Pathari,Pigeon Pea (Tur),2016,6641,8618,1977,29.769613010088843
Kolhapur,Ladies Finger,2015,636,2612,1976,310.69182389937106
Aurangabad,Jambhul,2015,4500,6475,1975,43.888888888888886
Umared,Rice(Paddy-Hus),2016,2000,3975,1975,98.75
Pune,DOUBLE BEE,2016,3000,4975,1975,65.83333333333333
Nashik,Lemon,2016,2696,4670,1974,73.21958456973294
Kolhapur-Malkapur,Tomato,2016,567,2539,1972,347.7954144620811
Aurangabad,Tomato,2016,3556,5528,1972,55.455568053993254
Sangali,Black Gram,2016,7355,9327,1972,26.81169272603671
Jalna,Pigeon Pea (Tur),2015,6529,8501,1972,30.203706540052075
Nagpur,Chillies(Red),2016,8000,9972,1972,24.65
Nagpur,Pineapple,2014,1119,3090,1971,176.13941018766755
Kolhapur-Laxmipuri,Sorgum(Jawar),2016,2030,4000,1970,97.04433497536945
Kolhapur-Laxmipuri,Sorgum(Jawar),2016,1752,3721,1969,112.38584474885845
Dhule,Ground Nut Pods (Dry),2014,3182,5151,1969,61.879321181646766
Kolhapur,Shevga,2016,2592,4561,1969,75.9645061728395
Solapur,Onion,2015,100,2068,1968,1968.0
Mumbai,Green Chilli,2015,2832,4800,1968,69.49152542372882
Ambad(Vadi Godri),Tamarind,2016,2395,4363,1968,82.17118997912317
Pandharpur,Ghevda,2015,700,2667,1967,281.0
Bhivandi,Rice(Paddy-Hus),2016,2190,4157,1967,89.81735159817352
Ahmednagar,Green Chilli,2015,1000,2967,1967,196.7
Nashik,CUCUMBER,2016,1356,3322,1966,144.98525073746313
Kolhapur-Laxmipuri,Sorgum(Jawar),2016,1722,3688,1966,114.16957026713125
Shirpur,Matki,2015,5374,7340,1966,36.5835504279866
Mangaon(Bhadav),Nachani,2015,1367,3333,1966,143.81858083394295
Indapur-Bhigwan,Cowpea,2016,5801,7767,1966,33.890708498534735
Jamkhed,Onion,2015,206,2172,1966,954.3689320388349
Pune-Manjri,Green-Peas,2015,3850,5815,1965,51.03896103896104
Mangalwedha,Green Chilli,2016,5692,7656,1964,34.50456781447646
Karad,Mosambi,2014,3643,5607,1964,53.91161130936042
Nashik,Cucumber,2016,1892,3856,1964,103.80549682875264
Daryapur,Pigeon Pea (Tur),2016,7277,9240,1963,26.97540195135358
Ahmednagar,Cucumber,2016,525,2488,1963,373.9047619047619
Latur,BLACK GRAM,2016,5653,7616,1963,34.72492481868035
Chandrapur,Apple,2015,2813,4775,1962,69.74760042659082
Kurdwadi-Modnimb,Green Gram,2016,2888,4850,1962,67.93628808864266
Pune,Mango(Raw),2016,4577,6538,1961,42.844658072973566
Dhule,Ground Nut Pods (Dry),2015,3253,5214,1961,60.28281586228097
Jamner-Neri,Green Gram,2015,6953,8914,1961,28.20365309938156
Kamthi,Tomato,2015,1820,3780,1960,107.6923076923077
Pandharpur,Onion,2015,213,2173,1960,920.1877934272301
Hingoli,Black Gram,2016,8890,10850,1960,22.04724409448819
Barshi,Turmeric,2015,6577,8537,1960,29.800821043028737
Mumbai-Fruit Market,Custard Apple,2016,3200,5160,1960,61.25
Sangali,Lentil,2015,4020,5980,1960,48.756218905472636
Kamthi,Coriander  ,2016,2007,3966,1959,97.60837070254111
Nagpur,Grapes,2015,2608,4567,1959,75.11503067484662
Lasalgaon-Niphad,Gram,2016,6759,8717,1958,28.968782364255066
Kolhapur,Cluster Bean,2015,1032,2990,1958,189.72868217054264
Nagpur,Pigeon Pea (Tur),2015,6993,8951,1958,27.999427999428
Akot,Black Gram,2016,6433,8390,1957,30.4212653505363
Rahuri-Vambori,Onion,2014,200,2157,1957,978.5
Kamthi,Custard Apple,2015,2829,4786,1957,69.17638741604807
Shrirampur,GRAM,2016,6175,8132,1957,31.692307692307693
Umared,Rice(Paddy-Hus),2016,2000,3957,1957,97.85
Lasalgaon,Onion,2015,2535,4492,1957,77.19921104536489
Sangali,Lentil,2015,6422,8378,1956,30.457801308003738
Jamner,Green Gram,2015,6995,8950,1955,27.94853466761973
Osmanabad,Ladies Finger,2015,1656,3611,1955,118.05555555555556
Kolhapur,Grapes,2016,1665,3620,1955,117.41741741741741
Kamthi,Capsicum,2014,3273,5227,1954,59.70058050717996
Kolhapur-Laxmipuri,Rice(Paddy-Hus),2015,2029,3983,1954,96.30359783144407
Kolhapur,Brinjal,2015,504,2458,1954,387.6984126984127
Jalgaon,Coriander (Dry),2015,9261,11214,1953,21.08843537414966
Kalyan,Grapes,2016,4480,6433,1953,43.59375
Pune,Pavtta,2014,3452,5405,1953,56.57589803012746
Karad,Mango,2016,4654,6607,1953,41.96390201976794
Dondaicha,Ground Nut Pods (Dry),2016,3980,5932,1952,49.04522613065327
Osmanabad,Brinjal,2015,950,2902,1952,205.47368421052633
Ambad(Vadi Godri),Black Gram,2016,5500,7451,1951,35.472727272727276
Partur,Pigeon Pea (Tur),2015,7800,9751,1951,25.012820512820515
Yeotmal,Pigeon Pea (Tur),2016,7285,9236,1951,26.781056966369253
Ahmednagar,Ghosali(Bhaji),2016,800,2750,1950,243.75
Vadgaon Peth,Ghevda,2016,2950,4900,1950,66.10169491525424
Sangali,Coriander (Dry),2014,9625,11575,1950,20.25974025974026
Ahmednagar,Ladies Finger,2016,1000,2950,1950,195.0
Majalgaon,Sesamum,2016,4967,6917,1950,39.25911012683712
Chikhali,Green Gram,2015,4900,6850,1950,39.795918367346935
Ahmednagar,Cucumber,2016,1000,2950,1950,195.0
Lonar,Black Gram,2016,6650,8600,1950,29.32330827067669
Nagpur,Ground Nut Pods (Dry),2016,3400,5350,1950,57.35294117647059
Rahuri,Brinjal,2016,200,2150,1950,975.0
Chalisgaon,Green Gram,2016,4300,6250,1950,45.348837209302324
Indapur-Bhigwan,Sesamum,2015,5300,7250,1950,36.79245283018868
Sangali,Pigeon Pea (Tur),2016,7300,9250,1950,26.71232876712329
Anajngaon Surji,Gram,2016,7438,9388,1950,26.21672492605539
Jalgaon,Garlic,2015,2500,4450,1950,78.0
Kopargaon,Chikoo,2015,975,2925,1950,200.0
Sangli-Phale Bhajipalam,Water Melon,2016,498,2448,1950,391.56626506024094
Pandharpur,Green-Peas,2014,1500,3450,1950,130.0
Aurangabad,Lemon,2016,3272,5220,1948,59.53545232273839
Rahuri-Vambori,Ground Nut Pods (Dry),2015,2846,4794,1948,68.44694307800421
Varud-Rajura Bazar,Gram,2016,6576,8523,1947,29.607664233576642
Khed,Farshi,2016,1561,3508,1947,124.72773862908392
Satara,Green-Peas,2015,6520,8467,1947,29.86196319018405
Kamthi,Cluster Bean,2014,1421,3368,1947,137.0161857846587
Rahuri-Vambori,Onion,2015,292,2238,1946,666.4383561643835
Jalgaon,Grapes,2016,2492,4438,1946,78.08988764044943
Pune,Pavtta,2016,3111,5056,1945,62.5200900032144
Pune-Pimpri,Green Chilli,2016,4083,6028,1945,47.6365417585109
Ahmednagar,Ghevda,2016,2556,4500,1944,76.05633802816901
Pandharpur,Brinjal,2015,500,2443,1943,388.6
Malkapur,Pigeon Pea (Tur),2015,5525,7468,1943,35.16742081447964
Kamthi,Beet Root,2014,2057,4000,1943,94.45794846864365
Nashik,Bitter Gourd,2016,2805,4748,1943,69.26916221033868
Pune-Moshi,Ladies Finger,2016,1700,3643,1943,114.29411764705883
Mumbai,Split Black Gram,2016,12483,14426,1943,15.565168629335897
Pune-Manjri,Ladies Finger,2014,2771,4714,1943,70.11909058101769
Jalgaon,Grapes,2015,2095,4037,1942,92.69689737470168
Umared,Rice(Paddy-Hus),2016,2033,3975,1942,95.5238563698967
Pune,Green Peas (Dry),2015,2975,4917,1942,65.27731092436974
Jalgaon,Green Chilli,2016,2795,4737,1942,69.48121645796064
Ulhasnagar,Other Vegetables,2016,1618,3559,1941,119.9629171817058
Kamthi,Flower,2015,1511,3452,1941,128.457974851092
Pune,Green-Peas,2015,2280,4220,1940,85.08771929824562
Jamner,Black Gram,2015,6843,8783,1940,28.350138827999416
Osmanabad,SQUASH GOURD,2016,1160,3100,1940,167.24137931034483
Karad,Garlic,2016,5040,6980,1940,38.492063492063494
Ahmednagar,Ladies Finger,2015,1200,3140,1940,161.66666666666666
Kalyan,Garlic,2016,3975,5915,1940,48.80503144654088
Nagpur,Pineapple,2015,1040,2980,1940,186.53846153846155
Kolhapur,Green Chilli,2015,1661,3600,1939,116.73690547862734
Varud-Rajura Bazar,Gram,2016,5825,7764,1939,33.287553648068666
Nashik,Bitter Gourd,2015,2471,4410,1939,78.47025495750708
Akluj,Bitter Gourd,2016,3005,4943,1938,64.49251247920134
Osmanabad,Ladies Finger,2015,1375,3313,1938,140.94545454545454
Kolhapur,Ladies Finger,2015,500,2438,1938,387.6
Chikhali,Pigeon Pea (Tur),2015,5253,7191,1938,36.89320388349515
Pandharpur,Onion,2015,815,2753,1938,237.7914110429448
Osmanabad,GRAM,2016,4863,6800,1937,39.83137980670368
Mumbai,Split Black Gram,2016,12746,14683,1937,15.196924525341284
Aurangabad,Shevga,2014,4313,6250,1937,44.91073498724786
Amarawati,Sesamum,2015,8188,10125,1937,23.65657059110894
Solapur,Cluster Bean,2015,891,2828,1937,217.39618406285072
Aurangabad,Onion,2015,2093,4030,1937,92.54658385093168
Nashik,Kanda Pat,2014,1155,3091,1936,167.61904761904762
Solapur,Ridge Gourd,2016,1821,3757,1936,106.31521142229545
Satana,Ground Nut Pods (Dry),2016,4306,6241,1935,44.93729679516953
Ulhasnagar,Other Vegetables,2016,933,2867,1934,207.2883172561629
Jalgaon,Mosambi,2015,2233,4167,1934,86.60994178235558
Junnar (Narayangaon),Coriander  ,2016,767,2701,1934,252.15123859191655
Malegaon,Onion,2015,553,2487,1934,349.7287522603978
Kamthi,Parwar,2015,1650,3583,1933,117.15151515151516
Pune,Squash Gourd,2016,2010,3943,1933,96.16915422885572
Mumbai,Small Gourd,2016,1792,3725,1933,107.86830357142857
Jalgaon,Garlic,2014,2067,4000,1933,93.51717464925012
Kalyan,Sesamum,2015,9667,11600,1933,19.995862211647875
Jalgaon,Garlic,2014,1900,3833,1933,101.73684210526316
Rahuri,Shevga,2015,1400,3333,1933,138.07142857142858
Vasai,Wheat(Husked),2014,1467,3400,1933,131.76550783912748
Chandur Bajar,Pigeon Pea (Tur),2015,7500,9433,1933,25.773333333333333
Jalgaon,Grapes,2016,3400,5333,1933,56.85294117647059
Pune-Manjri,Walvad,2015,2904,4836,1932,66.52892561983471
Nanded,Turmeric,2015,5937,7869,1932,32.54168772107125
Mumbai,Green-Peas,2015,6250,8182,1932,30.912
Nandurbar,Sunflower,2016,3633,5565,1932,53.179190751445084
Sangrampur,Gram,2015,1913,3844,1931,100.94093047569262
Vaijapur,Onion,2014,211,2142,1931,915.1658767772511
Kalyan,Grapes,2016,4740,6670,1930,40.71729957805907
Pandharpur,Brinjal,2015,495,2425,1930,389.8989898989899
Taloda,Gram,2016,4124,6054,1930,46.7992240543162
Osmanabad,Flower,2015,1892,3822,1930,102.00845665961945
Aurangabad,Ginger (Fresh),2016,900,2829,1929,214.33333333333334
Pune,Brinjal,2015,833,2762,1929,231.57262905162065
Baramati,Gram,2016,4869,6798,1929,39.61799137399877
Pune,Shevga,2015,2212,4140,1928,87.1609403254973
Gondiya,Tamarind,2016,3350,5278,1928,57.55223880597015
Kolhapur,Capsicum,2015,619,2547,1928,311.47011308562196
Akola,Pigeon Pea (Tur),2015,8133,10061,1928,23.705889585638754
Pune,Walvad,2016,3929,5857,1928,49.07101043522525
Mangrulpeer,Green Gram,2014,4200,6128,1928,45.904761904761905
Chandvad,Ladies Finger,2016,2209,4136,1927,87.23404255319149
Osmanabad,Cluster Bean,2016,1375,3300,1925,140.0
Kolhapur,Shepu,2016,1750,3675,1925,110.0
Vaijapur,Onion,2015,500,2425,1925,385.0
Balapur,Pigeon Pea (Tur),2016,6050,7975,1925,31.818181818181817
Pimpalgaon (B)-Saykheda,Onion,2015,1029,2954,1925,187.0748299319728
Balapur,Pigeon Pea (Tur),2015,5075,7000,1925,37.93103448275862
Pune,Ghevda,2016,2650,4575,1925,72.64150943396227
Lasur Station,Onion,2015,533,2458,1925,361.16322701688557
Kolhapur,Kanda Pat,2016,2275,4200,1925,84.61538461538461
Osmanabad,Green Chilli,2015,2275,4200,1925,84.61538461538461
Sangrampur-Varvatbakal,Green Gram,2015,5000,6925,1925,38.5
Kolhapur,Orange,2016,7000,8925,1925,27.5
Rahuri,Chikoo,2016,739,2663,1924,260.35182679296344
Nashik,Bitter Gourd,2015,1417,3341,1924,135.77981651376146
Chikhali,Pigeon Pea (Tur),2016,7104,9027,1923,27.069256756756758
Nagpur,CHIKOO,2016,1544,3467,1923,124.54663212435233
Kamthi,Capsicum,2014,3500,5423,1923,54.94285714285714
Lasalgaon,Coriander (Dry),2016,6367,8289,1922,30.186901209360766
Pune,Green Peas (Dry),2015,3536,5457,1921,54.32692307692308
Lonar,Pigeon Pea (Tur),2015,7590,9511,1921,25.30961791831357
Pune-Manjri,Bitter Gourd,2015,2833,4754,1921,67.80797740910695
Nandurbar,Ground Nut Pods (Dry),2016,3347,5268,1921,57.394681804601134
Gevrai,Gram,2016,5199,7120,1921,36.94941334872091
Solapur,Capsicum,2014,800,2721,1921,240.125
Pune,Black Gram,2016,10347,12267,1920,18.556103218324154
Solapur,Cluster Bean,2015,2364,4284,1920,81.21827411167513
Ulhasnagar,Rice(Paddy-Hus),2016,3500,5419,1919,54.82857142857143
Solapur,Bitter Gourd,2015,1131,3050,1919,169.67285587975243
Pune,Shevga,2015,3536,5455,1919,54.27036199095023
Kolhapur,CLUSTER BEAN,2016,1224,3143,1919,156.781045751634
Parner,Onion,2015,809,2727,1918,237.08281829419036
Taloda,Gram,2016,5571,7488,1917,34.41033925686591
Umared,Rice(Paddy-Hus),2016,2000,3917,1917,95.85
Amarawati,Grapes,2016,2208,4125,1917,86.82065217391305
Mangalwedha,Cucumber,2016,561,2478,1917,341.71122994652404
Pulgaon,Pigeon Pea (Tur),2015,6167,8084,1917,31.08480622669045
Sangli-Phale Bhajipalam,Ginger (Fresh),2016,2333,4250,1917,82.16888126875268
Kalyan,Apple,2016,7333,9250,1917,26.142097368062185
Rahata,Green Chilli,2015,3667,5583,1916,52.2497954731388
Pune-Manjri,Tomato,2016,2077,3993,1916,92.24843524313914
Pandharpur,Green Chilli,2015,1009,2925,1916,189.8909811694747
Rahuri,Onion,2014,169,2085,1916,1133.7278106508875
Ahmednagar,Capsicum,2016,2167,4083,1916,88.41716658975542
Solapur,Chikoo,2016,780,2695,1915,245.51282051282053
Mangalwedha,Cucumber,2014,507,2422,1915,377.7120315581854
Latur,Green Gram,2015,6382,8297,1915,30.006267627702915
Amalner,Green Gram,2015,4900,6815,1915,39.08163265306123
Chandrapur-Ganjwad,Garlic,2016,8660,10575,1915,22.113163972286372
Nagpur,Chillies(Red),2016,9986,11900,1914,19.16683356699379
Kamthi,Small Gourd,2015,657,2571,1914,291.324200913242
Shrirampur,Onion,2015,309,2223,1914,619.4174757281553
Kamthi,Green-Peas,2015,1854,3768,1914,103.23624595469256
Pune,Pavtta,2016,2304,4217,1913,83.02951388888889
Kada,Onion,2015,225,2138,1913,850.2222222222222
Lasalgaon-Vinchur,Soybean,2016,1919,3831,1912,99.6352266805628
Sangali,Lentil,2015,5588,7500,1912,34.216177523264136
Latur,Black Gram,2016,7264,9176,1912,26.3215859030837
Pandharpur,Chikoo,2015,323,2235,1912,591.9504643962848
Pune-Manjri,Ambat Chuka,2015,100,2010,1910,1910.0
Kolhapur,Pineapple,2016,565,2475,1910,338.05309734513276
Khed,CLUSTER BEAN,2016,1817,3727,1910,105.11832691249312
Koregaon,Ghevda Seed,2015,2851,4761,1910,66.99403717993687
Ahmednagar,Bottle Gourd,2016,510,2420,1910,374.5098039215686
Loha,Turmeric,2015,5400,7310,1910,35.370370370370374
Satara,Green Chilli,2015,2888,4798,1910,66.13573407202216
Kolhapur,Spinach,2016,1464,3373,1909,130.39617486338798
Kamthi,Chavli (Pala),2015,717,2625,1908,266.10878661087867
Parola,Green Gram,2016,4867,6775,1908,39.20279432915554
Sangali,Green Gram,2016,7020,8927,1907,27.165242165242166
Kolhapur-Malkapur,Brinjal,2016,886,2793,1907,215.2370203160271
Amarawati,Mango,2016,3306,5212,1906,57.65275257108288
Sangrampur-Varvatbakal,GRAM,2016,6222,8128,1906,30.633236901317904
Kamthi,Ginger (Fresh),2016,3388,5294,1906,56.25737898465171
Pune,Ridge Gourd,2015,2463,4368,1905,77.34470158343484
Solapur,Ladies Finger,2015,500,2404,1904,380.8
Kolhapur,Bitter Gourd,2016,1060,2964,1904,179.62264150943398
Kamthi,Small Gourd,2015,648,2552,1904,293.82716049382714
Solapur,Tomato,2015,204,2108,1904,933.3333333333334
Pune,Ginger (Fresh),2015,1615,3518,1903,117.83281733746131
Vasai,Rice(Paddy-Hus),2016,2100,4003,1903,90.61904761904762
Jintur,Pigeon Pea (Tur),2015,6521,8423,1902,29.16730562797117
Sinner,Ground Nut Pods (Dry),2016,3900,5801,1901,48.743589743589745
Manchar,Coriander  ,2016,924,2825,1901,205.73593073593074
Osmanabad,Ridge Gourd,2016,1600,3500,1900,118.75
Karad,Garlic,2016,4920,6820,1900,38.61788617886179
Ratanagari,Ginger (Fresh),2016,2500,4400,1900,76.0
Pune-Manjri,Kanda Pat,2015,1500,3400,1900,126.66666666666667
Vadgaon Peth,Capsicum,2016,2068,3968,1900,91.8762088974855
Sangrampur,Pigeon Pea (Tur),2016,5500,7400,1900,34.54545454545455
Kolhapur-Laxmipuri,Gr.Nut Kernels,2016,6500,8400,1900,29.23076923076923
Osmanabad,Carrot,2016,600,2500,1900,316.6666666666667
Mangalwedha,Cucumber,2014,1336,3236,1900,142.21556886227546
Jalgaon,Mosambi,2015,1200,3100,1900,158.33333333333334
Kolhapur,Green-Peas,2016,2600,4500,1900,73.07692307692308
Shirpur,Matki,2015,5757,7657,1900,33.00330033003301
Mahagaon,Pigeon Pea (Tur),2016,5600,7500,1900,33.92857142857143
Osmanabad,Brinjal,2015,1100,3000,1900,172.72727272727272
Karmala,Gram,2015,3100,5000,1900,61.29032258064516
Sangali,Horse Gram,2015,1900,3800,1900,100.0
Pune,Ridge Gourd,2014,2400,4300,1900,79.16666666666667
Pune-Manjri,Custard Apple,2014,1824,3724,1900,104.16666666666667
Palus,Ghevda,2016,1100,3000,1900,172.72727272727272
Jalgaon,Jambhul,2016,4800,6700,1900,39.583333333333336
Newasa-Ghodegaon,Onion,2014,231,2131,1900,822.5108225108225
Manmad,GRAM,2016,6684,8584,1900,28.426092160383003
Pune-Manjri,Walvad,2014,2892,4792,1900,65.6984785615491
Solapur,Matki,2015,7000,8900,1900,27.142857142857142
Junnar-Otur,Bitter Gourd,2015,100,2000,1900,1900.0
Kopargaon,Chikoo,2015,900,2800,1900,211.11111111111111
Nashik,Pineapple,2016,1600,3500,1900,118.75
Mangalwedha,Bitter Gourd,2015,628,2528,1900,302.54777070063693
Sillod-Bharadi,Pigeon Pea (Tur),2016,6000,7900,1900,31.666666666666668
Aurangabad,Fig,2016,3300,5200,1900,57.57575757575758
Nira-Saswad,Ghevda Seed,2015,4750,6650,1900,40.0
Akola,Sunflower,2015,3300,5200,1900,57.57575757575758
Newasa-Ghodegaon,Onion,2015,315,2215,1900,603.1746031746031
Manchar,Walvad,2014,1000,2900,1900,190.0
Indapur,Sorgum(Jawar),2014,1100,3000,1900,172.72727272727272
Kamthi,Raddish,2016,2383,4283,1900,79.73143096936634
Taloda,Black Gram,2015,7170,9070,1900,26.499302649930264
Ahmednagar,Flower,2016,950,2850,1900,200.0
Osmanabad,Grapes,2016,1600,3500,1900,118.75
Pune,Dhemse,2015,1100,3000,1900,172.72727272727272
Lasalgaon,Green Gram,2016,4834,6734,1900,39.304923458833265
Mumbai,Green-Peas,2014,7360,9260,1900,25.815217391304348
Nanded,Turmeric,2014,5134,7033,1899,36.988702765874564
Dhule,Ground Nut Pods (Dry),2015,4072,5970,1898,46.61100196463654
Mangrulpeer,GRAM,2016,5930,7828,1898,32.00674536256324
Sangamner,Onion,2015,500,2397,1897,379.4
Nagpur,Chikoo,2016,954,2850,1896,198.74213836477986
Kolhapur-Laxmipuri,Sorgum(Jawar),2016,1731,3627,1896,109.53206239168111
Solapur,Brinjal,2015,443,2339,1896,427.9909706546275
Pune,Mango(Raw),2015,994,2889,1895,190.64386317907446
Pune,Capsicum,2015,1180,3075,1895,160.59322033898306
Kamthi,Pumpkin,2014,921,2816,1895,205.75461454940282
Pune,Ladies Finger,2014,1313,3208,1895,144.3259710586443
Solapur,Custard Apple,2015,563,2456,1893,336.23445825932504
Jalgaon,Black Gram,2015,9816,11709,1893,19.28484107579462
Mangalwedha,Ridge Gourd,2016,1516,3408,1892,124.80211081794195
Shirpur,Green Gram,2015,6730,8622,1892,28.11292719167905
Nashik,Brinjal,2016,2860,4752,1892,66.15384615384616
Kamthi,Cucumber,2015,1882,3773,1891,100.47821466524974
Jalgaon,Coriander  ,2016,1919,3810,1891,98.54090672225118
Solapur,Cucumber,2016,343,2234,1891,551.3119533527697
Nandgaon Khandeshwar,Green Gram,2015,6252,8143,1891,30.24632117722329
Pimpalgaon Basawant,Onion,2015,1020,2911,1891,185.3921568627451
Jalgaon,Onion,2015,2170,4060,1890,87.09677419354838
Aurangabad,Mosambi,2015,2505,4395,1890,75.44910179640719
Pusad,Black Gram,2015,8975,10865,1890,21.058495821727018
Osmanabad,Ridge Gourd,2014,1710,3600,1890,110.52631578947368
Kalyan,BANANA,2016,6778,8667,1889,27.869578046621424
Baramati,Gram,2016,3050,4938,1888,61.90163934426229
Kolhapur,Mango,2016,1396,3284,1888,135.243553008596
Pune,Capsicum,2014,1840,3728,1888,102.6086956521739
Solapur,Bitter Gourd,2015,1222,3109,1887,154.4189852700491
Nashik,Ginger (Fresh),2016,3603,5490,1887,52.373022481265615
Solapur,Coriander  ,2016,383,2270,1887,492.6892950391645
Rahuri,Chikoo,2016,436,2322,1886,432.56880733944956
Pune,Ghevda,2014,1540,3425,1885,122.40259740259741
Nagpur,Pineapple,2015,1019,2904,1885,184.98527968596665
Pune,Ginger (Fresh),2016,1277,3162,1885,147.6115896632733
Mumbai,Fenugreek,2014,7086,8971,1885,26.60174992943833
Kamthi,Parwar,2014,1829,3714,1885,103.06178239475123
Amalner,Black Gram,2016,5225,7109,1884,36.057416267942585
Nandgaon,Ground Nut Pods (Dry),2016,5600,7484,1884,33.642857142857146
Jalgaon,Mango(Raw),2016,2783,4667,1884,67.69673014732304
Solapur,Onion,2014,101,1985,1884,1865.3465346534654
Armori,Ground Nut Pods (Dry),2016,4038,5921,1883,46.631996037642395
Pune-Manjri,Custard Apple,2014,1000,2883,1883,188.3
Sangali,Lentil,2015,4550,6433,1883,41.38461538461539
Lasalgaon,Black Gram,2016,5484,7367,1883,34.33625091174326
Solapur,Brinjal,2016,340,2223,1883,553.8235294117648
Pune,Tomato,2015,1167,3050,1883,161.35389888603257
Kamthi,Ginger (Fresh),2015,3529,5412,1883,53.35789175403797
Amarawati,Grapes,2016,2382,4265,1883,79.0512174643157
Pune,Brinjal,2016,1026,2909,1883,183.52826510721246
Rahuri-Vambori,Onion,2014,127,2009,1882,1481.8897637795276
Karad,Garlic,2015,4452,6333,1881,42.25067385444744
Jalgaon,Green Chilli,2016,3505,5386,1881,53.66619115549216
Nashik,Ginger (Fresh),2016,3064,4945,1881,61.39033942558747
Junnar-Otur,Walvad,2016,1450,3331,1881,129.72413793103448
Pune,Small Gourd,2015,1238,3119,1881,151.93861066235866
Mangalwedha,Ridge Gourd,2015,1200,3081,1881,156.75
Pune,Ghevda,2016,2100,3980,1880,89.52380952380952
Vadgaon Peth,Green-Peas,2015,2100,3980,1880,89.52380952380952
Shahada,Gram,2016,3908,5788,1880,48.106448311156605
Paranda,Pigeon Pea (Tur),2016,6540,8420,1880,28.74617737003058
Pachora,Pigeon Pea (Tur),2016,5888,7767,1879,31.91236413043478
Gevrai,Gram,2016,4720,6598,1878,39.78813559322034
Akluj,Shevga,2015,2333,4211,1878,80.49721388769824
Rahuri,Onion,2014,136,2014,1878,1380.8823529411766
Sangli-Phale Bhajipalam,Grapes,2016,1036,2914,1878,181.27413127413126
Solapur,RIDGE GOURD,2016,721,2598,1877,260.33287101248266
Mangalwedha,Bitter Gourd,2015,1419,3296,1877,132.27625088090204
Sangli-Phale Bhajipalam,Onion,2015,500,2377,1877,375.4
Kolhapur,Green Chilli,2015,1409,3286,1877,133.21504613200852
Nandgaon Khandeshwar,Black Gram,2015,8650,10527,1877,21.69942196531792
Pune,Ladies Finger,2016,1244,3120,1876,150.80385852090032
Ahmednagar,Ghevda,2016,3250,5125,1875,57.69230769230769
Pune,Ridge Gourd,2015,3000,4875,1875,62.5
Sangli-Phale Bhajipalam,Custard Apple,2015,625,2500,1875,300.0
Pune,TURMERIC,2016,14000,15875,1875,13.392857142857142
Baramati,Gram,2016,5467,7342,1875,34.29668922626669
Ramtek,Garlic,2016,6625,8500,1875,28.30188679245283
Chandrapur,MOSAMBI,2016,4250,6125,1875,44.11764705882353
Indapur-Bhigwan,Cowpea,2016,3251,5126,1875,57.67456167333128
Anajngaon Surji,Chillies(Red),2015,8125,10000,1875,23.076923076923077
Nagpur,Custard Apple,2016,1125,3000,1875,166.66666666666666
Mangalwedha,Cucumber,2015,858,2733,1875,218.53146853146853
Ahmednagar,Ghosali(Bhaji),2015,875,2750,1875,214.28571428571428
Mumbai,Shevga,2015,6067,7941,1874,30.888412724575574
Tuljapur,Black Gram,2014,4033,5907,1874,46.46665013637491
Kurdwadi-Modnimb,Pigeon Pea (Tur),2015,3804,5678,1874,49.26393270241851
Majalgaon,Pigeon Pea (Tur),2015,4550,6424,1874,41.18681318681319
Sangali,Green Gram,2016,6668,8542,1874,28.104379124175164
Amarawati,BLACK GRAM,2016,4652,6525,1873,40.26225279449699
Chandur Bajar,Gram,2016,5625,7498,1873,33.297777777777775
Ahmedpur,Pigeon Pea (Tur),2015,8805,10678,1873,21.27200454287337
Rahuri-Vambori,Green Gram,2014,4937,6809,1872,37.917763824184725
Mangalwedha,Tomato,2014,328,2200,1872,570.7317073170732
Kolhapur,Brinjal,2016,422,2294,1872,443.6018957345972
Aurangabad,Green Chilli,2015,1976,3848,1872,94.73684210526316
Nashik,Lemon,2016,2435,4306,1871,76.83778234086242
Nandgaon,Gram,2016,2400,4271,1871,77.95833333333333
Ahmednagar,Brinjal,2016,629,2500,1871,297.456279809221
Pune,Cluster Bean,2015,1281,3152,1871,146.05776736924278
Chikhali,Pigeon Pea (Tur),2016,7288,9158,1870,25.658616904500548
Mangaon(Bhadav),Rice(Paddy-Hus),2016,1854,3723,1869,100.80906148867314
Karad,Mosambi,2014,3545,5414,1869,52.722143864598024
Kalyan,Rice(Paddy-Hus),2016,2393,4261,1868,78.06101128290848
Akluj,Garlic,2015,3816,5684,1868,48.9517819706499
Mangalwedha,Bitter Gourd,2014,1396,3264,1868,133.810888252149
Kolhapur,Orange,2016,5133,7000,1867,36.37249172024158
Mangaon(Bhadav),Nagali,2015,1300,3167,1867,143.6153846153846
Loha,Turmeric,2016,6300,8167,1867,29.634920634920636
Sangrampur,Green Gram,2015,5333,7200,1867,35.00843802737671
Kolhapur,Awala,2016,983,2850,1867,189.9287894201424
Kamthi,Amla,2015,800,2667,1867,233.375
Khed,Cluster Bean,2016,3167,5033,1866,58.92011367224503
Devala,Onion,2015,1521,3387,1866,122.68244575936883
Pimpalgaon Basawant,Tomato,2014,459,2325,1866,406.5359477124183
Jalgaon Jamod-Aasalgaon,Pigeon Pea (Tur),2015,7067,8933,1866,26.40441488609028
Solapur,Onion,2015,107,1972,1865,1742.9906542056074
Aurangabad,Mango,2016,2585,4450,1865,72.14700193423597
Chandvad,Zendu,2016,507,2372,1865,367.8500986193294
Majalgaon,Pigeon Pea (Tur),2015,5177,7042,1865,36.024724744060265
Pune,Mango(Raw),2016,1935,3800,1865,96.38242894056847
Jalgaon,Lemon,2016,1468,3332,1864,126.97547683923706
Karad,Pomegranate,2015,3636,5500,1864,51.265126512651264
Pune,Squash Gourd,2016,2795,4659,1864,66.69051878354205
Latur,Black Gram,2015,5919,7783,1864,31.491806048318974
Nashik,Tomato,2016,1798,3662,1864,103.67074527252502
Sindi (Selu),Pigeon Pea (Tur),2016,7270,9134,1864,25.63961485557084
Nagpur,Chikoo,2016,1100,2963,1863,169.36363636363637
Sangrampur,Pigeon Pea (Tur),2015,3855,5718,1863,48.326848249027236
Pune,Shevga,2015,1857,3719,1862,100.26925148088314
Akola,GRAM,2016,7220,9082,1862,25.789473684210527
Ahmednagar,Lemon,2015,888,2750,1862,209.6846846846847
Pune,Ghevda,2014,1867,3729,1862,99.73219068023568
Kamthi,Bitter Gourd,2015,1594,3456,1862,116.81304893350062
Kada,Black Gram,2015,8651,10513,1862,21.523523292104958
Pandharpur,Green Chilli,2015,1000,2862,1862,186.2
Chandur Bajar,Pigeon Pea (Tur),2015,7214,9076,1862,25.8109232048794
Nandgaon,Green Gram,2014,4709,6570,1861,39.52006795497982
Sailu,Black Gram,2016,4567,6427,1860,40.72695423691702
Pune,Small Gourd,2014,1040,2900,1860,178.84615384615384
Solapur,Onion,2015,203,2063,1860,916.256157635468
Indapur-Bhigwan,Green Gram,2015,5250,7110,1860,35.42857142857143
Kolhapur,Lemon,2015,711,2570,1859,261.46272855133617
Pusad,Gram,2016,7257,9115,1858,25.602866198153507
Pandharpur,Brinjal,2015,460,2318,1858,403.9130434782609
Pune-Manjri,Cluster Bean,2015,3405,5263,1858,54.56681350954479
Amarawati-Fruit And Vegetables,Grapes,2016,2500,4357,1857,74.28
Koregaon,Ghevda Seed,2015,2786,4643,1857,66.65470208183775
Solapur,Chikoo,2016,638,2495,1857,291.0658307210031
Akluj,Tomato,2016,3000,4857,1857,61.9
Kolhapur,Cluster Bean,2015,1323,3180,1857,140.36281179138322
Kamthi,Ginger (Fresh),2016,3143,5000,1857,59.0836780146357
Pune,Ridge Gourd,2015,2810,4667,1857,66.08540925266904
Ahmednagar,Ghosali(Bhaji),2015,714,2571,1857,260.0840336134454
Pune,Turmeric,2016,11643,13500,1857,15.949497552177274
Nagpur,Chikoo,2016,1150,3007,1857,161.47826086956522
Akluj,Shevga,2015,3357,5214,1857,55.31724754244861
Dhule,Ground Nut Pods (Dry),2016,4415,6271,1856,42.03850509626274
Kolhapur,Carrot,2015,763,2619,1856,243.25032765399737
Khed,Green Chilli,2016,3504,5360,1856,52.96803652968037
Sonpeth,Gram,2016,6443,8299,1856,28.80645661958715
Hinganghat,Pigeon Pea (Tur),2015,7011,8866,1855,26.45842247896163
Rahuri-Vambori,Onion,2014,136,1991,1855,1363.9705882352941
Khamgaon,Pigeon Pea (Tur),2015,5459,7314,1855,33.980582524271846
Pune,Ginger (Fresh),2015,1600,3454,1854,115.875
Ulhasnagar,RICE(PADDY-HUS),2016,3459,5313,1854,53.59930615784909
Chandrapur-Ganjwad,Coriander  ,2014,2038,3892,1854,90.97154072620216
Latur,Pigeon Pea (Tur),2015,8906,10760,1854,20.817426454075903
Karad,Jaggery,2016,3229,5082,1853,57.38618767420254
Nagpur,Chikoo,2016,970,2822,1852,190.9278350515464
Kolhapur,Onion,2015,496,2348,1852,373.38709677419354
Ausa,Coriander (Dry),2014,7450,9301,1851,24.845637583892618
Osmanabad,Bitter Gourd,2015,1267,3117,1850,146.01420678768744
Sangli-Phale Bhajipalam,Chikoo,2016,1150,3000,1850,160.8695652173913
Kalyan,Rice(Paddy-Hus),2015,2680,4530,1850,69.02985074626865
Junnar-Otur,Ghosali(Bhaji),2016,1200,3050,1850,154.16666666666666
Amarawati,Apple,2015,3625,5475,1850,51.03448275862069
Manmad,Green Gram,2015,7392,9242,1850,25.02705627705628
Amarawati,Apple,2015,3150,5000,1850,58.73015873015873
Koregaon,Onion,2015,1375,3225,1850,134.54545454545453
Lasalgaon,Tomato,2014,255,2105,1850,725.4901960784314
Umared,Chillies(Red),2014,3750,5600,1850,49.333333333333336
Nashik,Pomegranate,2014,1850,3700,1850,100.0
Kamthi,Mint,2014,2358,4208,1850,78.45631891433418
Solapur,Bitter Gourd,2014,930,2779,1849,198.81720430107526
Solapur,Bitter Gourd,2016,1547,3395,1848,119.45701357466064
Daryapur,Pigeon Pea (Tur),2016,6902,8750,1848,26.774847870182555
Pune,Ghevda,2014,2640,4488,1848,70.0
Kamthi,Wal Bhaji,2015,1676,3524,1848,110.26252983293556
Nagpur,Chikoo,2016,832,2680,1848,222.1153846153846
Kolhapur,Capsicum,2015,617,2463,1846,299.1896272285251
Kolhapur,Green Chilli,2015,1073,2919,1846,172.04100652376513
Nashik,Ladies Finger,2016,3008,4854,1846,61.369680851063826
Nagpur,Pineapple,2014,1019,2865,1846,181.15799803729146
Karanja,Pigeon Pea (Tur),2015,8099,9944,1845,22.780590196320535
Phaltan,Onion,2015,460,2305,1845,401.0869565217391
Pune-Manjri,Ridge Gourd,2015,2750,4595,1845,67.0909090909091
Jalna,Pigeon Pea (Tur),2015,8587,10432,1845,21.48596715965995
Mumbai,Split Black Gram,2016,14404,16248,1844,12.801999444598723
Kamthi,Flower,2015,1539,3383,1844,119.8180636777128
Kamthi,Flower,2015,1361,3204,1843,135.41513592946362
Jalgaon,Ginger (Fresh),2014,2621,4464,1843,70.31667302556276
Chandrapur-Ganjwad,Garlic,2016,3663,5506,1843,50.313950313950315
Kolhapur,Ginger (Fresh),2015,1671,3514,1843,110.29323758228605
Kolhapur,Ginger (Fresh),2015,2169,4012,1843,84.97003227293683
Pune,Bitter Gourd,2016,2500,4343,1843,73.72
Pune-Manjri,Ladies Finger,2015,2875,4717,1842,64.0695652173913
Nashik,Ground Nut Pods (Dry),2014,2364,4205,1841,77.87648054145517
Akola,Gram,2016,7657,9498,1841,24.043359017892126
Kamthi,Chavli (Shenga ),2016,690,2531,1841,266.81159420289856
Nashik,Green Chilli,2016,3847,5688,1841,47.85547179620483
Pusad,Green Gram,2014,4440,6281,1841,41.46396396396396
Pune-Manjri,Bitter Gourd,2014,2656,4497,1841,69.31475903614458
Chikhali,GRAM,2016,5851,7692,1841,31.464706887711504
Naigaon,Black Gram,2016,5312,7152,1840,34.63855421686747
Kolhapur,Jaggery,2015,2500,4340,1840,73.6
Kamthi,Kanda Pat,2014,2560,4400,1840,71.875
Umared,Rice(Paddy-Hus),2016,2000,3840,1840,92.0
Solapur,Flower,2016,400,2240,1840,460.0
Beed,Green Gram,2015,6101,7940,1839,30.142599573840354
Pune-Manjri,Ridge Gourd,2015,2752,4591,1839,66.82412790697674
Gangapur,Onion,2015,739,2578,1839,248.84979702300407
Majalgaon,Pigeon Pea (Tur),2015,4289,6127,1838,42.85381207740732
Vadgaon Peth,Pavtta,2014,2600,4438,1838,70.6923076923077
Malkapur,Black Gram,2016,5304,7142,1838,34.653092006033184
Basmat,Turmeric,2015,7762,9600,1838,23.67946405565576
Aurangabad,Mosambi,2016,2829,4667,1838,64.96995404736656
Kolhapur,Shepu,2016,1575,3413,1838,116.6984126984127
Jalgaon,Coriander  ,2015,1400,3238,1838,131.28571428571428
Balapur,Pigeon Pea (Tur),2015,4350,6188,1838,42.252873563218394
Pune-Manjri,Ridge Gourd,2014,2374,4211,1837,77.37994945240101
Solapur,Tomato,2015,219,2056,1837,838.8127853881278
Mumbai,Garlic,2015,3270,5107,1837,56.17737003058104
Akole,Onion,2014,238,2075,1837,771.8487394957983
Rahuri-Vambori,Onion,2014,155,1991,1836,1184.516129032258
Kolhapur-Laxmipuri,Sorgum(Jawar),2016,1725,3560,1835,106.3768115942029
Pune,Carrot,2014,740,2575,1835,247.97297297297297
Nashik,Tomato,2015,904,2739,1835,202.9867256637168
Satara,Garlic,2015,1833,3667,1834,100.0545553737043
Osmanabad,Capsicum,2016,2333,4167,1834,78.6112301757394
Majalgaon,Sesamum,2014,9254,11088,1834,19.818456883509832
Ahmednagar,Capsicum,2016,1333,3167,1834,137.58439609902476
Ratanagari,Capsicum,2016,4333,6167,1834,42.32633279483037
Indapur-Bhigwan,Chillies(Red),2015,7333,9167,1834,25.010227737624437
Karmala,Black Gram,2016,5600,7434,1834,32.75
Karad,Pomegranate,2016,3875,5708,1833,47.303225806451614
Mumbai,Betelnuts,2016,30167,32000,1833,6.076175953856864
Sangali,Black Gram,2015,4500,6333,1833,40.733333333333334
Umared,Chillies(Red),2015,5500,7333,1833,33.32727272727273
Pune,Squash Gourd,2015,2667,4500,1833,68.7289088863892
Kalyan,Gr.Nut Kernels,2016,6667,8500,1833,27.493625318734065
Rahuri,Ladies Finger,2016,200,2033,1833,916.5
Palus,Capsicum,2016,2867,4700,1833,63.9344262295082
Kolhapur,Pineapple,2015,1167,3000,1833,157.0694087403599
Pune-Manjri,Cabbage,2015,146,1979,1833,1255.4794520547946
Nashik,Cluster Bean,2016,4167,6000,1833,43.988480921526275
Kamthi,Mint,2015,2000,3833,1833,91.65
Mumbai-Onion And Potato Mkt,Garlic,2016,5927,7760,1833,30.926269613632527
Pune-Manjri,Squash Gourd,2016,3571,5404,1833,51.3301596191543
Pune-Manjri,Coriander  ,2015,900,2733,1833,203.66666666666666
Osmanabad,Shevga,2016,4817,6650,1833,38.052729914884786
Lonand,Onion,2015,2611,4444,1833,70.2029873611643
Rahuri,Kharbuj,2016,413,2245,1832,443.5835351089588
Hinganghat,Pigeon Pea (Tur),2015,8690,10522,1832,21.081703107019564
Dhule,Pigeon Pea (Tur),2016,5524,7355,1831,33.14627081824764
Junnar-Otur,Ladies Finger,2016,1875,3706,1831,97.65333333333334
Nashik,Mosambi,2016,1710,3540,1830,107.01754385964912
Solapur,Capsicum,2016,2890,4720,1830,63.32179930795848
Solapur,Ladies Finger,2015,510,2340,1830,358.8235294117647
Pune-Manjri,Pavtta,2016,3544,5374,1830,51.636568848758465
Osmanabad,Ladies Finger,2016,1490,3320,1830,122.81879194630872
Mumbai,Spilt Gerrn Gram,2015,9185,11015,1830,19.923788786064236
Ahmednagar,Cucumber,2016,550,2379,1829,332.54545454545456
Kolhapur,Cluster Bean,2015,1113,2942,1829,164.33063791554358
Kamthi,Green-Peas,2014,2171,4000,1829,84.24689083371717
Pandharpur,Onion,2015,474,2303,1829,385.86497890295357
Osmanabad,Cluster Bean,2015,1742,3571,1829,104.99425947187142
Mumbai,Grapes,2015,2825,4654,1829,64.7433628318584
Dondaicha,Ground Nut Pods (Dry),2016,3828,5656,1828,47.7533960292581
Amarawati-Fruit And Vegetables,Green Chilli,2016,2986,4814,1828,61.21902210314802
Chandvad,Onion,2015,1243,3071,1828,147.06355591311345
Mandhal,Chillies(Red),2016,6528,8356,1828,28.002450980392158
Pune,Small Gourd,2014,1286,3114,1828,142.1461897356143
Dhule,Green Gram,2015,6261,8088,1827,29.180642069956875
Jalgaon,Chavli (Shenga ),2016,3206,5033,1827,56.98689956331878
Ratanagari,Tomato,2016,2895,4721,1826,63.07426597582038
Pune,Ghosali(Bhaji),2016,2326,4152,1826,78.50386930352536
Latur,Pigeon Pea (Tur),2015,8792,10618,1826,20.768880800727935
Pune,Shevga,2016,3000,4826,1826,60.86666666666667
Nira-Saswad,Ghevda Seed,2016,3500,5326,1826,52.17142857142857
Nagpur,Chikoo,2016,1416,3242,1826,128.954802259887
Ahmednagar,Green Chilli,2015,2000,3825,1825,91.25
Kalyan,Rice(Paddy-Hus),2016,2525,4350,1825,72.27722772277228
Kamthi,Beet Root,2015,1675,3500,1825,108.95522388059702
Aurangabad,Grapes,2015,2350,4175,1825,77.65957446808511
Varud-Rajura Bazar,Pigeon Pea (Tur),2016,5851,7676,1825,31.19124935908392
Vai,Turmeric,2016,9103,10928,1825,20.048335713501043
Jalgaon,Mosambi,2016,1725,3550,1825,105.79710144927536
Rahuri,Onion,2014,167,1992,1825,1092.814371257485
Solapur,Mula Shenga,2014,1850,3675,1825,98.64864864864865
Jalna,BLACK GRAM,2016,5120,6945,1825,35.64453125
Kamthi,Spinach,2015,1256,3080,1824,145.22292993630575
Kamthi,Bitter Gourd,2015,1636,3460,1824,111.49144254278728
Nashik,Bitter Gourd,2014,2196,4020,1824,83.06010928961749
Nandurbar,Sunflower,2015,3980,5804,1824,45.82914572864322
Mangalwedha,Ladies Finger,2014,1416,3240,1824,128.8135593220339
Nashik,Ladies Finger,2015,1469,3292,1823,124.09802586793737
Nashik,Ghevda,2016,4426,6248,1822,41.165838228648894
Kalyan,Rice(Paddy-Hus),2016,2089,3911,1822,87.21876495931068
Ahmednagar,Black Gram,2016,5221,7043,1822,34.8975292089638
Jalgaon,Green Chilli,2016,2774,4596,1822,65.68132660418169
Nashik,CORIANDER ,2016,975,2797,1822,186.87179487179486
Manwat,Pigeon Pea (Tur),2015,5067,6889,1822,35.95816064732583
Lasalgaon,BLACK GRAM,2016,3965,5787,1822,45.95208070617907
Sangrampur-Varvatbakal,Pigeon Pea (Tur),2015,5964,7786,1822,30.549966465459423
Barshi,Onion,2015,155,1976,1821,1174.8387096774193
Taloda,Gram,2015,3503,5324,1821,51.98401370254068
Pune-Manjri,Green Chilli,2014,2711,4532,1821,67.17078568793804
Bhivandi,Rice(Paddy-Hus),2016,2375,4195,1820,76.63157894736842
Mangaon(Bhadav),Rice(Paddy-Hus),2016,1811,3631,1820,100.49696300386526
Mehkar,Pigeon Pea (Tur),2015,7528,9348,1820,24.176408076514345
Pune,Capsicum,2016,3540,5360,1820,51.41242937853107
Mangalwedha,RIDGE GOURD,2016,715,2535,1820,254.54545454545453
Solapur,Chikoo,2016,593,2413,1820,306.91399662731874
Mumbai,Apple,2015,3060,4880,1820,59.47712418300654
Pandharpur,Capsicum,2015,1019,2838,1819,178.50834151128558
Nilanga,Green Gram,2014,4878,6697,1819,37.28987289872899
Mangalwedha,Tomato,2015,285,2104,1819,638.2456140350877
Kamthi,Mango,2015,636,2455,1819,286.0062893081761
Nashik,Bitter Gourd,2016,3210,5029,1819,56.666666666666664
Mumbai-Fruit Market,Custard Apple,2016,3409,5227,1818,53.329422117923144
Rahuri,Orange,2015,204,2021,1817,890.6862745098039
Kolhapur-Laxmipuri,Sorgum(Jawar),2015,1726,3543,1817,105.27230590961761
Nandura,Sesamum,2014,8883,10700,1817,20.454801305865136
Solapur,Cucumber,2015,333,2150,1817,545.6456456456457
Kamthi,Brinjal,2015,855,2672,1817,212.51461988304092
Kurdwadi,Black Gram,2016,4083,5900,1817,44.50159196669116
Nashik,Ladies Finger,2014,1639,3456,1817,110.86028065893838
Mumbai,Tomato,2014,1440,3256,1816,126.11111111111111
Pune,Brinjal,2016,1324,3140,1816,137.16012084592145
Nandurbar,Ground Nut Pods (Dry),2015,3107,4923,1816,58.44866430640489
Junnar-Otur,Walvad,2016,1654,3470,1816,109.79443772672309
Mumbai,Green Chilli,2015,3008,4823,1815,60.339095744680854
Kopargaon,Gram,2014,2307,4122,1815,78.67360208062419
Vadgaon Peth,Ridge Gourd,2014,2097,3912,1815,86.55221745350501
Mangaon(Bhadav),RICE(PADDY-HUS),2016,1813,3627,1814,100.05515719801434
Baramati,Ground Nut Pods (Dry),2015,3900,5714,1814,46.51282051282051
Solapur,Bitter Gourd,2014,1536,3350,1814,118.09895833333333
Nandgaon,Wheat(Husked),2015,1574,3388,1814,115.24777636594663
Mumbai,Green Peas (Dry),2015,2564,4377,1813,70.70982839313572
Kamthi,Tomato,2016,1747,3560,1813,103.77790497996565
Kolhapur,Onion,2015,968,2781,1813,187.29338842975207
Mumbai,Split Black Gram,2015,9654,11467,1813,18.779780401905946
Kolhapur-Laxmipuri,Sorgum(Jawar),2016,1708,3521,1813,106.14754098360656
Jamner-Neri,Black Gram,2015,6824,8637,1813,26.56799531066823
Pune,Walvad,2016,3000,4813,1813,60.43333333333333
Kamthi,Dhemse,2014,2187,4000,1813,82.8989483310471
Pune,Bitter Gourd,2016,2771,4583,1812,65.3915553951642
Mumbai,Fenugreek,2015,8659,10471,1812,20.926203949647764
Vaijapur,Onion,2015,933,2744,1811,194.10503751339763
Pune-Manjri,Ambat Chuka,2016,33,1844,1811,5487.878787878788
Pune-Manjri,Coriander  ,2014,1333,3144,1811,135.8589647411853
Pune-Manjri,Cluster Bean,2014,1995,3805,1810,90.72681704260651
Solapur,Bitter Gourd,2015,1297,3107,1810,139.5528141865844
Daryapur,Black Gram,2015,7104,8914,1810,25.478603603603602
Jintur,Black Gram,2015,8784,10594,1810,20.605646630236794
Sangali,Black Gram,2016,7265,9075,1810,24.91397109428768
Shirpur,Onion,2015,586,2396,1810,308.8737201365188
Sinner,Onion,2015,253,2062,1809,715.0197628458498
Mangaon(Bhadav),Rice(Paddy-Hus),2016,1852,3661,1809,97.67818574514038
Mumbai,Green Peas (Dry),2015,2783,4592,1809,65.00179662234999
Satara,Capsicum,2014,2262,4071,1809,79.973474801061
Nashik,Squash Gourd,2016,3262,5071,1809,55.45677498467198
Pune-Manjri,Squash Gourd,2016,2623,4432,1809,68.9668318719024
Pune-Manjri,Pavtta,2015,3174,4983,1809,56.99432892249527
Kolhapur-Laxmipuri,Sorgum(Jawar),2016,1776,3585,1809,101.85810810810811
Pandharpur,Capsicum,2016,2600,4408,1808,69.53846153846153
Mangalwedha,Ridge Gourd,2015,565,2373,1808,320.0
Manchar,Coriander  ,2015,287,2095,1808,629.9651567944251
Pune-Manjri,Cabbage,2016,192,2000,1808,941.6666666666666
Mangaon(Bhadav),Rice(Paddy-Hus),2016,1864,3671,1807,96.94206008583691
Pune,Walvad,2016,2808,4615,1807,64.35185185185185
Mehkar,Black Gram,2015,7112,8919,1807,25.407761529808774
Akluj,Bitter Gourd,2016,2244,4050,1806,80.4812834224599
Pune,Ridge Gourd,2015,2309,4114,1805,78.17236899090516
Pune,Walvad,2016,2643,4448,1805,68.29360575104049
Solapur,Chillies(Red),2016,11220,13025,1805,16.087344028520498
Manmad,Onion,2015,1338,3142,1804,134.82810164424515
Pune,Bitter Gourd,2016,2957,4761,1804,61.007778153533984
Aurangabad,Mosambi,2016,2463,4267,1804,73.2440113682501
Pune-Manjri,Cabbage,2015,196,2000,1804,920.4081632653061
Indapur-Bhigwan,Gram,2016,7367,9170,1803,24.474005701099497
Indapur-Bhigwan,Cowpea,2015,3683,5484,1801,48.90035297311974
Junnar-Otur,Brinjal,2016,768,2569,1801,234.50520833333334
Jalna-Badnapur,Sorgum(Jawar),2014,1250,3051,1801,144.08
Sangali,Horse Gram,2015,1800,3600,1800,100.0
Rahuri,Chikoo,2016,494,2294,1800,364.3724696356275
Pune-Manjri,Other Vegetables,2016,0,1800,1800,inf
Pune,Ginger (Fresh),2015,1600,3400,1800,112.5
Palus,Brinjal,2016,2625,4425,1800,68.57142857142857
Pune-Manjri,Other Vegetables,2014,0,1800,1800,inf
Indapur,GRAM,2016,7500,9300,1800,24.0
Pune-Manjri,Mint,2014,0,1800,1800,inf
Sangali,Horse Gram,2015,2200,4000,1800,81.81818181818181
Pune-Manjri,Mint,2014,0,1800,1800,inf
Pune-Manjri,Other Vegetables,2016,0,1800,1800,inf
Kolhapur-Malkapur,Capsicum,2016,700,2500,1800,257.14285714285717
Sangali,Pigeon Pea (Tur),2016,5200,7000,1800,34.61538461538461
Pune-Manjri,Other Vegetables,2014,0,1800,1800,inf
Newasa-Ghodegaon,Onion,2014,342,2142,1800,526.3157894736842
Solapur,Apple,2016,450,2250,1800,400.0
Pune-Manjri,Mint,2015,0,1800,1800,inf
Pune-Manjri,Mint,2015,0,1800,1800,inf
Kada (Ashti),BLACK GRAM,2016,5350,7150,1800,33.64485981308411
Pune-Manjri,Mint,2015,0,1800,1800,inf
Karad,Grapes,2016,3280,5080,1800,54.8780487804878
Pune-Manjri,Mint,2015,0,1800,1800,inf
Nira-Saswad,Gram,2015,4200,6000,1800,42.857142857142854
Kamthi,Coriander  ,2016,2045,3845,1800,88.01955990220048
Pune-Manjri,Mint,2015,0,1800,1800,inf
Ralegaon,Gram,2016,3700,5500,1800,48.648648648648646
Chandrapur,Bor,2016,1000,2800,1800,180.0
Chandur Bajar,Pigeon Pea (Tur),2015,8000,9800,1800,22.5
Indapur-Bhigwan,Matki,2016,5700,7500,1800,31.57894736842105
Pune-Manjri,Other Vegetables,2015,0,1800,1800,inf
Pune-Manjri,Other Vegetables,2015,0,1800,1800,inf
Pune-Manjri,Mint,2014,0,1800,1800,inf
Pune-Manjri,Mint,2015,0,1800,1800,inf
Mumbai,Brinjal,2016,769,2569,1800,234.0702210663199
Dound,Green Gram,2014,6200,8000,1800,29.032258064516128
Sangali,Pigeon Pea (Tur),2015,4700,6500,1800,38.297872340425535
Pune-Manjri,Mint,2015,0,1800,1800,inf
Pune-Manjri,Mint,2015,0,1800,1800,inf
Pune-Manjri,Mint,2015,0,1800,1800,inf
Akot,Thymol/Lovage,2015,7500,9300,1800,24.0
Pune-Manjri,Mint,2015,0,1800,1800,inf
Pune-Manjri,Mint,2016,0,1800,1800,inf
Pune-Manjri,Mint,2015,0,1800,1800,inf
Pune-Manjri,Mint,2016,0,1800,1800,inf
Dharmabad,Coriander (Dry),2016,7210,9010,1800,24.965325936199722
Dhule,Chillies(Red),2014,2500,4300,1800,72.0
Chandrapur,ORANGE,2016,733,2533,1800,245.56616643929058
Lasalgaon,Green Gram,2015,5001,6801,1800,35.99280143971206
Pune-Manjri,Mint,2016,0,1800,1800,inf
Manchar,Beet Root,2016,200,2000,1800,900.0
Pathardi,Onion,2015,750,2550,1800,240.0
Mangaon(Bhadav),Nachani,2015,1343,3143,1800,134.02829486224869
Pune-Manjri,Other Vegetables,2015,0,1800,1800,inf
Amarawati,Black Gram,2015,7022,8822,1800,25.63372258615779
Junnar (Narayangaon),Flower,2016,301,2101,1800,598.0066445182724
Jalgaon,Mosambi,2015,1067,2867,1800,168.69728209934397
Pune-Manjri,Other Vegetables,2015,0,1800,1800,inf
Jalgaon,Mosambi,2015,1950,3750,1800,92.3076923076923
Pune,Pavtta,2016,2861,4661,1800,62.91506466270535
Junnar-Otur,Chavli (Shenga ),2016,1000,2800,1800,180.0
Pune-Manjri,Other Vegetables,2014,0,1800,1800,inf
Kolhapur,Shevga,2015,1613,3413,1800,111.59330440173589
Kej,Black Gram,2016,6501,8301,1800,27.68804799261652
Pune-Manjri,Brinjal,2016,2100,3900,1800,85.71428571428571
Pune-Manjri,Other Vegetables,2016,0,1800,1800,inf
Pune-Manjri,Other Vegetables,2016,0,1800,1800,inf
Ramtek,Chillies(Red),2015,5950,7750,1800,30.252100840336134
Kalyan,Green Peas (Dry),2015,3200,5000,1800,56.25
Pune,Double Bee,2016,3800,5600,1800,47.36842105263158
Solapur,Bitter Gourd,2015,1546,3346,1800,116.42949547218629
Satana,Pigeon Pea (Tur),2015,7000,8800,1800,25.714285714285715
Pune-Manjri,Mint,2014,0,1800,1800,inf
Kalyan,Gulchadi,2016,8800,10600,1800,20.454545454545453
Ramtek,Chillies(Red),2016,7000,8800,1800,25.714285714285715
Pune-Manjri,Other Vegetables,2015,0,1800,1800,inf
Nira-Saswad,Gram,2016,4120,5920,1800,43.689320388349515
Pune-Manjri,Shepu,2016,1543,3343,1800,116.65586519766688
Pune-Manjri,Other Vegetables,2015,0,1800,1800,inf
Junnar-Otur,Farshi,2016,1425,3225,1800,126.3157894736842
Pune-Manjri,Other Vegetables,2015,0,1800,1800,inf
Pune,Brinjal,2016,1800,3600,1800,100.0
Jalgaon,Garlic,2014,1533,3333,1800,117.41682974559687
Pune-Manjri,Other Vegetables,2015,0,1800,1800,inf
Pune-Manjri,Other Vegetables,2015,0,1800,1800,inf
Pune-Manjri,Other Vegetables,2015,0,1800,1800,inf
Pandharpur,Chillies(Red),2014,1700,3500,1800,105.88235294117646
Pune-Manjri,Other Vegetables,2015,0,1800,1800,inf
Koregaon,Green Gram,2014,6000,7800,1800,30.0
Ausa,Ground Nut Pods (Dry),2015,3202,5001,1799,56.18363522798251
Kurdwadi-Modnimb,Black Gram,2015,6201,8000,1799,29.01144976616675
Pandharpur,Brinjal,2016,509,2307,1798,353.2416502946955
Khamgaon,Gram,2016,6242,8040,1798,28.80487023389939
Nashik,Bitter Gourd,2016,2919,4717,1798,61.596437136005484
Solapur,Cucumber,2016,341,2139,1798,527.2727272727273
Sangrampur-Varvatbakal,Pigeon Pea (Tur),2016,6110,7908,1798,29.427168576104748
Solapur,Brinjal,2015,495,2292,1797,363.030303030303
Latur,Black Gram,2014,4182,5979,1797,42.96987087517934
Osmanabad,Ladies Finger,2016,1248,3045,1797,143.9903846153846
Dhule,Ground Nut Pods (Dry),2016,4330,6126,1796,41.47806004618938
Kolhapur,Ground Nut Pods (Dry),2015,1725,3521,1796,104.1159420289855
Pune,Ladies Finger,2015,930,2725,1795,193.01075268817203
Pune,Ginger (Fresh),2015,1562,3357,1795,114.91677336747759
Vadgaon Peth,Green Chilli,2016,2088,3882,1794,85.91954022988506
Akole,Onion,2014,186,1980,1794,964.516129032258
Kolhapur,CUCUMBER,2016,456,2250,1794,393.42105263157896
Risod,Turmeric,2016,7072,8866,1794,25.36764705882353
Junnar-Otur,Maize(Corn.),2016,1813,3606,1793,98.89685603971319
Dhamangaon-Rly,Black Gram,2016,4258,6051,1793,42.10897134805073
Pune-Manjri,Ladies Finger,2016,2993,4786,1793,59.90644837955229
Kamthi,Wal Bhaji,2015,1765,3558,1793,101.58640226628896
Pune-Manjri,Brinjal,2016,2446,4239,1793,73.30335241210139
Pune-Manjri,Cluster Bean,2016,3385,5177,1792,52.93943870014771
Nashik,Capsicum,2016,3076,4868,1792,58.25747724317295
Pune,Chillies(Red),2016,13729,15521,1792,13.052662247796635
Gevrai,Green Gram,2014,5464,7256,1792,32.796486090775986
Nashik,Cluster Bean,2016,4082,5873,1791,43.87555120039197
Osmanabad,Bitter Gourd,2015,1917,3708,1791,93.42723004694835
Pune-Manjri,Tomato,2015,1483,3274,1791,120.76871207012812
Savner,Pigeon Pea (Tur),2016,6624,8415,1791,27.03804347826087
Dudhani,Green Gram,2014,4684,6475,1791,38.23654995730145
Katol,Ground Nut Pods (Dry),2015,3852,5643,1791,46.495327102803735
Malegaon,Green Gram,2016,5704,7495,1791,31.399018232819074
Solapur,Ladies Finger,2014,592,2383,1791,302.5337837837838
Lasalgaon,Gram,2016,2676,4466,1790,66.89088191330343
Solapur,Ridge Gourd,2014,438,2228,1790,408.675799086758
Akot,BLACK GRAM,2016,4958,6748,1790,36.10326744655103
Aurangabad,Grapes,2015,2080,3870,1790,86.0576923076923
Kamthi,Capsicum,2014,3895,5684,1789,45.93068035943517
Baramati,Onion,2016,325,2114,1789,550.4615384615385
Pune-Moshi,Chavli (Shenga ),2016,2095,3884,1789,85.39379474940334
Nandurbar,Sunflower,2016,3012,4801,1789,59.39575033200531
Yeotmal,Pigeon Pea (Tur),2015,7124,8913,1789,25.112296462661426
Shirpur,Chillies(Red),2016,2753,4541,1788,64.94733018525245
Kolhapur,Bitter Gourd,2015,1459,3247,1788,122.5496915695682
Aurangabad,Ginger (Fresh),2015,2025,3813,1788,88.29629629629629
Chandvad,Onion,2015,629,2417,1788,284.26073131955485
Pandharpur,Cucumber,2014,583,2370,1787,306.5180102915952
Aurangabad,Onion,2015,2194,3981,1787,81.44940747493163
Dhule,Chillies(Red),2015,2576,4363,1787,69.37111801242236
Nashik,Bitter Gourd,2016,4258,6045,1787,41.96806012212306
Indapur-Bhigwan,Sesamum,2015,6838,8625,1787,26.133372331090964
Nagpur,Pineapple,2015,1042,2829,1787,171.4971209213052
Pandharpur,Brinjal,2016,507,2293,1786,352.2682445759369
Kamthi,Green Chilli,2016,1893,3679,1786,94.34759640781827
Dhule,Gram,2016,6131,7917,1786,29.130647528951233
Pune,Wal Papdi,2016,2619,4405,1786,68.19396716303933
Pune,Ghosali(Bhaji),2016,2000,3785,1785,89.25
Barshi,Onion,2015,1542,3327,1785,115.75875486381322
Kamthi,Potato,2014,2292,4077,1785,77.87958115183245
Mumbai,Split Black Gram,2014,6547,8332,1785,27.264395906522072
Jalgaon,Ginger (Fresh),2015,2467,4252,1785,72.35508715038509
Nanded,Turmeric,2015,7068,8852,1784,25.24052065647991
Pune-Manjri,Custard Apple,2015,1344,3128,1784,132.73809523809524
Mangaon(Bhadav),Rice(Paddy-Hus),2014,1850,3633,1783,96.37837837837837
Jamkhed,Onion,2014,111,1894,1783,1606.3063063063064
Pune,Brinjal,2016,967,2750,1783,184.3846949327818
Ahmednagar,Ghevda,2016,1339,3122,1783,133.15907393577297
Kamthi,Cucumber,2015,992,2775,1783,179.73790322580646
Kolhapur,Cluster Bean,2015,1691,3474,1783,105.44056771141337
Pune,Arvi,2016,2721,4504,1783,65.5273796398383
Sangrampur,Pigeon Pea (Tur),2015,3845,5627,1782,46.34590377113134
Sangamner,Onion,2014,500,2282,1782,356.4
Nanded,Turmeric,2015,6661,8442,1781,26.737727068007807
Nanded,Turmeric,2016,7343,9124,1781,24.254391937900042
Mangalwedha,Green Chilli,2015,2169,3950,1781,82.11157215306594
Lasalgaon-Vinchur,Soybean,2015,2048,3829,1781,86.962890625
Solapur,Bitter Gourd,2016,1663,3444,1781,107.09561034275406
Satana,Gram,2016,6071,7852,1781,29.336188436830835
Dondaicha,Chillies(Red),2016,2808,4589,1781,63.425925925925924
Pune,Squash Gourd,2016,2012,3792,1780,88.46918489065607
Nagpur,ORANGE,2016,1076,2856,1780,165.4275092936803
Ausa,BLACK GRAM,2016,5087,6867,1780,34.99115392176135
Dhule,Pigeon Pea (Tur),2014,3615,5395,1780,49.23928077455049
Kamthi,Kand,2015,920,2700,1780,193.47826086956522
Daryapur,Gram,2016,4877,6656,1779,36.47734262866516
Mangalwedha,Cucumber,2015,1513,3292,1779,117.58096497025777
Mangalwedha,Green Chilli,2015,2404,4183,1779,74.00166389351081
Bhivandi,Rice(Paddy-Hus),2016,2142,3921,1779,83.0532212885154
Sangali,Black Gram,2016,7263,9042,1779,24.494010739363897
Mangalwedha,Ridge Gourd,2015,1342,3121,1779,132.56333830104322
Nagpur,Chikoo,2016,1570,3348,1778,113.2484076433121
Karad,Mosambi,2016,5833,7611,1778,30.481741813817933
Nandura,Black Gram,2016,5582,7360,1778,31.852382658545324
Pune-Manjri,Ridge Gourd,2014,2943,4721,1778,60.41454298335032
Ratanagari,Capsicum,2016,3667,5444,1777,48.45923097900191
Nashik,Brinjal,2016,3773,5550,1777,47.09780015902465
Pune,Small Gourd,2016,1023,2800,1777,173.7047898338221
Pune-Moshi,Garlic,2016,8130,9907,1777,21.857318573185733
Baramati,Gram,2016,6000,7777,1777,29.616666666666667
Mumbai,Brinjal,2014,984,2760,1776,180.4878048780488
Nandura,BLACK GRAM,2016,5062,6838,1776,35.084946661398654
Kej,Pigeon Pea (Tur),2015,7548,9324,1776,23.529411764705884
Kolhapur-Malkapur,Ladies Finger,2016,734,2510,1776,241.96185286103542
Amalner,Green Gram,2014,5140,6916,1776,34.552529182879375
Karanja,Black Gram,2015,8497,10272,1775,20.88972578557138
Junnar-Otur,Farshi,2016,1500,3275,1775,118.33333333333333
Kada,Onion,2015,113,1888,1775,1570.796460176991
Mumbai-Fruit Market,Custard Apple,2016,3100,4875,1775,57.25806451612903
Kolhapur,Orange,2015,1751,3526,1775,101.37064534551685
Rahata,Green Chilli,2016,5142,6917,1775,34.519642162582656
Kolhapur,Spinach,2015,1275,3050,1775,139.2156862745098
Ahmednagar,Bitter Gourd,2015,1125,2900,1775,157.77777777777777
Palus,Squash Gourd,2016,3100,4875,1775,57.25806451612903
Jalgaon Jamod-Aasalgaon,BLACK GRAM,2016,4125,5900,1775,43.03030303030303
Akola,Black Gram,2016,9850,11625,1775,18.02030456852792
Pune,Cluster Bean,2016,1383,3157,1774,128.27187274041938
Nilanga,Pigeon Pea (Tur),2015,8225,9998,1773,21.556231003039514
Chandrapur,PAPAI,2016,1182,2955,1773,150.0
Partur,Black Gram,2015,7817,9590,1773,22.681335550722785
Pune,Ghevda,2015,2211,3984,1773,80.1899592944369
Sangali,Lentil,2014,3964,5736,1772,44.702320887991924
Nagpur,Orange,2016,1050,2821,1771,168.66666666666666
Mangalwedha,Ladies Finger,2015,1783,3554,1771,99.32697700504767
Sangli-Phale Bhajipalam,PINEAPPLE,2016,590,2361,1771,300.1694915254237
Jalgaon Jamod-Aasalgaon,Pigeon Pea (Tur),2015,6500,8271,1771,27.246153846153845
Kolhapur,Ground Nut Pods (Dry),2016,2443,4214,1771,72.49283667621776
Mangaon(Bhadav),Rice(Paddy-Hus),2016,1806,3576,1770,98.00664451827242
Kolhapur-Laxmipuri,Sorgum(Jawar),2016,1751,3521,1770,101.0850942318675
Pune-Manjri,Shepu,2016,1905,3675,1770,92.91338582677166
Satara,Cluster Bean,2016,4269,6038,1769,41.43827594284376
Rahata,Garlic,2015,4769,6538,1769,37.09373034179073
Kamthi,Spinach,2016,1806,3574,1768,97.89590254706533
Pune,Ginger (Fresh),2016,1227,2995,1768,144.09127954360227
Ahmednagar,Lemon,2016,1000,2767,1767,176.7
Nashik,Onion,2015,811,2578,1767,217.87916152897657
Solapur,Mula Shenga,2015,1400,3167,1767,126.21428571428571
Latur-Murud,Gram,2016,3967,5734,1767,44.54247542223342
Kamthi,Carrot,2016,1733,3500,1767,101.96191575302943
Solapur,Bitter Gourd,2015,824,2590,1766,214.32038834951456
Jamkhed,Gram,2016,4667,6433,1766,37.84015427469466
Parner,Onion,2015,957,2723,1766,184.5350052246604
Vaijapur,Onion,2014,160,1925,1765,1103.125
Kamthi,Ladies Finger,2015,896,2661,1765,196.98660714285714
Kille Dharur,Pigeon Pea (Tur),2015,7215,8980,1765,24.462924462924462
Nashik,Green-Peas,2016,4236,6000,1764,41.64305949008499
Indapur,Onion,2015,1436,3200,1764,122.84122562674095
Pune-Moshi,Brinjal,2016,1479,3243,1764,119.26977687626776
Nandurbar,Gram,2016,4001,5764,1763,44.063984003999
Mangaon(Bhadav),Rice(Paddy-Hus),2015,1784,3547,1763,98.82286995515695
Mumbai,Coconut,2014,800,2563,1763,220.375
Pune,Double Bee,2015,2800,4563,1763,62.964285714285715
Nanded,Turmeric,2016,8223,9985,1762,21.427702784871702
Kolhapur-Malkapur,Brinjal,2016,513,2275,1762,343.4697855750487
Solapur,Green Chilli,2014,1221,2983,1762,144.3079443079443
Pathardi,Onion,2015,311,2073,1762,566.5594855305466
Osmanabad,Green Chilli,2015,2188,3950,1762,80.53016453382084
Shirpur,Green Gram,2015,6434,8196,1762,27.385763133354057
Karad,Pomegranate,2016,4196,5957,1761,41.96854146806482
Pune,Shevga,2016,2600,4360,1760,67.6923076923077
Nashik,Ladies Finger,2016,2381,4141,1760,73.91852162956741
Pune,Ghevda,2015,2090,3850,1760,84.21052631578948
Aurangabad,Garlic,2015,1700,3460,1760,103.52941176470588
Barshi-Vairag,Ground Nut Pods (Dry),2016,3845,5605,1760,45.77373211963589
Akola,Rice(Paddy-Hus),2016,3400,5160,1760,51.76470588235294
Osmanabad,Cluster Bean,2015,1342,3100,1758,130.99850968703427
Khamgaon,Gram,2016,4867,6625,1758,36.12081364290117
Ratanagari,Green Chilli,2016,5968,7726,1758,29.45710455764075
Aurangabad,Shevga,2015,3429,5186,1757,51.239428404782736
Lasalgaon,Pigeon Pea (Tur),2016,5700,7457,1757,30.82456140350877
Umared,Rice(Paddy-Hus),2014,2000,3757,1757,87.85
Umarga,Pigeon Pea (Tur),2015,9086,10843,1757,19.337442218798152
Mangaon(Bhadav),Rice(Paddy-Hus),2014,1832,3589,1757,95.9061135371179
Mangalwedha,Ladies Finger,2015,2457,4213,1756,71.46927146927148
Akole,Onion,2014,175,1931,1756,1003.4285714285714
Jamkhed,Onion,2015,163,1919,1756,1077.3006134969326
Chandur Bajar,Pigeon Pea (Tur),2015,5500,7255,1755,31.90909090909091
Pune-Manjri,Green Chilli,2014,2421,4176,1755,72.4907063197026
Kamthi,Bitter Gourd,2015,2828,4583,1755,62.05799151343706
Manchar,Wal Papdi,2016,3250,5005,1755,54.0
Rahuri,Onion,2015,109,1864,1755,1610.091743119266
Kolhapur-Laxmipuri,Spilt Pigeon Pea,2016,13538,15292,1754,12.956123504210371
Mangalwedha,Green Chilli,2015,1915,3669,1754,91.59268929503916
Kurdwadi-Modnimb,Pigeon Pea (Tur),2016,6570,8324,1754,26.69710806697108
Kamthi,Brinjal,2014,1438,3192,1754,121.97496522948539
Mumbai,Ginger (Dry),2015,3969,5723,1754,44.19249181153943
Khamgaon,GRAM,2016,6289,8043,1754,27.88996660836381
Solapur,Cucumber,2014,481,2235,1754,364.65696465696465
Kamthi,Lemon,2014,1477,3231,1754,118.75423155044008
Ratanagari,Brinjal,2016,1541,3294,1753,113.75730045425048
Latur,Wheat(Husked),2015,1699,3452,1753,103.17834020011772
Dhule,Matki,2015,5954,7707,1753,29.442391669465906
Vadgaon Peth,Ridge Gourd,2015,1867,3619,1752,93.84038564542045
Sinner,Rice(Paddy-Hus),2015,1500,3252,1752,116.8
Dhule,Gram,2015,3167,4919,1752,55.32049257972845
Sangrampur-Varvatbakal,Soybean,2015,1825,3577,1752,96.0
Basmat,Turmeric,2014,5577,7328,1751,31.396808319885242
Mangalwedha,Cucumber,2016,469,2220,1751,373.34754797441366
Majalgaon,Pigeon Pea (Tur),2016,7109,8860,1751,24.630749753833168
Karad,Green-Peas,2014,4167,5917,1750,41.9966402687785
Amarawati,Mango,2016,5000,6750,1750,35.0
Rahuri,Guava,2015,250,2000,1750,700.0
Osmanabad,Lemon,2015,1133,2883,1750,154.45719329214475
Palus,Green Chilli,2016,5500,7250,1750,31.818181818181817
Solapur,Capsicum,2015,1250,3000,1750,140.0
Osmanabad,Ginger (Fresh),2015,2500,4250,1750,70.0
Indapur,Sesamum,2016,4963,6713,1750,35.26093088857546
Osmanabad,Flower,2015,1500,3250,1750,116.66666666666667
Osmanabad,Flower,2015,2135,3885,1750,81.9672131147541
Pune,Black Gram,2015,10067,11817,1750,17.38353034667726
Sangali,Pigeon Pea (Tur),2016,7250,9000,1750,24.137931034482758
Karad,Green-Peas,2014,5750,7500,1750,30.434782608695652
Kolhapur,Papai,2016,700,2450,1750,250.0
Kolhapur,Pineapple,2016,950,2700,1750,184.21052631578948
Karad,Garlic,2015,3000,4750,1750,58.333333333333336
Pune,Wal Papdi,2016,3875,5625,1750,45.16129032258065
Jalgaon,Coriander  ,2015,2271,4021,1750,77.05856450902687
Jalgaon,Mosambi,2015,2000,3750,1750,87.5
Sakri,Ground Nut Pods (Dry),2016,3500,5250,1750,50.0
Karad,Pomegranate,2015,2800,4550,1750,62.5
Jamkhed,Onion,2015,117,1867,1750,1495.7264957264956
Ramtek,Chillies(Red),2016,7750,9500,1750,22.580645161290324
Chandrapur-Ganjwad,Coriander  ,2016,1708,3458,1750,102.45901639344262
Rahata,Garlic,2016,4000,5750,1750,43.75
Kalyan,Sesamum,2015,10250,12000,1750,17.073170731707318
Ratanagari,Ground Nut Pods (Dry),2016,4250,6000,1750,41.1764705882353
Phaltan,Gram,2015,3363,5113,1750,52.036871840618495
Osmanabad,Cluster Bean,2015,1500,3250,1750,116.66666666666667
Sangali,Coriander (Dry),2015,9000,10750,1750,19.444444444444443
Ratanagari,Ginger (Fresh),2015,3250,5000,1750,53.84615384615385
Pune-Pimpri,Green Chilli,2015,2875,4625,1750,60.869565217391305
Mehkar,Pigeon Pea (Tur),2016,7579,9329,1750,23.090117429740072
Kolhapur,Green-Peas,2015,6500,8250,1750,26.923076923076923
Indapur-Bhigwan,Black Gram,2016,7800,9550,1750,22.435897435897434
Kolhapur,Kanda Pat,2016,1633,3383,1750,107.16472749540722
Pune-Manjri,CUSTARD APPLE,2016,1939,3689,1750,90.25270758122744
Ahmednagar,Brinjal,2015,950,2700,1750,184.21052631578948
Pune,Turmeric,2016,11650,13400,1750,15.021459227467812
Umared,Gram,2015,3850,5600,1750,45.45454545454545
Pune,Turmeric,2016,11750,13500,1750,14.893617021276595
Ahmednagar,Cluster Bean,2015,2125,3875,1750,82.3529411764706
Kolhapur,Chikoo,2016,1050,2800,1750,166.66666666666666
Ahmednagar,Lemon,2015,1250,3000,1750,140.0
Sangali,Coriander (Dry),2015,7500,9250,1750,23.333333333333332
Pune-Manjri,Methi (Bhaji),2014,817,2567,1750,214.1982864137087
Ratanagari,Ginger (Fresh),2015,4250,6000,1750,41.1764705882353
Ahmednagar,Lemon,2015,833,2583,1750,210.08403361344537
Ratanagari,Green-Peas,2015,6750,8500,1750,25.925925925925927
Beed,Black Gram,2015,7384,9133,1749,23.6863488624052
Manmad,Green Gram,2014,5364,7113,1749,32.60626398210291
Shahada,Black Gram,2015,6505,8254,1749,26.887009992313605
Barshi,Brinjal,2016,2416,4163,1747,72.30960264900662
Dhule,Gram,2016,2971,4718,1747,58.80175025244026
Sangamner,Onion,2014,500,2247,1747,349.4
Ahmednagar,Onion,2016,200,1947,1747,873.5
Mumbai,Small Gourd,2016,1474,3221,1747,118.52103120759837
Majalgaon,Green Gram,2015,6369,8116,1747,27.429737792432093
Mangalwedha,Ladies Finger,2015,506,2252,1746,345.05928853754943
Kalmeshwar,Green Chilli,2016,3723,5469,1746,46.897663174858984
Nandgaon,Green Gram,2015,7147,8893,1746,24.429830698195047
Lasur Station,Onion,2014,171,1917,1746,1021.0526315789474
Mumbai,Orange,2015,912,2658,1746,191.44736842105263
Pimpalgaon Basawant,Onion,2015,1783,3528,1745,97.86876051598429
Jalgaon,Coriander  ,2015,1715,3460,1745,101.74927113702624
Khamgaon,Black Gram,2016,8199,9944,1745,21.28308330284181
Ghoti,Tomato,2014,1710,3455,1745,102.046783625731
Dhule,Ground Nut Pods (Dry),2015,3064,4809,1745,56.95169712793734
Nashik,Shahale ,2016,1641,3385,1744,106.27666057282146
Akkolkot,Black Gram,2014,4854,6598,1744,35.92913061392666
Mangalwedha,BRINJAL,2016,186,1930,1744,937.6344086021505
Aurangabad,Ginger (Fresh),2014,2378,4122,1744,73.33894028595458
Junnar-Otur,Capsicum,2016,1714,3457,1743,101.69194865810968
Murtizapur,Black Gram,2016,5564,7307,1743,31.326383896477353
Kamthi,Onion,2015,829,2571,1742,210.13268998793728
Kamthi,Cucumber,2014,2008,3750,1742,86.75298804780877
Nandura,Sesamum,2014,9897,11639,1742,17.60129332120845
Shrirampur,Onion,2014,258,2000,1742,675.1937984496124
Shrirampur,Onion,2014,259,2000,1741,672.2007722007722
Pune-Manjri,Brinjal,2014,2312,4053,1741,75.30276816608996
Mumbai,Cowpea,2016,4800,6541,1741,36.270833333333336
Phaltan,Cluster Bean,2016,2033,3773,1740,85.58780127889818
Kolhapur,Orange,2016,3900,5640,1740,44.61538461538461
Pune-Manjri,Mint,2016,0,1740,1740,inf
Rahata,Garlic,2015,6010,7750,1740,28.951747088186355
Junnar (Narayangaon),Coriander  ,2016,620,2360,1740,280.64516129032256
Karad,Mosambi,2016,4520,6260,1740,38.49557522123894
Solapur,Chikoo,2015,743,2483,1740,234.18573351278602
Jintur,Turmeric,2015,5661,7400,1739,30.718954248366014
Kolhapur,Bitter Gourd,2016,2582,4321,1739,67.35089078233928
Mangaon(Bhadav),Rice(Paddy-Hus),2015,1800,3539,1739,96.61111111111111
Sangamner,Onion,2014,500,2239,1739,347.8
Akola,Black Gram,2015,9695,11434,1739,17.937080969571944
Mumbai,Green-Peas,2016,3135,4873,1738,55.43859649122807
Kamthi,Coriander  ,2016,3069,4807,1738,56.630824372759854
Risod,Turmeric,2016,5375,7113,1738,32.334883720930236
Mangaon(Bhadav),Nagali,2015,1325,3063,1738,131.16981132075472
Kolhapur,Ground Nut Pods (Dry),2015,1848,3586,1738,94.04761904761905
Aurangabad,Grapes,2015,2556,4294,1738,67.99687010954617
Chandrapur-Ganjwad,Green Chilli,2016,2737,4474,1737,63.46364632809646
Washim,Black Gram,2016,8420,10157,1737,20.629453681710213
Pathari,Sorgum(Jawar),2016,0,1737,1737,inf
Chikhali,BLACK GRAM,2016,5424,7161,1737,32.02433628318584
Hingoli,Black Gram,2015,9466,11203,1737,18.349883794633424
Dhule,Pigeon Pea (Tur),2016,6636,8372,1736,26.160337552742615
Barshi,Lemon,2016,2911,4647,1736,59.63586396427345
Kolhapur,Bitter Gourd,2015,1005,2741,1736,172.7363184079602
Pune,Green Chilli,2016,2348,4083,1735,73.89267461669506
Nagpur,Pineapple,2015,1023,2758,1735,169.59921798631476
Pune-Manjri,Brinjal,2015,1743,3478,1735,99.54102122776821
Jalgaon,Chikoo,2016,1633,3367,1734,106.1849357011635
Sengaon,Pigeon Pea (Tur),2015,7650,9384,1734,22.666666666666668
Pune-Manjri,Bitter Gourd,2015,3344,5078,1734,51.854066985645936
Osmanabad,Tomato,2015,1033,2767,1734,167.86060019361085
Pune-Manjri,Ghevda,2015,1590,3323,1733,108.99371069182389
Latur,Black Gram,2016,5713,7446,1733,30.334325223175213
Kamthi,Chavli (Shenga ),2014,2219,3952,1733,78.09824245155475
Junnar (Narayangaon),Math (Bhaji),2016,890,2623,1733,194.7191011235955
Pune,Ghevda,2015,2100,3833,1733,82.52380952380952
Jalgaon,Ladies Finger,2015,2100,3833,1733,82.52380952380952
Mangaon(Bhadav),Rice(Paddy-Hus),2015,1767,3500,1733,98.07583474816073
Kamthi,Cucumber,2015,904,2637,1733,191.70353982300884
Kopargaon,Onion,2015,472,2203,1731,366.73728813559325
Chandrapur-Ganjwad,Garlic,2016,10974,12705,1731,15.77364680153089
Pune-Manjri,Cluster Bean,2014,3537,5268,1731,48.93977947413062
Mumbai,Green-Peas,2015,6000,7731,1731,28.85
Rahata,Onion,2015,442,2173,1731,391.6289592760181
Ulhasnagar,Other Cereals,2016,1962,3692,1730,88.17533129459736
Khamgaon,Green Gram,2015,6588,8318,1730,26.25986642380085
Pune,Dhemse,2016,2050,3780,1730,84.39024390243902
Umared,Rice(Paddy-Hus),2015,2000,3730,1730,86.5
Kamthi,Bitter Gourd,2014,3271,5000,1729,52.85845307245491
Mumbai,Split Black Gram,2014,6500,8229,1729,26.6
Nagpur,Ginger (Fresh),2014,3250,4979,1729,53.2
Akola,Black Gram,2016,8289,10018,1729,20.85896971890457
Pandharpur,Chikoo,2015,327,2055,1728,528.440366972477
Satara,Ginger (Fresh),2015,1129,2857,1728,153.05580159433126
Pune-Moshi,Brinjal,2016,1724,3452,1728,100.23201856148492
Hadgaon-Tamsa,Pigeon Pea (Tur),2015,7420,9148,1728,23.288409703504044
Mangaon(Bhadav),Rice(Paddy-Hus),2015,1744,3472,1728,99.08256880733946
Pune-Manjri,Brinjal,2014,1589,3316,1727,108.68470736312146
Mangaon(Bhadav),Rice(Paddy-Hus),2016,1813,3540,1727,95.25648097076669
Kamthi,Mango,2016,1180,2907,1727,146.35593220338984
Sinner,Gram,2015,3049,4776,1727,56.64152181042965
Manchar,Math (Bhaji),2015,851,2577,1726,202.8202115158637
Kolhapur,Spinach,2015,1797,3523,1726,96.04897050639956
Barshi,Cluster Bean,2016,3095,4821,1726,55.76736672051696
Jalgaon,Ladies Finger,2015,2111,3837,1726,81.7621980104216
Pune-Manjri,Bitter Gourd,2015,3129,4855,1726,55.161393416426975
Pandharpur,Onion,2016,157,1883,1726,1099.3630573248408
Jalgaon,Green Chilli,2014,1419,3144,1725,121.56448202959831
Pathari,Wheat(Husked),2016,0,1725,1725,inf
Jalgaon,Chavli (Shenga ),2016,2767,4492,1725,62.34188651969642
Aarni,Pigeon Pea (Tur),2015,7629,9354,1725,22.611089264648054
Aurangabad,Mosambi,2015,1170,2895,1725,147.43589743589743
Manchar,Methi (Bhaji),2015,680,2405,1725,253.6764705882353
Nagpur,Pineapple,2016,1060,2784,1724,162.64150943396226
Solapur,Cluster Bean,2014,1029,2753,1724,167.54130223517978
Shirpur,Matki,2015,6299,8022,1723,27.35354818225115
Kolhapur,Onion,2014,519,2242,1723,331.9845857418112
Solapur,Cucumber,2014,544,2267,1723,316.7279411764706
Nandura,Pigeon Pea (Tur),2015,5497,7220,1723,31.344369656176095
Majalgaon,Pigeon Pea (Tur),2016,6979,8701,1722,24.674022066198596
Kamthi,Beet Root,2015,1139,2861,1722,151.18525021949077
Ahmednagar,Cluster Bean,2015,2222,3944,1722,77.49774977497749
Akluj,Shevga,2015,4111,5833,1722,41.88761858428606
Rahuri,Grapes,2016,1529,3250,1721,112.55722694571615
Varud-Rajura Bazar,Green Chilli,2015,1338,3059,1721,128.62481315396113
Shirpur,Green Gram,2014,6206,7927,1721,27.731227844021916
Akluj,Ladies Finger,2016,2100,3821,1721,81.95238095238095
Akkolkot,Green Gram,2014,5323,7043,1720,32.31260567349239
Sangrampur,Pigeon Pea (Tur),2015,4490,6210,1720,38.30734966592428
Pimpalgaon (B)-Saykheda,Onion,2015,517,2237,1720,332.68858800773694
Mumbai,Small Gourd,2016,1938,3658,1720,88.75128998968009
Pune,WAL PAPDI,2016,976,2696,1720,176.2295081967213
Pune,Ladies Finger,2015,876,2595,1719,196.23287671232876
Chikhali,Pigeon Pea (Tur),2016,6441,8160,1719,26.688402421984165
Kolhapur,Capsicum,2016,1319,3038,1719,130.32600454890067
Osmanabad,Green Chilli,2015,2932,4650,1718,58.59481582537517
Pune-Manjri,Chavli (Shenga ),2015,1978,3696,1718,86.85540950455005
Nandurbar,Gram,2016,4554,6272,1718,37.72507685551164
Pandharpur,Green Chilli,2014,1382,3100,1718,124.31259044862519
Rahata,Onion,2014,445,2163,1718,386.0674157303371
Pathari,Pigeon Pea (Tur),2015,6492,8210,1718,26.463339494762785
Kolhapur,LADIES FINGER,2016,592,2310,1718,290.2027027027027
Sinner,Gram,2016,5684,7401,1717,30.207600281491906
Nandgaon,Pigeon Pea (Tur),2016,6096,7813,1717,28.166010498687665
Karad,Pomegranate,2015,3325,5042,1717,51.6390977443609
Mangalwedha,Bitter Gourd,2014,1696,3412,1716,101.17924528301887
Nagpur,Pineapple,2015,1100,2816,1716,156.0
Mangalwedha,Ridge Gourd,2014,1642,3358,1716,104.50669914738124
Newasa-Ghodegaon,Onion,2015,246,1962,1716,697.560975609756
Mangaon(Bhadav),Rice(Paddy-Hus),2016,1800,3516,1716,95.33333333333333
Sangamner,Onion,2015,500,2216,1716,343.2
Mangalwedha,Ridge Gourd,2015,2648,4364,1716,64.8036253776435
Mumbai,Orange,2015,800,2516,1716,214.5
Kej,Pigeon Pea (Tur),2016,6321,8036,1715,27.131782945736433
Nagpur,Pineapple,2015,1074,2789,1715,159.683426443203
Tuljapur,Green Gram,2014,4467,6182,1715,38.39265726438325
Mumbai,Chikoo,2016,1021,2736,1715,167.97257590597454
Kolhapur,Shepu,2015,3465,5180,1715,49.494949494949495
Karanja,Ground Nut Pods (Dry),2016,3516,5231,1715,48.77701934015927
Pathardi,Onion,2014,141,1855,1714,1215.6028368794325
Karad,Apple,2014,4429,6143,1714,38.699480695416575
Karad,Garlic,2015,4357,6071,1714,39.3389947211384
Koregaon,Ghevda Seed,2016,4113,5827,1714,41.67274495502067
Kalvan,Onion,2015,800,2514,1714,214.25
Pune-Manjri,Cluster Bean,2015,2238,3952,1714,76.58623771224308
Pune,Ghevda,2015,2568,4282,1714,66.74454828660436
Mangalwedha,Green Chilli,2016,3158,4871,1713,54.243191893603544
Pune-Manjri,Chavli (Shenga ),2016,1640,3353,1713,104.45121951219512
Anajngaon Surji,Chillies(Red),2016,7288,9000,1712,23.49066959385291
Kej,GRAM,2016,5958,7670,1712,28.734474655924807
Kolhapur,Cucumber,2015,492,2204,1712,347.9674796747967
Nashik,Ladies Finger,2015,1824,3536,1712,93.85964912280701
Pandharpur,Brinjal,2015,500,2212,1712,342.4
Jalgaon,Lemon,2015,2168,3879,1711,78.92066420664207
Basmat,Turmeric,2016,8704,10415,1711,19.657628676470587
Khamgaon,BLACK GRAM,2016,5393,7104,1711,31.72631188577786
Pathari,Soybean,2016,1750,3461,1711,97.77142857142857
Pune,Chillies(Red),2016,13605,15316,1711,12.576258728408673
Sinner,Pigeon Pea (Tur),2015,3238,4949,1711,52.84126003705991
Pune-Manjri,Walvad,2014,2417,4128,1711,70.79023582954075
Kolhapur,PINEAPPLE,2016,646,2357,1711,264.8606811145511
Osmanabad,Lemon,2015,1786,3497,1711,95.8006718924972
Sonpeth,Green Gram,2014,5588,7298,1710,30.601288475304223
Kamthi,Mint,2015,1583,3293,1710,108.0227416298168
Jalgaon,Green Chilli,2015,1874,3584,1710,91.2486659551761
Pune-Manjri,Other Vegetables,2015,0,1710,1710,inf
Pune,Small Gourd,2014,1017,2726,1709,168.0432645034415
Devala,Gram,2016,4314,6023,1709,39.61520630505331
Kolhapur,Beet Root,2016,1708,3417,1709,100.05854800936768
Jalgaon,Ginger (Fresh),2015,2479,4188,1709,68.93908834207342
Pune-Manjri,Ladies Finger,2015,2100,3808,1708,81.33333333333333
Nagpur,APPLE,2016,7686,9394,1708,22.22222222222222
Mumbai,Coconut,2016,302,2009,1707,565.2317880794702
Mumbai,Coconut,2016,398,2105,1707,428.89447236180905
Lasur Station,Onion,2014,175,1881,1706,974.8571428571429
Pathari,Gram,2016,2626,4332,1706,64.96572734196496
Baramati,Pigeon Pea (Tur),2016,5514,7220,1706,30.93942691331157
Pune,Small Gourd,2015,1025,2731,1706,166.4390243902439
Mangalwedha,Ridge Gourd,2015,566,2272,1706,301.41342756183747
Kolhapur,Bottle Gourd,2016,825,2530,1705,206.66666666666666
Rahuri,Kharbuj,2016,333,2038,1705,512.0120120120121
Akluj,Tomato,2016,2575,4280,1705,66.2135922330097
Akluj,Ladies Finger,2016,2468,4173,1705,69.08427876823339
Pathari,Gram,2016,2525,4230,1705,67.52475247524752
Pune,Cluster Bean,2015,1470,3175,1705,115.98639455782313
Telhara,BLACK GRAM,2016,4726,6430,1704,36.05586119339822
Aurangabad,Mosambi,2016,1635,3339,1704,104.22018348623853
Pune-Manjri,Bitter Gourd,2016,3242,4946,1704,52.56014805675509
Nagpur,Onion,2015,2476,4180,1704,68.82067851373182
Solapur,Custard Apple,2016,796,2500,1704,214.07035175879398
Majalgaon,Green Gram,2014,5493,7197,1704,31.021299836155105
Shegaon,Pigeon Pea (Tur),2015,5358,7060,1702,31.765584173198956
Dudhani,Pigeon Pea (Tur),2015,8939,10641,1702,19.040161091844727
Kille Dharur,Gram,2016,5500,7201,1701,30.927272727272726
Kolhapur,Water Melon,2016,195,1896,1701,872.3076923076923
Junnar (Narayangaon),Coriander  ,2016,301,2001,1700,564.7840531561462
Ahmednagar,Bitter Gourd,2015,1750,3450,1700,97.14285714285714
Mumbai,Coconut,2014,759,2459,1700,223.97891963109353
Sangali,Horse Gram,2015,1800,3500,1700,94.44444444444444
Sangali,Black Gram,2015,4700,6400,1700,36.170212765957444
Jalgaon,Jambhul,2016,4000,5700,1700,42.5
Osmanabad,Squash Gourd,2016,1300,3000,1700,130.76923076923077
Sangrampur,Gram,2016,6000,7700,1700,28.333333333333332
Aurangabad,Ginger (Fresh),2014,1425,3125,1700,119.29824561403508
Mumbai,Ridge Gourd,2015,2200,3900,1700,77.27272727272727
Junnar (Narayangaon),Coriander  ,2016,251,1951,1700,677.2908366533865
Junnar-Otur,Walvad,2015,500,2200,1700,340.0
Ahmednagar,Orange,2015,650,2350,1700,261.53846153846155
Vaijapur,Onion,2014,150,1850,1700,1133.3333333333333
Aurangabad,Dhemse,2016,800,2500,1700,212.5
Jalgaon,Mosambi,2015,1225,2925,1700,138.77551020408163
Ahmednagar,Coriander (Dry),2016,7800,9500,1700,21.794871794871796
Kolhapur,Wood Apple,2015,800,2500,1700,212.5
Pune,Ghevda,2015,2220,3920,1700,76.57657657657657
Kalvan,Chillies(Red),2016,5800,7500,1700,29.310344827586206
Kopargaon,Onion,2015,625,2325,1700,272.0
Pandharpur,Chikoo,2015,300,2000,1700,566.6666666666666
Mangaon(Bhadav),Nagali,2015,1514,3214,1700,112.28533685601057
Kada,Pigeon Pea (Tur),2016,5100,6800,1700,33.333333333333336
Satara,Onion,2015,1950,3650,1700,87.17948717948718
Mangaon(Bhadav),Rice(Paddy-Hus),2016,1800,3500,1700,94.44444444444444
Mangaon(Bhadav),Nagali,2015,1300,3000,1700,130.76923076923077
Nashik,Cluster Bean,2016,3350,5050,1700,50.74626865671642
Pune-Manjri,Other Vegetables,2014,0,1700,1700,inf
Kada,Black Gram,2016,5657,7357,1700,30.051263920806083
Anajngaon Surji,Chillies(Red),2016,6500,8200,1700,26.153846153846153
Khed,Farshi,2016,1556,3256,1700,109.25449871465295
Sangali,Horse Gram,2015,1800,3500,1700,94.44444444444444
Kamthi,Small Gourd,2014,1592,3292,1700,106.78391959798995
Dhule,Ground Nut Pods (Dry),2016,4394,6094,1700,38.68912152935822
Vasai,Wheat(Husked),2014,1700,3400,1700,100.0
Malkapur,Green Gram,2015,6617,8317,1700,25.691400936980504
Pandharpur,Cluster Bean,2015,1450,3150,1700,117.24137931034483
Mangaon(Bhadav),Rice(Paddy-Hus),2015,1800,3500,1700,94.44444444444444
Lasur Station,Ginger (Fresh),2015,1500,3200,1700,113.33333333333333
Ausa,Green Gram,2015,6500,8200,1700,26.153846153846153
Kamthi,Pumpkin,2014,1050,2750,1700,161.9047619047619
Manchar,Cucumber,2014,500,2200,1700,340.0
Indapur-Bhigwan,Ground Nut Pods (Dry),2015,4200,5900,1700,40.476190476190474
Mangaon(Bhadav),Rice(Paddy-Hus),2015,1800,3500,1700,94.44444444444444
Mumbai,Coconut,2016,300,2000,1700,566.6666666666666
Pune-Manjri,Bitter Gourd,2015,3109,4809,1700,54.67996140238019
Chalisgaon,Green Gram,2016,4640,6340,1700,36.63793103448276
Mangaon(Bhadav),Rice(Paddy-Hus),2015,1800,3500,1700,94.44444444444444
Indapur-Bhigwan,Green Gram,2015,6000,7700,1700,28.333333333333332
Nandurbar,Shepa,2015,5100,6800,1700,33.333333333333336
Ratanagari,Ginger (Fresh),2016,4300,6000,1700,39.53488372093023
Kolhapur-Malkapur,Ladies Finger,2016,650,2350,1700,261.53846153846155
Mangaon(Bhadav),Rice(Paddy-Hus),2014,1771,3471,1700,95.99096555618294
Balapur,Pigeon Pea (Tur),2015,5700,7400,1700,29.82456140350877
Akola,Black Gram,2016,10025,11725,1700,16.957605985037407
Mangaon(Bhadav),Rice(Paddy-Hus),2015,1800,3500,1700,94.44444444444444
Mangaon(Bhadav),Rice(Paddy-Hus),2015,1800,3500,1700,94.44444444444444
Osmanabad,Capsicum,2016,1150,2850,1700,147.82608695652175
Kopargaon,Chikoo,2015,757,2457,1700,224.57067371202115
Kopargaon,Chikoo,2015,500,2200,1700,340.0
Mangaon(Bhadav),Rice(Paddy-Hus),2015,1800,3500,1700,94.44444444444444
Mumbai,Coconut,2016,300,2000,1700,566.6666666666666
Pune-Manjri,Onion,2015,0,1700,1700,inf
Jalgaon,Orange,2016,800,2500,1700,212.5
Kolhapur,Pineapple,2016,700,2400,1700,242.85714285714286
Vadgaon Peth,Flower,2016,1833,3533,1700,92.74413529732679
Mangaon(Bhadav),Rice(Paddy-Hus),2014,1820,3520,1700,93.4065934065934
Sillod-Bharadi,Gram,2016,4000,5700,1700,42.5
Mahagaon,PIGEON PEA (TUR),2016,5300,7000,1700,32.075471698113205
Ratanagari,Bitter Gourd,2016,2500,4200,1700,68.0
Achalpur,Pigeon Pea (Tur),2015,5083,6783,1700,33.44481605351171
Jalgaon,Coriander  ,2014,1635,3335,1700,103.97553516819572
Jalgaon,Garlic,2014,2125,3825,1700,80.0
Buldhana,BLACK GRAM,2016,5000,6700,1700,34.0
Ahmednagar,Soybean,2016,2200,3900,1700,77.27272727272727
Sangali,Black Gram,2014,3800,5500,1700,44.73684210526316
Manwat,Gram,2016,7300,9000,1700,23.28767123287671
Junnar-Otur,Chavli (Shenga ),2016,1500,3200,1700,113.33333333333333
Osmanabad,Bitter Gourd,2014,1500,3200,1700,113.33333333333333
Rahuri,Cucumber,2016,500,2200,1700,340.0
Nashik,Orange,2014,1300,3000,1700,130.76923076923077
Sonpeth,Pigeon Pea (Tur),2015,5500,7200,1700,30.90909090909091
Aurangabad,Ginger (Fresh),2015,1957,3657,1700,86.86765457332652
Pune,Small Gourd,2015,1020,2720,1700,166.66666666666666
Jintur,Green Gram,2016,4601,6300,1699,36.926755053249295
Nampur,GRAM,2016,4998,6697,1699,33.99359743897559
Lonand,Onion,2015,938,2637,1699,181.13006396588486
Kej,Green Gram,2015,5901,7600,1699,28.79173021521776
Solapur,Black Gram,2016,5456,7154,1698,31.121700879765395
Rahuri,Onion,2015,192,1890,1698,884.375
Chikhali,Pigeon Pea (Tur),2015,5273,6970,1697,32.18281813009672
Armori,Ground Nut Pods (Dry),2016,4114,5810,1696,41.22508507535245
Akole,Onion,2015,131,1827,1696,1294.6564885496184
Kolhapur,Onion,2014,500,2195,1695,339.0
Junnar-Otur,Carrot,2016,760,2455,1695,223.02631578947367
Pune,Shevga,2015,1924,3619,1695,88.0977130977131
Nagpur,Ginger (Fresh),2015,1948,3643,1695,87.01232032854209
Solapur,Brinjal,2016,398,2092,1694,425.6281407035176
Osmanabad,Shevga,2015,1569,3263,1694,107.96685787125557
Nashik,Bitter Gourd,2014,1434,3128,1694,118.13110181311018
Dindori-Vani,Onion,2015,1095,2789,1694,154.70319634703196
Pune-Manjri,Guava,2015,1557,3250,1693,108.73474630700065
Dhule,Chillies(Red),2015,2090,3783,1693,81.00478468899522
Newasa-Ghodegaon,Onion,2014,300,1992,1692,564.0
Pimpalgaon Basawant,Tomato,2015,563,2255,1692,300.5328596802842
Mangalwedha,Tomato,2015,388,2080,1692,436.08247422680415
Lasalgaon,Soybean,2016,2205,3896,1691,76.68934240362812
Osmanabad,Cluster Bean,2016,1645,3336,1691,102.79635258358662
Dhule,Pigeon Pea (Tur),2016,5849,7540,1691,28.910924944434946
Pune-Manjri,Mint,2015,0,1691,1691,inf
Barshi,Turmeric,2016,5465,7155,1690,30.924062214089663
Akola,Pigeon Pea (Tur),2015,7189,8879,1690,23.508137432188065
Ahmednagar,Tomato,2015,550,2240,1690,307.27272727272725
Kolhapur,Ginger (Fresh),2015,2240,3930,1690,75.44642857142857
Hinganghat,Pigeon Pea (Tur),2016,6725,8414,1689,25.11524163568773
Kamthi,Beet Root,2015,2089,3778,1689,80.85208233604595
Nashik,Squash Gourd,2016,3057,4746,1689,55.250245338567225
Pune-Manjri,Ghevda,2014,2000,3689,1689,84.45
Karad,Mosambi,2015,4281,5969,1688,39.43003971034805
Mangalwedha,Green Chilli,2016,4680,6368,1688,36.06837606837607
Pune,Wal Bhaji,2016,2781,4469,1688,60.69759079467817
Mangalwedha,Cucumber,2016,300,1988,1688,562.6666666666666
Kolhapur,Pineapple,2016,1000,2688,1688,168.8
Karad,Shevga,2015,4813,6500,1687,35.05090380220237
Kolhapur,Pineapple,2015,813,2500,1687,207.5030750307503
Aurangabad,Mosambi,2016,1118,2805,1687,150.89445438282647
Dhule,Pigeon Pea (Tur),2016,6375,8062,1687,26.462745098039214
Nashik,Bitter Gourd,2016,3615,5302,1687,46.666666666666664
Mumbai,Coconut,2016,400,2087,1687,421.75
Chandrapur,Mosambi,2016,1971,3657,1686,85.54033485540334
Kamthi,Bitter Gourd,2016,2114,3800,1686,79.75402081362347
Parola,Pigeon Pea (Tur),2016,6316,8002,1686,26.69411019632679
Solapur,Chikoo,2016,767,2452,1685,219.6870925684485
Ambejogai,Pigeon Pea (Tur),2015,7531,9216,1685,22.374186694994023
Pathari,Wheat(Husked),2016,397,2082,1685,424.43324937027705
Nashik,Squash Gourd,2014,948,2633,1685,177.74261603375527
Mangaon(Bhadav),Nachani,2015,1386,3071,1685,121.57287157287158
Jintur,Turmeric,2016,6617,8301,1684,25.449599516397157
Jalgaon,Green Chilli,2016,2708,4392,1684,62.186115214180205
Kolhapur,Bitter Gourd,2015,1728,3412,1684,97.45370370370371
Lasalgaon,Black Gram,2016,5933,7617,1684,28.383617057138043
Mumbai,Split Black Gram,2016,13352,15036,1684,12.612342720191732
Sangli-Phale Bhajipalam,Custard Apple,2016,548,2232,1684,307.2992700729927
Pune-Manjri,LADIES FINGER,2016,2679,4362,1683,62.82194848824188
Osmanabad,Ladies Finger,2015,1150,2833,1683,146.34782608695653
Aarni,Black Gram,2016,5167,6850,1683,32.57209212308884
Pune,Ghosali(Bhaji),2016,1804,3487,1683,93.29268292682927
Nashik,Green-Peas,2015,1417,3100,1683,118.77205363443896
Pune,Double Bee,2016,3000,4683,1683,56.1
Mangaon(Bhadav),Rice(Paddy-Hus),2016,1826,3509,1683,92.16867469879519
Satara,Cluster Bean,2015,4023,5705,1682,41.80959482972906
Phaltan,Cluster Bean,2016,3091,4773,1682,54.41604658686509
Risod,Pigeon Pea (Tur),2016,7575,9257,1682,22.204620462046204
Jintur,Turmeric,2016,6583,8265,1682,25.550660792951543
Daryapur,Green Gram,2016,3257,4939,1682,51.64261590420632
Malkapur,Gram,2016,6309,7991,1682,26.660326517673166
Shegaon,Pigeon Pea (Tur),2015,5219,6900,1681,32.20923548572524
Nashik,Green Chilli,2016,6644,8325,1681,25.301023479831425
Aurangabad,Ginger (Fresh),2015,1769,3450,1681,95.02543810062183
Katol,GROUND NUT PODS (DRY),2016,2739,4420,1681,61.37276378240234
Pachora,Gram,2016,5457,7137,1680,30.78614623419461
Pune,Green Peas (Dry),2015,2740,4420,1680,61.31386861313869
Mangalwedha,Ladies Finger,2014,2905,4585,1680,57.83132530120482
Kamthi,Bitter Gourd,2014,3320,5000,1680,50.602409638554214
Aurangabad,Ginger (Fresh),2016,1580,3260,1680,106.32911392405063
Karad,Grapes,2016,3780,5460,1680,44.44444444444444
Pandharpur,Capsicum,2016,1980,3660,1680,84.84848484848484
Karmala,Sorgum(Jawar),2014,1604,3284,1680,104.73815461346634
Nashik,Brinjal,2016,2565,4245,1680,65.49707602339181
Kamthi,Mosambi,2014,1587,3267,1680,105.8601134215501
Malegaon,Ground Nut Pods (Dry),2015,4634,6314,1680,36.25377643504532
Nashik-Devlali,Mango,2016,3380,5060,1680,49.70414201183432
Rahuri,Flower,2016,400,2080,1680,420.0
Ambejogai,Pigeon Pea (Tur),2016,7431,9110,1679,22.59453640156103
Pune,Rice(Paddy-Hus),2016,3863,5542,1679,43.463629303650016
Kolhapur,Shevga,2016,1853,3532,1679,90.60982191041555
Khamgaon,Green Gram,2015,7043,8722,1679,23.83927303705807
Mumbai,Coconut,2015,889,2567,1678,188.75140607424072
Pune,Ghevda,2015,1261,2939,1678,133.0689928628073
Kolhapur,Grapes,2016,1822,3500,1678,92.09659714599341
Mangrulpeer,Pigeon Pea (Tur),2016,6780,8458,1678,24.749262536873157
Pune,Dhemse,2015,1036,2714,1678,161.96911196911196
Manchar,Farshi,2016,2181,3858,1677,76.89133425034387
Aurangabad,Capsicum,2016,4292,5968,1676,39.049394221808015
Mumbai,GREEN-PEAS,2016,5240,6916,1676,31.984732824427482
Khamgaon,Black Gram,2016,7534,9210,1676,22.24581895407486
Kolhapur,Awala,2016,825,2500,1675,203.03030303030303
Pune-Manjri,Goosefoot,2014,0,1675,1675,inf
Solapur,Capsicum,2015,1206,2881,1675,138.88888888888889
Pune,Ghosali(Bhaji),2015,1385,3060,1675,120.93862815884476
Latur-Murud,Black Gram,2016,5667,7342,1675,29.557084877360154
Nandura,Green Gram,2014,4259,5934,1675,39.328480864052594
Kamthi,Jambhul,2015,2263,3938,1675,74.01679186920018
Kamthi,Guava,2015,1950,3625,1675,85.8974358974359
Pandharpur,Capsicum,2014,1275,2950,1675,131.37254901960785
Digras,Green Gram,2015,7225,8900,1675,23.18339100346021
Nashik,Ghevda,2015,2000,3675,1675,83.75
Shirpur,Black Gram,2015,7249,8923,1674,23.092840391778175
Nashik,Kanda Pat,2016,2445,4119,1674,68.46625766871166
Dondaicha,Green Gram,2014,6203,7877,1674,26.9869418023537
Karanja,Pigeon Pea (Tur),2015,8597,10271,1674,19.47190880539723
Pune-Manjri,Brinjal,2016,2073,3747,1674,80.75253256150506
Nashik,Ghevda,2016,2220,3893,1673,75.36036036036036
Bhiwapur,Chillies(Red),2015,3687,5360,1673,45.37564415513968
Kolhapur,Onion,2014,500,2173,1673,334.6
Lasalgaon,Soybean,2016,2324,3997,1673,71.98795180722891
Pune-Manjri,Coriander  ,2016,1114,2786,1672,150.08976660682225
Solapur,Green Chilli,2014,1475,3147,1672,113.35593220338983
Sangali,Lentil,2015,6371,8043,1672,26.243917752315177
Mumbai,Split Black Gram,2014,6500,8172,1672,25.723076923076924
Kolhapur-Laxmipuri,SORGUM(JAWAR),2016,2372,4044,1672,70.48903878583474
Vadgaon Peth,Tomato,2016,1400,3071,1671,119.35714285714286
Umarga,Pigeon Pea (Tur),2016,7782,9453,1671,21.472629144178875
Mumbai,Cowpea,2015,4448,6119,1671,37.56744604316547
Nagpur,Pigeon Pea (Tur),2016,7318,8989,1671,22.834107679693904
Pune-Manjri,Raddish,2016,986,2657,1671,169.47261663286005
Solapur,Capsicum,2016,1473,3144,1671,113.44195519348268
Sangali,Coriander (Dry),2015,7643,9314,1671,21.86314274499542
Pune,Ridge Gourd,2015,2000,3671,1671,83.55
Jalgaon,Ginger (Fresh),2014,3160,4830,1670,52.848101265822784
Pune-Manjri,Cucumber,2015,800,2470,1670,208.75
Pandharpur,Brinjal,2016,500,2170,1670,334.0
Solapur,Bitter Gourd,2016,698,2367,1669,239.11174785100286
Varora,Pigeon Pea (Tur),2016,7130,8799,1669,23.40813464235624
Pune,Green Chilli,2015,2026,3695,1669,82.37907206317868
Kolhapur,Orange,2016,6731,8400,1669,24.795721289555786
Karad,Mango,2015,4312,5980,1668,38.68274582560297
Osmanabad,Green Chilli,2014,2105,3773,1668,79.23990498812351
Manora,Pigeon Pea (Tur),2015,8109,9777,1668,20.569737328893822
Umarga,Black Gram,2016,5469,7137,1668,30.49917718047175
Pune,Shevga,2015,1679,3346,1667,99.2852888624181
Ahmednagar,Capsicum,2016,1000,2667,1667,166.7
Kalyan,Sesamum,2016,8333,10000,1667,20.00480019200768
Kolhapur-Malkapur,Ladies Finger,2016,833,2500,1667,200.12004801920767
Kopargaon,Chikoo,2015,1033,2700,1667,161.37463697967087
Chandrapur-Ganjwad,Wal Bhaji,2016,2000,3667,1667,83.35
Pandharpur,Capsicum,2016,333,2000,1667,500.6006006006006
Pune,Pavtta,2016,3104,4771,1667,53.704896907216494
Nashik,Shepu,2016,2433,4100,1667,68.51623510069872
Pune-Moshi,Garlic,2016,8963,10630,1667,18.59868347651456
Rahata,Garlic,2015,3250,4917,1667,51.292307692307695
Pune-Manjri,Kanda Pat,2016,1211,2878,1667,137.65483071841453
Sangali,Chillies(Red),2016,13333,15000,1667,12.502812570314259
Sangali,Coriander (Dry),2015,10333,12000,1667,16.132778476725054
Sangali,Pigeon Pea (Tur),2015,4833,6500,1667,34.492033933374714
Manchar,Farshi,2014,1500,3167,1667,111.13333333333334
Jalgaon,Mosambi,2015,1500,3167,1667,111.13333333333334
Lasalgaon-Vinchur,Soybean,2016,2136,3803,1667,78.04307116104869
Kalyan,Custard Apple,2015,3333,5000,1667,50.015001500150014
Akluj,Shevga,2015,4000,5667,1667,41.675
Mumbai,Grapes,2015,5000,6667,1667,33.34
Ausa,Pigeon Pea (Tur),2016,6767,8434,1667,24.63425447022314
Baramati,Gram,2015,3350,5017,1667,49.76119402985075
Pune,Papai,2015,667,2333,1666,249.7751124437781
Kalvan,Pigeon Pea (Tur),2016,4667,6333,1666,35.69745018212985
Kalyan,Matki,2015,7067,8733,1666,23.57435970001415
Ratanagari,Ginger (Fresh),2016,3167,4833,1666,52.604988948531734
Mumbai,Spilt Gerrn Gram,2015,9492,11158,1666,17.551622418879056
Satara,Garlic,2015,2167,3833,1666,76.88047992616521
Pune,Mango(Raw),2015,2667,4333,1666,62.46719160104987
Kej,Sesamum,2016,5000,6666,1666,33.32
Junnar (Narayangaon),Math (Bhaji),2016,568,2234,1666,293.3098591549296
Chandrapur,Chikoo,2016,1667,3333,1666,99.94001199760048
Nagpur,Pineapple,2015,1062,2727,1665,156.77966101694915
Kolhapur-Laxmipuri,Split Black Gram,2016,15485,17150,1665,10.75234097513723
Solapur,Brinjal,2015,362,2026,1664,459.6685082872928
Mangalwedha,Cucumber,2016,424,2088,1664,392.45283018867923
Pune,Rice(Paddy-Hus),2016,4114,5777,1663,40.4229460379193
Nashik,Mosambi,2014,900,2563,1663,184.77777777777777
Junnar-Otur,Cucumber,2016,300,1963,1663,554.3333333333334
Pandharpur,Brinjal,2016,483,2146,1663,344.3064182194617
Palus,Brinjal,2016,2600,4263,1663,63.96153846153846
Rahuri-Vambori,Onion,2015,223,1885,1662,745.2914798206278
Nandura,Pigeon Pea (Tur),2015,7490,9152,1662,22.18958611481976
Mumbai,Spilt Gerrn Gram,2015,8338,10000,1662,19.932837610937874
Kolhapur,Ladies Finger,2016,508,2170,1662,327.1653543307087
Chopda,Sesamum,2015,5355,7017,1662,31.03641456582633
Vadgaon Peth,Ridge Gourd,2014,1944,3606,1662,85.49382716049382
Karmala,Sorgum(Jawar),2015,1550,3211,1661,107.16129032258064
Junnar-Otur,Ghevda,2016,1678,3339,1661,98.98688915375448
Umared,Rice(Paddy-Hus),2015,2060,3720,1660,80.58252427184466
Solapur,Garlic,2014,1707,3367,1660,97.24663151728178
Nandura,Pigeon Pea (Tur),2015,7350,9010,1660,22.58503401360544
Dondaicha,Gram,2015,3035,4695,1660,54.69522240527183
Kada,Onion,2015,400,2060,1660,415.0
Pune-Manjri,Raddish,2015,1180,2840,1660,140.67796610169492
Dhule,Ground Nut Pods (Dry),2014,2861,4521,1660,58.021670744494934
Pune,Ground Nut Pods (Dry),2016,2955,4614,1659,56.142131979695435
Pune,Tomato,2016,955,2614,1659,173.717277486911
Palus,Tomato,2016,1471,3129,1658,112.71244051665533
Kalyan,Apple,2016,3429,5086,1657,48.32312627588218
Sangamner,Onion,2014,500,2157,1657,331.4
Pune-Manjri,Methi (Bhaji),2015,914,2571,1657,181.2910284463895
Pune,Gram,2014,5032,6689,1657,32.929252782193956
Vadgaon Peth,Green Chilli,2016,2626,4283,1657,63.0997715156131
Khamgaon,Pigeon Pea (Tur),2016,7642,9299,1657,21.68280554828579
Basmat,Turmeric,2014,5400,7056,1656,30.666666666666668
Sakri,Ground Nut Pods (Dry),2015,2586,4242,1656,64.03712296983758
Kolhapur,Bor,2015,700,2356,1656,236.57142857142858
Savner,Pigeon Pea (Tur),2015,6425,8081,1656,25.77431906614786
Ramtek,Tomato,2016,2687,4343,1656,61.63007071082992
Parola,Black Gram,2016,4713,6369,1656,35.136855506047105
Ambejogai,Pigeon Pea (Tur),2016,7413,9069,1656,22.33913395386483
Kada,Sorgum(Jawar),2014,1533,3189,1656,108.02348336594912
Manchar,Cluster Bean,2015,5000,6655,1655,33.1
Murum,Green Gram,2014,6350,8005,1655,26.062992125984252
Pusad,Sesamum,2015,7550,9205,1655,21.920529801324502
Solapur,Ladies Finger,2015,524,2179,1655,315.8396946564886
Akola,Pigeon Pea (Tur),2015,8173,9827,1654,20.23736693992414
Nagpur,GRAM,2016,7033,8686,1653,23.50348357742073
Pandharpur,Onion,2014,424,2077,1653,389.85849056603774
Karmala,Sorgum(Jawar),2015,1638,3291,1653,100.91575091575092
Latur-Murud,Pigeon Pea (Tur),2016,7300,8953,1653,22.643835616438356
Jalgaon,Ladies Finger,2015,2176,3829,1653,75.96507352941177
Pune,Ghevda,2016,2500,4152,1652,66.08
Pune,Ridge Gourd,2015,2296,3948,1652,71.95121951219512
Shirpur,Pigeon Pea (Tur),2015,4242,5893,1651,38.92032060348892
Karmala,BLACK GRAM,2016,5500,7151,1651,30.01818181818182
Kalvan,Onion,2015,480,2131,1651,343.9583333333333
Chandrapur-Ganjwad,Ginger (Fresh),2016,3996,5646,1650,41.291291291291294
Kolhapur,Math (Bhaji),2016,767,2417,1650,215.1238591916558
Pune,Cluster Bean,2015,1158,2808,1650,142.48704663212436
Ahmednagar,Green Peas (Dry),2015,2000,3650,1650,82.5
Chandrapur,Naspatti ,2016,3617,5267,1650,45.61791539950235
Solapur,Ghevda,2015,1600,3250,1650,103.125
Kamthi,Lemon,2014,1600,3250,1650,103.125
Pune,Capsicum,2016,2073,3723,1650,79.59479015918959
Chandrapur-Ganjwad,Garlic,2015,6750,8400,1650,24.444444444444443
Mangaon(Bhadav),Rice(Paddy-Hus),2016,1800,3450,1650,91.66666666666667
Ahmednagar,Ginger (Fresh),2016,1250,2900,1650,132.0
Junnar-Otur,Small Gourd,2016,2000,3650,1650,82.5
Kolhapur,Bitter Gourd,2016,2570,4220,1650,64.2023346303502
Nashik,Ground Nut Pods (Dry),2015,2500,4150,1650,66.0
Osmanabad,Chikoo,2016,2350,4000,1650,70.2127659574468
Ghansawangi,Green Gram,2014,4800,6450,1650,34.375
Jalgaon,Methi (Bhaji),2016,3100,4750,1650,53.225806451612904
Ambejogai,Pigeon Pea (Tur),2015,5198,6848,1650,31.74297806848788
Khalapur(Shil-Phata),Other Cereals,2016,4750,6400,1650,34.73684210526316
Kolhapur-Laxmipuri,Sorgum(Jawar),2014,1700,3350,1650,97.05882352941177
Pune-Manjri,Cluster Bean,2016,2829,4479,1650,58.324496288441146
Pune-Manjri,Ambat Chuka,2014,0,1650,1650,inf
Kannad,Ginger (Fresh),2016,1200,2850,1650,137.5
Ulhasnagar,Other Vegetables,2016,1750,3400,1650,94.28571428571429
Nagpur,Mosambi,2015,1300,2950,1650,126.92307692307692
Junnar (Narayangaon),Math (Bhaji),2016,651,2301,1650,253.45622119815667
Junnar-Otur,Brinjal,2016,1183,2833,1650,139.47590870667793
Kopargaon,Gram,2016,4990,6640,1650,33.06613226452906
Junnar-Otur,Cabbage,2016,908,2557,1649,181.6079295154185
Katol,Gram,2016,7756,9405,1649,21.26095925734915
Solapur,Green Chilli,2015,1238,2887,1649,133.19870759289176
Chikhali,Black Gram,2016,5507,7156,1649,29.94370800798983
Solapur,Cucumber,2015,432,2080,1648,381.48148148148147
Sangli-Phale Bhajipalam,Grapes,2015,832,2480,1648,198.07692307692307
Khamgaon,Gram,2016,7753,9401,1648,21.256287888559267
Mumbai,Brinjal,2014,1432,3080,1648,115.08379888268156
Pusad,Pigeon Pea (Tur),2015,7926,9573,1647,20.779712339137017
Basmat,Turmeric,2015,7014,8661,1647,23.481608212147133
Solapur,Pigeon Pea (Tur),2015,8651,10298,1647,19.03826147266212
Chalisgaon,Green Chilli,2016,1978,3625,1647,83.26592517694641
Mumbai,Coconut,2015,898,2545,1647,183.4075723830735
Khamgaon,Pigeon Pea (Tur),2016,7573,9219,1646,21.735111580615342
Osmanabad,Capsicum,2014,1527,3173,1646,107.79305828421742
Solapur,Tomato,2016,227,1873,1646,725.1101321585903
Rahuri-Vambori,Onion,2015,131,1777,1646,1256.4885496183206
Solapur,Bitter Gourd,2015,1892,3538,1646,86.99788583509513
Aurangabad,Fig,2016,3159,4805,1646,52.105096549540995
Pune,Ladies Finger,2015,986,2632,1646,166.9371196754564
Tuljapur,Black Gram,2015,7463,9109,1646,22.055473670105854
Dhule,Ground Nut Pods (Dry),2016,3433,5079,1646,47.94640256335567
Rahuri,Tomato,2016,277,1923,1646,594.2238267148015
Umarga,Pigeon Pea (Tur),2015,8466,10112,1646,19.44247578549492
Dondaicha,Ground Nut Pods (Dry),2016,4402,6047,1645,37.36937755565652
Solapur,MULA SHENGA,2016,1610,3255,1645,102.17391304347827
Kolhapur,Ladies Finger,2016,435,2080,1645,378.1609195402299
Kolhapur,Jaggery,2016,3280,4924,1644,50.1219512195122
Akkolkot,Gram,2016,7800,9444,1644,21.076923076923077
Mangalwedha,Ridge Gourd,2014,800,2444,1644,205.5
Akluj,Carrot,2016,1467,3111,1644,112.06543967280163
Amarawati,Pomegranate,2016,3386,5029,1643,48.523331364441816
Pune,Mango(Raw),2015,3500,5143,1643,46.94285714285714
Mumbai,Coconut,2015,766,2409,1643,214.49086161879896
Ratanagari,Green Chilli,2016,4321,5964,1643,38.023605646841006
Malegaon,Pigeon Pea (Tur),2016,6476,8119,1643,25.370599135268684
Solapur,Ridge Gourd,2015,477,2120,1643,344.44444444444446
Pune,Green-Peas,2016,2796,4438,1642,58.726752503576535
Pune,Squash Gourd,2016,2108,3750,1642,77.89373814041745
Pune,Cluster Bean,2015,1588,3229,1641,103.33753148614609
Kamthi,Coriander  ,2015,1652,3293,1641,99.33414043583535
Pandharpur,Brinjal,2015,500,2141,1641,328.2
Mangalwedha,Ladies Finger,2014,711,2352,1641,230.8016877637131
Daryapur,Pigeon Pea (Tur),2016,6774,8415,1641,24.224977856510186
Aurangabad,Shevga,2015,2992,4633,1641,54.846256684491976
Shahada,Pigeon Pea (Tur),2015,6965,8606,1641,23.560660445082554
Kolhapur-Laxmipuri,Green Gram,2016,6000,7640,1640,27.333333333333332
Pune,SMALL GOURD,2016,1100,2740,1640,149.0909090909091
Kamthi,Wal Bhaji,2015,2100,3740,1640,78.0952380952381
Mumbai,Small Gourd,2014,1104,2744,1640,148.55072463768116
Junnar-Otur,Farshi,2016,1156,2796,1640,141.86851211072664
Chandrapur-Ganjwad,Ginger (Fresh),2016,3960,5600,1640,41.41414141414141
Pune-Manjri,Walvad,2016,3240,4880,1640,50.617283950617285
Majalgaon,Pigeon Pea (Tur),2015,5133,6772,1639,31.93064484706799
Jamkhed,Onion,2016,244,1883,1639,671.7213114754098
Basmat,Turmeric,2015,7044,8683,1639,23.268029528676887
Sangali,Turmeric,2016,7000,8638,1638,23.4
Barshi,Squash Gourd,2016,2175,3813,1638,75.3103448275862
Majalgaon,Pigeon Pea (Tur),2015,7035,8673,1638,23.28358208955224
Indapur-Bhigwan,Green Gram,2016,5875,7513,1638,27.880851063829788
Solapur,Mula Shenga,2015,1771,3409,1638,92.4901185770751
Ahmednagar,Bitter Gourd,2016,613,2250,1637,267.047308319739
Jalgaon,Lemon,2015,2126,3763,1637,76.99905926622766
Nashik,Wal Papdi,2016,2538,4175,1637,64.49960598896769
Pune,Chavli (Shenga ),2016,1568,3205,1637,104.40051020408163
Pune,Cluster Bean,2014,2238,3875,1637,73.14566577301161
Satara,GREEN-PEAS,2016,8318,9955,1637,19.680211589324358
Daryapur,Pigeon Pea (Tur),2016,7552,9189,1637,21.67637711864407
Dhule,Green Gram,2014,5853,7489,1636,27.951477874594225
Lasalgaon-Vinchur,Soybean,2015,2329,3965,1636,70.24474023185917
Latur,Black Gram,2015,5315,6951,1636,30.780809031044214
Kamthi,Coriander  ,2015,1668,3304,1636,98.08153477218225
Daryapur,Gram,2015,3947,5583,1636,41.449201925513044
Umarga,Black Gram,2015,7450,9086,1636,21.959731543624162
Rahata,Onion,2015,355,1991,1636,460.84507042253523
Mumbai,Small Gourd,2016,1539,3174,1635,106.23781676413256
Malkapur,Onion,2015,2532,4166,1634,64.53396524486571
Malegaon,Cowpea,2015,4501,6135,1634,36.303043768051545
Nagpur,Gram,2016,7606,9240,1634,21.48303970549566
Sangli-Phale Bhajipalam,Custard Apple,2016,652,2286,1634,250.61349693251535
Osmanabad,Onion,2015,833,2467,1634,196.15846338535414
Dhule,Ground Nut Pods (Dry),2015,3270,4904,1634,49.969418960244646
Mangaon(Bhadav),Rice(Paddy-Hus),2015,1800,3433,1633,90.72222222222223
Aurangabad,Ginger (Fresh),2015,1200,2833,1633,136.08333333333334
Sinner,Ground Nut Pods (Dry),2015,3001,4634,1633,54.41519493502166
Jalgaon Jamod-Aasalgaon,Pigeon Pea (Tur),2015,5200,6833,1633,31.403846153846153
Aurangabad,Green Chilli,2014,2425,4058,1633,67.34020618556701
Vadgaon Peth,Ladies Finger,2015,1700,3333,1633,96.05882352941177
Kolhapur,SHEVGA,2016,3005,4637,1632,54.30948419301165
Risod,Pigeon Pea (Tur),2016,6727,8359,1632,24.260442990932066
Jintur,Turmeric,2014,3607,5239,1632,45.245356251732744
Mumbai,Coconut,2015,700,2331,1631,233.0
Ulhasnagar,Other Vegetables,2016,769,2400,1631,212.09362808842653
Kamthi,Cluster Bean,2016,1792,3423,1631,91.015625
Jalgaon,Grapes,2015,2377,4008,1631,68.61590239798065
Baramati,Onion,2015,633,2264,1631,257.6619273301738
Ausa,Gram,2015,3021,4651,1630,53.9556438265475
Osmanabad,Bitter Gourd,2015,1200,2830,1630,135.83333333333334
Daryapur,Pigeon Pea (Tur),2015,5641,7271,1630,28.89558588902677
Mumbai,Green Peas (Dry),2015,2648,4278,1630,61.5558912386707
Jalgaon,Green Chilli,2015,1625,3255,1630,100.3076923076923
Chikhali,Pigeon Pea (Tur),2016,7152,8782,1630,22.79082774049217
Rahata,Onion,2014,440,2070,1630,370.45454545454544
Pune-Manjri,Mint,2016,0,1629,1629,inf
Pune-Manjri,Kanda Pat,2016,1114,2743,1629,146.229802513465
Pune,Ground Nut Pods (Dry),2016,2976,4605,1629,54.73790322580645
Pune,Pavtta,2015,2952,4581,1629,55.18292682926829
Dhule,Ground Nut Pods (Dry),2015,3175,4803,1628,51.275590551181104
Osmanabad,BRINJAL,2016,894,2522,1628,182.10290827740494
Chandrapur-Ganjwad,Coriander  ,2014,1967,3595,1628,82.76563294356889
Pune,Walvad,2015,1188,2816,1628,137.03703703703704
Daryapur,Green Gram,2015,5888,7515,1627,27.632472826086957
Newasa-Ghodegaon,Onion,2014,335,1962,1627,485.67164179104475
Nashik,Mosambi,2015,1117,2744,1627,145.65801253357208
Solapur,Chillies(Red),2015,8753,10379,1626,18.576488061236148
Pimpalgaon Basawant,Onion,2015,972,2598,1626,167.28395061728395
Dhule,Black Gram,2015,6292,7918,1626,25.842339478703114
Karmala,Sorgum(Jawar),2016,1666,3292,1626,97.59903961584634
Shirpur,Pigeon Pea (Tur),2015,6935,8561,1626,23.446286950252343
Barshi,Onion,2014,150,1776,1626,1084.0
Pune,Brinjal,2016,874,2500,1626,186.04118993135012
Chandrapur,Mosambi,2016,1600,3225,1625,101.5625
Karad,Mosambi,2015,4229,5854,1625,38.42515961220147
Pune-Moshi,Squash Gourd,2016,3625,5250,1625,44.827586206896555
Pune,Wal Papdi,2015,2250,3875,1625,72.22222222222223
Aurangabad,Tamarind,2015,2750,4375,1625,59.09090909090909
Indapur-Bhigwan,GRAM,2016,7175,8800,1625,22.64808362369338
Aurangabad,Grapes,2014,4125,5750,1625,39.39393939393939
Dondaicha,Matki,2015,6336,7961,1625,25.64709595959596
Khamgaon,Pigeon Pea (Tur),2015,6044,7669,1625,26.886168100595633
Pandharpur,Ginger (Dry),2015,2250,3875,1625,72.22222222222223
Akot,Thymol/Lovage,2016,14488,16113,1625,11.21617890668139
Manchar,Capsicum,2016,3125,4750,1625,52.0
Ahmednagar,Ghosali(Bhaji),2016,1250,2875,1625,130.0
Kolhapur,Pineapple,2015,375,2000,1625,433.3333333333333
Osmanabad,Ladies Finger,2016,1500,3125,1625,108.33333333333333
Vadgaon Peth,Cluster Bean,2016,2750,4375,1625,59.09090909090909
Pune-Manjri,Goosefoot,2015,0,1625,1625,inf
Solapur,Carrot,2014,577,2202,1625,281.62911611785097
Ramtek,Garlic,2015,6375,8000,1625,25.49019607843137
Sangli-Phale Bhajipalam,Ginger (Fresh),2016,2125,3750,1625,76.47058823529412
Osmanabad,Green Chilli,2016,1650,3275,1625,98.48484848484848
Ratanagari,Bitter Gourd,2016,3125,4750,1625,52.0
Shrirampur,Garlic,2016,4750,6375,1625,34.21052631578947
Ratanagari,Bitter Gourd,2016,4750,6375,1625,34.21052631578947
Aurangabad,Garlic,2015,3125,4750,1625,52.0
Mantha,Black Gram,2015,6600,8225,1625,24.62121212121212
Jalna,GRAM,2016,7056,8680,1624,23.015873015873016
Kamthi,Mint,2015,1965,3588,1623,82.59541984732824
Aurangabad,Lemon,2015,2659,4282,1623,61.03798420458819
Lasalgaon,Soybean,2014,1713,3336,1623,94.7460595446585
Pune,Ginger (Fresh),2015,1427,3050,1623,113.73510861948142
Sinner,Onion,2014,118,1741,1623,1375.4237288135594
Pandharpur,Green Chilli,2015,1600,3223,1623,101.4375
Karmala,Sorgum(Jawar),2016,1664,3287,1623,97.5360576923077
Khed-Chakan,Green Chilli,2016,5377,7000,1623,30.184117537660406
Solapur,Guava,2015,731,2354,1623,222.02462380300958
Akluj,Shevga,2016,2410,4033,1623,67.34439834024896
Jalgaon Jamod-Aasalgaon,Pigeon Pea (Tur),2015,5757,7379,1622,28.17439638700712
Pune,Ginger (Fresh),2014,1988,3610,1622,81.58953722334005
Kurdwadi-Modnimb,Onion,2015,83,1705,1622,1954.2168674698796
Lasalgaon-Niphad,Onion,2014,1975,3596,1621,82.07594936708861
Ahmedpur,Sunflower,2014,2840,4461,1621,57.07746478873239
Latur,Pigeon Pea (Tur),2016,7974,9595,1621,20.32856784549787
Rahuri,LADIES FINGER,2016,700,2320,1620,231.42857142857142
Solapur,Green Gram,2015,7500,9120,1620,21.6
Pathardi,Onion,2014,150,1770,1620,1080.0
Kolhapur,Green-Peas,2015,4730,6350,1620,34.24947145877378
Ahmednagar,SQUASH GOURD,2016,780,2400,1620,207.69230769230768
Pune-Manjri,Coriander  ,2016,1050,2670,1620,154.28571428571428
Phaltan,Green-Peas,2016,2947,4567,1620,54.97115710892433
Shirpur,Sesamum,2016,4047,5667,1620,40.02965159377317
Lasalgaon,Onion,2014,323,1943,1620,501.5479876160991
Mukhed,Black Gram,2016,5697,7317,1620,28.436018957345972
Malegaon,Onion,2015,824,2444,1620,196.60194174757282
Sangali,Coriander (Dry),2016,6440,8060,1620,25.15527950310559
Mehkar,Black Gram,2015,8083,9703,1620,20.042063590251143
Nashik,Garlic,2014,3914,5533,1619,41.3643331630046
Solapur,Brinjal,2015,346,1965,1619,467.91907514450867
Sinner,Gram,2016,5962,7581,1619,27.15531700771553
Ramtek,Coriander  ,2015,6143,7762,1619,26.355201041836235
Kolhapur,Green Chilli,2016,3237,4856,1619,50.01544640098857
Nandgaon,Ground Nut Pods (Dry),2014,2379,3998,1619,68.05380411937789
Junnar-Otur,Cluster Bean,2016,2125,3743,1618,76.14117647058823
Anajngaon Surji,Chillies(Red),2014,6582,8200,1618,24.58219386204801
Lasalgaon-Vinchur,Green Gram,2016,4302,5919,1617,37.58716875871688
Kolhapur,Squash Gourd,2016,433,2050,1617,373.44110854503464
Vadgaon Peth,Ladies Finger,2015,1633,3250,1617,99.02020820575628
Kolhapur,Cucumber,2016,457,2074,1617,353.8293216630197
Daryapur,Pigeon Pea (Tur),2016,7261,8878,1617,22.269659826470182
Jalna,Sorgum(Jawar),2015,1171,2788,1617,138.0871050384287
Akot,Thymol/Lovage,2015,9894,11511,1617,16.343238326258337
Manchar,Ladies Finger,2016,1770,3387,1617,91.35593220338983
Nashik,Squash Gourd,2016,3939,5555,1616,41.02564102564103
Indapur-Bhigwan,Green Gram,2015,5267,6883,1616,30.681602430225936
Solapur,Capsicum,2015,796,2412,1616,203.01507537688443
Nashik,Green Chilli,2016,4658,6274,1616,34.69300128810649
Nagpur,Pineapple,2015,1040,2656,1616,155.3846153846154
Telhara,Black Gram,2016,5134,6749,1615,31.456953642384107
Solapur,Brinjal,2016,407,2022,1615,396.8058968058968
Kamthi,Spinach,2014,1170,2785,1615,138.03418803418805
Shrirampur,Gram,2015,3296,4911,1615,48.99878640776699
Rahuri,Onion,2015,123,1738,1615,1313.0081300813008
Mangalwedha,Green Chilli,2016,2831,4446,1615,57.04697986577181
Nashik,Lemon,2016,1938,3552,1614,83.28173374613003
Jalna,Gram,2016,5678,7292,1614,28.425501937301867
Baramati,Onion,2015,717,2331,1614,225.10460251046024
Karmala,Sorgum(Jawar),2016,1647,3260,1613,97.93564055859137
Pune-Manjri,Bitter Gourd,2015,2570,4183,1613,62.762645914396884
Jalgaon,Onion,2015,1222,2835,1613,131.99672667757775
Kolhapur,Brinjal,2015,412,2025,1613,391.50485436893206
Nashik,Brinjal,2015,1225,2838,1613,131.6734693877551
Basmat,Turmeric,2015,7789,9401,1612,20.69585312620362
Pune,Wal Bhaji,2016,3444,5056,1612,46.80603948896632
Ahmednagar,Ghosali(Bhaji),2016,1444,3056,1612,111.63434903047091
Karad,Apple,2015,3944,5556,1612,40.87221095334686
Vadgaon Peth,Capsicum,2016,2222,3833,1611,72.50225022502251
Ahmednagar,Ghevda,2015,1889,3500,1611,85.283218634198
Pune-Manjri,Methi (Bhaji),2016,900,2511,1611,179.0
Jamkhed,Onion,2014,189,1800,1611,852.3809523809524
Aurangabad,Shevga,2015,3033,4644,1611,53.11572700296736
Mangalwedha,Tomato,2015,315,1926,1611,511.42857142857144
Pune,Turmeric,2016,10556,12167,1611,15.261462675255778
Kolhapur,Onion,2015,560,2171,1611,287.67857142857144
Mumbai,Coconut,2014,830,2440,1610,193.97590361445782
Rahata,Onion,2014,490,2100,1610,328.57142857142856
Latur,Pigeon Pea (Tur),2016,8130,9740,1610,19.80319803198032
Kamthi,Onion,2016,675,2285,1610,238.5185185185185
Nashik,Mosambi,2014,816,2426,1610,197.30392156862746
Jamkhed,Gram,2016,4090,5700,1610,39.36430317848411
Kolhapur,Bottle Gourd,2016,658,2267,1609,244.52887537993922
Solapur,Cucumber,2016,323,1932,1609,498.14241486068113
Osmanabad,Lemon,2016,1176,2785,1609,136.81972789115648
Newasa-Ghodegaon,Onion,2015,309,1918,1609,520.7119741100323
Pune-Manjri,Shepu,2015,955,2564,1609,168.48167539267016
Basmat,Turmeric,2015,9309,10917,1608,17.273606187560425
Ambad(Vadi Godri),Wheat(Husked),2016,1513,3121,1608,106.27891606080634
Kada,Onion,2014,467,2075,1608,344.3254817987152
Chalisgaon,Flower,2016,2017,3625,1608,79.7223599405057
Kamthi,Cabbage,2014,1160,2768,1608,138.6206896551724
Yeola,Onion,2015,850,2457,1607,189.05882352941177
Chandrapur-Ganjwad,CORIANDER ,2016,964,2571,1607,166.701244813278
Junnar-Otur,Ghevda,2016,1433,3040,1607,112.14235868806699
Pune-Manjri,Tomato,2016,1982,3589,1607,81.07971745711403
Kamthi,Methi (Bhaji),2015,960,2567,1607,167.39583333333334
Junnar-Otur,Beet Root,2016,682,2289,1607,235.63049853372434
Mumbai,Mosambi,2016,1000,2607,1607,160.7
Sangali,Green Gram,2016,5780,7387,1607,27.802768166089965
Vadgaon Peth,Green Chilli,2016,2644,4250,1606,60.741301059001515
Khamgaon,Sesamum,2015,7687,9293,1606,20.892415766879147
Kille Dharur,Pigeon Pea (Tur),2016,5818,7424,1606,27.603987624613268
Mohol,Pigeon Pea (Tur),2015,3800,5405,1605,42.23684210526316
Ahmednagar,Flower,2016,395,2000,1605,406.32911392405066
Kolhapur,Chikoo,2015,683,2288,1605,234.9926793557833
Samudrapur,Pigeon Pea (Tur),2016,7000,8605,1605,22.928571428571427
Nashik,Ginger (Fresh),2016,4769,6374,1605,33.65485426714196
Pune,Small Gourd,2016,1504,3108,1604,106.64893617021276
Karad,Pomegranate,2016,3496,5100,1604,45.88100686498856
Mumbai,Green Peas (Dry),2016,3200,4804,1604,50.125
Akola,Black Gram,2016,5803,7407,1604,27.640875409271068
Malkapur,GRAM,2016,7169,8773,1604,22.374110754638025
Kamthi,Methi (Bhaji),2016,2413,4017,1604,66.47326978864484
Sangli-Phale Bhajipalam,Onion,2016,325,1929,1604,493.53846153846155
Pune-Manjri,Brinjal,2016,1643,3246,1603,97.56542909312233
Kolhapur,Onion,2015,325,1928,1603,493.2307692307692
Chikhali,Pigeon Pea (Tur),2016,7197,8800,1603,22.273169376128944
Sindi (Selu),Pigeon Pea (Tur),2016,4204,5807,1603,38.13035204567079
Nashik,Brinjal,2016,2856,4458,1602,56.09243697478992
Pune-Pimpri,Ladies Finger,2016,3088,4690,1602,51.87823834196891
Baramati,Onion,2014,400,2002,1602,400.5
Nandura,Pigeon Pea (Tur),2015,5686,7288,1602,28.174463594794233
Nanded,Turmeric,2015,6118,7720,1602,26.185027786858452
Kolhapur,Tomato,2015,520,2122,1602,308.0769230769231
Basmat,Turmeric,2016,7783,9384,1601,20.570474110240266
Indapur-Bhigwan,Cowpea,2016,5000,6601,1601,32.02
Sillod-Bharadi,Gram,2016,5300,6901,1601,30.20754716981132
Kej,Pigeon Pea (Tur),2016,6248,7849,1601,25.624199743918055
Solapur,Green Chilli,2015,1256,2857,1601,127.46815286624204
Kolhapur,Carrot,2016,900,2500,1600,177.77777777777777
Kamthi,Kanda Pat,2014,2400,4000,1600,66.66666666666667
Lasur Station,Thymol/Lovage,2016,10400,12000,1600,15.384615384615385
Kamthi,Small Gourd,2016,400,2000,1600,400.0
Deglur,GREEN GRAM,2016,3001,4601,1600,53.31556147950683
Kamthi,Guava,2014,3400,5000,1600,47.05882352941177
Dound,Green Gram,2015,7200,8800,1600,22.22222222222222
Kalyan,Aster,2015,8000,9600,1600,20.0
Pune,Small Gourd,2015,1300,2900,1600,123.07692307692308
Karanja,Black Gram,2016,6075,7675,1600,26.337448559670783
Kalyan,Sesamum,2016,9000,10600,1600,17.77777777777778
Khed,Brinjal,2016,2900,4500,1600,55.172413793103445
Mangalwedha,Green Gram,2016,3600,5200,1600,44.44444444444444
Karanja,Black Gram,2016,6700,8300,1600,23.880597014925375
Akole,Gram,2016,5000,6600,1600,32.0
Mumbai,Grapes,2015,3800,5400,1600,42.10526315789474
Vadgaon Peth,Pavtta,2016,1500,3100,1600,106.66666666666667
Nagpur,Grapes,2016,3192,4792,1600,50.12531328320802
Bhandara,Pigeon Pea (Tur),2015,7000,8600,1600,22.857142857142858
Indapur-Bhigwan,Green Gram,2015,6767,8367,1600,23.644155460322153
Pune-Pimpri,Green Peas (Dry),2016,2600,4200,1600,61.53846153846154
Rahuri,Other Vegetables,2015,100,1700,1600,1600.0
Chandrapur,Jambhul,2015,1511,3111,1600,105.89013898080741
Akola,Batbati,2016,2600,4200,1600,61.53846153846154
Kamthi,Papai,2015,400,2000,1600,400.0
Nashik,Wal Papdi,2014,1875,3475,1600,85.33333333333333
Kamthi,Carrot,2014,3400,5000,1600,47.05882352941177
Kalyan,Sesamum,2016,7800,9400,1600,20.512820512820515
Risod,Black Gram,2016,7500,9100,1600,21.333333333333332
Sengaon,Turmeric,2015,7633,9233,1600,20.96161404428141
Kamthi,Guava,2016,1400,3000,1600,114.28571428571429
Pune,Mula Shenga,2015,1170,2770,1600,136.75213675213675
Kolhapur,Spinach,2016,1200,2800,1600,133.33333333333334
Kamthi,Beet Root,2016,1092,2692,1600,146.5201465201465
Indapur-Bhigwan,Cowpea,2015,4625,6225,1600,34.5945945945946
Kolhapur-Laxmipuri,Green Peas (Dry),2014,3600,5200,1600,44.44444444444444
Junnar-Otur,Capsicum,2016,1000,2600,1600,160.0
Kamthi,Lemon,2016,1110,2710,1600,144.14414414414415
Mumbai,Cowpea,2015,4395,5995,1600,36.40500568828214
Kamthi,Pumpkin,2016,400,2000,1600,400.0
Umared,Rice(Paddy-Hus),2015,2000,3600,1600,80.0
Pune,Bitter Gourd,2016,2945,4545,1600,54.32937181663837
Ausa,Wheat(Husked),2015,1541,3141,1600,103.82868267358857
Dound,Cowpea,2015,5400,7000,1600,29.62962962962963
Anajngaon Surji,Chillies(Red),2015,8500,10100,1600,18.823529411764707
Kamthi,Methi (Bhaji),2015,1468,3068,1600,108.99182561307902
Aurangabad,Jambhul,2016,5200,6800,1600,30.76923076923077
Kalyan,Sesamum,2015,10440,12040,1600,15.32567049808429
Kamthi,Papai,2015,1400,3000,1600,114.28571428571429
Mangalwedha,Ladies Finger,2016,413,2013,1600,387.409200968523
Kolhapur-Laxmipuri,Spilt Pigeon Pea,2016,13000,14600,1600,12.307692307692308
Manchar,Onion,2014,400,2000,1600,400.0
Sinner,Black Gram,2015,5940,7540,1600,26.936026936026938
Rahuri,Brinjal,2015,400,2000,1600,400.0
Nagpur,Chikoo,2016,1130,2730,1600,141.5929203539823
Akluj,Shevga,2014,3300,4900,1600,48.484848484848484
Mumbai,Green-Peas,2015,5600,7200,1600,28.571428571428573
Kamthi,Leafy Vegetable,2014,2400,4000,1600,66.66666666666667
Kolhapur-Malkapur,Ladies Finger,2016,900,2500,1600,177.77777777777777
Kalyan,Matki,2015,8000,9600,1600,20.0
Varud-Rajura Bazar,Pigeon Pea (Tur),2016,6200,7800,1600,25.806451612903224
Kada,Onion,2015,500,2100,1600,320.0
Kopargaon,Chikoo,2015,450,2050,1600,355.55555555555554
Vadgaon Peth,Ridge Gourd,2016,2545,4145,1600,62.86836935166994
Barshi,Chillies(Red),2016,5200,6800,1600,30.76923076923077
Ahmednagar,Brinjal,2015,1273,2873,1600,125.68735271013354
Jalgaon,Mosambi,2015,1325,2925,1600,120.75471698113208
Kolhapur-Malkapur,Cluster Bean,2016,900,2500,1600,177.77777777777777
Sangali,Horse Gram,2015,2000,3600,1600,80.0
Kamthi,Guava,2015,1900,3500,1600,84.21052631578948
Basmat (Kurunda),Turmeric,2016,7600,9200,1600,21.05263157894737
Paithan,Mosambi,2016,1082,2681,1599,147.7818853974122
Pune,Chillies(Red),2016,14601,16200,1599,10.951304705157181
Karmala,Sorgum(Jawar),2014,1623,3222,1599,98.52125693160814
Indapur,Ground Nut Pods (Dry),2015,3850,5449,1599,41.532467532467535
Sinner,Onion,2014,225,1823,1598,710.2222222222222
Loha,Green Gram,2014,5028,6626,1598,31.782020684168657
Dhule,Ground Nut Pods (Dry),2014,2755,4353,1598,58.00362976406534
Lasalgaon,Gram,2015,2687,4284,1597,59.43431336062523
Parola,Gram,2015,2097,3693,1596,76.10872675250357
Khed-Chakan,Farshi,2016,6250,7846,1596,25.536
Kopargaon,Onion,2014,383,1979,1596,416.710182767624
Nagpur,Mosambi,2015,1342,2938,1596,118.92697466467958
Jalgaon,Tomato,2016,2663,4258,1595,59.89485542621104
Mumbai,Guava,2016,990,2585,1595,161.11111111111111
Gangapur,Black Gram,2016,5000,6595,1595,31.9
Mandhal,Chillies(Red),2016,5385,6980,1595,29.619312906220983
Jalgaon,Lemon,2015,1930,3525,1595,82.64248704663213
Lasalgaon,Onion,2015,1789,3383,1594,89.10005589714925
Devala,Gram,2015,3241,4835,1594,49.18235112619562
Nagpur,Gram,2016,6496,8089,1593,24.522783251231527
Babhulgaon,Pigeon Pea (Tur),2016,7539,9132,1593,21.130123358535617
Phaltan,Onion,2014,500,2092,1592,318.4
Kamthi,Mango,2016,1089,2681,1592,146.18916437098255
Pune,Pavtta,2016,2556,4148,1592,62.284820031298906
Akluj,Shevga,2015,3833,5425,1592,41.534046438820766
Vadgaon Peth,Ridge Gourd,2016,1575,3167,1592,101.07936507936508
Chikhali,Gram,2016,5688,7280,1592,27.9887482419128
Mangaon(Bhadav),Nachani,2015,1367,2958,1591,116.38624725676664
Khed-Chakan,Green-Peas,2016,6273,7864,1591,25.362665391359798
Vadgaon Peth,Ridge Gourd,2015,1545,3136,1591,102.97734627831716
Aurangabad,Onion,2015,659,2250,1591,241.42640364188165
Nashik,Coriander  ,2016,1800,3390,1590,88.33333333333333
Osmanabad,Gram,2016,5200,6790,1590,30.576923076923077
Nashik,Ghevda,2015,2755,4345,1590,57.71324863883847
Sangli-Phale Bhajipalam,Pineapple,2015,833,2423,1590,190.8763505402161
Kurdwadi-Modnimb,Gram,2015,3156,4745,1589,50.348542458808616
Kamthi,Onion,2015,900,2489,1589,176.55555555555554
Kolhapur-Malkapur,Brinjal,2016,411,2000,1589,386.61800486618006
Jamkhed,Onion,2015,139,1728,1589,1143.1654676258993
Nanded,Turmeric,2016,8239,9828,1589,19.286321155480035
Nashik,Ghevda,2014,1515,3103,1588,104.81848184818482
Solapur,Green Chilli,2015,1732,3320,1588,91.68591224018476
Umared,Rice(Paddy-Hus),2016,2000,3588,1588,79.4
Aurangabad,Ginger (Fresh),2016,750,2338,1588,211.73333333333332
Akluj,Garlic,2016,4447,6035,1588,35.70946705644255
Sangrampur-Varvatbakal,Pigeon Pea (Tur),2016,6984,8571,1587,22.7233676975945
Aurangabad,Ginger (Fresh),2016,871,2457,1586,182.08955223880596
Pune,Ghosali(Bhaji),2015,1338,2924,1586,118.53512705530643
Babhulgaon,Pigeon Pea (Tur),2015,5181,6767,1586,30.6118509940166
Kamthi,Cluster Bean,2015,1224,2810,1586,129.5751633986928
Dhule,Onion,2015,548,2133,1585,289.2335766423358
Kamthi,Chavli (Shenga ),2015,1648,3233,1585,96.17718446601941
Kej,Pigeon Pea (Tur),2015,9200,10785,1585,17.22826086956522
Sinner,Green Gram,2016,3581,5166,1585,44.261379502932144
Jalna,Pigeon Pea (Tur),2015,5052,6636,1584,31.35391923990499
Aurangabad,Lemon,2016,3444,5028,1584,45.99303135888502
Jalgaon,Coriander  ,2015,2153,3737,1584,73.57176033441709
Jalna,Sorgum(Jawar),2014,1121,2705,1584,141.30240856378234
Nashik,Bitter Gourd,2015,2416,4000,1584,65.56291390728477
Mehkar,Gram,2016,7683,9267,1584,20.61694650527138
Kopargaon,Onion,2014,600,2184,1584,264.0
Nashik,Green Chilli,2016,5200,6784,1584,30.46153846153846
Lasalgaon,Gram,2015,3014,4598,1584,52.55474452554745
Akluj,Carrot,2016,1482,3065,1583,106.81511470985156
Malegaon,Ground Nut Pods (Dry),2015,4727,6310,1583,33.48847048868204
Junnar-Otur,Maize(Corn.),2016,1100,2683,1583,143.9090909090909
Chandrapur,Papai,2016,1417,3000,1583,111.71489061397318
Solapur,Ladies Finger,2015,502,2085,1583,315.3386454183267
Mangaon(Bhadav),Nachani,2014,1400,2983,1583,113.07142857142857
Baramati,Ground Nut Pods (Dry),2015,4460,6043,1583,35.493273542600896
Nandurbar,Wheat(Husked),2015,1219,2802,1583,129.8605414273995
Gangapur,Onion,2014,428,2011,1583,369.85981308411215
Pandharpur,Math (Bhaji),2014,500,2083,1583,316.6
Chikhali,Pigeon Pea (Tur),2016,6717,8300,1583,23.567068631829684
Ratanagari,Green-Peas,2016,4250,5833,1583,37.247058823529414
Lasalgaon,Soybean,2016,2513,4096,1583,62.992439315559096
Dondaicha,Gram,2015,2933,4516,1583,53.972042277531536
Pune-Manjri,Methi (Bhaji),2015,927,2509,1582,170.65803667745416
Pathari,Wheat(Husked),2015,507,2089,1582,312.0315581854043
Mumbai,Split Black Gram,2015,13877,15459,1582,11.400158535706565
Kolhapur,Carrot,2015,684,2266,1582,231.28654970760235
Shirpur,Soybean,2015,1960,3542,1582,80.71428571428571
Kamthi,Guava,2015,1048,2630,1582,150.95419847328245
Nanded,Turmeric,2016,6639,8221,1582,23.828889893056182
Mumbai,Cowpea,2016,5022,6604,1582,31.501393866985264
Risod,Pigeon Pea (Tur),2016,6892,8474,1582,22.954149738827628
Solapur,Ridge Gourd,2015,535,2117,1582,295.70093457943926
Phaltan,Onion,2014,440,2022,1582,359.54545454545456
Akluj,Shevga,2016,2700,4281,1581,58.55555555555556
Nandgaon Khandeshwar,Black Gram,2015,7970,9551,1581,19.836888331242157
Kurdwadi,Sorgum(Jawar),2014,1183,2764,1581,133.64327979712596
Satara,Green-Peas,2015,4638,6219,1581,34.08796895213454
Vadgaon Peth,Flower,2016,1350,2931,1581,117.11111111111111
Pune-Manjri,Kanda Pat,2015,764,2345,1581,206.9371727748691
Aurangabad,Green Chilli,2016,3336,4916,1580,47.3621103117506
Amarawati,Black Gram,2015,9311,10891,1580,16.96917624315326
Kolhapur,Carrot,2016,1560,3140,1580,101.28205128205128
Pune,Green Peas (Dry),2015,2990,4570,1580,52.84280936454849
Solapur,Cucumber,2014,304,1884,1580,519.7368421052631
Akluj,Chikoo,2015,1953,3533,1580,80.90117767537123
Solapur,Tomato,2014,232,1812,1580,681.0344827586207
Phaltan,Onion,2015,350,1930,1580,451.42857142857144
Hinganghat,Gram,2016,5019,6599,1580,31.480374576608884
Pandharpur,Brinjal,2015,497,2077,1580,317.90744466800805
Amalner,GRAM,2016,7460,9040,1580,21.179624664879356
Solapur,Chikoo,2016,616,2195,1579,256.33116883116884
Solapur,Tomato,2016,616,2195,1579,256.33116883116884
Pune-Manjri,GUAVA,2016,2238,3817,1579,70.55406613047364
Manchar,Onion,2014,533,2112,1579,296.2476547842401
Malegaon,Pigeon Pea (Tur),2016,6570,8149,1579,24.033485540334855
Nagpur,Pineapple,2014,1042,2621,1579,151.5355086372361
Kamthi,Coriander  ,2015,1445,3024,1579,109.27335640138408
Aurangabad,Mosambi,2016,1365,2943,1578,115.6043956043956
Sangrampur,Gram,2016,4072,5650,1578,38.7524557956778
Udgir,Tamarind,2015,3525,5103,1578,44.765957446808514
Aurangabad,Mosambi,2016,3423,5000,1577,46.07069821793748
Karad,Garlic,2016,6788,8365,1577,23.232174425456687
Dhule,Onion,2015,531,2108,1577,296.98681732580036
Rahata,Garlic,2016,3462,5038,1576,45.522819179664936
Mangalwedha,Bitter Gourd,2015,1187,2763,1576,132.77169334456613
Ausa,Wheat(Husked),2015,1375,2951,1576,114.61818181818182
Kolhapur,Jaggery,2015,2425,4001,1576,64.98969072164948
Mumbai,Coconut,2014,800,2376,1576,197.0
Kamthi,Pumpkin,2014,1000,2575,1575,157.5
Pathardi,GRAM,2016,4675,6250,1575,33.68983957219251
Sangali,Lentil,2015,4150,5725,1575,37.95180722891566
Kolhapur,Spinach,2016,1225,2800,1575,128.57142857142858
Pune-Manjri,Hemp,2016,0,1575,1575,inf
Kolhapur,Chikoo,2016,1050,2625,1575,150.0
Palus,Bitter Gourd,2015,1800,3375,1575,87.5
Khed-Chakan,Farshi,2016,4775,6350,1575,32.98429319371728
Umared,Rice(Paddy-Hus),2015,2000,3575,1575,78.75
Kolhapur,Spinach,2015,1706,3281,1575,92.32121922626025
Karanja,Gram,2016,5649,7223,1574,27.86333864400779
Karad,Grapes,2016,3907,5481,1574,40.28666496032762
Pune,Cluster Bean,2014,1347,2921,1574,116.85226429101708
Pune-Manjri,Shepu,2015,1683,3256,1573,93.4640522875817
Pandharpur,Brinjal,2015,500,2073,1573,314.6
Osmanabad,Ghevda,2016,1700,3273,1573,92.52941176470588
Vadgaon Peth,Bitter Gourd,2016,2127,3700,1573,73.95392571697226
Chandrapur-Ganjwad,Garlic,2016,5107,6680,1573,30.80086156256119
Nashik,Methi (Bhaji),2016,746,2318,1572,210.72386058981232
Pune-Manjri,Brinjal,2015,1888,3460,1572,83.26271186440678
Pune,Black Gram,2016,10678,12250,1572,14.721858025847537
Pune,Wal Papdi,2016,2008,3580,1572,78.28685258964144
Sangamner,Bajri,2015,1411,2983,1572,111.4103472714387
Pune,Green Chilli,2015,2133,3705,1572,73.69901547116737
Vadgaon Peth,Pavtta,2016,2214,3786,1572,71.00271002710028
Karad,Mosambi,2014,4714,6286,1572,33.347475604582094
Pune,Black Gram,2016,10571,12143,1572,14.870873143505818
Pune,Carrot,2015,989,2561,1572,158.948432760364
Mumbai-Onion And Potato Mkt,GARLIC,2016,6622,8194,1572,23.73905164602839
Paranda,Onion,2015,232,1803,1571,677.1551724137931
Osmanabad,Ginger (Fresh),2016,1829,3400,1571,85.89393110989612
Kamthi,Green-Peas,2015,2000,3571,1571,78.55
Karad,Garlic,2015,3000,4571,1571,52.36666666666667
Lasalgaon,Ground Nut Pods (Dry),2016,2500,4070,1570,62.8
Malegaon,Green Gram,2014,5172,6742,1570,30.355761794276876
Pimpalgaon Basawant,Tomato,2016,408,1978,1570,384.80392156862746
Ramtek,Pigeon Pea (Tur),2016,5708,7278,1570,27.505255781359494
Kolhapur,Bitter Gourd,2015,1370,2940,1570,114.5985401459854
Chikhali,Pigeon Pea (Tur),2015,4180,5750,1570,37.55980861244019
Arvi,Pigeon Pea (Tur),2015,6644,8214,1570,23.63034316676701
Solapur,Tomato,2014,146,1715,1569,1074.6575342465753
Sillod-Bharadi,Pigeon Pea (Tur),2016,6831,8400,1569,22.968818620992533
Pandharpur,Green Chilli,2015,1055,2624,1569,148.72037914691944
Manchar,Farshi,2016,1164,2733,1569,134.79381443298968
Baramati,Onion,2014,350,1919,1569,448.2857142857143
Pune,Mango(Raw),2016,709,2277,1568,221.15655853314527
Kolhapur,Shevga,2016,750,2318,1568,209.06666666666666
Manora,BLACK GRAM,2016,5186,6754,1568,30.23524874662553
Barshi,Onion,2014,199,1767,1568,787.9396984924623
Shahada,Black Gram,2016,5446,7014,1568,28.79177377892031
Nagpur,Pigeon Pea (Tur),2015,5702,7270,1568,27.499123114696598
Nagpur,Apple,2015,3064,4632,1568,51.174934725848566
Jalna,Black Gram,2016,5591,7159,1568,28.04507243784654
Solapur,Mula Shenga,2015,1416,2984,1568,110.73446327683615
Junnar-Otur,Ghevda,2016,1433,3000,1567,109.351011863224
Solapur,Guava,2016,1298,2865,1567,120.72419106317412
Majalgaon,Sorgum(Jawar),2014,1025,2592,1567,152.8780487804878
Jalgaon,Green Chilli,2014,1661,3228,1567,94.34075857916918
Junnar-Otur,LADIES FINGER,2016,1333,2900,1567,117.55438859714928
Jalgaon,Mosambi,2015,1100,2667,1567,142.45454545454547
Ambejogai,Pigeon Pea (Tur),2015,5350,6917,1567,29.289719626168225
Pune-Manjri,Bottle Gourd,2015,1208,2775,1567,129.7185430463576
Umared,Gram,2015,3617,5184,1567,43.32319601880011
Mangalwedha,Green Chilli,2015,1144,2711,1567,136.97552447552448
Solapur,Tomato,2015,248,1814,1566,631.4516129032259
Parner,Onion,2015,675,2241,1566,232.0
Shirpur,Black Gram,2016,6139,7705,1566,25.50904056035185
Sangrampur,Gram,2015,2638,4204,1566,59.36315390447309
Dhule,Gram,2016,5996,7562,1566,26.117411607738493
Mumbai,Split Black Gram,2015,10543,12109,1566,14.853457270226691
Dhule,Ground Nut Pods (Dry),2015,3971,5537,1566,39.43591035003777
Pune,Wal Bhaji,2016,2043,3609,1566,76.65198237885463
Kalyan,Matki,2015,6167,7733,1566,25.393221988000647
Pandharpur,Onion,2015,253,1818,1565,618.5770750988142
Risod,Pigeon Pea (Tur),2016,7886,9451,1565,19.84529546030941
Jalgaon,Ladies Finger,2016,2250,3814,1564,69.5111111111111
Osmanabad,Brinjal,2015,739,2303,1564,211.63734776725303
Chandrapur,Apple,2015,3318,4882,1564,47.13682941531043
Kalvan,Onion,2014,336,1900,1564,465.4761904761905
Latur,Pigeon Pea (Tur),2016,7253,8817,1564,21.5634909692541
Jalgaon,Ginger (Fresh),2015,2425,3988,1563,64.45360824742268
Pune,Small Gourd,2015,1500,3063,1563,104.2
Palus,Squash Gourd,2016,2375,3938,1563,65.81052631578947
Jalna,Gram,2016,6473,8036,1563,24.14645450332149
Kolhapur,Squash Gourd,2016,750,2313,1563,208.4
Mumbai,Green Peas (Dry),2015,2611,4174,1563,59.8621217924167
Ahmednagar,Ladies Finger,2016,476,2038,1562,328.1512605042017
Partur,Black Gram,2016,5065,6627,1562,30.839091806515302
Solapur,Green Chilli,2015,1214,2776,1562,128.665568369028
Karad,Mosambi,2015,2688,4250,1562,58.11011904761905
Sangamner,Onion,2015,500,2062,1562,312.4
Osmanabad,Flower,2015,1600,3161,1561,97.5625
Barshi,Gram,2016,6030,7591,1561,25.887230514096185
Mangaon(Bhadav),Nachani,2015,1340,2900,1560,116.41791044776119
Pune,Walvad,2016,2000,3560,1560,78.0
Kamthi,Lemon,2014,1490,3050,1560,104.69798657718121
Kolhapur-Malkapur,Cluster Bean,2016,1260,2820,1560,123.80952380952381
Mumbai,Pineapple,2015,940,2500,1560,165.95744680851064
Solapur,Chikoo,2016,1190,2750,1560,131.0924369747899
Pune-Pimpri,Green Peas (Dry),2015,2640,4200,1560,59.09090909090909
Manchar,Bitter Gourd,2016,4380,5940,1560,35.61643835616438
Baramati,Pigeon Pea (Tur),2015,6300,7860,1560,24.761904761904763
Kamthi,Orange,2015,1290,2850,1560,120.93023255813954
Latur,Gram,2016,6797,8357,1560,22.95130204501986
Kamthi,Mint,2016,1573,3133,1560,99.17355371900827
Lasur Station,Onion,2015,180,1740,1560,866.6666666666666
Pusad,Gram,2015,4080,5639,1559,38.21078431372549
Manchar,Methi (Bhaji),2015,555,2114,1559,280.9009009009009
Rahata,Onion,2016,427,1986,1559,365.10538641686185
Mumbai,Shevga,2015,4108,5667,1559,37.95034079844206
Aurangabad,Pomegranate,2015,1071,2629,1558,145.47152194211017
Kalamb (Os),Pigeon Pea (Tur),2016,7478,9036,1558,20.834447713292324
Rahuri,Onion,2016,200,1758,1558,779.0
Ramtek,Garlic,2015,7906,9464,1558,19.706551985833546
Mumbai,Mosambi,2015,1008,2565,1557,154.46428571428572
Satara,Green Chilli,2016,6058,7615,1557,25.701551667216904
Osmanabad,Ridge Gourd,2015,979,2536,1557,159.03983656792644
Chandrapur,Pomegranate,2015,2750,4307,1557,56.61818181818182
Ahmednagar,Mango(Raw),2016,1619,3176,1557,96.17047560222359
Shrigonda,Black Gram,2016,5214,6771,1557,29.86191024165708
Pune,Wal Papdi,2015,1126,2683,1557,138.2770870337478
Hingoli,Turmeric,2015,6974,8530,1556,22.31144250071695
Dondaicha,Pigeon Pea (Tur),2016,6855,8411,1556,22.698760029175784
Ramtek,Garlic,2016,7222,8778,1556,21.545278316255885
Buldhana,GRAM,2016,7200,8756,1556,21.61111111111111
Kolhapur,CARROT,2016,636,2191,1555,244.49685534591194
Jalgaon,Methi (Bhaji),2015,3786,5341,1555,41.072371896460645
Kalyan,Shewanti,2016,6778,8333,1555,22.941870758335792
Osmanabad,Cluster Bean,2016,1520,3075,1555,102.30263157894737
Jalgaon,Ladies Finger,2016,2258,3813,1555,68.86625332152347
Karad,Ginger (Fresh),2015,2667,4222,1555,58.30521184851894
Kolhapur,Onion,2016,488,2042,1554,318.44262295081967
Ahmednagar,Brinjal,2016,429,1983,1554,362.23776223776224
Latur,Green Gram,2016,5540,7094,1554,28.050541516245488
Mumbai,Grapes,2014,2514,4068,1554,61.81384248210024
Kamthi,Onion,2015,818,2371,1553,189.85330073349633
Kamthi,Wal Bhaji,2016,1682,3235,1553,92.33055885850179
Vadgaon Peth,Cluster Bean,2016,2976,4529,1553,52.18413978494624
Sonpeth,Pigeon Pea (Tur),2016,7534,9087,1553,20.61322006902044
Lasalgaon,Soybean,2014,1954,3507,1553,79.47799385875128
Pune,Mango(Raw),2015,652,2204,1552,238.03680981595093
Parner,Onion,2014,443,1995,1552,350.33860045146724
Shahada,Green Gram,2014,4852,6404,1552,31.986809563066778
Solapur,CARROT,2016,396,1948,1552,391.9191919191919
Pune,Bitter Gourd,2016,2957,4509,1552,52.48562732499155
Yeola,Green Gram,2015,5200,6751,1551,29.826923076923077
Taloda,Green Gram,2015,4459,6009,1550,34.7611572101368
Amarawati,Onion,2015,2708,4258,1550,57.23781388478582
Chalisgaon,Ladies Finger,2016,1950,3500,1550,79.48717948717949
Kamthi,Kanda Pat,2015,1975,3525,1550,78.48101265822785
Aurangabad,Garlic,2014,1575,3125,1550,98.41269841269842
Nandgaon,Green Gram,2014,7117,8667,1550,21.778839398623017
Nashik,Kanda Pat,2016,1503,3053,1550,103.12707917498336
Kamthi,Spinach,2014,1682,3232,1550,92.15219976218788
Udgir,Tamarind,2015,4686,6236,1550,33.07725138711054
Dudhani,Green Gram,2015,7300,8850,1550,21.232876712328768
Ausa,Gram,2016,5667,7217,1550,27.351332274572083
Manchar,Shevga,2016,5400,6950,1550,28.703703703703702
Nira,Rice(Paddy-Hus),2015,1900,3450,1550,81.57894736842105
Kolhapur,Carrot,2015,1275,2825,1550,121.56862745098039
Kalyan,Green Peas (Dry),2015,3063,4613,1550,50.603983023179886
Osmanabad,Cluster Bean,2016,2950,4500,1550,52.54237288135593
Shrirampur,GARLIC,2016,5450,7000,1550,28.440366972477065
Jalgaon,Flower,2016,2641,4191,1550,58.689890193108674
Mumbai,Jaggery,2014,4000,5550,1550,38.75
Vadgaon Peth,Ridge Gourd,2016,1875,3425,1550,82.66666666666667
Kolhapur,Sweet Potato,2016,388,1938,1550,399.4845360824742
Ahmednagar,Cucumber,2016,500,2050,1550,310.0
Pune-Manjri,Cluster Bean,2015,1713,3263,1550,90.48453006421482
Osmanabad,Cluster Bean,2015,2104,3654,1550,73.66920152091255
Balapur,Green Gram,2015,5800,7350,1550,26.724137931034484
Mangalwedha,Green Chilli,2015,1859,3407,1548,83.27057557826788
Kolhapur,Green Chilli,2015,650,2198,1548,238.15384615384616
Mehkar,Pigeon Pea (Tur),2016,7634,9182,1548,20.27770500392979
Solapur,Cucumber,2015,326,1874,1548,474.84662576687117
Vadgaon Peth,Flower,2016,1552,3100,1548,99.74226804123711
Mumbai,Orange,2015,1000,2548,1548,154.8
Mumbai,Mosambi,2016,888,2436,1548,174.32432432432432
Mehkar,Green Gram,2014,6215,7762,1547,24.891391794046662
Jamkhed,Sorgum(Jawar),2015,1664,3211,1547,92.96875
Aurangabad,Green Chilli,2016,3127,4673,1546,49.44035817077071
Pune-Manjri,Ambat Chuka,2015,92,1638,1546,1680.4347826086957
Lasalgaon,Pigeon Pea (Tur),2015,4077,5623,1546,37.92003924454256
Pune,Small Gourd,2015,1023,2568,1545,151.02639296187684
Kurdwadi-Modnimb,Gram,2016,4106,5651,1545,37.627861665854844
Kamthi,Chavli (Shenga ),2015,1172,2717,1545,131.8259385665529
Mangrulpeer,Green Gram,2015,6647,8192,1545,23.24356852715511
Pune,Brinjal,2014,1020,2565,1545,151.47058823529412
Nashik,Ground Nut Pods (Dry),2015,3811,5356,1545,40.54054054054054
Shrirampur,Onion,2015,260,1805,1545,594.2307692307693
Manchar,Chavli (Shenga ),2016,1881,3426,1545,82.13716108452951
Nashik,Ladies Finger,2015,1659,3204,1545,93.12839059674502
Aurangabad,Mosambi,2015,1439,2983,1544,107.2967338429465
Nagpur,Orange,2015,1236,2780,1544,124.91909385113269
Indapur-Bhigwan,Pigeon Pea (Tur),2016,6260,7804,1544,24.664536741214057
Sinner,Green Gram,2014,6142,7686,1544,25.138391403451646
Mumbai,Pineapple,2015,852,2396,1544,181.2206572769953
Pandharpur,Ladies Finger,2015,889,2433,1544,173.67829021372327
Akluj,Bitter Gourd,2016,1667,3211,1544,92.62147570485902
Kamthi,Chavli (Pala),2015,876,2420,1544,176.25570776255708
Shrirampur,Onion,2015,192,1735,1543,803.6458333333334
Kolhapur-Laxmipuri,Gr.Nut Kernels,2014,5563,7106,1543,27.736832644256697
Rahuri,Onion,2015,114,1657,1543,1353.5087719298247
Nagpur,Ginger (Dry),2015,3686,5229,1543,41.86109603906674
Kamthi,Spinach,2014,876,2419,1543,176.1415525114155
Mumbai,Coconut,2016,533,2075,1542,289.30581613508446
Solapur,Ghevda,2015,1708,3250,1542,90.28103044496487
Vasai,Onion,2015,2358,3900,1542,65.39440203562341
Pune-Manjri,Green Chilli,2015,2944,4486,1542,52.37771739130435
Akluj,Ladies Finger,2015,1747,3289,1542,88.26559816828849
Solapur,Cucumber,2015,206,1748,1542,748.5436893203884
Pusad,Green Gram,2015,6486,8027,1541,23.75886524822695
Solapur,Green Chilli,2014,1163,2704,1541,132.50214961306963
Dudhani,Gram,2016,7211,8752,1541,21.370128969629732
Shirpur,Soybean,2015,2166,3707,1541,71.1449676823638
Vadgaon Peth,Brinjal,2016,1765,3306,1541,87.30878186968839
Chandur Bajar,Gram,2016,8405,9946,1541,18.3343248066627
Rahata,Garlic,2016,3792,5333,1541,40.63818565400844
Osmanabad,Lemon,2016,1572,3113,1541,98.02798982188295
Mumbai,Pineapple,2016,1006,2546,1540,153.08151093439363
Umared,Rice(Paddy-Hus),2015,2000,3540,1540,77.0
Devala,Gram,2016,4848,6388,1540,31.765676567656765
Kamthi,Green Chilli,2015,1310,2850,1540,117.55725190839695
Anajngaon Surji,Ground Nut Pods (Dry),2016,3763,5303,1540,40.92479404730268
Umarga,Green Gram,2015,6343,7883,1540,24.27873246098061
Pune-Manjri,Ladies Finger,2016,3313,4853,1540,46.48354965288259
Kolhapur-Malkapur,Bitter Gourd,2016,610,2150,1540,252.45901639344262
Kolhapur-Malkapur,Brinjal,2016,294,1833,1539,523.469387755102
Chandrapur-Ganjwad,Coriander  ,2016,1692,3231,1539,90.95744680851064
Kolhapur,Onion,2014,491,2030,1539,313.44195519348267
Khed-Chakan,Green Chilli,2016,4519,6058,1539,34.05620712547024
Jamkhed,Onion,2014,217,1756,1539,709.2165898617511
Pune-Manjri,Cluster Bean,2016,2668,4207,1539,57.68365817091454
Kamthi,Green Chilli,2015,1641,3179,1538,93.72333942717854
Indapur,Ground Nut Pods (Dry),2015,3601,5139,1538,42.71035823382394
Chandrapur-Ganjwad,Wal Bhaji,2014,1881,3419,1538,81.76501860712386
Amarawati,Garlic,2014,2154,3692,1538,71.40204271123491
Mangrulpeer,Gram,2015,3388,4926,1538,45.39551357733176
Pune-Manjri,Coriander  ,2014,919,2456,1537,167.24700761697497
Pune-Manjri,Chavli (Shenga ),2016,2563,4100,1537,59.96878657822864
Rahuri,Orange,2016,271,1807,1536,566.789667896679
Pune-Manjri,Walvad,2014,2387,3923,1536,64.34855467113532
Nashik,Tomato,2015,1071,2607,1536,143.4173669467787
Pathari,Soybean,2016,1967,3503,1536,78.0884595831215
Pune-Manjri,Ladies Finger,2016,2119,3655,1536,72.48702218027371
Dhule,Black Gram,2015,8090,9626,1536,18.986402966625462
Mumbai,Ladies Finger,2014,1640,3176,1536,93.65853658536585
Pune-Manjri,Cucumber,2015,1482,3018,1536,103.64372469635627
Kamthi,Cluster Bean,2014,1096,2632,1536,140.14598540145985
Mangalwedha,Green Chilli,2014,1550,3085,1535,99.03225806451613
Pune-Manjri,Shepu,2015,975,2510,1535,157.43589743589743
Chalisgaon,Black Gram,2016,5611,7146,1535,27.356977365888433
Umared,Pigeon Pea (Tur),2016,6900,8435,1535,22.246376811594203
Chandrapur-Ganjwad,Garlic,2016,10365,11900,1535,14.809454896285576
Kamthi,Carrot,2016,1483,3017,1534,103.43897505057316
Barshi,Onion,2015,119,1653,1534,1289.0756302521008
Basmat,Turmeric,2015,6656,8190,1534,23.046875
Nashik,Mosambi,2015,883,2417,1534,173.7259343148358
Manchar,Coriander  ,2015,332,1866,1534,462.04819277108436
Pune-Moshi,Bitter Gourd,2016,3621,5155,1534,42.36398784866059
Pune-Manjri,Ambat Chuka,2015,162,1696,1534,946.9135802469136
Chalisgaon,Matki,2016,6200,7734,1534,24.741935483870968
Kolhapur-Laxmipuri,Spilt Pigeon Pea,2015,15711,17244,1533,9.757494748902044
Pune-Moshi,Squash Gourd,2016,3896,5429,1533,39.34804928131417
Nandura,Green Gram,2015,7095,8628,1533,21.60676532769556
Basmat,Turmeric,2016,8971,10504,1533,17.088395942481327
Kamthi,Green Chilli,2014,1138,2671,1533,134.71001757469244
Kolhapur-Laxmipuri,Gr.Nut Kernels,2015,7542,9075,1533,20.32617342879873
Phaltan,Gram,2016,6767,8300,1533,22.654056450421162
Mangaon(Bhadav),Nagali,2015,1467,3000,1533,104.49897750511248
Pune,Capsicum,2015,1713,3246,1533,89.49211908931699
Pune,Double Bee,2015,2786,4319,1533,55.02512562814071
Umared,Rice(Paddy-Hus),2016,2000,3533,1533,76.65
Shahada,Black Gram,2015,6901,8434,1533,22.21417185915085
Junnar-Otur,CLUSTER BEAN,2016,2000,3533,1533,76.65
Mumbai,Pineapple,2015,1000,2533,1533,153.3
Pune-Pimpri,Ridge Gourd,2015,2500,4033,1533,61.32
Indapur-Bhigwan,Green Gram,2016,6375,7908,1533,24.04705882352941
Nashik,Cucumber,2014,1299,2832,1533,118.01385681293303
Kolhapur,Cucumber,2015,550,2082,1532,278.54545454545456
Solapur,Sorgum(Jawar),2015,1690,3222,1532,90.6508875739645
Narkhed,Orange,2016,1814,3346,1532,84.4542447629548
Kolhapur,Ginger (Fresh),2016,1518,3050,1532,100.92226613965744
Shrirampur,Onion,2015,369,1900,1531,414.9051490514905
Kamthi,Flower,2014,1642,3173,1531,93.23995127892813
Vadgaon Peth,Ridge Gourd,2014,1750,3281,1531,87.48571428571428
Baramati,Ground Nut Pods (Dry),2015,3613,5144,1531,42.37475781898699
Pune,Brinjal,2016,851,2381,1530,179.78848413631022
Aurangabad,Garlic,2015,1540,3070,1530,99.35064935064935
Partur,Black Gram,2015,7139,8669,1530,21.4315730494467
Jalgaon,Green Chilli,2016,1596,3126,1530,95.86466165413533
Sindi (Selu),Pigeon Pea (Tur),2016,6067,7597,1530,25.218394593703643
Kamthi,Mint,2016,1161,2691,1530,131.7829457364341
Mumbai,Pineapple,2015,1000,2530,1530,153.0
Jalna,Sorgum(Jawar),2014,1145,2675,1530,133.6244541484716
Solapur,Tomato,2016,285,1815,1530,536.8421052631579
Pimpalgaon Basawant,Tomato,2014,237,1766,1529,645.1476793248945
Daryapur,Gram,2016,6452,7981,1529,23.69807811531308
Karad,Pomegranate,2015,2265,3794,1529,67.50551876379691
Kurdwadi-Modnimb,Pigeon Pea (Tur),2016,5567,7096,1529,27.46542123226154
Pune,Curry Leaves,2016,1521,3050,1529,100.52596975673899
Pune,Cucumber,2015,952,2481,1529,160.609243697479
Kamthi,Beet Root,2015,1836,3364,1528,83.2244008714597
Kamthi,Beet Root,2015,1745,3273,1528,87.56446991404012
Kamthi,Cluster Bean,2015,1836,3364,1528,83.2244008714597
Kamthi,Potato,2014,1868,3395,1527,81.74518201284796
Mangrulpeer,Pigeon Pea (Tur),2015,5935,7462,1527,25.728727885425442
Nashik,Cabbage,2016,1666,3193,1527,91.65666266506602
Jalgaon,Lemon,2016,2088,3615,1527,73.13218390804597
Kamthi,Kand,2015,1000,2527,1527,152.7
Mumbai,Brinjal,2015,1965,3492,1527,77.70992366412214
Kolhapur,Ginger (Fresh),2016,1500,3026,1526,101.73333333333333
Dhamangaon-Rly,GRAM,2016,5700,7226,1526,26.771929824561404
Vadgaon Peth,Ridge Gourd,2016,2487,4013,1526,61.359067149175715
Vadgaon Peth,Brinjal,2016,1474,3000,1526,103.52781546811397
Malkapur,Green Gram,2015,6068,7594,1526,25.148319050758076
Chikhali,Black Gram,2016,5972,7498,1526,25.552578700602812
Shrigonda,Onion,2015,307,1833,1526,497.0684039087948
Balapur,Pigeon Pea (Tur),2016,6650,8175,1525,22.93233082706767
Phaltan,Gram,2016,3425,4950,1525,44.52554744525548
Mangaon(Bhadav),Nagali,2015,1333,2858,1525,114.40360090022506
Pune,Dhemse,2016,1350,2875,1525,112.96296296296296
Malkapur,Black Gram,2016,7213,8738,1525,21.142381810619714
Jalgaon Jamod,Ground Nut Pods (Dry),2015,3397,4922,1525,44.89255225198705
Mangrulpeer,Pigeon Pea (Tur),2015,5706,7231,1525,26.726253066947073
Pune,MANGO(RAW),2016,3375,4900,1525,45.18518518518518
Solapur,Bitter Gourd,2015,1600,3125,1525,95.3125
Pune-Manjri,Guava,2014,1000,2525,1525,152.5
Akluj,Shevga,2015,1988,3513,1525,76.7102615694165
Akole,Gram,2016,4375,5900,1525,34.857142857142854
Kolhapur,Cabbage,2016,1137,2662,1525,134.12489006156554
Pathardi,Onion,2015,369,1894,1525,413.2791327913279
Sinner,Matki,2016,5621,7145,1524,27.112613413983276
Newasa-Ghodegaon,Onion,2016,238,1762,1524,640.3361344537815
Murum,Green Gram,2014,5185,6709,1524,29.39247830279653
Barshi,Green Gram,2014,5346,6870,1524,28.50729517396184
Varud,GRAM,2016,7751,9275,1524,19.661979099471036
Nashik,Ground Nut Pods (Dry),2016,4072,5595,1523,37.40176817288802
Daryapur,GREEN GRAM,2016,3428,4951,1523,44.42823803967328
Mumbai,Pineapple,2016,927,2450,1523,164.29341963322545
Pune,Ghosali(Bhaji),2015,1418,2941,1523,107.40479548660085
Mangaon(Bhadav),Rice(Paddy-Hus),2015,1801,3324,1523,84.56413103831206
Hinganghat,Pigeon Pea (Tur),2015,6045,7568,1523,25.19437551695616
Nashik,Capsicum,2016,3063,4586,1523,49.72249428664708
Akot,Ground Nut Pods (Dry),2016,3792,5315,1523,40.163502109704645
Jalgaon,Bitter Gourd,2016,1714,3236,1522,88.79813302217036
Kurdwadi-Modnimb,Pigeon Pea (Tur),2015,7048,8570,1522,21.59477866061294
Lasalgaon,Green Gram,2015,6900,8422,1522,22.057971014492754
Akluj,Bitter Gourd,2016,1739,3261,1522,87.5215641173088
Jalgaon,Methi (Bhaji),2015,1989,3511,1522,76.52086475615887
Vadgaon Peth,Ladies Finger,2016,1617,3139,1522,94.12492269635126
Palghar(Bevur),Rice(Paddy-Hus),2016,2163,3685,1522,70.36523347202959
Karmala,Sorgum(Jawar),2016,1660,3181,1521,91.62650602409639
Kamthi,Coriander  ,2014,2018,3539,1521,75.37165510406344
Majalgaon,Sorgum(Jawar),2015,1055,2576,1521,144.17061611374407
Jalgaon,Ginger (Fresh),2015,2100,3621,1521,72.42857142857143
Solapur,Capsicum,2014,746,2267,1521,203.88739946380696
Nashik,Ground Nut Pods (Dry),2016,3000,4521,1521,50.7
Solapur,Ghevda,2014,2161,3682,1521,70.38408144377603
Loha,Turmeric,2015,6137,7658,1521,24.784096464070394
Nashik,Orange,2016,1380,2900,1520,110.14492753623189
Kolhapur,Papai,2015,280,1800,1520,542.8571428571429
Latur,Wheat(Husked),2015,1634,3154,1520,93.02325581395348
Nandgaon,Pigeon Pea (Tur),2015,6716,8236,1520,22.632519356759975
Chandrapur,Apple,2015,5050,6570,1520,30.099009900990097
Pune,Rice(Paddy-Hus),2014,4961,6481,1520,30.63898407579117
Pimpalgaon Basawant,Tomato,2015,268,1788,1520,567.1641791044776
Lasalgaon,Pigeon Pea (Tur),2016,5798,7318,1520,26.215936529837876
Hinganghat,Pigeon Pea (Tur),2015,6000,7520,1520,25.333333333333332
Umarga,Black Gram,2014,4092,5612,1520,37.14565004887586
Pune,Elephant Root,2016,1481,3000,1519,102.5658338960162
Nagpur,Pigeon Pea (Tur),2016,7461,8980,1519,20.35920117946656
Kamthi,Raddish,2016,1506,3025,1519,100.86321381142098
Mangalwedha,Brinjal,2015,300,1819,1519,506.3333333333333
Solapur,Tomato,2015,284,1802,1518,534.5070422535211
Shirpur,Ground Nut Pods (Dry),2015,4108,5626,1518,36.952288218111
Mumbai-Fruit Market,Mosambi,2016,1018,2536,1518,149.11591355599214
Mumbai,Guava,2015,1411,2928,1517,107.512402551382
Kolhapur,PAPAI,2016,350,1867,1517,433.42857142857144
Osmanabad,Ladies Finger,2016,1150,2667,1517,131.91304347826087
Ahmednagar,FLOWER,2016,350,1867,1517,433.42857142857144
Umared,Rice(Paddy-Hus),2015,2000,3517,1517,75.85
Nagpur,Mango,2016,2767,4284,1517,54.824719913263465
Vaijapur,Onion,2015,200,1716,1516,758.0
Pune,Onion,2015,1015,2531,1516,149.35960591133005
Mumbai,Pineapple,2015,1000,2516,1516,151.6
Sangali,Chillies(Red),2016,12838,14354,1516,11.808692942825985
Nashik,Cucumber,2014,1559,3075,1516,97.24182168056447
Newasa-Ghodegaon,Onion,2015,242,1758,1516,626.4462809917355
Mangalwedha,Green Chilli,2015,2744,4260,1516,55.24781341107872
Sillod-Bharadi,Gram,2016,4430,5946,1516,34.22121896162528
Palus,Brinjal,2016,2842,4358,1516,53.34271639690359
Pune,Small Gourd,2016,1269,2785,1516,119.46414499605989
Mumbai,Mosambi,2015,1000,2515,1515,151.5
Kej,Tamarind,2016,5534,7049,1515,27.37621973256234
Pune,Brinjal,2016,1000,2515,1515,151.5
Beed,Black Gram,2016,5753,7268,1515,26.334086563532072
Pathardi,Onion,2014,208,1723,1515,728.3653846153846
Pune,Small Gourd,2015,1352,2867,1515,112.05621301775147
Umared,Rice(Paddy-Hus),2016,2000,3514,1514,75.7
Rahuri,Ground Nut Pods (Dry),2016,3343,4857,1514,45.2886628776548
Malegaon,Green Gram,2016,5325,6839,1514,28.431924882629108
Kinwat,Pigeon Pea (Tur),2015,7580,9094,1514,19.973614775725594
Junnar-Otur,Beet Root,2016,845,2359,1514,179.1715976331361
Jalkot,Pigeon Pea (Tur),2015,7740,9254,1514,19.560723514211887
Malkapur,BLACK GRAM,2016,5508,7022,1514,27.487291212781408
Akluj,CHIKOO,2016,3500,5014,1514,43.25714285714286
Dhule,Green Gram,2014,5029,6543,1514,30.10538874527739
Mumbai,Coconut,2016,300,1813,1513,504.3333333333333
Solapur,Carrot,2015,675,2188,1513,224.14814814814815
Morshi,BLACK GRAM,2016,2800,4313,1513,54.035714285714285
Kolhapur,Wal Bhaji,2015,2125,3638,1513,71.2
Pathari,Pigeon Pea (Tur),2016,7155,8668,1513,21.14605171208945
Kamthi,Green-Peas,2016,1059,2572,1513,142.8706326723324
Bhiwapur,Chillies(Red),2015,810,2323,1513,186.79012345679013
Khalapur(Shil-Phata),Wheat(Husked),2016,2250,3763,1513,67.24444444444444
Pune,Cucumber,2016,822,2335,1513,184.0632603406326
Pune,Cucumber,2014,732,2244,1512,206.55737704918033
Mumbai,Guava,2015,1469,2981,1512,102.92716133424098
Dondaicha,GROUND NUT PODS (DRY),2016,2764,4276,1512,54.70332850940666
Pune,Ginger (Fresh),2016,1496,3008,1512,101.06951871657753
Mumbai,Ginger (Dry),2014,3080,4592,1512,49.09090909090909
Mumbai,Small Gourd,2015,1027,2538,1511,147.1275559883155
Pune,Elephant Root,2016,1500,3011,1511,100.73333333333333
Ahmednagar,Flower,2015,1600,3111,1511,94.4375
Shirpur,Onion,2015,292,1803,1511,517.4657534246576
Ulhasnagar,Other Vegetables,2016,989,2500,1511,152.78058645096056
Mumbai,Cucumber,2014,963,2474,1511,156.9055036344756
Pune,Capsicum,2015,1071,2581,1510,140.98972922502335
Dhule,Chillies(Red),2016,5540,7050,1510,27.256317689530686
Solapur,Carrot,2015,463,1973,1510,326.13390928725704
Himayatnagar,Pigeon Pea (Tur),2015,8000,9510,1510,18.875
Solapur,Cucumber,2015,465,1975,1510,324.73118279569894
Mumbai,Guava,2015,1483,2992,1509,101.75320296695887
Shahada,Gram,2015,2578,4087,1509,58.53374709076804
Kalamb (Os),Pigeon Pea (Tur),2016,6760,8269,1509,22.32248520710059
Malkapur,Black Gram,2015,7574,9083,1509,19.923422233958277
Nashik,BOR,2016,1336,2845,1509,112.94910179640719
Basmat,Turmeric,2016,7988,9496,1508,18.87831747621432
Lasalgaon,Soybean,2014,1900,3408,1508,79.36842105263158
Nagpur,Pineapple,2015,1021,2529,1508,147.69833496571988
Pune-Manjri,Goosefoot,2016,0,1508,1508,inf
Pune-Manjri,Chavli (Shenga ),2016,2129,3636,1507,70.78440582433068
Gevrai,Pigeon Pea (Tur),2015,5013,6520,1507,30.061839218033114
Pune,Curry Leaves,2016,1460,2967,1507,103.21917808219177
Dhule,Ground Nut Pods (Dry),2015,3435,4941,1506,43.842794759825324
Gangapur,Onion,2015,483,1989,1506,311.80124223602485
Pune-Pimpri,Bottle Gourd,2016,1613,3119,1506,93.36639801611904
Balapur,Green Gram,2015,7769,9275,1506,19.384734200025743
Lonand,Onion,2015,2700,4206,1506,55.77777777777778
Kurdwadi,Onion,2015,1000,2506,1506,150.6
Solapur,Ghevda,2014,1625,3131,1506,92.67692307692307
Kolhapur-Laxmipuri,GREEN GRAM,2016,6000,7506,1506,25.1
Pune-Manjri,Pavtta,2014,2861,4367,1506,52.63893743446347
Pune,Small Gourd,2015,1333,2838,1505,112.90322580645162
Pathardi,Onion,2016,282,1787,1505,533.6879432624113
Osmanabad,Green Chilli,2015,1284,2789,1505,117.21183800623054
Junnar-Otur,Walvad,2016,1333,2838,1505,112.90322580645162
Junnar-Otur,Flower,2016,784,2289,1505,191.96428571428572
Yeola,Green Gram,2014,5037,6542,1505,29.878896168354178
Pandharpur,Cabbage,2016,993,2498,1505,151.56092648539777
Vadgaon Peth,Ridge Gourd,2015,1306,2811,1505,115.23736600306279
Mumbai,Guava,2015,1452,2957,1505,103.65013774104683
Dondaicha,Gram,2015,3318,4823,1505,45.358649789029535
Dondaicha,Green Gram,2014,5232,6736,1504,28.74617737003058
Sangamner,Onion,2015,500,2004,1504,300.8
Mangalwedha,Ridge Gourd,2014,2300,3804,1504,65.3913043478261
Solapur,Bitter Gourd,2015,1363,2867,1504,110.34482758620689
Jalgaon,Green Chilli,2015,1830,3334,1504,82.18579234972678
Osmanabad,Tomato,2014,709,2213,1504,212.12976022566997
Kamthi,Carrot,2016,1028,2532,1504,146.30350194552528
Pune-Manjri,Green Chilli,2014,2164,3668,1504,69.50092421441775
Kolhapur,Cucumber,2016,400,1904,1504,376.0
Mangalwedha,Ridge Gourd,2016,3296,4800,1504,45.63106796116505
Solapur,Ridge Gourd,2015,459,1963,1504,327.66884531590415
Kamthi,Cucumber,2015,794,2297,1503,189.29471032745593
Nashik,Mosambi,2016,1316,2819,1503,114.209726443769
Pune-Moshi,Tomato,2016,2297,3800,1503,65.43317370483238
Varud-Rajura Bazar,Pigeon Pea (Tur),2015,4600,6103,1503,32.67391304347826
Kolhapur,Kanda Pat,2015,1951,3453,1502,76.9861609431061
Ramtek,Garlic,2016,7136,8638,1502,21.048206278026907
Malegaon,Sesamum,2016,5800,7301,1501,25.879310344827587
Partur,Gram,2016,5000,6501,1501,30.02
Ausa,Coriander (Dry),2016,3500,5001,1501,42.885714285714286
Osmanabad,Ginger (Fresh),2016,2229,3729,1500,67.29475100942126
Sillod,Green Gram,2014,5000,6500,1500,30.0
Ramtek,Chillies(Red),2016,9000,10500,1500,16.666666666666668
Kolhapur,Ghevda,2015,1800,3300,1500,83.33333333333333
Chandrapur,Naspatti ,2016,2500,4000,1500,60.0
Ausa,Coriander (Dry),2015,5701,7201,1500,26.311173478337135
Chandrapur,CHIKOO,2016,3250,4750,1500,46.15384615384615
Chandrapur,Coriander  ,2016,1000,2500,1500,150.0
Mumbai,Split Black Gram,2015,7113,8613,1500,21.08814846056516
Pune,Chavli (Pala),2014,1000,2500,1500,150.0
Jalgaon,Mango,2016,3500,5000,1500,42.857142857142854
Dhamangaon-Rly,Pigeon Pea (Tur),2015,6000,7500,1500,25.0
Sangrampur,Pigeon Pea (Tur),2016,5550,7050,1500,27.027027027027028
Nashik-Devlali,Mango,2016,3500,5000,1500,42.857142857142854
Pune-Manjri,Methi (Bhaji),2016,1500,3000,1500,100.0
Akluj,Garlic,2015,3615,5115,1500,41.49377593360996
Pune-Pimpri,Green-Peas,2015,2000,3500,1500,75.0
Satara,Shevga,2014,6000,7500,1500,25.0
Sakri,MALE LAMB,2016,2500,4000,1500,60.0
Aurangabad,Sweet Potato,2016,2000,3500,1500,75.0
Jalgaon,Bullock Heart,2015,2500,4000,1500,60.0
Akhadabalapur,Turmeric,2016,9167,10667,1500,16.363041343951128
Mumbai,Spilt Pigeon Pea,2014,6000,7500,1500,25.0
Kolhapur-Malkapur,Coriander  ,2016,4000,5500,1500,37.5
Indapur,Horse Gram,2015,2001,3501,1500,74.96251874062969
Vadgaon Peth,Cluster Bean,2016,2500,4000,1500,60.0
Kalyan,Coriander (Dry),2016,11000,12500,1500,13.636363636363637
Kolhapur-Malkapur,Coriander  ,2016,500,2000,1500,300.0
Kamthi,Cucumber,2015,1221,2721,1500,122.85012285012284
Pune-Manjri,Ladies Finger,2016,3250,4750,1500,46.15384615384615
Nashik,Kharbuj,2016,1000,2500,1500,150.0
Pune-Manjri,Ladies Finger,2016,3250,4750,1500,46.15384615384615
Ahmednagar,Green Peas (Dry),2016,2000,3500,1500,75.0
Nagpur,Chillies(Red),2014,6000,7500,1500,25.0
Mumbai,Spilt Pigeon Pea,2014,5984,7484,1500,25.066844919786096
Dhule,Ginger (Fresh),2016,2000,3500,1500,75.0
Sindkhed Raja,Pigeon Pea (Tur),2016,7000,8500,1500,21.428571428571427
Kolhapur,Ghevda,2015,1333,2833,1500,112.52813203300825
Ahmednagar,Lemon,2016,1571,3071,1500,95.48058561425843
Pathardi,Onion,2015,260,1760,1500,576.9230769230769
Buldhana,Black Gram,2016,6000,7500,1500,25.0
Sangli-Phale Bhajipalam,Grapes,2016,1100,2600,1500,136.36363636363637
Junnar-Otur,Squash Gourd,2016,1500,3000,1500,100.0
Shrirampur,Sweet Potato,2016,2000,3500,1500,75.0
Ahmednagar,Garlic,2016,4500,6000,1500,33.333333333333336
Pune,Raddish,2016,1500,3000,1500,100.0
Aurangabad,Shevga,2015,3300,4800,1500,45.45454545454545
Pune,Mula Shenga,2015,1143,2643,1500,131.23359580052494
Chandrapur-Ganjwad,Spinach,2016,1000,2500,1500,150.0
Shrirampur,Onion,2014,282,1782,1500,531.9148936170212
Dudhani,Green Gram,2015,4600,6100,1500,32.608695652173914
Akluj,Cluster Bean,2016,4500,6000,1500,33.333333333333336
Mumbai,Pineapple,2015,1000,2500,1500,150.0
Manchar,Shevga,2014,2500,4000,1500,60.0
Koregaon,Green Gram,2015,6000,7500,1500,25.0
Vadgaon Peth,Green Chilli,2015,2000,3500,1500,75.0
Aurangabad,Custard Apple,2014,3750,5250,1500,40.0
Manchar,Onion,2014,300,1800,1500,500.0
Pune-Pimpri,Pavata,2015,2000,3500,1500,75.0
Vadgaon Peth,Goats,2016,1500,3000,1500,100.0
Osmanabad,Ginger (Fresh),2015,2333,3833,1500,64.29489927132448
Varud-Rajura Bazar,Pigeon Pea (Tur),2014,3533,5033,1500,42.456835550523635
Pune-Manjri,Ambat Chuka,2015,0,1500,1500,inf
Vadgaon Peth,Ladies Finger,2016,1607,3107,1500,93.34163036714375
Indapur-Bhigwan,Chillies(Red),2016,10000,11500,1500,15.0
Kolhapur,Ginger (Fresh),2015,2433,3933,1500,61.652281134401974
Kamthi,Small Gourd,2016,1233,2733,1500,121.65450121654501
Kalyan,Green Peas (Dry),2016,2500,4000,1500,60.0
Nashik,Cluster Bean,2016,2000,3500,1500,75.0
Yawal,Green Gram,2016,5000,6500,1500,30.0
Akluj,Ladies Finger,2016,1971,3471,1500,76.10350076103501
Kamthi,Cluster Bean,2014,1654,3154,1500,90.68923821039903
Kalyan,Green Gram,2016,7000,8500,1500,21.428571428571427
Kada,Onion,2016,300,1800,1500,500.0
Solapur,Mula Shenga,2016,2500,4000,1500,60.0
Rahuri,Cabbage,2016,500,2000,1500,300.0
Sangli-Phale Bhajipalam,Bor,2015,500,2000,1500,300.0
Ausa,Coriander (Dry),2016,6001,7501,1500,24.995834027662056
Kalyan,Shewanti,2015,6000,7500,1500,25.0
Ratanagari,Maize(Corn.),2014,3000,4500,1500,50.0
Dhule,Capsicum,2016,2000,3500,1500,75.0
Osmanabad,Ground Nut Pods (Dry),2016,3500,5000,1500,42.857142857142854
Pune,Mula Shenga,2015,500,2000,1500,300.0
Amarawati,Ginger (Fresh),2015,3000,4500,1500,50.0
Nashik,Papai,2016,1000,2500,1500,150.0
Karad,Mosambi,2015,3077,4577,1500,48.74878128046799
Varud,Orange,2014,1000,2500,1500,150.0
Vadgaon Peth,Cluster Bean,2015,2500,4000,1500,60.0
Pune,Mango(Raw),2015,837,2337,1500,179.21146953405017
Osmanabad,Capsicum,2016,1500,3000,1500,100.0
Ratanagari,Green-Peas,2016,6500,8000,1500,23.076923076923077
Vadgaon Peth,Pavtta,2016,2867,4367,1500,52.319497732821766
Kannad,Pigeon Pea (Tur),2015,7250,8750,1500,20.689655172413794
Chandrapur-Ganjwad,Bitter Gourd,2016,2167,3667,1500,69.2201199815413
Ratanagari,French Bean,2015,1500,3000,1500,100.0
Umared,Chillies(Red),2015,8500,10000,1500,17.647058823529413
Pune,Mango,2015,1000,2500,1500,150.0
Jalgaon,Mosambi,2016,1400,2900,1500,107.14285714285714
Rahuri,BITTER GOURD,2016,450,1950,1500,333.3333333333333
Amarawati-Fruit And Vegetables,Lemon,2016,2000,3500,1500,75.0
Pune,Wal Papdi,2016,1196,2696,1500,125.41806020066889
Kamthi,Methi (Bhaji),2016,1229,2729,1500,122.05044751830756
Manchar,Capsicum,2014,1500,3000,1500,100.0
Manchar,Chavli (Shenga ),2014,1000,2500,1500,150.0
Lonar,Green Gram,2016,5500,7000,1500,27.272727272727273
Osmanabad,Grapes,2016,1200,2700,1500,125.0
Yawal,Sesamum,2016,6500,8000,1500,23.076923076923077
Indapur,Ground Nut Pods (Dry),2014,1800,3300,1500,83.33333333333333
Ahmednagar,Ghevda,2016,4500,6000,1500,33.333333333333336
Kolhapur,Beet Root,2015,875,2375,1500,171.42857142857142
Ahmednagar,Ghevda,2015,2250,3750,1500,66.66666666666667
Sangli-Phale Bhajipalam,Ginger (Fresh),2015,3000,4500,1500,50.0
Malegaon,Horse Gram,2015,2001,3501,1500,74.96251874062969
Patan,Pavtta,2016,4000,5500,1500,37.5
Nashik,Green-Peas,2016,4048,5548,1500,37.055335968379445
Jamkhed,Green Gram,2015,6000,7500,1500,25.0
Malegaon,Ground Nut Pods (Dry),2015,3500,5000,1500,42.857142857142854
Nashik,Lemon,2015,1200,2700,1500,125.0
Barshi,Ghevda,2016,2000,3500,1500,75.0
Rahata,Grapes,2015,1500,3000,1500,100.0
Nashik,Mosambi,2015,1000,2500,1500,150.0
Kalyan,Sesamum,2016,9500,11000,1500,15.789473684210526
Sangali,Coriander (Dry),2015,10500,12000,1500,14.285714285714286
Nagpur,Wal Bhaji,2015,4500,6000,1500,33.333333333333336
Lasalgaon-Niphad,Green Gram,2016,4500,6000,1500,33.333333333333336
Aheri,Sesamum,2015,7750,9250,1500,19.35483870967742
Akluj,Tamarind,2014,2000,3500,1500,75.0
Ratanagari,French Bean,2014,4000,5500,1500,37.5
Sangali,Coriander (Dry),2015,10500,12000,1500,14.285714285714286
Osmanabad,Shevga,2015,2500,4000,1500,60.0
Nashik,Cucumber,2015,650,2150,1500,230.76923076923077
Nashik,Orange,2016,3000,4500,1500,50.0
Khed-Chakan,Walvad,2016,3000,4500,1500,50.0
Sangli-Phale Bhajipalam,Ginger (Fresh),2016,1500,3000,1500,100.0
Kamthi,Dhemse,2014,2250,3750,1500,66.66666666666667
Anajngaon Surji,Ground Nut Pods (Dry),2015,3500,5000,1500,42.857142857142854
Manchar,Shevga,2015,2000,3500,1500,75.0
Taloda,Pigeon Pea (Tur),2016,6500,8000,1500,23.076923076923077
Mumbai,Gr.Nut Kernels,2015,8000,9500,1500,18.75
Palus,Shevga,2015,2000,3500,1500,75.0
Mumbai,Gr.Nut Kernels,2015,8000,9500,1500,18.75
Mumbai,Mosambi,2016,1091,2591,1500,137.4885426214482
Osmanabad,Mango,2016,2500,4000,1500,60.0
Vadgaon Peth,Pavtta,2015,2000,3500,1500,75.0
Kolhapur,Tomato,2015,502,2002,1500,298.804780876494
Mohol,Pigeon Pea (Tur),2016,6000,7500,1500,25.0
Shrirampur,Garlic,2016,5125,6625,1500,29.26829268292683
Ratanagari,Ginger (Fresh),2015,4500,6000,1500,33.333333333333336
Junnar-Otur,Capsicum,2015,500,2000,1500,300.0
Rahata,Lemon,2016,3500,5000,1500,42.857142857142854
Aurangabad,Fig,2016,9500,11000,1500,15.789473684210526
Kolhapur,Ground Nut Pods (Dry),2016,2625,4125,1500,57.142857142857146
Pune-Manjri,Harbara(Pendi),2014,0,1500,1500,inf
Mumbai,Sorgum(Jawar),2015,1700,3200,1500,88.23529411764706
Ahmednagar,Capsicum,2015,1400,2900,1500,107.14285714285714
Jalgaon,Apple,2016,3000,4500,1500,50.0
Kurdwadi,Onion,2014,100,1600,1500,1500.0
Kolhapur,Awala,2016,1000,2500,1500,150.0
Kolhapur-Malkapur,Sweet Potato,2016,500,2000,1500,300.0
Vadgaon Peth,Cluster Bean,2015,2000,3500,1500,75.0
Malegaon,Matki,2016,5000,6500,1500,30.0
Ratanagari,Maize(Corn.),2016,3500,5000,1500,42.857142857142854
Chandrapur-Ganjwad,PIGEN-PEA (BHAJI),2016,3000,4500,1500,50.0
Pandharpur,Ladies Finger,2015,786,2286,1500,190.83969465648855
Pune-Manjri,Ridge Gourd,2016,3000,4500,1500,50.0
Kolhapur-Malkapur,Squash Gourd,2016,200,1700,1500,750.0
Yeola,Gram,2016,4293,5793,1500,34.940600978336825
Sangali,Coriander (Dry),2016,8500,10000,1500,17.647058823529413
Sangali,Coriander (Dry),2016,7000,8500,1500,21.428571428571427
Ahmednagar,Capsicum,2016,1667,3167,1500,89.98200359928015
Ramtek,Chillies(Red),2015,6500,8000,1500,23.076923076923077
Armori-Desaiganj,Chillies(Red),2016,17000,18500,1500,8.823529411764707
Jalgaon,Custard Apple,2014,3500,5000,1500,42.857142857142854
Ahmednagar,Capsicum,2015,1500,3000,1500,100.0
Junnar (Narayangaon),Math (Bhaji),2016,501,2001,1500,299.4011976047904
Koregaon,GHEVDA SEED,2016,5000,6500,1500,30.0
Kamthi,Parwar,2015,2000,3500,1500,75.0
Pune-Manjri,Pavtta,2016,3500,5000,1500,42.857142857142854
Osmanabad,Black Gram,2016,3925,5425,1500,38.21656050955414
Nashik,Green-Peas,2016,2000,3500,1500,75.0
Indapur,Pigeon Pea (Tur),2015,2000,3500,1500,75.0
Chandrapur,Pomegranate,2016,3750,5250,1500,40.0
Akola,Sesamum,2016,5000,6500,1500,30.0
Ratanagari,Brinjal,2016,2471,3971,1500,60.70416835289357
Junnar-Otur,Brinjal,2016,1000,2500,1500,150.0
Pune,Chavli (Pala),2016,2000,3500,1500,75.0
Umarkhed-Danki,Gram,2015,3000,4500,1500,50.0
Kada,Pigeon Pea (Tur),2015,7500,9000,1500,20.0
Kolhapur,Beet Root,2016,688,2188,1500,218.02325581395348
Kolhapur,Beet Root,2016,1667,3167,1500,89.98200359928015
Mumbai,Mosambi,2015,1000,2500,1500,150.0
Chalisgaon,Matki,2015,6500,8000,1500,23.076923076923077
Chandrapur-Ganjwad,Coriander  ,2015,1500,3000,1500,100.0
Karanja,Green Gram,2015,6127,7626,1499,24.46548065937653
Kopargaon,Gram,2016,5406,6905,1499,27.728449870514243
Mangrulpeer,Black Gram,2015,9151,10650,1499,16.380723418205662
Ausa,Sesamum,2015,9001,10500,1499,16.6537051438729
Kopargaon,GRAM,2016,5844,7343,1499,25.650239561943874
Dhule,Gram,2016,3089,4588,1499,48.52703140174814
Nashik,Squash Gourd,2015,1396,2895,1499,107.378223495702
Kurdwadi-Modnimb,Pigeon Pea (Tur),2015,3625,5124,1499,41.351724137931036
Akot,Black Gram,2015,6294,7792,1498,23.800444868128377
Chandur Bajar,GRAM,2016,7840,9338,1498,19.107142857142858
Chandrapur-Ganjwad,Onion,2015,1167,2665,1498,128.36332476435305
Nashik,Lemon,2014,1543,3041,1498,97.08360337005833
Solapur,ONION,2016,111,1609,1498,1349.5495495495495
Nandurbar,Chillies(Red),2016,3256,4753,1497,45.97665847665848
Shegaon,Thymol/Lovage,2015,7531,9028,1497,19.87783826849024
Kurdwadi-Modnimb,Gram,2016,4989,6486,1497,30.006013229104028
Karanja,Green Gram,2014,5711,7208,1497,26.212572229031693
Lasalgaon,Ground Nut Pods (Dry),2015,4218,5715,1497,35.49075391180654
Malkapur,Green Gram,2015,6690,8187,1497,22.376681614349774
Pune-Manjri,Brinjal,2015,2208,3704,1496,67.7536231884058
Pune,Bitter Gourd,2016,2958,4454,1496,50.57471264367816
Vasai,Onion,2015,3095,4591,1496,48.336025848142164
Kamthi,Methi (Bhaji),2014,1374,2870,1496,108.87918486171762
Mumbai,Pineapple,2015,1000,2496,1496,149.6
Karad,Jaggery,2015,2225,3720,1495,67.19101123595506
Kurdwadi,Sorgum(Jawar),2014,1114,2609,1495,134.20107719928185
Nandurbar,Sunflower,2015,3661,5156,1495,40.83583720295001
Vadgaon Peth,Ladies Finger,2016,1585,3080,1495,94.3217665615142
Mumbai,Guava,2016,1006,2500,1494,148.5089463220676
Barshi,Lemon,2016,1926,3420,1494,77.57009345794393
Shegaon,Pigeon Pea (Tur),2015,8609,10102,1493,17.342316180741086
Dondaicha,Gram,2015,2750,4243,1493,54.29090909090909
Kamthi,Wal Bhaji,2015,1186,2679,1493,125.88532883642496
Latur,Wheat(Husked),2015,1605,3098,1493,93.02180685358256
Nashik,Green-Peas,2014,2957,4450,1493,50.49036185322962
Pune,Elephant Root,2015,1507,3000,1493,99.07100199071002
Mumbai-Fruit Market,POMEGRANATE,2016,6781,8273,1492,22.002654475741043
Dudhani,Pigeon Pea (Tur),2016,7325,8817,1492,20.368600682593858
Mumbai,Pineapple,2015,1000,2492,1492,149.2
Kolhapur,Onion,2015,523,2015,1492,285.2772466539197
Akola,Pigeon Pea (Tur),2015,8002,9494,1492,18.645338665333668
Aurangabad,ORANGE,2016,1908,3400,1492,78.19706498951781
Nashik,Onion,2014,346,1838,1492,431.21387283236993
Kalyan,Green-Peas,2016,8046,9538,1492,18.543375590355456
Chikhali,Green Gram,2015,5650,7142,1492,26.4070796460177
Khalapur(Shil-Phata),Wheat(Husked),2016,2200,3692,1492,67.81818181818181
Kamthi,Lemon,2015,1354,2846,1492,110.19202363367799
Mumbai,Small Gourd,2016,1400,2892,1492,106.57142857142857
Mumbai,Grapes,2014,2571,4062,1491,57.992998833138856
Nashik,Lemon,2016,1648,3139,1491,90.47330097087378
Pune,Small Gourd,2016,1477,2968,1491,100.9478672985782
Nashik,Tomato,2015,1667,3158,1491,89.44211157768446
Amalner,BLACK GRAM,2016,5007,6497,1490,29.758338326343118
Shrirampur,Onion,2014,271,1761,1490,549.8154981549816
Kamthi,Potato,2016,470,1960,1490,317.02127659574467
Pune,Green Chilli,2015,1310,2800,1490,113.74045801526718
Rahuri,Ground Nut Pods (Dry),2016,3289,4779,1490,45.30252356339313
Akluj,Ladies Finger,2016,2045,3535,1490,72.86063569682152
Vadgaon Peth,Ridge Gourd,2014,1460,2950,1490,102.05479452054794
Vadgaon Peth,Ridge Gourd,2016,2060,3550,1490,72.33009708737865
Vadgaon Peth,Bitter Gourd,2016,2079,3568,1489,71.62097162097162
Pune-Manjri,Green-Peas,2016,4600,6089,1489,32.369565217391305
Nashik,Bottle Gourd,2016,799,2288,1489,186.35794743429287
Mumbai,Brinjal,2016,1125,2613,1488,132.26666666666668
Pune,Green Chilli,2015,2228,3716,1488,66.78635547576302
Shrirampur,Onion,2016,263,1751,1488,565.7794676806084
Mumbai,Cowpea,2016,4732,6220,1488,31.445477599323752
Sinner,Gram,2016,2773,4261,1488,53.660295708618825
Kolhapur,Papai,2016,525,2013,1488,283.42857142857144
Ambejogai,Gram,2016,7062,8550,1488,21.07051826677995
Pandharpur,Onion,2014,196,1684,1488,759.1836734693877
Balapur,Pigeon Pea (Tur),2015,4300,5788,1488,34.604651162790695
Mumbai,Small Gourd,2015,1391,2878,1487,106.90150970524802
Kamthi,Bitter Gourd,2016,1493,2980,1487,99.59812458137978
Rahata,Green Chilli,2015,4413,5900,1487,33.69589848175844
Mumbai,Mosambi,2016,1004,2490,1486,148.00796812749005
Solapur,Ridge Gourd,2014,622,2108,1486,238.90675241157555
Majalgaon,Pigeon Pea (Tur),2016,7338,8824,1486,20.250749523030798
Washim,Pigeon Pea (Tur),2016,7263,8749,1486,20.459865069530498
Barshi,Turmeric,2015,6550,8036,1486,22.68702290076336
Mangalwedha,Tomato,2015,302,1788,1486,492.05298013245033
Amarawati-Fruit And Vegetables,MOSAMBI,2016,2881,4366,1485,51.544602568552584
Pune-Manjri,Cluster Bean,2015,2305,3790,1485,64.42516268980478
Mumbai,Pineapple,2015,1000,2485,1485,148.5
Mumbai,Spilt Gerrn Gram,2015,10056,11541,1485,14.767303102625299
Pune-Manjri,Cluster Bean,2015,2386,3871,1485,62.238055322715844
Kamthi,Green-Peas,2016,1336,2821,1485,111.15269461077844
Malkapur,Pigeon Pea (Tur),2016,7740,9225,1485,19.186046511627907
Pune,Pavtta,2014,2200,3685,1485,67.5
Pathardi,Onion,2015,108,1592,1484,1374.0740740740741
Barshi,Onion,2016,106,1590,1484,1400.0
Aurangabad,Ginger (Fresh),2015,1883,3367,1484,78.81040892193309
Satara,Ginger (Fresh),2014,2333,3817,1484,63.60908701243035
Sonpeth,Green Gram,2016,2790,4273,1483,53.15412186379928
Pachora,Gram,2016,7313,8796,1483,20.27895528510871
Kamthi,Cluster Bean,2016,1224,2707,1483,121.16013071895425
Kille Dharur,Pigeon Pea (Tur),2016,6295,7778,1483,23.558379666401905
Pune,Mango(Raw),2015,2617,4100,1483,56.667940389759266
Kamthi,Capsicum,2015,3350,4833,1483,44.26865671641791
Pune-Manjri,Ladies Finger,2016,1690,3173,1483,87.75147928994083
Gevrai,Black Gram,2016,4992,6475,1483,29.70753205128205
Loha,Turmeric,2016,6505,7988,1483,22.7978478093774
Pandharpur,Capsicum,2015,1067,2550,1483,138.98781630740393
Osmanabad,Shevga,2016,2329,3812,1483,63.67539716616574
Shirpur,Green Gram,2015,5109,6591,1482,29.00763358778626
Kolhapur,Papai,2016,560,2042,1482,264.64285714285717
Malegaon,Gram,2015,3442,4924,1482,43.056362579895406
Sinner,Gram,2015,3117,4599,1482,47.54571703561116
Sangli-Phale Bhajipalam,Custard Apple,2016,618,2100,1482,239.80582524271844
Akluj,Ground Nut Pods (Dry),2016,3882,5364,1482,38.17619783616692
Nagpur,Coriander  ,2015,4154,5635,1481,35.652383245064996
Mumbai,Guava,2015,900,2381,1481,164.55555555555554
Kamthi,Ladies Finger,2016,1741,3222,1481,85.06605399195864
Parner,Onion,2014,600,2081,1481,246.83333333333334
Nagpur,Grapes,2016,3396,4876,1480,43.580683156654885
Mumbai,Mosambi,2016,908,2388,1480,162.99559471365637
Osmanabad,Ground Nut Pods (Dry),2015,2100,3580,1480,70.47619047619048
Karad,Mosambi,2016,5200,6680,1480,28.46153846153846
Latur,Black Gram,2014,4550,6030,1480,32.527472527472526
Ahmednagar,Tomato,2016,480,1960,1480,308.3333333333333
Kamthi,Capsicum,2015,1620,3100,1480,91.35802469135803
Khed,Cluster Bean,2016,1117,2597,1480,132.49776186213072
Khed,Coriander  ,2016,1025,2505,1480,144.390243902439
Kamthi,Tomato,2015,1770,3250,1480,83.61581920903954
Kamthi,Lemon,2015,2020,3500,1480,73.26732673267327
Kamthi,Methi (Bhaji),2015,1177,2657,1480,125.74341546304163
Dondaicha,Chillies(Red),2015,1913,3393,1480,77.36539466806063
Karad,Pomegranate,2016,3635,5115,1480,40.715268225584595
Jalgaon,Green Chilli,2015,1542,3021,1479,95.91439688715953
Kamthi,Carrot,2015,879,2357,1478,168.14562002275312
Risod,Pigeon Pea (Tur),2016,7508,8986,1478,19.685668620138518
Malegaon (Washim),Pigeon Pea (Tur),2015,8043,9521,1478,18.376227775705583
Jalgaon,Bitter Gourd,2016,3133,4611,1478,47.175231407596556
Bhivandi,Rice(Paddy-Hus),2016,2860,4338,1478,51.67832167832168
Nashik,Onion,2014,238,1716,1478,621.0084033613446
Dhule,Ground Nut Pods (Dry),2016,3459,4936,1477,42.70020237062735
Kolhapur,Bitter Gourd,2015,906,2383,1477,163.0242825607064
Rahuri-Vambori,Onion,2016,231,1708,1477,639.3939393939394
Jalgaon,Ginger (Fresh),2015,1852,3329,1477,79.75161987041037
Akot,Black Gram,2016,7623,9100,1477,19.375573921028465
Mangalwedha,Green Chilli,2015,1373,2850,1477,107.57465404224327
Mumbai,Orange,2015,867,2344,1477,170.35755478662054
Pune,Walvad,2015,1635,3112,1477,90.33639143730886
Pune,Gram,2015,3164,4641,1477,46.68141592920354
Newasa-Ghodegaon,Onion,2015,192,1669,1477,769.2708333333334
Osmanabad,Ladies Finger,2016,1587,3063,1476,93.00567107750473
Partur,Green Gram,2014,4657,6133,1476,31.694223749194762
Lasalgaon,Soybean,2015,2311,3787,1476,63.86845521419299
Pandharpur,Tomato,2015,461,1937,1476,320.17353579175705
Bhivandi,Rice(Paddy-Hus),2016,2182,3658,1476,67.64436296975252
Nandurbar,Chillies(Red),2016,2930,4406,1476,50.37542662116041
Jalna,Pigeon Pea (Tur),2015,5040,6516,1476,29.285714285714285
Kamthi,CORIANDER ,2016,1883,3359,1476,78.38555496548062
Mumbai,Guava,2015,722,2198,1476,204.43213296398892
Ambad(Vadi Godri),Gram,2016,6313,7788,1475,23.364485981308412
Akot,Black Gram,2016,5068,6543,1475,29.10418310970797
Barshi,Sunflower,2015,4400,5875,1475,33.52272727272727
Solapur,Cucumber,2015,220,1695,1475,670.4545454545455
Latur,Green Gram,2015,6058,7533,1475,24.347969626939584
Pune,Black Gram,2016,13280,14755,1475,11.106927710843374
Akola,Black Gram,2016,6509,7984,1475,22.660931018589647
Junnar (Narayangaon),Tomato,2016,3260,4735,1475,45.24539877300614
Pune-Manjri,Green Chilli,2015,2825,4300,1475,52.21238938053097
Akluj,Shevga,2016,1590,3065,1475,92.76729559748428
Kalamb (Os),Gram,2016,6019,7494,1475,24.505731849144375
Pune-Pimpri,Cluster Bean,2016,3996,5471,1475,36.911911911911915
Nashik,Onion,2014,323,1798,1475,456.65634674922603
Lasur Station,Onion,2014,200,1675,1475,737.5
Nashik,Ladies Finger,2015,1526,3000,1474,96.59239842726082
Osmanabad,Onion,2015,1245,2719,1474,118.39357429718875
Dhule,Ground Nut Pods (Dry),2014,2891,4365,1474,50.985818056035974
Mangalwedha,Ridge Gourd,2015,2761,4235,1474,53.386454183266935
Akluj,Shevga,2016,2237,3711,1474,65.89181940098347
Osmanabad,Chikoo,2015,1313,2787,1474,112.26199543031227
Kamthi,Small Gourd,2015,632,2105,1473,233.06962025316454
Manmad,Onion,2015,923,2396,1473,159.58829902491874
Manmad,Onion,2015,901,2374,1473,163.4850166481687
Kolhapur,Bor,2015,694,2167,1473,212.2478386167147
Karanja,Gram,2016,6341,7814,1473,23.22977448351995
Rahata,Onion,2015,450,1923,1473,327.3333333333333
Mumbai,Orange,2015,1000,2473,1473,147.3
Savner,Pigeon Pea (Tur),2016,6431,7904,1473,22.90468045405069
Kolhapur,Jaggery,2016,2383,3856,1473,61.81284095677717
Jalgaon,Coriander  ,2016,1314,2786,1472,112.02435312024353
Jalgaon,Lemon,2016,2090,3562,1472,70.43062200956938
Akot,Thymol/Lovage,2016,12845,14317,1472,11.459711950175166
Pathardi,Onion,2015,106,1578,1472,1388.6792452830189
Osmanabad,Brinjal,2016,1016,2488,1472,144.88188976377953
Pune,Onion,2014,664,2136,1472,221.6867469879518
Lasalgaon-Niphad,BLACK GRAM,2016,3716,5188,1472,39.61248654467169
Pune-Manjri,Tomato,2015,1139,2611,1472,129.2361720807726
Umared,Rice(Paddy-Hus),2015,2000,3471,1471,73.55
Daryapur,Green Gram,2015,6015,7486,1471,24.455527847049044
Mumbai,Spilt Pigeon Pea,2014,6000,7471,1471,24.516666666666666
Udgir,Tamarind,2016,8343,9814,1471,17.63154740501019
Mangaon(Bhadav),Nachani,2014,1438,2908,1470,102.22531293463143
Dondaicha-Sindkheda,Gram,2016,4798,6268,1470,30.637765735723217
Mangaon(Bhadav),Nagali,2014,1440,2910,1470,102.08333333333333
Risod,Green Gram,2016,6530,8000,1470,22.511485451761104
Pune,Ladies Finger,2014,860,2330,1470,170.93023255813952
Kolhapur,Ladies Finger,2015,432,1902,1470,340.27777777777777
Lasur Station,Onion,2015,244,1714,1470,602.4590163934427
Dhule,Ground Nut Pods (Dry),2016,3648,5117,1469,40.26864035087719
Chandrapur,Pomegranate,2015,2623,4092,1469,56.004574914220356
Kamthi,Mint,2016,1485,2954,1469,98.92255892255892
Dhule,BLACK GRAM,2016,4176,5645,1469,35.1772030651341
Shirpur,Green Gram,2016,3083,4551,1468,47.61595848199806
Parner,Onion,2014,450,1918,1468,326.22222222222223
Aurangabad,Custard Apple,2015,1053,2521,1468,139.41120607787275
Pandharpur,Cucumber,2015,541,2009,1468,271.34935304990756
Osmanabad,Brinjal,2016,1009,2477,1468,145.49058473736372
Latur,Pigeon Pea (Tur),2016,7464,8932,1468,19.667738478027868
Lonar,Green Gram,2015,5890,7358,1468,24.923599320882854
Junnar-Otur,Cabbage,2016,973,2441,1468,150.87358684480986
Akole,Onion,2015,148,1615,1467,991.2162162162163
Kamthi,Cluster Bean,2015,1050,2517,1467,139.71428571428572
Rahuri,Green Chilli,2016,800,2267,1467,183.375
Nandgaon,Gram,2014,1917,3384,1467,76.52582159624413
Mumbai,Coconut,2015,933,2400,1467,157.23472668810288
Jintur,Turmeric,2015,6115,7582,1467,23.990188062142273
Osmanabad,Capsicum,2015,1033,2500,1467,142.0135527589545
Indapur-Bhigwan,Cowpea,2016,6167,7634,1467,23.78790335657532
Nagpur,Mango,2015,1123,2590,1467,130.63223508459484
Indapur-Bhigwan,Ground Nut Pods (Dry),2015,4533,6000,1467,32.36267372600926
Sangli-Phale Bhajipalam,Orange,2015,1133,2600,1467,129.4792586054722
Mangalwedha,Ladies Finger,2014,2050,3517,1467,71.5609756097561
Pune,Sweet Potato,2016,1233,2700,1467,118.97810218978103
Chalisgaon,Green Gram,2014,5500,6967,1467,26.672727272727272
Kamthi,Kanda Pat,2015,1067,2533,1466,137.3945641986879
Kamthi,Guava,2015,1867,3333,1466,78.52169255490091
Akluj,Shevga,2015,3667,5133,1466,39.978183801472596
Murtizapur,Green Gram,2014,6427,7893,1466,22.81002022716664
Sangali,Wheat(Husked),2015,1606,3072,1466,91.2826899128269
Mumbai,Coconut,2015,867,2333,1466,169.08881199538638
Karmala,Pigeon Pea (Tur),2015,7614,9080,1466,19.254005778828475
Khamgaon,Ground Nut Pods (Dry),2016,3448,4914,1466,42.51740139211137
Solapur,Carrot,2016,443,1909,1466,330.9255079006772
Karanja,Green Gram,2016,4946,6412,1466,29.64011322280631
Mangalwedha,Cucumber,2015,327,1792,1465,448.01223241590213
Tasgaon,Tamarind,2016,6490,7955,1465,22.573189522342066
Vadgaon Peth,Ladies Finger,2014,1906,3371,1465,76.86253934942287
Nilanga,Gram,2016,5800,7265,1465,25.25862068965517
Basmat,Turmeric,2016,9040,10505,1465,16.20575221238938
Pune-Manjri,Cluster Bean,2015,1905,3370,1465,76.9028871391076
Pune,Capsicum,2014,1765,3230,1465,83.0028328611898
Nashik,Flower,2015,500,1964,1464,292.8
Mumbai,Pineapple,2016,993,2457,1464,147.4320241691843
Mumbai,Pineapple,2016,1000,2464,1464,146.4
Kamthi,Cluster Bean,2015,1332,2796,1464,109.90990990990991
Daryapur,Green Gram,2016,3573,5037,1464,40.973971452560875
Chikhali,Green Gram,2015,6136,7600,1464,23.859191655801826
Kolhapur-Laxmipuri,Wheat(Husked),2016,1823,3286,1463,80.2523313219967
Kolhapur,Onion,2015,482,1945,1463,303.52697095435684
Pune,Small Gourd,2015,1182,2645,1463,123.77326565143824
Jalna,Sorgum(Jawar),2014,1147,2610,1463,127.55013077593723
Pune-Manjri,Goosefoot,2015,0,1463,1463,inf
Vadgaon Peth,Flower,2016,656,2119,1463,223.01829268292684
Manchar,Green Chilli,2016,3273,4736,1463,44.69905285670639
Kamthi,Flower,2015,859,2321,1462,170.19790454016297
Yeola,Onion,2014,270,1732,1462,541.4814814814815
Nashik,Green Chilli,2016,4200,5662,1462,34.80952380952381
Chikhali,Pigeon Pea (Tur),2016,5086,6547,1461,28.725914274478964
Nashik,Bitter Gourd,2015,1401,2862,1461,104.28265524625267
Kamthi,Chavli (Shenga ),2015,2009,3470,1461,72.72274763563962
Solapur,Black Gram,2016,6566,8027,1461,22.250989948218095
Pune,Brinjal,2015,852,2313,1461,171.4788732394366
Kolhapur,Flower,2016,442,1903,1461,330.5429864253394
Ghoti,Tomato,2016,2377,3838,1461,61.46403029028187
Aurangabad,Mosambi,2015,964,2424,1460,151.45228215767634
Chalisgaon,Bitter Gourd,2016,2490,3950,1460,58.63453815261044
Kamthi,Potato,2015,565,2025,1460,258.4070796460177
Pune-Manjri,Kanda Pat,2015,920,2380,1460,158.69565217391303
Mumbai,Pineapple,2015,1005,2465,1460,145.273631840796
Nandgaon,Gram,2015,3308,4768,1460,44.1354292623942
Pandharpur,Capsicum,2016,1620,3080,1460,90.12345679012346
Kamthi,Guava,2015,660,2120,1460,221.21212121212122
Kamthi,Mango,2015,807,2267,1460,180.9169764560099
Umared,Rice(Paddy-Hus),2015,2000,3460,1460,73.0
Kamthi,Dhemse,2016,1790,3250,1460,81.56424581005587
Osmanabad,Brinjal,2016,960,2420,1460,152.08333333333334
Kamthi,Carrot,2014,1670,3130,1460,87.42514970059881
Pune,Curry Leaves,2016,1482,2941,1459,98.4480431848853
Kolhapur,Shepu,2015,1594,3053,1459,91.53074027603513
Indapur,Gram,2016,5075,6534,1459,28.748768472906406
Satara,Green-Peas,2016,7227,8686,1459,20.18818320188183
Jalgaon,Methi (Bhaji),2016,2223,3682,1459,65.63202878992352
Savner,Pigeon Pea (Tur),2016,6269,7727,1458,23.257297814643483
Vadgaon Peth,Brinjal,2014,1542,3000,1458,94.55252918287938
Nashik,Bitter Gourd,2015,3429,4887,1458,42.51968503937008
Lasalgaon,GREEN GRAM,2016,3627,5085,1458,40.1985111662531
Ratanagari,Capsicum,2016,3042,4500,1458,47.928994082840234
Pune,Chavli (Shenga ),2016,2192,3650,1458,66.51459854014598
Sinner,Onion,2014,339,1796,1457,429.79351032448375
Yeola,Onion,2015,1003,2460,1457,145.2642073778664
Vadgaon Peth,Flower,2014,1223,2680,1457,119.13327882256746
Kalamb (Os),Black Gram,2015,7578,9035,1457,19.226708894167327
Vaijapur,Onion,2015,400,1857,1457,364.25
Pimpalgaon (B)-Saykheda,Onion,2015,943,2399,1456,154.40084835630964
Solapur,Mula Shenga,2016,1275,2731,1456,114.19607843137256
Satara,Shevga,2015,4109,5565,1456,35.43441226575809
Nandura,Black Gram,2015,8046,9502,1456,18.09594829729058
Mangalwedha,Green Chilli,2014,1920,3376,1456,75.83333333333333
Vadgaon Peth,Ladies Finger,2014,1461,2917,1456,99.65776865160849
Vadgaon Peth,Brinjal,2015,822,2278,1456,177.12895377128953
Solapur,Bitter Gourd,2014,906,2361,1455,160.59602649006624
Nashik,Wal Papdi,2016,2784,4239,1455,52.26293103448276
Sangali,Chillies(Red),2015,11767,13222,1455,12.365088807682502
Rahata,GARLIC,2016,8545,10000,1455,17.02750146284377
Kamthi,GINGER (FRESH),2016,2318,3773,1455,62.76962899050906
Jalgaon,Ginger (Fresh),2015,1965,3420,1455,74.04580152671755
Pune-Manjri,Raddish,2015,1125,2580,1455,129.33333333333334
Amarawati,Pomegranate,2015,2955,4409,1454,49.20473773265651
Kolhapur,Ginger (Fresh),2015,2317,3771,1454,62.753560638757016
Nagpur,Chikoo,2016,1142,2596,1454,127.32049036777583
Manchar,Bitter Gourd,2016,3664,5118,1454,39.68340611353712
Pune-Manjri,Cluster Bean,2016,2063,3517,1454,70.47988366456616
Vadgaon Peth,Ladies Finger,2015,1353,2806,1453,107.3909830007391
Akluj,Onion,2015,900,2353,1453,161.44444444444446
Kolhapur-Laxmipuri,Green Peas (Dry),2014,3600,5053,1453,40.361111111111114
Pusad,Pigeon Pea (Tur),2015,9469,10922,1453,15.344809377970218
Manchar,Coriander  ,2015,319,1772,1453,455.4858934169279
Nandurbar,Chillies(Red),2016,2254,3706,1452,64.41881100266194
Pune,Wal Papdi,2015,1578,3030,1452,92.01520912547528
Jalgaon,Lemon,2016,2662,4114,1452,54.54545454545455
Aurangabad,Cucumber,2014,1578,3030,1452,92.01520912547528
Kamthi,Potato,2014,1852,3304,1452,78.40172786177106
Satana,Gram,2016,5801,7253,1452,25.03016721254956
Kolhapur,Bottle Gourd,2015,656,2108,1452,221.34146341463415
Kolhapur-Laxmipuri,Spilt Pigeon Pea,2015,14553,16005,1452,9.977324263038549
Chalisgaon,Coriander  ,2016,1286,2738,1452,112.90824261275272
Mangalwedha,Bitter Gourd,2014,926,2378,1452,156.80345572354213
Pusad,Gram,2015,3807,5259,1452,38.140267927501974
Shegaon,Pigeon Pea (Tur),2015,5033,6484,1451,28.82972382276972
Pune,Wal Bhaji,2016,1900,3350,1450,76.3157894736842
Kamthi,Raddish,2015,1300,2750,1450,111.53846153846153
Kada,Onion,2015,500,1950,1450,290.0
Solapur,Cucumber,2015,352,1802,1450,411.9318181818182
Chalisgaon,Green Gram,2015,5500,6950,1450,26.363636363636363
Latur,Wheat(Husked),2016,1542,2992,1450,94.0337224383917
Kolhapur,Shepu,2016,1550,3000,1450,93.54838709677419
Indapur-Bhigwan,Sorgum(Jawar),2015,1626,3076,1450,89.17589175891759
Pune,Ridge Gourd,2015,1827,3277,1450,79.36507936507937
Mumbai,Sorgum(Jawar),2014,1550,3000,1450,93.54838709677419
Kille Dharur,Pigeon Pea (Tur),2016,6000,7450,1450,24.166666666666668
Kalyan,Green Gram,2015,6513,7963,1450,22.263165975740826
Sangali,Lentil,2015,4625,6075,1450,31.35135135135135
Vadgaon Peth,Ridge Gourd,2015,2188,3638,1450,66.27056672760511
Phaltan,Gram,2015,3425,4875,1450,42.33576642335766
Nagpur,Pigeon Pea (Tur),2015,8150,9600,1450,17.791411042944784
Shegaon,Thymol/Lovage,2016,11350,12800,1450,12.775330396475772
Sinner,Green Gram,2015,6188,7638,1450,23.432449903038137
Kamthi,Papai,2016,800,2250,1450,181.25
Sengaon,Turmeric,2015,6500,7950,1450,22.307692307692307
Dondaicha,Ground Nut Pods (Dry),2016,4603,6053,1450,31.50119487290897
Pune-Manjri,Kanda Pat,2014,850,2300,1450,170.58823529411765
Satara,Ginger (Fresh),2015,1600,3050,1450,90.625
Jalna-Badnapur,Gram,2016,7750,9200,1450,18.70967741935484
Chalisgaon,Lemon,2016,2000,3450,1450,72.5
Osmanabad,Lemon,2016,1800,3250,1450,80.55555555555556
Mumbai,Guava,2015,1400,2850,1450,103.57142857142857
Aurangabad,Mosambi,2015,1475,2925,1450,98.30508474576271
Chandur Bajar,Gram,2015,3367,4817,1450,43.065043065043064
Pune,Snake Gourd,2016,1650,3100,1450,87.87878787878788
Pune-Manjri,Bitter Gourd,2015,2786,4236,1450,52.045944005743
Kamthi,Flower,2015,1241,2690,1449,116.76067687348912
Murum,Pigeon Pea (Tur),2015,9701,11150,1449,14.936604473765591
Lasalgaon,Ground Nut Pods (Dry),2015,2901,4350,1449,49.9482936918304
Aurangabad,Tomato,2015,1365,2813,1448,106.08058608058609
Jalgaon,Methi (Bhaji),2016,4089,5537,1448,35.41208119344583
Ahmednagar,Pigeon Pea (Tur),2015,7313,8760,1447,19.786681252563927
Nashik,Brinjal,2016,2559,4006,1447,56.54552559593591
Katol,Ground Nut Pods (Dry),2015,3747,5194,1447,38.61756071523886
Lasalgaon-Vinchur,Soybean,2015,2198,3645,1447,65.83257506824386
Daryapur,Gram,2016,5318,6765,1447,27.20947724708537
Chandrapur-Ganjwad,Onion,2015,945,2391,1446,153.015873015873
Chandrapur,Chikoo,2016,1023,2469,1446,141.34897360703812
Kamthi,Cucumber,2016,935,2381,1446,154.6524064171123
Pune,Wal Papdi,2015,1554,3000,1446,93.05019305019304
Mumbai,Split Black Gram,2015,7045,8491,1446,20.525195173882185
Mumbai,Split Black Gram,2016,11804,13250,1446,12.25008471704507
Vaijapur,Onion,2015,188,1634,1446,769.1489361702128
Kolhapur,Tomato,2015,407,1853,1446,355.2825552825553
Pune,Ladies Finger,2015,1013,2458,1445,142.6456071076012
Ambad(Vadi Godri),Wheat(Husked),2015,1519,2964,1445,95.12837393021725
Kamthi,Ladies Finger,2015,3611,5056,1445,40.01661589587372
Akot,Ground Nut Pods (Dry),2016,3595,5040,1445,40.19471488178025
Akluj,Chikoo,2016,2222,3667,1445,65.03150315031503
Kamthi,Carrot,2015,1144,2589,1445,126.31118881118881
Pune,Ghosali(Bhaji),2015,1240,2685,1445,116.53225806451613
Lasur Station,Sorgum(Jawar),2016,1318,2763,1445,109.63581183611532
Pimpalgaon Basawant,Tomato,2014,320,1765,1445,451.5625
Akluj,Garlic,2016,4722,6167,1445,30.601440067767896
Chopda,Black Gram,2016,6105,7550,1445,23.669123669123667
Gevrai,GRAM,2016,5529,6974,1445,26.134924941219026
Pune,Parwar,2016,1667,3111,1444,86.62267546490702
Ratanagari,Maize(Corn.),2015,3778,5222,1444,38.2212811011117
Pune-Manjri,Kardai,2016,0,1444,1444,inf
Kamthi,Cluster Bean,2016,1426,2870,1444,101.26227208976157
Kalyan,Zendu,2016,3667,5111,1444,39.37823834196891
Pune-Pimpri,Green Chilli,2015,3139,4583,1444,46.0019114367633
Shirpur,Pigeon Pea (Tur),2016,5448,6892,1444,26.505139500734213
Kurdwadi,Onion,2015,2463,3907,1444,58.6276898091758
Nashik,Kanda Pat,2016,1085,2529,1444,133.08755760368663
Chopda,Green Gram,2015,6584,8028,1444,21.931956257594166
Mangalwedha,Green Chilli,2015,1236,2680,1444,116.8284789644013
Khed-Chakan,Green-Peas,2016,6778,8222,1444,21.304219533785776
Kamthi,Mosambi,2015,914,2357,1443,157.87746170678338
Solapur,Black Gram,2016,5800,7243,1443,24.879310344827587
Ausa,Pigeon Pea (Tur),2015,8352,9795,1443,17.277298850574713
Chandvad,Onion,2015,912,2355,1443,158.22368421052633
Pune-Pimpri,Brinjal,2015,1633,3076,1443,88.36497244335578
Pune,Ridge Gourd,2015,1043,2486,1443,138.35091083413232
Balapur,Pigeon Pea (Tur),2016,7317,8760,1443,19.721197211972118
Pune,Parwar,2015,1605,3047,1442,89.84423676012462
Rahata,Onion,2014,429,1871,1442,336.13053613053614
Pune,Ghosali(Bhaji),2016,900,2342,1442,160.22222222222223
Solapur,Bor,2014,321,1763,1442,449.22118380062307
Kolhapur,Cluster Bean,2015,1650,3092,1442,87.39393939393939
Satana,Onion,2015,1068,2510,1442,135.0187265917603
Pune-Manjri,Guava,2015,1176,2618,1442,122.61904761904762
Varud-Rajura Bazar,Green Chilli,2015,1600,3041,1441,90.0625
Aurangabad,Lemon,2015,3214,4655,1441,44.835096453018046
Chandvad,Onion,2014,177,1618,1441,814.1242937853108
Kamthi,Cucumber,2015,1142,2583,1441,126.18213660245183
Mumbai,Orange,2015,1000,2441,1441,144.1
Chikhali,Pigeon Pea (Tur),2015,3905,5345,1440,36.875800256081945
Nashik,Bitter Gourd,2014,1296,2736,1440,111.11111111111111
Nashik,Ghevda,2015,1900,3340,1440,75.78947368421052
Koregaon,Potato,2014,1000,2440,1440,144.0
Kamthi,Raddish,2015,960,2400,1440,150.0
Ausa,Wheat(Husked),2015,1465,2905,1440,98.29351535836177
Junnar (Narayangaon),Math (Bhaji),2016,961,2401,1440,149.84391259105098
Nashik,Cucumber,2015,1196,2636,1440,120.40133779264214
Kalvan,Onion,2014,457,1897,1440,315.0984682713348
Chandrapur-Ganjwad,Coriander  ,2016,1600,3040,1440,90.0
Mumbai,Green-Peas,2014,5668,7108,1440,25.40578687367678
Chandrapur,Apple,2015,3615,5055,1440,39.83402489626556
Nagpur,Mango,2015,1976,3416,1440,72.8744939271255
Solapur,Ladies Finger,2016,439,1878,1439,327.7904328018223
Chandvad,Onion,2015,410,1849,1439,350.9756097560976
Kolhapur,Cucumber,2016,288,1727,1439,499.65277777777777
Umarga,Green Gram,2014,6495,7934,1439,22.155504234026175
Aurangabad,Tomato,2016,1883,3321,1438,76.36749867233138
Kej,Gram,2016,6422,7860,1438,22.391778262223607
Kille Dharur,Cotton,2014,3954,5392,1438,36.36823469903895
Devala,Sweet Potato,2015,1350,2788,1438,106.51851851851852
Aurangabad,Mosambi,2014,1104,2542,1438,130.2536231884058
Pune,Pavtta,2015,2781,4219,1438,51.708018698309964
Pune-Manjri,Hemp,2014,0,1438,1438,inf
Pune,Shevga,2016,2108,3546,1438,68.21631878557875
Osmanabad,Chikoo,2016,1188,2625,1437,120.95959595959596
Latur,Pigeon Pea (Tur),2015,8600,10037,1437,16.709302325581394
Nashik,Ginger (Fresh),2015,3813,5250,1437,37.68686073957514
Aurangabad,Ginger (Fresh),2016,538,1975,1437,267.1003717472119
Ulhasnagar,Green Gram,2015,6313,7750,1437,22.76255346111199
Khamgaon,Sesamum,2014,9721,11158,1437,14.782429791173747
Pune,Ghevda,2016,2521,3958,1437,57.00119000396668
Sangamner,Tomato,2016,658,2095,1437,218.3890577507599
Mangalwedha,Green Chilli,2014,1693,3130,1437,84.87891317188424
Pune,Shevga,2016,3188,4625,1437,45.075282308657464
Nagpur,Chikoo,2015,1464,2900,1436,98.08743169398907
Mumbai,Mosambi,2015,1000,2436,1436,143.6
Pune,Walvad,2015,1714,3150,1436,83.78063010501751
Pune-Manjri,Ghevda,2014,2253,3689,1436,63.73723923657346
Shahada,Pigeon Pea (Tur),2016,6917,8353,1436,20.760445279745554
Kamthi,Cucumber,2015,807,2243,1436,177.9429987608426
Kurdwadi-Modnimb,Pigeon Pea (Tur),2015,3807,5242,1435,37.69372209088521
Dondaicha,Green Gram,2015,6835,8270,1435,20.99487929773226
Vadgaon Peth,Ladies Finger,2015,1529,2964,1435,93.85219097449313
Pune,Walvad,2016,2271,3706,1435,63.18802289740203
Kamthi,Ladies Finger,2015,2186,3621,1435,65.64501372369625
Shirpur,Ground Nut Pods (Dry),2016,4798,6233,1435,29.908295122967903
Khamgaon,Pigeon Pea (Tur),2015,4127,5562,1435,34.77102011146111
Phaltan,Onion,2014,475,1910,1435,302.10526315789474
Karad,Mosambi,2016,6239,7674,1435,23.00048084628947
Kalyan,Gram,2015,4733,6167,1434,30.29790830340165
Mumbai,Coconut,2015,670,2104,1434,214.02985074626866
Sangali,Coriander (Dry),2016,7333,8767,1434,19.555434337924453
Baramati,Onion,2015,333,1767,1434,430.6306306306306
Buldhana,PIGEON PEA (TUR),2016,4333,5767,1434,33.094853450265404
Mangaon(Bhadav),Nagali,2014,1408,2842,1434,101.8465909090909
Kopargaon,Onion,2015,350,1784,1434,409.7142857142857
Aurangabad,Ginger (Fresh),2015,1367,2800,1433,104.82809070958302
Mangaon(Bhadav),Nachani,2014,1456,2889,1433,98.42032967032966
Shahada,Soybean,2015,2365,3798,1433,60.59196617336152
Kalyan,Garlic,2016,6267,7700,1433,22.86580501037179
Khamgaon,Green Gram,2015,5462,6895,1433,26.23581105822043
Palus,Bottle Gourd,2016,800,2233,1433,179.125
Kolhapur,Ginger (Fresh),2016,2357,3790,1433,60.797624098430205
Mangalwedha,Ridge Gourd,2016,2646,4079,1433,54.15721844293273
Kolhapur-Laxmipuri,Spilt Gerrn Gram,2015,9500,10933,1433,15.08421052631579
Barshi,Onion,2015,214,1647,1433,669.626168224299
Kolhapur-Laxmipuri,Green Gram,2015,8567,10000,1433,16.726975604062098
Akluj,Ground Nut Pods (Dry),2015,3167,4600,1433,45.247868645405745
Mumbai,Wheat(Husked),2014,1800,3232,1432,79.55555555555556
Pathardi,Onion,2016,173,1605,1432,827.7456647398844
Taloda,Pigeon Pea (Tur),2016,7245,8677,1432,19.76535541752933
Nashik,Brinjal,2015,1786,3218,1432,80.17917133258679
Daryapur,Green Gram,2016,4880,6311,1431,29.32377049180328
Pune-Manjri,Goosefoot,2015,0,1431,1431,inf
Nagpur,Pigeon Pea (Tur),2016,5263,6694,1431,27.189815694470834
Chandvad,Onion,2014,242,1673,1431,591.3223140495868
Nanded,Turmeric,2016,6218,7649,1431,23.013830813766486
Chandrapur-Ganjwad,Onion,2015,3255,4686,1431,43.963133640552996
Kamthi,Potato,2015,570,2000,1430,250.87719298245614
Jalgaon,Bitter Gourd,2015,2982,4412,1430,47.95439302481556
Kolhapur-Malkapur,Capsicum,2016,520,1950,1430,275.0
Pune,Walvad,2016,1933,3363,1430,73.97827211588205
Junnar-Otur,Carrot,2016,1100,2530,1430,130.0
Kolhapur-Laxmipuri,Green Gram,2016,6100,7530,1430,23.442622950819672
Malkapur,Pigeon Pea (Tur),2015,4746,6176,1430,30.13063632532659
Chopda,Sesamum,2015,4972,6402,1430,28.761061946902654
Nashik,Ladies Finger,2014,1359,2788,1429,105.15084621044886
Sinner,Onion,2015,174,1603,1429,821.264367816092
Mumbai-Fruit Market,Custard Apple,2016,3571,5000,1429,40.01680201624195
Solapur,Chikoo,2016,979,2408,1429,145.9652706843718
Khamgaon,Pigeon Pea (Tur),2016,7023,8452,1429,20.34742987327353
Varud-Rajura Bazar,Pigeon Pea (Tur),2015,5569,6998,1429,25.659903034656132
Mumbai,Small Gourd,2014,867,2296,1429,164.82122260668973
Aurangabad,Green Chilli,2015,2645,4073,1428,53.98865784499055
Dhule,Onion,2014,476,1904,1428,300.0
Kamthi,Dhemse,2015,1643,3071,1428,86.91418137553256
Kamthi,Beet Root,2014,2143,3571,1428,66.63555762949137
Kolhapur-Laxmipuri,Split Black Gram,2016,16444,17872,1428,8.684018486986135
Kamthi,Cluster Bean,2015,1145,2573,1428,124.71615720524018
Jalgaon,Flower,2016,2610,4038,1428,54.71264367816092
Mumbai,Fenugreek,2015,9029,10457,1428,15.815704950714364
Ratanagari,Brinjal,2016,1183,2611,1428,120.71005917159763
Dudhani,Pigeon Pea (Tur),2016,6979,8407,1428,20.461384152457374
Sailu,Pigeon Pea (Tur),2015,4681,6108,1427,30.484939115573596
Pimpalgaon Basawant,Tomato,2015,391,1818,1427,364.9616368286445
Barshi,Black Gram,2015,6364,7791,1427,22.423004399748585
Rahuri,Tomato,2016,255,1682,1427,559.6078431372549
Solapur,Ghevda,2016,2357,3783,1426,60.5006364022062
Manchar,Coriander  ,2014,218,1644,1426,654.1284403669724
Murum,Black Gram,2015,8427,9853,1426,16.921798979470747
Loha,Turmeric,2015,6600,8026,1426,21.606060606060606
Pune-Manjri,Kanda Pat,2015,1074,2500,1426,132.77467411545624
Mumbai,Guava,2015,1009,2435,1426,141.32804757185332
Pune-Manjri,Ladies Finger,2016,1379,2804,1425,103.33575054387236
Palus,Squash Gourd,2016,4700,6125,1425,30.319148936170212
Rahuri-Songaon,Tomato,2016,1425,2850,1425,100.0
Latur,Wheat(Husked),2015,1519,2944,1425,93.81171823568137
Nashik,Papai,2016,1000,2425,1425,142.5
Umared,Rice(Paddy-Hus),2015,2000,3425,1425,71.25
Solapur,Green Chilli,2015,1740,3165,1425,81.89655172413794
Koregaon,Onion,2015,3500,4925,1425,40.714285714285715
Sangrampur-Varvatbakal,Ground Nut Pods (Dry),2016,4317,5742,1425,33.0090340514246
Kolhapur-Malkapur,Cucumber,2016,675,2100,1425,211.11111111111111
Mehkar,Black Gram,2015,6000,7425,1425,23.75
Nilanga,Pigeon Pea (Tur),2015,10425,11850,1425,13.66906474820144
Kolhapur,Sweet Potato,2015,767,2192,1425,185.78878748370275
Vadgaon Peth,Ridge Gourd,2016,1658,3083,1425,85.94692400482509
Achalpur,Pigeon Pea (Tur),2015,7475,8900,1425,19.06354515050167
Phaltan,Green Chilli,2016,3150,4575,1425,45.23809523809524
Akluj,Chikoo,2015,2038,3462,1424,69.87242394504416
Phaltan,Gram,2015,3483,4907,1424,40.88429514786104
Jalna,Green Gram,2014,6190,7614,1424,23.004846526655896
Latur-Murud,Wheat(Husked),2016,1556,2980,1424,91.51670951156812
Solapur,Chikoo,2014,561,1985,1424,253.8324420677362
Pune-Moshi,Garlic,2016,4964,6388,1424,28.686543110394844
Pune,Mula Shenga,2015,1077,2501,1424,132.21912720519964
Mumbai,Orange,2015,1000,2424,1424,142.4
Kada,Black Gram,2015,3826,5250,1424,37.219027705175115
Pune,Carrot,2014,714,2138,1424,199.43977591036415
Vadgaon Peth,Flower,2016,959,2382,1423,148.3837330552659
Amarawati,Ginger (Fresh),2016,2115,3538,1423,67.28132387706856
Kolhapur,Jaggery,2016,2423,3846,1423,58.728848534874125
Kolhapur,Jaggery,2015,2430,3853,1423,58.559670781893004
Manchar,Ghevda,2016,2541,3964,1423,56.001574183392364
Barshi,Sorgum(Jawar),2014,1452,2875,1423,98.00275482093664
Parola,Black Gram,2016,5844,7267,1423,24.349760438056126
Mumbai,Split Black Gram,2014,6607,8030,1423,21.537762978658996
Nashik,Lemon,2014,1267,2690,1423,112.31254932912391
Pune,Carrot,2015,855,2277,1422,166.31578947368422
Pune-Manjri,Brinjal,2015,1167,2589,1422,121.8508997429306
Nashik,Ginger (Fresh),2016,3156,4578,1422,45.05703422053232
Barshi,Gram,2016,5097,6519,1422,27.898763978811065
Mangalwedha,LADIES FINGER,2016,666,2088,1422,213.51351351351352
Pune,Ghevda,2016,1513,2935,1422,93.98545935228024
Pune,Green Chilli,2015,1423,2845,1422,99.92972593113141
Pune,Bitter Gourd,2015,2816,4237,1421,50.46164772727273
Solapur,Onion,2015,226,1647,1421,628.7610619469026
Manmad,Gram,2016,7808,9229,1421,18.199282786885245
Dondaicha,Ground Nut Pods (Dry),2015,4436,5857,1421,32.03336339044184
Khamgaon,Pigeon Pea (Tur),2015,4708,6129,1421,30.18266779949023
Khed-Chakan,GREEN-PEAS,2016,6500,7921,1421,21.861538461538462
Pune,Walvad,2015,1553,2974,1421,91.50032195750161
Osmanabad,Brinjal,2015,952,2373,1421,149.26470588235293
Chalisgaon,Brinjal,2016,1010,2430,1420,140.59405940594058
Solapur,Green Chilli,2015,1617,3037,1420,87.8169449598021
Jalgaon,Green Gram,2014,5123,6543,1420,27.718133905914502
Kolhapur,Wal Bhaji,2016,1280,2700,1420,110.9375
Kille Dharur,Gram,2016,6240,7660,1420,22.756410256410255
Mumbai,Garlic,2015,4340,5760,1420,32.71889400921659
Pune,Mula Shenga,2015,1180,2600,1420,120.33898305084746
Mumbai,Brinjal,2014,724,2144,1420,196.13259668508286
Hingoli,Pigeon Pea (Tur),2015,6260,7680,1420,22.68370607028754
Osmanabad,Capsicum,2016,3580,5000,1420,39.66480446927374
Mangalwedha,Ridge Gourd,2015,1656,3076,1420,85.7487922705314
Anajngaon Surji,Pigeon Pea (Tur),2015,9320,10740,1420,15.236051502145923
Jalgaon Jamod,Pigeon Pea (Tur),2015,4800,6220,1420,29.583333333333332
Chikhali,Pigeon Pea (Tur),2016,6678,8097,1419,21.248876909254268
Kolhapur,Carrot,2015,1069,2488,1419,132.74087932647333
Jalgaon,Maize,2016,1475,2894,1419,96.20338983050847
Akluj,Chikoo,2016,2024,3443,1419,70.1086956521739
Rahuri-Vambori,Onion,2015,336,1755,1419,422.32142857142856
Jamkhed,Sorgum(Jawar),2014,1821,3239,1418,77.86930258099945
Barshi,Turmeric,2014,4449,5867,1418,31.87233086086761
Hingoli,Turmeric,2015,7380,8798,1418,19.21409214092141
Lonar,Green Gram,2015,6521,7939,1418,21.745131114859685
Lasur Station,Thymol/Lovage,2016,11167,12585,1418,12.69812841407719
Sangli-Phale Bhajipalam,Bor,2015,527,1945,1418,269.07020872865274
Dhule,Onion,2014,374,1792,1418,379.14438502673795
Sangali,Lentil,2015,6727,8145,1418,21.079232941876022
Akluj,Chikoo,2016,1618,3035,1417,87.57725587144623
Pune,Turmeric,2014,9000,10417,1417,15.744444444444444
Nashik,Dhemse,2016,1222,2639,1417,115.95744680851064
Kamthi,Ladies Finger,2015,1021,2438,1417,138.78550440744368
Sangli-Phale Bhajipalam,Ginger (Fresh),2016,1583,3000,1417,89.51358180669615
Chandrapur-Ganjwad,Coriander  ,2015,1833,3250,1417,77.30496453900709
Pune,Cucumber,2016,1600,3017,1417,88.5625
Nashik,Squash Gourd,2015,667,2084,1417,212.44377811094452
Kurdwadi-Modnimb,Onion,2015,150,1567,1417,944.6666666666666
Paranda,Onion,2016,116,1533,1417,1221.551724137931
Kamthi,Dhemse,2016,1757,3174,1417,80.64883323847468
Kalvan,Onion,2014,400,1817,1417,354.25
Solapur,Ghevda,2015,2417,3833,1416,58.585022755482
Karad,Orange,2015,3417,4833,1416,41.43985952589991
Shirpur,Ground Nut Pods (Dry),2016,4104,5520,1416,34.50292397660819
Karad,Apple,2015,3563,4979,1416,39.74179062587707
Kurdwadi,Chillies(Red),2016,7186,8602,1416,19.70498190926802
Vadgaon Peth,Capsicum,2016,1969,3385,1416,71.91467750126968
Jalgaon,Onion,2015,532,1948,1416,266.16541353383457
Osmanabad,Tomato,2015,813,2229,1416,174.16974169741698
Dondaicha,Green Gram,2015,5643,7058,1415,25.075314548998758
Jalna,Soybean,2015,3123,4538,1415,45.30899775856548
Pandharpur,Tomato,2014,446,1861,1415,317.2645739910314
Kamthi,Chavli (Shenga ),2016,1637,3052,1415,86.43860720830789
Nagpur,Mosambi,2015,1281,2696,1415,110.46057767369243
Shirpur,Gram,2016,7894,9309,1415,17.9250063339245
Osmanabad,Pigeon Pea (Tur),2016,6839,8253,1414,20.67553735926305
Pune-Manjri,Hemp,2015,0,1414,1414,inf
Parner,Onion,2014,500,1914,1414,282.8
Mehkar,Black Gram,2015,8032,9446,1414,17.60458167330677
Kamthi,Cucumber,2016,1079,2493,1414,131.047265987025
Katol,Pigeon Pea (Tur),2015,6572,7986,1414,21.515520389531346
Jalgaon,Methi (Bhaji),2015,2009,3423,1414,70.38327526132404
Latur-Murud,Gram,2016,3110,4523,1413,45.434083601286176
Nashik,Methi (Bhaji),2014,723,2136,1413,195.4356846473029
Kamthi,Cabbage,2015,667,2080,1413,211.84407796101948
Nandura,Black Gram,2015,7399,8812,1413,19.097175293958642
Daryapur,Gram,2016,4049,5462,1413,34.897505556927634
Ratanagari,Ladies Finger,2016,2735,4147,1412,51.62705667276051
Kalvan,Bajri,2016,1594,3006,1412,88.58218318695107
Junnar-Otur,Small Gourd,2016,1088,2500,1412,129.77941176470588
Umared,Rice(Paddy-Hus),2015,1944,3356,1412,72.63374485596708
Akluj,Shevga,2016,1740,3152,1412,81.14942528735632
Lonar,Pigeon Pea (Tur),2015,8513,9925,1412,16.586397274756255
Mehkar,Green Gram,2015,6497,7909,1412,21.733107588117594
Pandharpur,Tomato,2015,427,1839,1412,330.6791569086651
Bhokardan,Sorgum(Jawar),2015,1163,2574,1411,121.32416165090284
Nashik,Ghevda,2016,2335,3746,1411,60.42826552462527
Pune-Moshi,Bitter Gourd,2016,1326,2737,1411,106.41025641025641
Nashik,Methi (Bhaji),2016,1658,3069,1411,85.10253317249699
Barshi,Tamarind,2016,6754,8165,1411,20.891323660053303
Kamthi,Potato,2016,537,1947,1410,262.5698324022346
Sindi (Selu),Gram,2016,4000,5410,1410,35.25
Aurangabad,Orange,2016,1580,2990,1410,89.24050632911393
Pune,Ginger (Fresh),2015,1615,3025,1410,87.30650154798762
Chandrapur,Mosambi,2014,1474,2884,1410,95.65807327001357
Pune-Manjri,Guava,2016,2733,4143,1410,51.59165751920966
Kamthi,Dhemse,2016,2140,3550,1410,65.88785046728972
Kamthi,Mint,2016,1179,2589,1410,119.59287531806616
Pune-Moshi,Capsicum,2016,2738,4148,1410,51.49744338933528
Jalgaon,Lemon,2015,1650,3060,1410,85.45454545454545
Jalgaon,Green Chilli,2015,1030,2440,1410,136.89320388349515
Sangali,Lentil,2014,3980,5390,1410,35.42713567839196
Vadgaon Peth,Ladies Finger,2016,1045,2455,1410,134.92822966507177
Kolhapur,Cucumber,2016,448,1857,1409,314.50892857142856
Manchar,Cucumber,2016,613,2022,1409,229.85318107667212
Nagpur,Chikoo,2016,1279,2688,1409,110.16419077404223
Pimpalgaon Basawant,Tomato,2016,295,1704,1409,477.6271186440678
Dhule,Ground Nut Pods (Dry),2016,3859,5268,1409,36.51204975382223
Indapur-Bhigwan,Gram,2016,4900,6308,1408,28.73469387755102
Solapur,BOR,2016,800,2208,1408,176.0
Pune,Carrot,2016,1023,2431,1408,137.63440860215053
Pune,Cucumber,2016,932,2340,1408,151.07296137339057
Lasalgaon,Ground Nut Pods (Dry),2015,3631,5039,1408,38.77719636463784
Sinner,Onion,2015,265,1673,1408,531.3207547169811
Jalgaon,Green Chilli,2015,1035,2443,1408,136.03864734299518
Pimpalgaon Basawant,Onion,2015,685,2093,1408,205.54744525547446
Kolhapur,Flower,2016,537,1944,1407,262.0111731843575
Kurdwadi,Onion,2015,148,1555,1407,950.6756756756756
Pune-Pimpri,Tomato,2016,2576,3983,1407,54.619565217391305
Kamthi,Spinach,2015,1073,2480,1407,131.12767940354146
Umared,Rice(Paddy-Hus),2015,2000,3406,1406,70.3
Solapur,Ghevda,2014,1603,3009,1406,87.7105427323768
Kamthi,Ginger (Fresh),2016,2594,4000,1406,54.20200462606014
Jalgaon,Ginger (Fresh),2015,2519,3925,1406,55.81579992060341
Pune-Manjri,Ladies Finger,2014,1405,2811,1406,100.0711743772242
Ulhasnagar,Bajri,2015,2694,4100,1406,52.19005196733482
Manchar,Wal Papdi,2016,4350,5755,1405,32.298850574712645
Akot,Black Gram,2016,7065,8470,1405,19.886765746638357
Khalapur(Shil-Phata),Wheat(Husked),2016,2085,3490,1405,67.38609112709833
Murum,Bajri,2014,1404,2809,1405,100.07122507122507
Solapur,Capsicum,2015,1600,3005,1405,87.8125
Ambejogai,Pigeon Pea (Tur),2016,6975,8380,1405,20.14336917562724
Mumbai,Cucumber,2014,948,2352,1404,148.1012658227848
Buldhana,Black Gram,2016,5582,6986,1404,25.152275170189895
Chikhali,Gram,2016,5073,6477,1404,27.67593140153755
Nandura,Green Gram,2014,5946,7350,1404,23.612512613521695
Amalner,Green Gram,2016,3425,4829,1404,40.99270072992701
Kamthi,Capsicum,2016,1741,3144,1403,80.58587018954624
Koregaon,Ghevda Seed,2015,3877,5280,1403,36.18777405210214
Pune-Pimpri,Green Chilli,2016,5873,7276,1403,23.888983483739146
Ulhasnagar,OTHER VEGETABLES,2016,1000,2403,1403,140.3
Pune,RICE(PADDY-HUS),2016,3659,5062,1403,38.34380978409401
Kurdwadi-Modnimb,Onion,2015,300,1703,1403,467.6666666666667
Nashik,Bottle Gourd,2015,665,2067,1402,210.82706766917292
Jalna,Sorgum(Jawar),2015,1127,2529,1402,124.40106477373558
Mangalwedha,Ridge Gourd,2016,610,2012,1402,229.8360655737705
Malkapur,Black Gram,2016,6036,7438,1402,23.227302849569252
Akola,Gram,2016,6674,8076,1402,21.006892418339827
Solapur,Onion,2015,111,1513,1402,1263.063063063063
Shirur,Green Gram,2015,6323,7725,1402,22.173019136485845
Amarawati,Pigeon Pea (Tur),2015,8146,9547,1401,17.198625092069726
Kopargaon,Onion,2015,471,1872,1401,297.45222929936307
Risod,Pigeon Pea (Tur),2016,7039,8440,1401,19.90339536866032
Kolhapur-Laxmipuri,Spilt Pigeon Pea,2014,5800,7200,1400,24.137931034482758
Akluj,Shepu,2016,1800,3200,1400,77.77777777777777
Jalgaon,Mosambi,2016,1667,3067,1400,83.98320335932813
Akluj,Ground Nut Pods (Dry),2016,4250,5650,1400,32.94117647058823
Pune-Manjri,Spinach,2015,643,2043,1400,217.7293934681182
Kada,Onion,2014,300,1700,1400,466.6666666666667
Mumbai,Wheat(Husked),2014,1800,3200,1400,77.77777777777777
Karad,POMEGRANATE,2016,4680,6080,1400,29.914529914529915
Satara,Green-Peas,2015,6300,7700,1400,22.22222222222222
Pandharpur,Tomato,2015,342,1742,1400,409.3567251461988
Junnar-Otur,Cucumber,2016,500,1900,1400,280.0
Nanded,Pigeon Pea (Tur),2014,3200,4600,1400,43.75
Kamthi,Mosambi,2016,600,2000,1400,233.33333333333334
Chalisgaon,Ground Nut Pods (Dry),2016,3300,4700,1400,42.42424242424242
Akot,SESAMUM,2016,5000,6400,1400,28.0
Manchar,Small Gourd,2016,800,2200,1400,175.0
Sangli-Phale Bhajipalam,Bor,2015,600,2000,1400,233.33333333333334
Solapur,Custard Apple,2015,517,1917,1400,270.79303675048357
Junnar-Otur,Beet Root,2015,100,1500,1400,1400.0
Solapur,Green Peas (Dry),2015,3600,5000,1400,38.888888888888886
Jamkhed,Onion,2015,156,1556,1400,897.4358974358975
Pune-Moshi,Tomato,2016,1500,2900,1400,93.33333333333333
Solapur,Matki,2016,4500,5900,1400,31.11111111111111
Kamthi,Brinjal,2015,1148,2548,1400,121.95121951219512
Aurangabad,Ginger (Fresh),2016,763,2163,1400,183.4862385321101
Rahuri,CAPSICUM,2016,650,2050,1400,215.3846153846154
Kamthi,Potato,2016,871,2271,1400,160.73478760045924
Palus,Green-Peas,2016,1750,3150,1400,80.0
Parli-Vaijnath,Pigeon Pea (Tur),2015,7384,8784,1400,18.95991332611051
Kamthi,Mint,2015,2000,3400,1400,70.0
Pune,Sweet Potato,2016,1529,2929,1400,91.56311314584696
Nagpur,Green Peas (Dry),2016,6000,7400,1400,23.333333333333332
Chandrapur-Ganjwad,Wal Bhaji,2016,1933,3333,1400,72.42628039317124
Anajngaon Surji,Chillies(Red),2015,9500,10900,1400,14.736842105263158
Vadgaon Peth,Capsicum,2015,1821,3221,1400,76.88083470620538
Akluj,Carrot,2016,2050,3450,1400,68.29268292682927
Mumbai-Fruit Market,Guava,2016,1017,2417,1400,137.65978367748278
Kolhapur,Spinach,2016,3267,4667,1400,42.8527701254974
Kolhapur,Spinach,2016,700,2100,1400,200.0
Ahmednagar,Ground Nut Pods (Dry),2016,3477,4877,1400,40.26459591601956
Karad,Ginger (Fresh),2014,3492,4892,1400,40.09163802978236
Kolhapur,Shepu,2016,4200,5600,1400,33.333333333333336
Vadgaon Peth,Brinjal,2016,1025,2425,1400,136.58536585365854
Nashik,Sweet Potato,2016,4000,5400,1400,35.0
Pune,Elephant Root,2016,1500,2900,1400,93.33333333333333
Akluj,Chikoo,2016,1480,2880,1400,94.5945945945946
Kolhapur,SPINACH,2016,700,2100,1400,200.0
Ahmednagar,BITTER GOURD,2016,625,2025,1400,224.0
Kolhapur,Kanda Pat,2016,2100,3500,1400,66.66666666666667
Hingoli,Turmeric,2015,6000,7400,1400,23.333333333333332
Chandrapur,Papai,2016,2267,3667,1400,61.755624172915745
Rahuri,Green Chilli,2015,1600,3000,1400,87.5
Aurangabad,Mosambi,2016,2700,4100,1400,51.851851851851855
Akkalkuwa,Other Cereals,2015,6000,7400,1400,23.333333333333332
Barshi-Vairag,Pigeon Pea (Tur),2015,5000,6400,1400,28.0
Pune-Manjri,Raddish,2015,1000,2400,1400,140.0
Nira-Saswad,Rice(Paddy-Hus),2015,1900,3300,1400,73.6842105263158
Sangli-Phale Bhajipalam,Bor,2016,430,1830,1400,325.5813953488372
Solapur,Carrot,2014,620,2020,1400,225.80645161290323
Kolhapur-Malkapur,Brinjal,2016,533,1933,1400,262.6641651031895
Sangrampur,Green Gram,2014,6620,8020,1400,21.148036253776436
Balapur,Sesamum,2015,5600,7000,1400,25.0
Nandurbar,Thymol/Lovage,2015,6600,8000,1400,21.21212121212121
Mumbai-Fruit Market,CUSTARD APPLE,2016,3444,4844,1400,40.65040650406504
Kalyan,Gram,2016,4333,5733,1400,32.31017770597738
Indapur-Bhigwan,Chillies(Red),2015,8600,10000,1400,16.27906976744186
Osmanabad,Ginger (Fresh),2015,2000,3400,1400,70.0
Lasalgaon,Ground Nut Pods (Dry),2016,3500,4900,1400,40.0
Ahmednagar,GHOSALI(BHAJI),2016,817,2217,1400,171.35862913096696
Ratanagari,Brinjal,2016,1835,3235,1400,76.29427792915531
Osmanabad,Ladies Finger,2015,1350,2750,1400,103.70370370370371
Chandrapur,Grapes,2014,5520,6920,1400,25.36231884057971
Parbhani,Pigeon Pea (Tur),2015,8650,10050,1400,16.184971098265898
Solapur,Ghevda,2014,1325,2725,1400,105.66037735849056
Kolhapur,Spinach,2015,2531,3931,1400,55.314105096799686
Nashik,Ghevda,2015,2500,3900,1400,56.0
Kamthi,Parwar,2015,3100,4500,1400,45.16129032258065
Mumbai,Guava,2016,1000,2400,1400,140.0
Rahuri,Flower,2016,150,1550,1400,933.3333333333334
Ahmednagar,Cluster Bean,2015,2900,4300,1400,48.275862068965516
Pune-Manjri,Kanda Pat,2015,833,2233,1400,168.0672268907563
Mandhal,Chillies(Red),2015,3816,5215,1399,36.66142557651992
Gevrai,Pigeon Pea (Tur),2015,5224,6623,1399,26.780245022970902
Chopda,Black Gram,2015,7350,8749,1399,19.034013605442176
Shirpur,Sesamum,2014,7941,9340,1399,17.617428535448937
Kille Dharur,Pigeon Pea (Tur),2016,6892,8291,1399,20.298897272199653
Solapur,Capsicum,2014,986,2384,1398,141.78498985801218
Pandharpur,Onion,2015,229,1627,1398,610.4803493449782
Nashik,Ladies Finger,2016,2796,4193,1397,49.964234620886984
Pune-Manjri,Raddish,2015,1295,2692,1397,107.87644787644787
Pune-Moshi,GREEN-PEAS,2016,7017,8414,1397,19.908792931452187
Karanja,Ground Nut Pods (Dry),2016,4019,5415,1396,34.73500870863399
Murum,Green Gram,2014,6184,7580,1396,22.57438551099612
Pune,Capsicum,2015,1914,3310,1396,72.9362591431557
Varud-Rajura Bazar,Pigeon Pea (Tur),2015,5860,7256,1396,23.822525597269625
Manmad,Gram,2016,6097,7493,1396,22.89650647859603
Jalna,Green Gram,2015,6964,8360,1396,20.045950603101666
Majalgaon,Green Gram,2015,5932,7328,1396,23.533378287255562
Sinner,Green Gram,2015,6830,8226,1396,20.439238653001464
Osmanabad,BITTER GOURD,2016,932,2327,1395,149.67811158798284
Barshi,Pigeon Pea (Tur),2016,7535,8930,1395,18.51360318513603
Kalamb (Os),Green Gram,2015,7701,9096,1395,18.114530580444097
Ratanagari,Flower,2016,2579,3974,1395,54.090732842186895
Pune,Ridge Gourd,2015,1510,2905,1395,92.3841059602649
Pune,Wal Papdi,2015,2248,3643,1395,62.055160142348754
Vadgaon Peth,Brinjal,2015,1105,2500,1395,126.24434389140272
Mehkar,Green Gram,2015,5370,6765,1395,25.977653631284916
Akluj,Bitter Gourd,2015,1826,3221,1395,76.39649507119387
Parola,Gram,2015,2257,3652,1395,61.80770934869295
Kamthi,Chavli (Pala),2015,819,2213,1394,170.2075702075702
Kamthi,Cabbage,2015,677,2071,1394,205.90841949778434
Barshi,Tamarind,2015,4169,5563,1394,33.43727512592948
Junnar-Otur,Chavli (Shenga ),2016,1000,2394,1394,139.4
Solapur,Pigeon Pea (Tur),2016,7726,9120,1394,18.042971783587884
Solapur,Guava,2014,722,2115,1393,192.93628808864267
Kej,Pigeon Pea (Tur),2016,7188,8581,1393,19.37952142459655
Pune-Manjri,Brinjal,2016,2030,3423,1393,68.62068965517241
Osmanabad,Flower,2015,1435,2828,1393,97.07317073170732
Khamgaon,Pigeon Pea (Tur),2016,7083,8476,1393,19.666807849781165
Pandharpur,Onion,2015,199,1591,1392,699.4974874371859
Karanja,Sesamum,2015,7373,8765,1392,18.879696188796963
Pusad,Gram,2016,6560,7952,1392,21.21951219512195
Pune-Pimpri,Black Gram,2016,9279,10671,1392,15.00161655350792
Kamthi,Carrot,2015,936,2328,1392,148.71794871794873
Pune,Sweet Potato,2016,1431,2823,1392,97.27463312368972
Sinner,Gram,2015,2551,3943,1392,54.56683653469228
Phaltan,Onion,2014,400,1792,1392,348.0
Lonand,Gram,2015,2683,4075,1392,51.882221393961984
Pune,Mango(Raw),2015,2791,4182,1391,49.83876746685776
Pune-Manjri,Hemp,2014,0,1391,1391,inf
Purna,Pigeon Pea (Tur),2015,4603,5994,1391,30.219422116011298
Vadgaon Peth,Green Chilli,2015,1490,2881,1391,93.35570469798658
Sangali,Jaggery,2014,2406,3797,1391,57.813798836242725
Nagpur,Pineapple,2015,1000,2391,1391,139.1
Ausa,Pigeon Pea (Tur),2015,8900,10290,1390,15.617977528089888
Pune,Small Gourd,2014,1080,2470,1390,128.7037037037037
Aurangabad,Bor,2015,805,2195,1390,172.67080745341616
Varud-Rajura Bazar,Gram,2016,6996,8386,1390,19.868496283590623
Pune,Tomato,2015,865,2255,1390,160.6936416184971
Mehkar,Green Gram,2015,6672,8061,1389,20.818345323741006
Latur,Pigeon Pea (Tur),2016,7915,9304,1389,17.548957675300063
Nilanga,Pigeon Pea (Tur),2016,8167,9556,1389,17.007469082894577
Chandrapur-Ganjwad,Coriander  ,2015,2111,3500,1389,65.79819990525817
Kalyan,Custard Apple,2015,2889,4278,1389,48.07892004153686
Vadgaon Peth,Cluster Bean,2016,2278,3667,1389,60.97453906935909
Nandurbar,Shepa,2016,3675,5063,1388,37.7687074829932
Umared,Rice(Paddy-Hus),2016,2125,3513,1388,65.31764705882352
Kolhapur-Laxmipuri,Wheat(Husked),2016,1900,3288,1388,73.05263157894737
Shegaon,Thymol/Lovage,2015,7006,8394,1388,19.811590065658006
Nandgaon Khandeshwar,Pigeon Pea (Tur),2015,7833,9221,1388,17.719902974594664
Akluj,Brinjal,2014,2865,4253,1388,48.446771378708554
Pune-Manjri,Harbara(Pendi),2014,525,1913,1388,264.3809523809524
Phaltan,Gram,2015,3100,4488,1388,44.774193548387096
Karad,Jaggery,2015,2475,3863,1388,56.08080808080808
Kolhapur,Ladies Finger,2015,517,1904,1387,268.27852998065765
Kamthi,Methi (Bhaji),2016,1476,2863,1387,93.97018970189701
Aurangabad,Cluster Bean,2016,3136,4523,1387,44.22831632653061
Kamthi,Spinach,2015,1372,2759,1387,101.0932944606414
Satara,Ginger (Fresh),2016,1538,2925,1387,90.18205461638492
Kamthi,Potato,2015,613,2000,1387,226.26427406199022
Nandgaon,Onion,2015,705,2091,1386,196.59574468085106
Solapur,Bitter Gourd,2015,547,1933,1386,253.382084095064
Jalgaon,Green Gram,2014,5234,6620,1386,26.480703095147113
Sangali,Wheat(Husked),2015,1614,3000,1386,85.8736059479554
Barshi,Green Gram,2014,5126,6512,1386,27.03862660944206
Ahmedpur,BLACK GRAM,2016,4415,5800,1385,31.370328425821064
Mumbai,Pineapple,2016,774,2159,1385,178.9405684754522
Ratanagari,Green Chilli,2016,4577,5962,1385,30.25999563032554
Kamthi,Cabbage,2015,1029,2414,1385,134.59669582118562
Pune,Elephant Root,2015,1540,2925,1385,89.93506493506493
Akole,Onion,2015,200,1585,1385,692.5
Kamthi,Methi (Bhaji),2016,2000,3385,1385,69.25
Yeola,Onion,2015,501,1885,1384,276.24750499001993
Kamthi,Mint,2015,1404,2788,1384,98.57549857549857
Akola,Rice(Paddy-Hus),2016,2631,4015,1384,52.603572786012926
Akola,Pigeon Pea (Tur),2016,7943,9327,1384,17.424147047714968
Osmanabad,Cluster Bean,2015,1033,2417,1384,133.97870280735722
Kamthi,Flower,2016,1643,3027,1384,84.23615337796713
Nashik,Methi (Bhaji),2016,2274,3658,1384,60.861917326297274
Manchar,Carrot,2014,183,1567,1384,756.2841530054645
Shirpur,Onion,2015,313,1696,1383,441.85303514376994
Mumbai,Small Gourd,2015,975,2358,1383,141.84615384615384
Manchar,Methi (Bhaji),2014,670,2053,1383,206.4179104477612
Chopda,BLACK GRAM,2016,3970,5353,1383,34.83627204030227
Dondaicha,Ground Nut Pods (Dry),2016,2465,3847,1382,56.064908722109536
Kamthi,Raddish,2015,682,2064,1382,202.63929618768327
Pune,Ghosali(Bhaji),2016,1836,3218,1382,75.2723311546841
Mangalwedha,Tomato,2016,322,1704,1382,429.1925465838509
Pune-Manjri,Guava,2016,3774,5156,1382,36.61897191308956
Basmat,Turmeric,2015,7800,9181,1381,17.705128205128204
Pune,Ghevda,2016,1404,2785,1381,98.36182336182337
Kalyan,Small Gourd,2016,2515,3896,1381,54.910536779324055
Solapur,Ghevda,2016,1629,3010,1381,84.77593615715163
Kille Dharur,Pigeon Pea (Tur),2016,7380,8761,1381,18.712737127371273
Washim,Black Gram,2015,8624,10005,1381,16.013450834879407
Osmanabad,Flower,2014,1169,2550,1381,118.13515825491874
Nashik,Carrot,2016,2118,3498,1380,65.15580736543909
Nashik,Coriander  ,2015,220,1600,1380,627.2727272727273
Kamthi,Cucumber,2016,1260,2640,1380,109.52380952380952
Pune,Ghosali(Bhaji),2016,1950,3330,1380,70.76923076923077
Solapur,Mosambi,2015,120,1500,1380,1150.0
Nagpur,Maize(Corn.),2016,720,2100,1380,191.66666666666666
Pune,Wal Papdi,2015,1030,2410,1380,133.98058252427185
Chandur Bajar,Pigeon Pea (Tur),2015,5875,7255,1380,23.48936170212766
Jalgaon,Custard Apple,2015,3770,5150,1380,36.60477453580902
Nandurbar,Pigeon Pea (Tur),2016,5924,7304,1380,23.295070898041864
Shirpur,Ground Nut Pods (Dry),2014,3166,4546,1380,43.588123815540115
Pimpalgaon Basawant,Onion,2015,563,1943,1380,245.11545293072825
Jalna,Green Gram,2015,6194,7573,1379,22.26348078785922
Latur,Wheat(Husked),2016,1534,2913,1379,89.89569752281616
Pune,Chavli (Shenga ),2016,1842,3221,1379,74.8642779587405
Kamthi,Capsicum,2016,1148,2526,1378,120.03484320557492
Pandharpur,Capsicum,2015,1078,2456,1378,127.82931354359926
Pune-Manjri,Onion,2015,1222,2600,1378,112.76595744680851
Vadgaon Peth,Ladies Finger,2014,1289,2667,1378,106.90457719162141
Vadgaon Peth,Brinjal,2016,1187,2565,1378,116.09098567818029
Kolhapur,Small Gourd,2015,1922,3300,1378,71.6961498439126
Jalgaon,Ladies Finger,2016,1948,3326,1378,70.73921971252567
Kamthi,Capsicum,2016,922,2300,1378,149.45770065075922
Ahmednagar,Lemon,2015,1867,3244,1377,73.75468666309588
Malegaon,Green Gram,2015,6045,7422,1377,22.779156327543426
Daryapur,Pigeon Pea (Tur),2015,8064,9441,1377,17.075892857142858
Chandrapur-Ganjwad,Coriander  ,2016,1354,2731,1377,101.698670605613
Chandur Bajar,Gram,2015,3220,4596,1376,42.732919254658384
Pune,Chavli (Shenga ),2016,1628,3004,1376,84.52088452088452
Mehkar,Green Gram,2015,6000,7376,1376,22.933333333333334
Kamthi,Cucumber,2016,1284,2660,1376,107.16510903426791
Kamthi,Dhemse,2015,1984,3360,1376,69.35483870967742
Dhamangaon-Rly,Pigeon Pea (Tur),2015,7200,8576,1376,19.11111111111111
Khamgaon,Gram,2016,6390,7766,1376,21.53364632237872
Kamthi,Cabbage,2015,800,2176,1376,172.0
Khed-Chakan,Walvad,2016,2750,4125,1375,50.0
Pune,Double Bee,2015,2250,3625,1375,61.111111111111114
Pune-Manjri,Coriander  ,2016,644,2019,1375,213.50931677018633
Ahmednagar,Ladies Finger,2015,1125,2500,1375,122.22222222222223
Yeola,Onion,2014,287,1662,1375,479.0940766550523
Nagpur,Orange,2015,996,2371,1375,138.05220883534136
Ahmednagar,Ghevda,2015,4000,5375,1375,34.375
Ulhasnagar,Green Gram,2016,8000,9375,1375,17.1875
Risod,Green Gram,2015,6625,8000,1375,20.754716981132077
Shahada,Bajri,2015,1391,2766,1375,98.84974838245866
Akluj,Chillies(Red),2016,3875,5250,1375,35.483870967741936
Chandrapur,Mosambi,2016,1450,2825,1375,94.82758620689656
Daryapur,Pigeon Pea (Tur),2016,4478,5853,1375,30.70567217507816
Ramtek,GARLIC,2016,7125,8500,1375,19.29824561403509
Rahuri,Green Chilli,2015,1800,3175,1375,76.38888888888889
Karad,Garlic,2014,3250,4625,1375,42.30769230769231
Jalna,Pigeon Pea (Tur),2015,5119,6494,1375,26.860714983395194
Nashik,Onion,2015,183,1558,1375,751.3661202185792
Aurangabad,Cluster Bean,2015,3425,4800,1375,40.14598540145985
Balapur,Gram,2016,4875,6250,1375,28.205128205128204
Koregaon,Onion,2014,575,1950,1375,239.1304347826087
Ahmednagar,Green Gram,2014,6645,8020,1375,20.692249811888637
Jalgaon,Mosambi,2015,1650,3025,1375,83.33333333333333
Malegaon (Washim),Green Gram,2015,8000,9375,1375,17.1875
Karad,Ginger (Fresh),2014,3167,4542,1375,43.416482475528895
Nashik,Mango(Raw),2016,2063,3438,1375,66.65050896752302
Jalgaon,CHAVLI (SHENGA ),2016,1950,3325,1375,70.51282051282051
Satara,Pavtta,2016,5000,6375,1375,27.5
Satara,Ginger (Fresh),2014,3438,4813,1375,39.99418266433973
Mangaon(Bhadav),Nachani,2015,1325,2700,1375,103.77358490566037
Pune-Manjri,Green Chilli,2015,2117,3492,1375,64.95040151157298
Mumbai,Small Gourd,2015,1133,2507,1374,121.27096204766107
Aurangabad,Mosambi,2015,1139,2513,1374,120.63213345039509
Jalna,Pigeon Pea (Tur),2016,6848,8222,1374,20.064252336448597
Pune-Manjri,Chavli (Shenga ),2014,1088,2462,1374,126.28676470588235
Solapur,Green Gram,2014,5179,6553,1374,26.530218188839545
Pune,Pavtta,2016,2091,3465,1374,65.71018651362984
Kamthi,Coriander  ,2015,1771,3145,1374,77.58328627893846
Nashik,Ghosali(Bhaji),2016,1505,2879,1374,91.29568106312293
Devala,Onion,2015,1005,2379,1374,136.71641791044777
Pune,Onion,2015,591,1964,1373,232.3181049069374
Vadgaon Peth,Capsicum,2014,1736,3109,1373,79.08986175115207
Phaltan,Sorgum(Jawar),2015,1575,2948,1373,87.17460317460318
Aurangabad,Green Chilli,2014,2036,3409,1373,67.43614931237721
Solapur,Bitter Gourd,2015,1429,2802,1373,96.08117564730581
Karmala,Sorgum(Jawar),2016,1643,3015,1372,83.50578210590383
Pune-Manjri,Chavli (Shenga ),2015,1094,2466,1372,125.41133455210237
Khed-Chakan,Cluster Bean,2016,2700,4072,1372,50.81481481481482
Ambad(Vadi Godri),Wheat(Husked),2016,1512,2884,1372,90.74074074074075
Beed,Pigeon Pea (Tur),2015,7545,8917,1372,18.184227965540092
Kamthi,Guava,2016,1271,2643,1372,107.94649881982691
Aurangabad,Lemon,2016,2736,4108,1372,50.146198830409354
Manchar,Methi (Bhaji),2015,844,2216,1372,162.55924170616115
Rahuri,Ground Nut Pods (Dry),2015,2144,3516,1372,63.992537313432834
Mumbai,Split Black Gram,2016,13938,15310,1372,9.843593054957669
Pune,Bitter Gourd,2015,2500,3871,1371,54.84
Pune-Moshi,Garlic,2016,4000,5371,1371,34.275
Akluj,Chikoo,2016,1429,2800,1371,95.94121763470959
Mumbai,Brinjal,2015,1148,2519,1371,119.42508710801394
Rahata,Onion,2015,315,1685,1370,434.92063492063494
Hingoli,Pigeon Pea (Tur),2015,8135,9505,1370,16.84081130915796
Sangamner,Gram,2016,7610,8980,1370,18.00262812089356
Chandrapur-Ganjwad,Coriander  ,2016,930,2300,1370,147.31182795698925
Ausa,Wheat(Husked),2015,1431,2801,1370,95.73724668064291
Ambad(Vadi Godri),Wheat(Husked),2016,1532,2902,1370,89.42558746736293
Pune-Manjri,Ridge Gourd,2015,2415,3785,1370,56.7287784679089
Pune-Manjri,Brinjal,2015,1315,2685,1370,104.18250950570342
Chandvad,Tomato,2015,583,1953,1370,234.99142367066895
Vadgaon Peth,Cucumber,2016,1278,2648,1370,107.19874804381847
Ambejogai,Pigeon Pea (Tur),2016,6824,8194,1370,20.07620164126612
Pune,Parwar,2015,1530,2900,1370,89.54248366013071
Shegaon,Gram,2016,7250,8619,1369,18.882758620689657
Baramati,Onion,2014,363,1732,1369,377.1349862258953
Ausa,Black Gram,2016,5782,7151,1369,23.676928398478037
Barshi,Turmeric,2016,6850,8219,1369,19.985401459854014
Umared,Gram,2015,3625,4994,1369,37.765517241379314
Nagpur,Orange,2016,858,2227,1369,159.55710955710956
Kamthi,Kanda Pat,2015,831,2200,1369,164.74127557160048
Kamthi,Chavli (Shenga ),2015,1947,3316,1369,70.31330251669235
Kamthi,Flower,2015,626,1994,1368,218.5303514376997
Latur,Wheat(Husked),2015,1525,2893,1368,89.70491803278688
Ratanagari,Tomato,2016,2237,3605,1368,61.153330353151546
Kamthi,Kanda Pat,2015,804,2172,1368,170.1492537313433
Indapur-Bhigwan,Ground Nut Pods (Dry),2015,3913,5281,1368,34.96038844876054
Kamthi,Dhemse,2015,1000,2368,1368,136.8
Pune,Green Chilli,2015,1233,2600,1367,110.86780210867802
Kurdwadi-Modnimb,Pigeon Pea (Tur),2015,3900,5267,1367,35.05128205128205
Kamthi,Green-Peas,2016,1500,2867,1367,91.13333333333334
Sinner,Onion,2015,160,1527,1367,854.375
Chandrapur,Mosambi,2015,1633,3000,1367,83.7109614206981
Mumbai,Shevga,2014,4975,6342,1367,27.477386934673365
Mumbai,Mosambi,2015,1000,2367,1367,136.7
Kalyan,Indian Bean,2015,5200,6567,1367,26.28846153846154
Murum,Pigeon Pea (Tur),2015,9161,10528,1367,14.921951751992141
Kamthi,Ladies Finger,2015,1571,2938,1367,87.01464035646086
Hadgaon,Pigeon Pea (Tur),2015,5700,7067,1367,23.982456140350877
Pune,Ground Nut Pods (Dry),2016,2942,4308,1366,46.430999320190345
Chalisgaon,Green Gram,2015,5578,6944,1366,24.48906418070993
Chandur Bajar,Gram,2016,5067,6433,1366,26.95875271363726
Ratanagari,Cucumber,2016,1578,2944,1366,86.56527249683143
Nagpur,Pigeon Pea (Tur),2016,6758,8124,1366,20.213080793134065
Kolhapur,Brinjal,2016,330,1696,1366,413.93939393939394
Dondaicha,Gram,2015,3450,4816,1366,39.594202898550726
Lasalgaon,Onion,2015,1950,3316,1366,70.05128205128206
Kolhapur,Ginger (Fresh),2015,2404,3770,1366,56.82196339434276
Majalgaon,Gram,2016,5430,6796,1366,25.156537753222835
Barshi-Vairag,Pigeon Pea (Tur),2016,7311,8676,1365,18.670496512105046
Mandhal,Chillies(Red),2015,3212,4577,1365,42.49688667496887
Aurangabad,Lemon,2016,2585,3950,1365,52.804642166344294
Satana,Gram,2016,5335,6700,1365,25.585754451733834
Pune,Cucumber,2016,861,2226,1365,158.53658536585365
Chandrapur-Ganjwad,Tomato,2016,1885,3250,1365,72.41379310344827
Pune,Small Gourd,2015,975,2340,1365,140.0
Pune-Manjri,Brinjal,2015,1486,2850,1364,91.79004037685061
Vai,Green Chilli,2016,5818,7182,1364,23.4444826400825
Kada,Sorgum(Jawar),2014,1530,2894,1364,89.15032679738562
Kamthi,Dhemse,2016,1600,2964,1364,85.25
Majalgaon,Sorgum(Jawar),2015,1068,2432,1364,127.71535580524345
Kamthi,Small Gourd,2015,1500,2864,1364,90.93333333333334
Dhule,Ground Nut Pods (Dry),2015,4099,5463,1364,33.27640888021469
Pune,Black Gram,2016,11857,13221,1364,11.503753057265751
Nampur,Gram,2016,4219,5583,1364,32.32993600379237
Akluj,Ladies Finger,2015,2389,3753,1364,57.095018836333196
Sangrampur,Ground Nut Pods (Dry),2015,3543,4907,1364,38.49844764324019
Chandvad,Onion,2015,203,1566,1363,671.4285714285714
Mukhed,Black Gram,2015,7101,8464,1363,19.194479650753415
Kille Dharur,Pigeon Pea (Tur),2016,6651,8014,1363,20.493158923470155
Hinganghat,Pigeon Pea (Tur),2015,5639,7002,1363,24.170952296506474
Mumbai-Fruit Market,Pineapple,2016,964,2327,1363,141.39004149377593
Kolhapur,Capsicum,2015,610,1973,1363,223.44262295081967
Jamkhed,Onion,2015,106,1469,1363,1285.8490566037735
Shrigonda,Gram,2016,5325,6688,1363,25.5962441314554
Sangrampur-Varvatbakal,Gram,2016,5525,6888,1363,24.669683257918553
Karad,Mosambi,2014,3682,5045,1363,37.01792504073873
Pune-Manjri,Bitter Gourd,2014,2553,3916,1363,53.388170779475125
Osmanabad,Lemon,2016,1613,2975,1362,84.43893366398017
Malegaon (Washim),Black Gram,2015,10063,11425,1362,13.53473119348107
Pune-Pimpri,Green Chilli,2014,2694,4056,1362,50.55679287305122
Chandur Bajar,Pigeon Pea (Tur),2016,7780,9142,1362,17.506426735218508
Parner,Onion,2015,567,1929,1362,240.2116402116402
Barshi-Vairag,Green Gram,2014,4851,6213,1362,28.076685219542362
Lasur Station,GRAM,2016,6473,7834,1361,21.025799474741234
Mumbai,Coconut,2015,822,2183,1361,165.57177615571777
Kada,Sorgum(Jawar),2014,1530,2891,1361,88.95424836601308
Shrigonda,Onion,2016,222,1583,1361,613.063063063063
Kamthi,Papai,2016,600,1960,1360,226.66666666666666
Osmanabad,Kharbuj,2016,2400,3760,1360,56.666666666666664
Kolhapur,Ginger (Fresh),2015,2584,3944,1360,52.63157894736842
Kamthi,Cluster Bean,2016,1540,2900,1360,88.31168831168831
Pune,Green Chilli,2014,1460,2820,1360,93.15068493150685
Satara,Shevga,2015,4270,5630,1360,31.850117096018735
Jalgaon,Grapes,2015,2840,4200,1360,47.88732394366197
Barshi,Sorgum(Jawar),2014,1194,2554,1360,113.90284757118928
Mangalwedha,CUCUMBER,2016,294,1654,1360,462.5850340136054
Pune-Manjri,RADDISH,2016,874,2234,1360,155.60640732265446
Kamthi,Orange,2015,640,2000,1360,212.5
Hinganghat,Pigeon Pea (Tur),2016,7016,8376,1360,19.384264538198405
Kalyan,Green Chilli,2016,5940,7300,1360,22.895622895622896
Jalgaon,Brinjal,2016,818,2177,1359,166.13691931540342
Tumsar,Rice(Paddy-Hus),2014,2036,3395,1359,66.74852652259332
Pune,Capsicum,2015,1009,2368,1359,134.68780971258673
Solapur,Green Gram,2014,5813,7172,1359,23.378634095991742
Pune,Carrot,2016,1086,2445,1359,125.13812154696133
Pune,Green Chilli,2015,1650,3008,1358,82.3030303030303
Manwat,Ground Nut Pods (Dry),2016,4000,5358,1358,33.95
Manchar,Green Chilli,2016,2217,3575,1358,61.25394677492106
Chandrapur,Chikoo,2016,1021,2379,1358,133.00685602350637
Nashik,Wal Papdi,2015,1167,2525,1358,116.36675235646958
Aurangabad,Mosambi,2016,1319,2677,1358,102.95678544351782
Hinganghat,Pigeon Pea (Tur),2016,7944,9302,1358,17.094662638469284
Nandura,Pigeon Pea (Tur),2015,5362,6720,1358,25.326370757180158
Pune-Pimpri,Onion,2015,3216,4574,1358,42.22636815920398
Chopda,Soybean,2015,2286,3643,1357,59.36132983377078
Sakri,Ground Nut Pods (Dry),2015,2861,4218,1357,47.43096819293953
Pune,Snake Gourd,2016,1107,2464,1357,122.58355916892502
Akluj,Tomato,2015,1679,3036,1357,80.82191780821918
Mangrulpeer,Black Gram,2016,5734,7091,1357,23.665852807813046
Karad,Pomegranate,2015,3857,5214,1357,35.182784547575835
Ambejogai,Pigeon Pea (Tur),2015,6986,8343,1357,19.424563412539364
Pune,Chavli (Shenga ),2014,1344,2700,1356,100.89285714285714
Akluj,Chikoo,2016,1213,2569,1356,111.78895300906842
Kolhapur,Ladies Finger,2015,465,1821,1356,291.61290322580646
Mangalwedha,Bitter Gourd,2014,2112,3468,1356,64.20454545454545
Devala,Onion,2015,954,2310,1356,142.13836477987422
Dhule,Ground Nut Pods (Dry),2016,4315,5671,1356,31.425260718424102
Kamthi,Papai,2015,700,2056,1356,193.71428571428572
Mumbai,Spilt Gerrn Gram,2015,8364,9720,1356,16.212338593974174
Chandrapur,Mosambi,2014,1627,2982,1355,83.28211432083589
Basmat,Turmeric,2016,6708,8063,1355,20.199761478831245
Partur,Pigeon Pea (Tur),2015,8115,9470,1355,16.69747381392483
Sangamner,GRAM,2016,7244,8599,1355,18.705135284373274
Dondaicha,Gram,2015,3161,4516,1355,42.86618158810503
Sinner,Gram,2014,1992,3347,1355,68.02208835341365
Sinner,Matki,2016,6143,7498,1355,22.057626566824027
Kolhapur,Papai,2015,338,1692,1354,400.5917159763314
Mumbai,Coconut,2015,669,2023,1354,202.3916292974589
Latur,Wheat(Husked),2016,1518,2872,1354,89.19631093544137
Kamthi,Onion,2015,654,2008,1354,207.03363914373088
Nagpur,Pigeon Pea (Tur),2016,7521,8875,1354,18.00292514293312
Pune,Green Gram,2014,7346,8700,1354,18.431799618840184
Nashik,Banana,2016,1264,2618,1354,107.12025316455696
Mangalwedha,Tomato,2015,253,1607,1354,535.1778656126482
Murtizapur,Green Gram,2015,6367,7721,1354,21.265902308779644
Pune,Cucumber,2014,814,2167,1353,166.21621621621622
Baramati,Onion,2015,445,1798,1353,304.0449438202247
Pathari,Pigeon Pea (Tur),2016,7010,8363,1353,19.300998573466476
Kamthi,Lemon,2016,1894,3247,1353,71.43611404435057
Indapur-Bhigwan,Chillies(Red),2015,8775,10128,1353,15.418803418803419
Sangamner,Onion,2016,500,1853,1353,270.6
Kamthi,Flower,2016,1004,2356,1352,134.6613545816733
Jalgaon,Bitter Gourd,2016,3587,4939,1352,37.691664343462506
Pune-Manjri,Brinjal,2015,1148,2500,1352,117.77003484320558
Jintur,Gram,2016,7400,8752,1352,18.27027027027027
Manmad,Onion,2014,356,1708,1352,379.7752808988764
Nagpur,Grapes,2014,2211,3563,1352,61.14880144730891
Pune,Pavtta,2014,1780,3132,1352,75.95505617977528
Pune,Ridge Gourd,2015,1511,2863,1352,89.47716743878226
Pune-Moshi,Capsicum,2016,2959,4310,1351,45.65731666103413
Dhule,Gram,2016,4323,5674,1351,31.251445755262548
Pune-Manjri,Goosefoot,2016,0,1350,1350,inf
Ahmednagar,Ladies Finger,2015,1338,2688,1350,100.89686098654708
Rahuri-Vambori,Onion,2015,100,1450,1350,1350.0
Akkolkot,BLACK GRAM,2016,5025,6375,1350,26.865671641791046
Purna,Turmeric,2016,6905,8255,1350,19.551049963794352
Kolhapur,Raddish,2015,600,1950,1350,225.0
Koregaon,Ghevda Seed,2015,4140,5490,1350,32.608695652173914
Pune-Manjri,Kardai,2015,0,1350,1350,inf
Rahuri,BRINJAL,2016,194,1544,1350,695.8762886597938
Latur,Coriander (Dry),2016,4800,6150,1350,28.125
Ausa,Coriander (Dry),2015,5651,7001,1350,23.889577066006016
Sangali,Wheat(Husked),2015,1650,3000,1350,81.81818181818181
Amalner,Coriander (Dry),2015,7750,9100,1350,17.419354838709676
Solapur,Matki,2015,6583,7933,1350,20.50736746164363
Pune,Curry Leaves,2016,1650,3000,1350,81.81818181818181
Pune-Manjri,Ambat Chuka,2015,0,1350,1350,inf
Lasalgaon,Green Gram,2015,5413,6763,1350,24.93995935710327
Kamthi,Ladies Finger,2016,2088,3438,1350,64.65517241379311
Pathardi,Gram,2016,5357,6707,1350,25.20067201792048
Solapur,Ridge Gourd,2016,650,2000,1350,207.69230769230768
Kolhapur,Green Chilli,2015,607,1957,1350,222.40527182866558
Osmanabad,Grapes,2016,1250,2600,1350,108.0
Nashik,Cluster Bean,2015,4075,5425,1350,33.12883435582822
Akluj,Chillies(Red),2015,2250,3600,1350,60.0
Pune,Green Chilli,2014,1521,2871,1350,88.75739644970415
Devala,Sweet Potato,2015,800,2150,1350,168.75
Pune-Manjri,Cucumber,2016,1400,2750,1350,96.42857142857143
Kamthi,Mint,2015,1075,2425,1350,125.5813953488372
Palus,Ginger (Fresh),2016,2333,3683,1350,57.86540934419203
Manchar,Green Chilli,2016,4500,5850,1350,30.0
Vadgaon Peth,Brinjal,2014,1443,2793,1350,93.55509355509355
Jalgaon,Mosambi,2014,1250,2600,1350,108.0
Kolhapur,Jaggery,2014,2513,3862,1349,53.6808595304417
Shirpur,Ground Nut Pods (Dry),2016,3531,4879,1348,38.17615406400453
Pune,Onion,2014,681,2029,1348,197.94419970631424
Shirpur,GRAM,2016,7977,9325,1348,16.898583427353643
Kamthi,Small Gourd,2016,696,2044,1348,193.67816091954023
Mumbai,SPLIT LENTIL,2016,5404,6752,1348,24.944485566247224
Kamthi,Parwar,2016,1039,2387,1348,129.74013474494706
Karmala,Black Gram,2016,5988,7336,1348,22.511690046760187
Nagpur,Pineapple,2014,1033,2381,1348,130.49370764762827
Beed,Gram,2015,3239,4587,1348,41.617783266440256
Jalgaon,Ginger (Fresh),2015,1947,3295,1348,69.2347200821777
Karad,Garlic,2016,7935,9283,1348,16.988027725267802
Kurdwadi,Onion,2015,596,1943,1347,226.00671140939596
Barshi-Vairag,Ground Nut Pods (Dry),2015,3683,5030,1347,36.57344556068423
Ahmednagar,Squash Gourd,2016,486,1833,1347,277.1604938271605
Solapur,Onion,2016,96,1443,1347,1403.125
Mumbai,Ginger (Dry),2016,2138,3485,1347,63.00280636108513
Kamthi,Dhemse,2015,1020,2367,1347,132.05882352941177
Pune,Ginger (Fresh),2016,1138,2485,1347,118.36555360281196
Shirpur,Ground Nut Pods (Dry),2014,3466,4813,1347,38.86324293133295
Gevrai,Gram,2016,6991,8337,1346,19.253325704477184
Ulhasnagar,Other Vegetables,2016,987,2333,1346,136.37284701114487
Nashik,Ghevda,2015,2728,4074,1346,49.34017595307918
Pune-Manjri,Bitter Gourd,2016,3231,4577,1346,41.65892912411018
Kamthi,Carrot,2015,1519,2865,1346,88.61092824226465
Sangali,Wheat(Husked),2015,1669,3015,1346,80.64709406830437
Hinganghat,Gram,2016,4435,5781,1346,30.349492671927848
Ausa,Green Gram,2014,5301,6647,1346,25.391435578192795
Akluj,Bitter Gourd,2014,2122,3467,1345,63.38360037700283
Kamthi,Mango,2016,1200,2545,1345,112.08333333333333
Jalgaon,Green Chilli,2015,1361,2706,1345,98.8243938280676
Ambad(Vadi Godri),Pigeon Pea (Tur),2015,7422,8767,1345,18.12180005389383
Pune-Manjri,Walvad,2015,1700,3045,1345,79.11764705882354
Mangaon(Bhadav),Nagali,2015,1300,2645,1345,103.46153846153847
Ahmednagar,Onion,2015,114,1459,1345,1179.8245614035088
Taloda,Pigeon Pea (Tur),2015,4736,6081,1345,28.399493243243242
Kamthi,Mint,2016,1915,3259,1344,70.18276762402088
Sangamner,Onion,2015,500,1844,1344,268.8
Dondaicha,Gram,2016,4751,6095,1344,28.288781309198065
Shahada,Gram,2016,4791,6135,1344,28.052598622417033
Solapur,Bor,2015,548,1892,1344,245.25547445255475
Nashik,Wal Papdi,2016,3333,4677,1344,40.324032403240324
Akot,Pigeon Pea (Tur),2016,7780,9124,1344,17.275064267352185
Aurangabad,Fig,2015,3906,5250,1344,34.40860215053763
Tumsar,Rice(Paddy-Hus),2016,1858,3202,1344,72.33584499461787
Majalgaon,Sorgum(Jawar),2014,1126,2470,1344,119.36056838365897
Osmanabad,Chikoo,2014,1043,2386,1343,128.76318312559923
Karad,Grapes,2015,1767,3110,1343,76.00452744765138
Ambad(Vadi Godri),Gram,2016,6000,7343,1343,22.383333333333333
Shirpur,Ground Nut Pods (Dry),2015,3517,4860,1343,38.18595393801535
Ahmednagar,Brinjal,2015,471,1814,1343,285.1380042462845
Sakri,Ground Nut Pods (Dry),2016,4357,5700,1343,30.823961441358733
Kamthi,Beet Root,2016,1621,2964,1343,82.85009253547193
Mangaon(Bhadav),Nagali,2014,1457,2800,1343,92.17570350034318
Solapur,Ladies Finger,2016,277,1619,1342,484.4765342960289
Pune,GHEVDA,2016,1450,2792,1342,92.55172413793103
Pune,Double Bee,2015,1732,3074,1342,77.48267898383372
Umarga,Green Gram,2015,7617,8959,1342,17.618484967835105
Aurangabad,Fig,2015,2447,3789,1342,54.842664487127095
Sangali,Lentil,2015,5942,7283,1341,22.568158869067656
Sinner,Onion,2014,320,1661,1341,419.0625
Barshi,Capsicum,2016,2228,3569,1341,60.18850987432675
Dhule,Green Gram,2016,3685,5026,1341,36.39077340569878
Sakri,Gram,2016,4115,5456,1341,32.58809234507898
Pune,Dhemse,2015,1078,2419,1341,124.39703153988869
Varud-Rajura Bazar,Pigeon Pea (Tur),2016,7360,8701,1341,18.220108695652176
Tuljapur,Black Gram,2016,5495,6836,1341,24.40400363967243
Dhule,Black Gram,2016,6701,8041,1340,19.997015370840174
Lasalgaon,Ground Nut Pods (Dry),2015,3329,4669,1340,40.25232802643436
Jalgaon,Green Chilli,2015,1270,2610,1340,105.51181102362204
Sengaon,Black Gram,2015,7235,8575,1340,18.52107809260539
Pune,Onion,2014,685,2025,1340,195.62043795620437
Nagpur,Pineapple,2015,1020,2360,1340,131.37254901960785
Mumbai,Split Lentil,2016,5705,7045,1340,23.488168273444348
Kamthi,Lemon,2015,1410,2750,1340,95.0354609929078
Kalyan,Matki,2015,6560,7900,1340,20.426829268292682
Vadgaon Peth,Pavtta,2016,1910,3250,1340,70.15706806282722
Pune,Squash Gourd,2016,843,2183,1340,158.95610913404508
Pune,Bitter Gourd,2014,2384,3724,1340,56.20805369127517
Nashik,Brinjal,2016,2257,3597,1340,59.37084625609216
Hinganghat,Pigeon Pea (Tur),2015,6152,7492,1340,21.7815344603381
Aurangabad,Jambhul,2015,2938,4277,1339,45.575221238938056
Jintur,Turmeric,2014,4293,5632,1339,31.190309806662007
Nashik,BANANA,2016,1069,2408,1339,125.25724976613658
Pimpalgaon Basawant,Onion,2015,372,1711,1339,359.9462365591398
Lasalgaon,Ground Nut Pods (Dry),2015,3686,5024,1338,36.299511665762346
Kolhapur,Brinjal,2015,391,1729,1338,342.1994884910486
Vadgaon Peth,Flower,2015,755,2093,1338,177.2185430463576
Sangali,Wheat(Husked),2015,1614,2952,1338,82.8996282527881
Pune-Manjri,PAVTTA,2016,2693,4031,1338,49.68436687708875
Lasur Station,Onion,2015,175,1513,1338,764.5714285714286
Sangrampur,Gram,2016,5350,6688,1338,25.009345794392523
Pune,Capsicum,2015,1833,3171,1338,72.99509001636662
Kolhapur,Papai,2015,366,1703,1337,365.30054644808746
Akkolkot,Sorgum(Jawar),2014,1063,2400,1337,125.7761053621825
Pune,Black Gram,2016,12745,14082,1337,10.490388387602982
Akluj,Chillies(Red),2015,1974,3311,1337,67.73049645390071
Ambad(Vadi Godri),Green Gram,2015,6601,7938,1337,20.254506892895016
Daryapur,Black Gram,2014,4026,5362,1336,33.18430203676105
Jamkhed,Sorgum(Jawar),2014,1800,3136,1336,74.22222222222223
Kolhapur,Bor,2016,487,1823,1336,274.33264887063655
Mandhal,Chillies(Red),2015,4622,5958,1336,28.90523582864561
Malegaon,Gram,2014,2028,3364,1336,65.87771203155819
Pune,Walvad,2014,1790,3125,1335,74.58100558659218
Karmala,Sorgum(Jawar),2015,1620,2955,1335,82.4074074074074
Pune-Manjri,Methi (Bhaji),2015,930,2265,1335,143.5483870967742
Indapur,Onion,2015,112,1447,1335,1191.9642857142858
Malkapur,Green Gram,2014,5429,6764,1335,24.59016393442623
Sailu,Gram,2016,6300,7635,1335,21.19047619047619
Ratanagari,Tomato,2015,1435,2770,1335,93.03135888501743
Satara,Green-Peas,2014,4533,5867,1334,29.42863445841606
Mumbai,Curry Leaves,2015,3083,4417,1334,43.26954265325981
Chimur,Pigeon Pea (Tur),2015,7333,8667,1334,18.191735987999454
Kalyan,Black Gram,2016,10333,11667,1334,12.910093873995935
Jalgaon,Mosambi,2016,1733,3067,1334,76.97634160415464
Aurangabad,Mango(Raw),2016,5333,6667,1334,25.014063378961186
Sinner,Onion,2015,211,1545,1334,632.2274881516588
Shahada,Gram,2016,6666,8000,1334,20.01200120012001
Amarawati,Sesamum,2015,8308,9642,1334,16.056812710640347
Chandrapur,Papai,2016,2583,3917,1334,51.64537359659311
Pune-Manjri,Raddish,2015,833,2167,1334,160.1440576230492
Kolhapur,Bitter Gourd,2016,2833,4167,1334,47.08789269325803
Ahmednagar,LEMON,2016,833,2167,1334,160.1440576230492
Pune-Moshi,Ghosali(Bhaji),2016,3333,4667,1334,40.02400240024002
Solapur,Capsicum,2016,1333,2667,1334,100.07501875468867
Kamthi,Beet Root,2016,1833,3167,1334,72.77686852154937
Jalna,Pigeon Pea (Tur),2016,7593,8927,1334,17.568813380745425
Karad,Garlic,2015,2958,4292,1334,45.09803921568628
Kamthi,Onion,2015,1619,2952,1333,82.33477455219271
Kalyan,Chillies(Red),2016,6667,8000,1333,19.994000299985
Karad,Green-Peas,2014,3100,4433,1333,43.0
Karad,Mosambi,2015,5000,6333,1333,26.66
Vadgaon Peth,Ridge Gourd,2015,1500,2833,1333,88.86666666666666
Akot,Pigeon Pea (Tur),2015,7667,9000,1333,17.386200599973915
Ahmednagar,Bitter Gourd,2016,5000,6333,1333,26.66
Beed,Pigeon Pea (Tur),2015,7742,9075,1333,17.217773185223457
Ratanagari,Capsicum,2016,2700,4033,1333,49.370370370370374
Kamthi,Amla,2015,1000,2333,1333,133.3
Ramtek,Garlic,2015,6667,8000,1333,19.994000299985
Jamkhed,Sorgum(Jawar),2015,1769,3102,1333,75.35330695308083
Murum,Black Gram,2016,6036,7369,1333,22.08416169648774
Kamthi,Jack Fruit(Raw),2015,667,2000,1333,199.85007496251873
Nashik,Ladies Finger,2015,1334,2667,1333,99.92503748125937
Pune-Manjri,Chavli (Shenga ),2015,1500,2833,1333,88.86666666666666
Dhule,Horse Gram,2015,1670,3003,1333,79.82035928143712
Ahmednagar,Ginger (Fresh),2016,1667,3000,1333,79.96400719856028
Mumbai,Fennel,2015,14667,16000,1333,9.088429808413444
Bhiwapur,Orange,2014,2000,3333,1333,66.65
Kamthi,Papai,2015,667,2000,1333,199.85007496251873
Khed-Chakan,Shevga,2016,5146,6479,1333,25.903614457831324
Manchar,Cluster Bean,2016,1500,2833,1333,88.86666666666666
Balapur,Black Gram,2015,5000,6333,1333,26.66
Kamthi,Raddish,2015,738,2071,1333,180.62330623306232
Ahmednagar,Capsicum,2016,2067,3400,1333,64.4895984518626
Kolhapur-Malkapur,Ladies Finger,2016,1000,2333,1333,133.3
Pune,Wal Papdi,2015,1328,2661,1333,100.37650602409639
Barshi,Tamarind,2015,5190,6522,1332,25.664739884393065
Nashik,Ghevda,2016,2284,3616,1332,58.31873905429072
Pune,Tomato,2015,809,2141,1332,164.64771322620518
Pune,Snake Gourd,2016,1668,3000,1332,79.85611510791367
Kamthi,Cluster Bean,2016,1012,2344,1332,131.62055335968378
Koregaon,Onion,2015,836,2168,1332,159.33014354066987
Pune,Ghosali(Bhaji),2016,1605,2936,1331,82.92834890965732
Jalna,Sorgum(Jawar),2015,1147,2478,1331,116.04184829991281
Ramtek,Coriander  ,2016,5772,7103,1331,23.05959805959806
Kamthi,Ladies Finger,2015,1390,2721,1331,95.75539568345324
Lasur Station,Gram,2016,6384,7715,1331,20.848997493734334
Ulhasnagar,Other Cereals,2016,1720,3050,1330,77.32558139534883
Rahata,Potato,2015,1000,2330,1330,133.0
Manora,Black Gram,2016,5925,7255,1330,22.447257383966246
Dondaicha,Gram,2016,3416,4746,1330,38.9344262295082
Dhule,Gram,2016,4694,6024,1330,28.334043459735835
Solapur,Mula Shenga,2015,1176,2506,1330,113.0952380952381
Sangli-Phale Bhajipalam,Water Melon,2016,83,1413,1330,1602.4096385542168
Aurangabad,Garlic,2014,990,2320,1330,134.34343434343435
Latur,Pigeon Pea (Tur),2016,5991,7321,1330,22.199966616591553
Basmat,TURMERIC,2016,7113,8443,1330,18.69815830170111
Sonpeth,Cotton,2016,3417,4747,1330,38.923031899326894
Mumbai,Spilt Pigeon Pea,2014,6107,7437,1330,21.77828721139676
Sangali,Wheat(Husked),2015,1700,3029,1329,78.17647058823529
Dondaicha,Sorgum(Jawar),2016,1636,2965,1329,81.23471882640587
Dhule,Gram,2015,3691,5020,1329,36.006502302898944
Latur,Wheat(Husked),2016,1537,2866,1329,86.46714378659726
Amarawati-Fruit And Vegetables,Lemon,2016,2147,3476,1329,61.900326036329766
Kurdwadi-Modnimb,Sorgum(Jawar),2015,1071,2400,1329,124.08963585434174
Nashik-Devlali,Kanda Pat,2016,2449,3777,1328,54.22621478154349
Solapur,Green Chilli,2014,1331,2659,1328,99.77460555972952
Chalisgaon,Tomato,2016,1953,3281,1328,67.99795186891961
Lasalgaon-Niphad,Onion,2015,1016,2344,1328,130.70866141732284
Akluj,Chikoo,2015,1900,3227,1327,69.84210526315789
Chopda,Soybean,2015,2325,3652,1327,57.075268817204304
Nagpur,Mango,2016,2824,4151,1327,46.99008498583569
Basmat,Turmeric,2015,7811,9138,1327,16.988861861477403
Malkapur,Pigeon Pea (Tur),2014,3734,5061,1327,35.5382967327263
Pune,Ginger (Fresh),2016,1081,2407,1326,122.66419981498612
Pune,Shevga,2016,1770,3096,1326,74.91525423728814
Udgir,Pigeon Pea (Tur),2015,5000,6326,1326,26.52
Mangalwedha,Gram,2016,7043,8369,1326,18.827204316342467
Pune-Manjri,Onion,2015,1209,2535,1326,109.6774193548387
Pune-Manjri,Ambat Chuka,2016,0,1326,1326,inf
Jalgaon,Chavli (Shenga ),2016,3087,4413,1326,42.95432458697765
Kamthi,Brinjal,2016,1561,2887,1326,84.94554772581678
Jalgaon,Mosambi,2014,1125,2450,1325,117.77777777777777
Kolhapur,Pineapple,2015,706,2031,1325,187.67705382436262
Kolhapur,Small Gourd,2015,1300,2625,1325,101.92307692307692
Vasai,Tomato,2014,1275,2600,1325,103.92156862745098
Ahmednagar,Onion,2016,100,1425,1325,1325.0
Nashik,Mosambi,2015,758,2083,1325,174.80211081794195
Nandgaon,Ground Nut Pods (Dry),2015,3799,5124,1325,34.877599368254806
Barshi,Chikoo,2016,1645,2970,1325,80.54711246200608
Ahmednagar,Bottle Gourd,2016,500,1825,1325,265.0
Shrirampur,Onion,2015,209,1534,1325,633.9712918660288
Sinner,Gram,2016,6004,7329,1325,22.068620919387076
Sonpeth,Pigeon Pea (Tur),2015,5625,6950,1325,23.555555555555557
Chikhali,Green Gram,2014,5926,7250,1324,22.34222072224097
Kolhapur-Laxmipuri,Spilt Gerrn Gram,2015,10181,11505,1324,13.004616442392692
Nashik,Squash Gourd,2015,765,2089,1324,173.0718954248366
Jamkhed,Sorgum(Jawar),2015,1626,2950,1324,81.42681426814268
Akot,Green Gram,2016,5357,6681,1324,24.715325742019786
Osmanabad,Lemon,2016,1126,2450,1324,117.58436944937833
Akluj,Ladies Finger,2016,1883,3206,1323,70.26022304832713
Pune-Manjri,Ladies Finger,2016,2562,3885,1323,51.63934426229508
Ratanagari,Ladies Finger,2016,2559,3882,1323,51.69988276670574
Sonpeth,Cotton,2016,3579,4902,1323,36.96563285834032
Jamkhed,Sorgum(Jawar),2015,1606,2929,1323,82.3785803237858
Vasai,Wheat(Husked),2015,1519,2842,1323,87.09677419354838
Devani,BLACK GRAM,2016,5621,6944,1323,23.536737235367372
Akluj,Carrot,2016,1308,2631,1323,101.14678899082568
Mangalwedha,Green Chilli,2015,2574,3896,1322,51.35975135975136
Hingoli,Pigeon Pea (Tur),2015,8447,9769,1322,15.650526814253581
Kada,Green Gram,2014,5169,6491,1322,25.575546527374733
Bhokar,Black Gram,2015,7072,8394,1322,18.693438914027148
Dondaicha,Ground Nut Pods (Dry),2015,3200,4522,1322,41.3125
Latur,Wheat(Husked),2015,1495,2816,1321,88.36120401337793
Pune,Green Chilli,2015,1492,2813,1321,88.53887399463807
Mumbai,Green Peas (Dry),2015,2608,3929,1321,50.65184049079755
Mangrulpeer,Black Gram,2015,7592,8913,1321,17.399894625922023
Osmanabad,Cucumber,2016,750,2071,1321,176.13333333333333
Jamkhed,Sorgum(Jawar),2015,1603,2924,1321,82.40798502807236
Kopargaon,Onion,2014,261,1582,1321,506.13026819923374
Chandvad,Onion,2015,238,1559,1321,555.0420168067227
Partur,Sorgum(Jawar),2014,1494,2814,1320,88.35341365461848
Mangaon(Bhadav),Nagali,2015,1320,2640,1320,100.0
Akluj,Carrot,2016,1650,2970,1320,80.0
Kamthi,Mint,2016,1813,3133,1320,72.80750137892996
Phaltan,Gram,2015,3100,4420,1320,42.58064516129032
Kamthi,Mosambi,2016,2300,3620,1320,57.391304347826086
Kamthi,Coriander  ,2016,2350,3670,1320,56.170212765957444
Rahuri,Bor,2015,590,1910,1320,223.72881355932202
Kurdwadi-Modnimb,Sorgum(Jawar),2015,1019,2339,1320,129.5387634936212
Pune-Moshi,Cluster Bean,2016,2983,4303,1320,44.25075427422058
Mumbai,Ginger (Dry),2014,3088,4408,1320,42.74611398963731
Barshi,Black Gram,2014,4956,6276,1320,26.634382566585955
Rahata,Tomato,2015,710,2030,1320,185.91549295774647
Palus,Green Chilli,2016,2740,4060,1320,48.175182481751825
Beed,Green Gram,2015,6000,7320,1320,22.0
Chopda,Gram,2016,6929,8249,1320,19.050368018473083
Pandharpur,Onion,2016,71,1390,1319,1857.7464788732395
Sangli-Phale Bhajipalam,Pineapple,2016,231,1550,1319,570.995670995671
Manchar,Squash Gourd,2016,2481,3800,1319,53.164046755340586
Kada,Black Gram,2014,4688,6007,1319,28.13566552901024
Karad,Mango,2016,3806,5125,1319,34.65580662112454
Indapur,Ground Nut Pods (Dry),2015,4142,5461,1319,31.84451955577016
Akot,Black Gram,2016,8719,10038,1319,15.127881637802501
Pune,Walvad,2015,2595,3914,1319,50.82851637764933
Mehkar,Gram,2016,6272,7591,1319,21.02997448979592
Akluj,Chikoo,2016,1657,2976,1319,79.6016898008449
Katol,Pigeon Pea (Tur),2016,7306,8624,1318,18.039967150287435
Indapur,Ground Nut Pods (Dry),2015,3571,4889,1318,36.90842901148138
Akluj,Chillies(Red),2015,2318,3636,1318,56.85936151855047
Majalgaon,Green Gram,2015,5863,7181,1318,22.47995906532492
Pune,Green Chilli,2015,1423,2741,1318,92.62122276879832
Kurdwadi,Onion,2015,100,1418,1318,1318.0
Kamthi,Capsicum,2016,773,2091,1318,170.5045278137128
Shahada,Gram,2015,2703,4021,1318,48.7606363300037
Jalgaon,CUSTARD APPLE,2016,1282,2600,1318,102.80811232449298
Kolhapur,Ginger (Fresh),2016,2290,3608,1318,57.55458515283843
Navapur,Tomato,2016,2182,3500,1318,60.40329972502291
Pune-Manjri,Harbara(Pendi),2015,840,2157,1317,156.78571428571428
Kamthi,Orange,2014,2100,3417,1317,62.714285714285715
Vaijapur,Onion,2014,358,1675,1317,367.877094972067
Pune,Curry Leaves,2016,1461,2778,1317,90.14373716632444
Pune-Manjri,Ladies Finger,2015,1425,2742,1317,92.42105263157895
Lasalgaon-Vinchur,Soybean,2016,2446,3763,1317,53.84300899427637
Nagpur,Pigeon Pea (Tur),2015,5315,6632,1317,24.77892756349953
Pune,Parwar,2016,2000,3316,1316,65.8
Pandharpur,Capsicum,2016,3192,4508,1316,41.228070175438596
Ausa,Gram,2016,5208,6524,1316,25.268817204301076
Akluj,Bitter Gourd,2015,1892,3208,1316,69.55602536997885
Mumbai,Mosambi,2015,1000,2316,1316,131.6
Mangrulpeer,Green Gram,2015,7579,8895,1316,17.363768307164534
Manchar,Brinjal,2016,1605,2921,1316,81.99376947040498
Manmad,Gram,2016,6654,7969,1315,19.762548842801323
Pune,Elephant Root,2015,1553,2868,1315,84.67482292337411
Nagpur,Onion,2015,1696,3011,1315,77.53537735849056
Kolhapur,Shevga,2016,450,1765,1315,292.22222222222223
Pune-Manjri,Ladies Finger,2015,1645,2960,1315,79.93920972644376
Rahuri,Ladies Finger,2016,271,1586,1315,485.23985239852396
Kamthi,Beet Root,2016,1543,2857,1314,85.15878159429683
Barshi-Vairag,Sorgum(Jawar),2014,1362,2676,1314,96.47577092511013
Kamthi,Spinach,2016,1954,3268,1314,67.24667349027635
Yeola,Green Gram,2015,7323,8636,1313,17.9298101870818
Osmanabad,Lemon,2015,1202,2515,1313,109.23460898502496
Jalgaon,Ginger (Fresh),2015,2475,3788,1313,53.05050505050505
Latur-Murud,Gram,2015,2743,4056,1313,47.867298578199055
Nashik,Tomato,2014,969,2281,1312,135.39731682146544
Pathari,Gram,2016,4367,5679,1312,30.043508129150446
Kurdwadi-Modnimb,Sorgum(Jawar),2015,1018,2330,1312,128.88015717092338
Pune,Chavli (Shenga ),2014,1036,2348,1312,126.64092664092664
Kurdwadi,Sorgum(Jawar),2015,1185,2496,1311,110.63291139240506
Kurdwadi,CHILLIES(RED),2016,6900,8211,1311,19.0
Pandharpur,Cucumber,2014,672,1983,1311,195.08928571428572
Solapur,Green Chilli,2015,1522,2833,1311,86.13666228646518
Akot,Pigeon Pea (Tur),2015,7840,9151,1311,16.721938775510203
Chalisgaon,Gram,2015,3600,4911,1311,36.416666666666664
Aurangabad,Orange,2015,1410,2720,1310,92.90780141843972
Manmad,Green Gram,2015,6841,8151,1310,19.149247186083905
Gevrai,Green Gram,2014,6483,7793,1310,20.206694431590314
Pune-Manjri,Kanda Pat,2015,1445,2755,1310,90.65743944636678
Kamthi,Green Chilli,2016,1576,2886,1310,83.12182741116752
Purna,Pigeon Pea (Tur),2015,7300,8610,1310,17.945205479452056
Aurangabad,Mosambi,2015,1800,3109,1309,72.72222222222223
Karanja,Sesamum,2014,8331,9640,1309,15.712399471852118
Nanded,Turmeric,2016,6261,7570,1309,20.90720332215301
Akola,Green Gram,2015,6539,7848,1309,20.018351429882244
Mangrulpeer,Pigeon Pea (Tur),2015,4182,5491,1309,31.30081300813008
Ahmednagar,Brinjal,2016,405,1714,1309,323.2098765432099
Pune,Dhemse,2016,983,2292,1309,133.16378433367242
Karad,Banana,2015,2458,3767,1309,53.254678600488205
Osmanabad,Ground Nut Pods (Dry),2016,3159,4468,1309,41.43716365938588
Sangrampur,Gram,2015,2834,4143,1309,46.18913196894848
Solapur,Carrot,2014,448,1757,1309,292.1875
Pune,Dhemse,2016,988,2296,1308,132.38866396761134
Mangalwedha,Bitter Gourd,2016,1868,3176,1308,70.02141327623126
Sangrampur-Varvatbakal,Soybean,2015,2121,3429,1308,61.66902404526167
Nandura,Black Gram,2016,5870,7178,1308,22.282793867120954
Pune-Manjri,Green Chilli,2015,1740,3048,1308,75.17241379310344
Barshi,Tamarind,2016,6372,7680,1308,20.527306967984934
Ulhasnagar,Sorgum(Jawar),2016,2656,3964,1308,49.24698795180723
Yeola,Green Gram,2015,7730,9037,1307,16.908150064683053
Rahuri-Vambori,Onion,2015,108,1415,1307,1210.1851851851852
Nashik,Ghevda,2016,2872,4179,1307,45.508356545961
Rahata,Garlic,2016,8847,10154,1307,14.773369503786594
Sangali,Jaggery,2015,1776,3083,1307,73.59234234234235
Nashik,GUAVA,2016,1771,3078,1307,73.80011293054771
Kolhapur,Shepu,2015,1773,3080,1307,73.71686407219403
Kamthi,Cluster Bean,2015,1407,2714,1307,92.89267945984363
Ulhasnagar,Sorgum(Jawar),2016,2560,3867,1307,51.0546875
Nandura,Black Gram,2015,8661,9967,1306,15.079090174344763
Ausa,Pigeon Pea (Tur),2016,8174,9480,1306,15.977489601174456
Dhule,Green Gram,2015,7514,8820,1306,17.380889007186585
Shahada,BLACK GRAM,2016,4596,5902,1306,28.416013925152306
Pune-Manjri,Walvad,2014,2376,3682,1306,54.966329966329965
Kolhapur,Green Chilli,2015,700,2006,1306,186.57142857142858
Vadgaon Peth,Capsicum,2016,1333,2638,1305,97.89947486871718
Pune-Manjri,Rajgira,2016,56,1361,1305,2330.3571428571427
Jalna,Pigeon Pea (Tur),2015,8039,9344,1305,16.2333623585023
Kamthi,Methi (Bhaji),2016,1595,2900,1305,81.81818181818181
Osmanabad,FLOWER,2016,1183,2488,1305,110.312764158918
Malegaon,Pigeon Pea (Tur),2015,6462,7767,1305,20.194986072423397
Nashik,Cucumber,2015,979,2284,1305,133.29928498467825
Akole,Onion,2016,113,1418,1305,1154.867256637168
Pune-Manjri,Pavtta,2015,1724,3029,1305,75.69605568445476
Lasalgaon,Soybean,2015,2000,3305,1305,65.25
Ratanagari,Brinjal,2016,2028,3333,1305,64.3491124260355
Jalna,Sorgum(Jawar),2016,1314,2619,1305,99.31506849315069
Latur,Black Gram,2016,9520,10825,1305,13.707983193277311
Akola,Green Gram,2015,6788,8092,1304,19.210371243370655
Mumbai,Ginger (Dry),2015,2452,3756,1304,53.1810766721044
Mumbai,Shevga,2015,3022,4326,1304,43.150231634679024
Ahmedpur,Pigeon Pea (Tur),2016,5033,6337,1304,25.909000596065965
Manchar,Small Gourd,2016,2100,3404,1304,62.095238095238095
Nashik,Kanda Pat,2016,1212,2516,1304,107.59075907590758
Khed-Chakan,Green Chilli,2016,4173,5477,1304,31.24850227653966
Sangli-Phale Bhajipalam,Pineapple,2016,250,1553,1303,521.2
Shirpur,Sesamum,2015,8005,9308,1303,16.277326670830732
Nandurbar,Chillies(Red),2015,1569,2872,1303,83.04652644996813
Phaltan,SORGUM(JAWAR),2016,1638,2941,1303,79.54822954822954
Malkapur,Onion,2015,1350,2653,1303,96.51851851851852
Nanded,Turmeric,2016,7979,9282,1303,16.330367213936583
Sangali,Wheat(Husked),2015,1633,2935,1302,79.73055725658297
Kolhapur,Jaggery,2015,2362,3664,1302,55.12277730736664
Lasalgaon,Soybean,2015,2410,3712,1302,54.024896265560166
Majalgaon,Sorgum(Jawar),2015,1006,2308,1302,129.4234592445328
Solapur,Ghevda,2015,884,2186,1302,147.28506787330318
Pune-Manjri,Ghevda,2015,1337,2639,1302,97.38219895287958
Pune,Rice(Paddy-Hus),2015,4521,5822,1301,28.77681928776819
Dhule,Ground Nut Pods (Dry),2015,4633,5934,1301,28.081156917763867
Parner,Onion,2015,604,1905,1301,215.39735099337747
Nira-Saswad,Pigeon Pea (Tur),2015,7000,8301,1301,18.585714285714285
Chalisgaon,Black Gram,2015,5600,6901,1301,23.232142857142858
Kalyan,Banana,2016,3567,4867,1300,36.44519203812728
Malkapur,Green Gram,2015,6697,7997,1300,19.411676870240406
Ahmednagar,Ghevda,2016,2600,3900,1300,50.0
Chalisgaon,Cluster Bean,2016,3500,4800,1300,37.142857142857146
Mumbai,Small Gourd,2015,1333,2633,1300,97.52438109527382
Jalgaon Jamod-Aasalgaon,Pigeon Pea (Tur),2015,7714,9014,1300,16.852476017630284
Kamthi,Cucumber,2014,1468,2768,1300,88.5558583106267
Pune,Chavli (Pala),2015,1200,2500,1300,108.33333333333333
Barshi,Pomegranate,2016,2038,3338,1300,63.78802747791953
Vai,Turmeric,2016,9000,10300,1300,14.444444444444445
Satara,Onion,2015,1488,2788,1300,87.36559139784946
Pune,Onion,2015,854,2154,1300,152.2248243559719
Sillod,Pigeon Pea (Tur),2016,6407,7707,1300,20.29030747619791
Pune,Elephant Root,2015,1536,2836,1300,84.63541666666667
Osmanabad,Sesamum,2015,8700,10000,1300,14.942528735632184
Pune,Mula Shenga,2015,700,2000,1300,185.71428571428572
Pune-Manjri,Bottle Gourd,2015,1092,2392,1300,119.04761904761905
Pune-Manjri,Raddish,2016,1533,2833,1300,84.80104370515329
Nashik,Coriander  ,2015,500,1800,1300,260.0
Karmala,Pigeon Pea (Tur),2016,6533,7833,1300,19.8989744374713
Chopda,Black Gram,2015,9104,10404,1300,14.279437609841828
Nashik,Brinjal,2015,643,1943,1300,202.1772939346812
Karad,Garlic,2015,4700,6000,1300,27.659574468085108
Jalgaon,Mosambi,2016,2200,3500,1300,59.09090909090909
Kamthi,Cluster Bean,2016,2200,3500,1300,59.09090909090909
Kalvan,Gram,2016,7026,8326,1300,18.502704241389125
Satara,Ginger (Fresh),2015,1625,2925,1300,80.0
Pune,Wal Papdi,2016,1600,2900,1300,81.25
Karad,Custard Apple,2015,3100,4400,1300,41.935483870967744
Pune-Pimpri,Ghevda,2015,2700,4000,1300,48.148148148148145
Akluj,Tomato,2016,1225,2525,1300,106.12244897959184
Mumbai,Green Gram,2014,6800,8100,1300,19.11764705882353
Karmala,Pigeon Pea (Tur),2016,7000,8300,1300,18.571428571428573
Lasalgaon,Soybean,2016,2468,3768,1300,52.6742301458671
Pune-Manjri,Chavli (Pala),2016,725,2025,1300,179.31034482758622
Shirpur,Green Gram,2015,5364,6664,1300,24.23564504101417
Barshi,Mango,2016,2200,3500,1300,59.09090909090909
Karad,Jaggery,2014,2600,3900,1300,50.0
Katol,Green Gram,2016,4350,5650,1300,29.885057471264368
Pune-Manjri,Methi (Bhaji),2015,925,2225,1300,140.54054054054055
Mumbai,Sorgum(Jawar),2014,1700,3000,1300,76.47058823529412
Varud-Rajura Bazar,Pigeon Pea (Tur),2015,8085,9385,1300,16.079158936301795
Palus,Cucumber,2016,1467,2767,1300,88.61622358554874
Chandrapur,Mosambi,2015,1143,2443,1300,113.73578302712161
Pune,Wal Papdi,2016,3000,4300,1300,43.333333333333336
Kamthi,Wal Bhaji,2015,1750,3050,1300,74.28571428571429
Vadgaon Peth,Ghevda,2014,1700,3000,1300,76.47058823529412
Loha,Turmeric,2016,6115,7415,1300,21.25919869174162
Kamthi,Wal Bhaji,2016,1700,3000,1300,76.47058823529412
Zarijamini,Gram,2016,2717,4017,1300,47.84688995215311
Ahmednagar,Ginger (Fresh),2015,2000,3300,1300,65.0
Ahmednagar,Ginger (Fresh),2015,2000,3300,1300,65.0
Kalyan,Garlic,2015,3100,4400,1300,41.935483870967744
Pune-Pimpri,Capsicum,2015,1200,2500,1300,108.33333333333333
Kamthi,Pumpkin,2015,908,2208,1300,143.1718061674009
Kamthi,Potato,2016,667,1967,1300,194.9025487256372
Khalapur(Shil-Phata),Other Cereals,2016,5650,6950,1300,23.008849557522122
Chikhali,Black Gram,2016,5400,6700,1300,24.074074074074073
Kalyan,Green Peas (Dry),2016,3200,4500,1300,40.625
Vasai,Potato,2014,1400,2700,1300,92.85714285714286
Junnar-Otur,Flower,2016,800,2100,1300,162.5
Pune-Manjri,Ambat Chuka,2015,0,1300,1300,inf
Dharmabad,Turmeric,2016,7200,8500,1300,18.055555555555557
Kamthi,Chavli (Shenga ),2014,1179,2479,1300,110.2629346904156
Pandharpur,BITTER GOURD,2016,542,1842,1300,239.85239852398524
Khed,Brinjal,2016,200,1500,1300,650.0
Paranda,Black Gram,2016,6000,7300,1300,21.666666666666668
Pune-Manjri,Harbara(Pendi),2015,750,2050,1300,173.33333333333334
Nashik,Methi (Bhaji),2015,400,1700,1300,325.0
Ahmednagar,Coriander (Dry),2016,6800,8100,1300,19.11764705882353
Manchar,Capsicum,2016,1200,2500,1300,108.33333333333333
Balapur,Black Gram,2015,7125,8425,1300,18.24561403508772
Satara,Ginger (Fresh),2016,1357,2657,1300,95.79955784819455
Kopargaon,Green Gram,2015,5667,6967,1300,22.939827068995942
Manchar,Capsicum,2016,2500,3800,1300,52.0
Osmanabad,Ghevda,2016,1100,2400,1300,118.18181818181819
Kolhapur,Awala,2015,1300,2600,1300,100.0
Khalapur(Shil-Phata),Wheat(Husked),2016,2067,3367,1300,62.893081761006286
Hadgaon,Pigeon Pea (Tur),2015,7500,8800,1300,17.333333333333332
Pune-Manjri,Ambat Chuka,2014,133,1433,1300,977.4436090225564
Akluj,Tamarind,2015,1200,2500,1300,108.33333333333333
Nashik,Coriander  ,2016,1153,2452,1299,112.66261925411969
Gangapur,Gram,2016,5993,7292,1299,21.675287835808444
Indapur-Bhigwan,HORSE GRAM,2016,2801,4100,1299,46.376294180649765
Raver,Green Gram,2015,5601,6900,1299,23.19228709159079
Khamgaon,Pigeon Pea (Tur),2015,4696,5995,1299,27.661839863713798
Pune-Manjri,Chavli (Shenga ),2016,2200,3498,1298,59.0
Ratanagari,Green Chilli,2014,2475,3773,1298,52.44444444444444
Shirpur,Soybean,2016,2103,3401,1298,61.72135045173562
Manchar,Methi (Bhaji),2015,466,1764,1298,278.54077253218884
Kej,Sesamum,2015,7702,9000,1298,16.852765515450532
Kolhapur,Tomato,2016,540,1838,1298,240.37037037037038
Dhule,Gram,2016,5449,6747,1298,23.82088456597541
Jalgaon,Chavli (Shenga ),2015,2318,3615,1297,55.95340811044004
Pimpalgaon (B)-Saykheda,Onion,2015,571,1868,1297,227.14535901926445
Pune,Rice(Paddy-Hus),2016,4361,5658,1297,29.74088511809218
Nashik,Tomato,2016,1215,2512,1297,106.74897119341564
Kamthi,CUSTARD APPLE,2016,2389,3685,1296,54.24863959815823
Mumbai,Guava,2014,1017,2313,1296,127.43362831858407
Nagpur,Pigeon Pea (Tur),2016,7570,8866,1296,17.12021136063408
Hinganghat,Gram,2016,4063,5359,1296,31.897612601525967
Pune,Ghosali(Bhaji),2016,813,2109,1296,159.40959409594095
Aurangabad,Green Chilli,2015,1576,2872,1296,82.23350253807106
Kej,Green Gram,2014,5757,7053,1296,22.511724856696198
Kej,Gram,2016,4949,6245,1296,26.187108506769043
Pune,Bitter Gourd,2015,2714,4010,1296,47.75239498894621
Osmanabad,Capsicum,2015,1305,2600,1295,99.23371647509579
Ambad(Vadi Godri),Pigeon Pea (Tur),2016,7924,9219,1295,16.342756183745582
Nashik,Carrot,2014,1276,2571,1295,101.48902821316615
Akluj,Bitter Gourd,2015,2100,3395,1295,61.666666666666664
Kolhapur,Chikoo,2015,630,1925,1295,205.55555555555554
Kej,Wheat(Husked),2015,1749,3044,1295,74.0423098913665
Pune,Ghevda,2015,1667,2962,1295,77.68446310737852
Sinner,Gram,2016,3075,4369,1294,42.08130081300813
Jalgaon,Bitter Gourd,2014,2100,3394,1294,61.61904761904762
Vadgaon Peth,Bitter Gourd,2015,1471,2765,1294,87.96736913664174
Jalgaon,Chavli (Shenga ),2016,3253,4547,1294,39.77866584691054
Pathari,Green Gram,2014,5673,6967,1294,22.80980081085845
Kamthi,Parwar,2016,1488,2782,1294,86.96236559139786
Akluj,Shevga,2014,3593,4886,1293,35.986640690231006
Khamgaon,Pigeon Pea (Tur),2016,7720,9013,1293,16.748704663212436
Chikhali,Green Gram,2015,6080,7373,1293,21.26644736842105
Mumbai,Small Gourd,2015,965,2257,1292,133.8860103626943
Mumbai,Ginger (Dry),2016,2954,4246,1292,43.737305348679755
Kamthi,Cucumber,2016,1375,2667,1292,93.96363636363637
Mumbai,Small Gourd,2014,824,2116,1292,156.79611650485438
Chalisgaon,Black Gram,2015,6321,7613,1292,20.439803828508147
Pune,Cluster Bean,2016,1527,2819,1292,84.61034708578913
Shirpur,Green Gram,2015,6184,7476,1292,20.892626131953428
Mumbai,Coconut,2015,704,1996,1292,183.52272727272728
Pune-Moshi,Shevga,2016,3746,5038,1292,34.49012279765083
Rahuri,Tomato,2015,342,1633,1291,377.48538011695905
Shahada,Green Gram,2014,6178,7469,1291,20.896730333441244
Mumbai,Split Black Gram,2015,7032,8323,1291,18.35893060295791
Solapur,Carrot,2016,567,1858,1291,227.689594356261
Latur,Pigeon Pea (Tur),2016,8014,9305,1291,16.109308709757922
Mumbai,Spilt Gerrn Gram,2015,8664,9955,1291,14.900738688827332
Karmala,Sorgum(Jawar),2015,1614,2904,1290,79.92565055762081
Solapur,Capsicum,2015,798,2088,1290,161.65413533834587
Pune-Manjri,Ladies Finger,2015,1584,2874,1290,81.43939393939394
Akluj,Garlic,2015,3526,4816,1290,36.58536585365854
Sangamner,Tomato,2015,492,1782,1290,262.1951219512195
Lasalgaon,Black Gram,2014,4075,5365,1290,31.65644171779141
Kamthi,Wal Bhaji,2015,1635,2925,1290,78.89908256880734
Shrirampur,Green Chilli,2016,4763,6053,1290,27.083770732731473
Vadgaon Peth,Ladies Finger,2016,1772,3061,1289,72.74266365688487
Kamthi,Mint,2015,1683,2972,1289,76.58942364824718
Kolhapur,Bitter Gourd,2016,754,2043,1289,170.9549071618037
Akot,Gram,2016,7998,9287,1289,16.11652913228307
Malegaon,Onion,2015,509,1798,1289,253.2416502946955
Rahuri,Onion,2015,100,1389,1289,1289.0
Chandrapur-Ganjwad,Ginger (Fresh),2016,3000,4288,1288,42.93333333333333
Kamthi,Capsicum,2015,1008,2296,1288,127.77777777777777
Mangaon(Bhadav),Nagali,2015,1431,2719,1288,90.00698812019567
Majalgaon,Sesamum,2014,9525,10813,1288,13.52230971128609
Pune,Tomato,2015,640,1928,1288,201.25
Shirpur,Black Gram,2014,4498,5786,1288,28.634948866162738
Satana,Onion,2015,382,1670,1288,337.17277486910996
Amarawati-Fruit And Vegetables,Mosambi,2016,2706,3994,1288,47.597930524759796
Jalgaon,Green Chilli,2016,2175,3463,1288,59.2183908045977
Nashik,Lemon,2016,2178,3466,1288,59.13682277318641
Lonar,Pigeon Pea (Tur),2016,7916,9204,1288,16.270843860535624
Mumbai,Ginger (Dry),2015,3256,4544,1288,39.55773955773956
Patan,Green Chilli,2016,3906,5194,1288,32.97491039426523
Indapur-Bhigwan,Black Gram,2015,8750,10038,1288,14.72
Pune,Wal Papdi,2015,1670,2957,1287,77.06586826347305
Varud-Rajura Bazar,Pigeon Pea (Tur),2016,5375,6662,1287,23.94418604651163
Nandura,Pigeon Pea (Tur),2015,5986,7273,1287,21.500167056465084
Manmad,Onion,2015,600,1887,1287,214.5
Shirpur,Matki,2015,6467,7754,1287,19.901036029070667
Solapur,Chikoo,2015,665,1952,1287,193.53383458646616
Aurangabad,Mosambi,2014,983,2270,1287,130.92573753814852
Jalna,Sorgum(Jawar),2016,1305,2592,1287,98.62068965517241
Shahada,Soybean,2015,2473,3760,1287,52.042054185200165
Kamthi,Mango,2015,896,2182,1286,143.52678571428572
Pune,Green Chilli,2014,1657,2943,1286,77.6101388050694
Amalner,Coriander (Dry),2016,7114,8400,1286,18.077031206072533
Ahmednagar,ONION,2016,190,1476,1286,676.8421052631579
Nashik,Ladies Finger,2016,2448,3734,1286,52.532679738562095
Pune,Mango(Raw),2015,3357,4643,1286,38.30801310694072
Pune,Pavtta,2015,1450,2736,1286,88.6896551724138
Vasai,Wheat(Husked),2015,1520,2805,1285,84.53947368421052
Akluj,Chikoo,2016,1585,2870,1285,81.07255520504732
Kamthi,Methi (Bhaji),2016,1638,2923,1285,78.44932844932845
Satara,Cluster Bean,2015,4429,5714,1285,29.01332129148792
Mumbai,Brinjal,2016,923,2208,1285,139.21993499458287
Malegaon,Gram,2015,3580,4865,1285,35.89385474860335
Sangali,Wheat(Husked),2015,1720,3005,1285,74.70930232558139
Nashik,Guava,2016,1702,2986,1284,75.4406580493537
Akola,Pigeon Pea (Tur),2015,5232,6516,1284,24.541284403669724
Nanded,TURMERIC,2016,6929,8213,1284,18.53081252706018
Ausa,Sesamum,2014,8169,9453,1284,15.717958134410576
Mandhal,Chillies(Red),2015,5615,6899,1284,22.867319679430096
Kamthi,Ladies Finger,2016,981,2265,1284,130.8868501529052
Kada,Sorgum(Jawar),2015,1535,2819,1284,83.64820846905538
Ahmednagar,BRINJAL,2016,333,1617,1284,385.5855855855856
Latur,Wheat(Husked),2014,1512,2796,1284,84.92063492063492
Aurangabad,Capsicum,2016,4133,5417,1284,31.067021533994676
Nashik,Carrot,2015,2416,3700,1284,53.145695364238414
Pune,Turmeric,2014,9083,10367,1284,14.136298579764395
Sangali,Wheat(Husked),2015,1696,2980,1284,75.70754716981132
Vadgaon Peth,Pavtta,2014,1985,3269,1284,64.68513853904282
Karmala,SUNFLOWER,2016,1827,3110,1283,70.22441160372195
Khamgaon,Pigeon Pea (Tur),2016,7198,8481,1283,17.824395665462628
Kolhapur,JAGGERY,2016,3025,4308,1283,42.413223140495866
Kamthi,Wal Bhaji,2016,1113,2396,1283,115.27403414195867
Mumbai,Brinjal,2016,700,1983,1283,183.28571428571428
Akole,Onion,2015,223,1506,1283,575.3363228699552
Akole,Onion,2015,106,1389,1283,1210.377358490566
Satara,Green-Peas,2016,4065,5348,1283,31.562115621156213
Karanja,Black Gram,2015,7863,9146,1283,16.316927381406586
Pune,Rice(Paddy-Hus),2014,5245,6528,1283,24.46139180171592
Vadgaon Peth,Pavtta,2016,1045,2327,1282,122.67942583732058
Sailu,Pigeon Pea (Tur),2015,5540,6822,1282,23.140794223826713
Nashik,Capsicum,2016,1265,2547,1282,101.34387351778656
Kolhapur,Sweet Potato,2016,579,1861,1282,221.4162348877375
Basmat,Turmeric,2015,7110,8392,1282,18.0309423347398
Daryapur,Black Gram,2016,4613,5894,1281,27.76934749620637
Nashik,Squash Gourd,2015,790,2071,1281,162.15189873417722
Junnar (Narayangaon),Tomato,2016,1783,3064,1281,71.84520471116096
Dhule,Gram,2015,3690,4971,1281,34.71544715447155
Malegaon,Green Gram,2016,5400,6681,1281,23.72222222222222
Junnar,Onion,2015,1350,2631,1281,94.88888888888889
Kopargaon,Gram,2016,4435,5716,1281,28.883878241262682
Phaltan,Gram,2016,3425,4706,1281,37.4014598540146
Pandharpur,FLOWER,2016,361,1642,1281,354.8476454293629
Latur,Wheat(Husked),2015,1569,2850,1281,81.64435946462716
Mangalwedha,Green Chilli,2015,2150,3431,1281,59.58139534883721
Karanja,Green Gram,2014,6350,7630,1280,20.15748031496063
Kamthi,Mint,2015,1487,2767,1280,86.07935440484196
Pune-Manjri,Cabbage,2015,720,2000,1280,177.77777777777777
Solapur,Flower,2015,320,1600,1280,400.0
Pune,Shevga,2015,1430,2710,1280,89.5104895104895
Chandrapur-Ganjwad,Bitter Gourd,2016,1760,3040,1280,72.72727272727273
Pune,Potato,2014,1592,2872,1280,80.40201005025126
Kalyan,Sesamum,2016,9000,10280,1280,14.222222222222221
Kamthi,Mint,2016,1980,3260,1280,64.64646464646465
Osmanabad,Cucumber,2015,620,1900,1280,206.4516129032258
Kamthi,Papai,2015,720,2000,1280,177.77777777777777
Nagpur,Chillies(Red),2014,6700,7980,1280,19.104477611940297
Ulhasnagar,Wheat(Husked),2016,2008,3288,1280,63.745019920318725
Devala,Green Gram,2015,7300,8579,1279,17.52054794520548
Kalmeshwar,Pigeon Pea (Tur),2016,7374,8653,1279,17.34472470843504
Lasalgaon,Onion,2014,521,1800,1279,245.489443378119
Jalgaon,Coriander (Dry),2015,7772,9051,1279,16.4565105506948
Chandrapur,Pigeon Pea (Tur),2015,6546,7825,1279,19.538649556981362
Jalgaon,Coriander  ,2016,1317,2596,1279,97.11465451784359
Latur,Wheat(Husked),2016,1535,2814,1279,83.32247557003258
Ambejogai,Pigeon Pea (Tur),2016,7359,8638,1279,17.380078815056393
Gangapur,Onion,2015,369,1648,1279,346.61246612466124
Kej,Pigeon Pea (Tur),2016,5965,7244,1279,21.441743503772003
Pune,Bitter Gourd,2015,2196,3474,1278,58.19672131147541
Karad,Garlic,2015,2889,4167,1278,44.23676012461059
Pune-Manjri,Green Chilli,2015,1665,2943,1278,76.75675675675676
Kolhapur-Laxmipuri,WHEAT(HUSKED),2016,2140,3418,1278,59.7196261682243
Pune,Ginger (Fresh),2016,1500,2778,1278,85.2
Ahmednagar,Cucumber,2016,1000,2278,1278,127.8
Jalna,Pigeon Pea (Tur),2015,4369,5647,1278,29.25154497596704
Sangali,Wheat(Husked),2015,1705,2983,1278,74.95601173020528
Kolhapur,Flower,2016,419,1697,1278,305.01193317422434
Lasur Station,Green Gram,2014,5673,6951,1278,22.527763088313062
Akluj,Tomato,2016,1311,2589,1278,97.48283752860412
Karad,Mosambi,2016,4907,6185,1278,26.044426329733035
Pune,Black Gram,2015,11879,13157,1278,10.758481353649296
Mumbai,Pomegranate,2014,4900,6178,1278,26.081632653061224
Kamthi,Lemon,2016,1552,2830,1278,82.34536082474227
Loha,Turmeric,2016,6745,8022,1277,18.93254262416605
Kamthi,Green-Peas,2015,1358,2635,1277,94.03534609720177
Manora,Pigeon Pea (Tur),2016,8141,9418,1277,15.68603365679892
Pune,Pavtta,2015,2192,3469,1277,58.25729927007299
Kamthi,Kanda Pat,2015,1676,2952,1276,76.13365155131265
Mangalwedha,Bitter Gourd,2016,2680,3956,1276,47.61194029850746
Shegaon,Pigeon Pea (Tur),2015,7352,8628,1276,17.35582154515778
Nashik,Ground Nut Pods (Dry),2016,2489,3765,1276,51.265568501406186
Kille Dharur,Pigeon Pea (Tur),2015,4736,6012,1276,26.94256756756757
Pune-Manjri,Chavli (Shenga ),2015,912,2188,1276,139.91228070175438
Jalgaon,Ladies Finger,2014,1593,2868,1275,80.0376647834275
Kamthi,Lemon,2015,1281,2556,1275,99.53161592505855
Balapur,Green Gram,2016,4025,5300,1275,31.677018633540374
Pune-Manjri,Hemp,2015,0,1275,1275,inf
Lasur Station,Black Gram,2015,6738,8013,1275,18.922528940338378
Ambejogai,Pigeon Pea (Tur),2015,5212,6487,1275,24.462778204144282
Satara,Ladies Finger,2016,2750,4025,1275,46.36363636363637
Sakri,Gram,2016,4000,5275,1275,31.875
Mumbai,Guava,2014,1295,2570,1275,98.45559845559846
Nandura,Sesamum,2015,5721,6996,1275,22.286313581541688
Latur,Wheat(Husked),2015,1555,2830,1275,81.9935691318328
Chandrapur-Ganjwad,Coriander  ,2014,1517,2792,1275,84.04746209624258
Satara,Ginger (Fresh),2015,1725,3000,1275,73.91304347826087
Junnar-Otur,Walvad,2016,1483,2758,1275,85.97437626432907
Jalgaon,Coriander  ,2015,985,2260,1275,129.44162436548223
Mumbai,Brinjal,2014,1763,3037,1274,72.26318774815655
Shirpur,Ground Nut Pods (Dry),2015,3889,5163,1274,32.759064026742095
Kolhapur,Cabbage,2016,1252,2526,1274,101.75718849840256
Kalvan,Onion,2015,346,1620,1274,368.2080924855491
Latur,Pigeon Pea (Tur),2016,7800,9074,1274,16.333333333333332
Kamthi,Wal Bhaji,2016,1215,2489,1274,104.8559670781893
Pune,Mango(Raw),2016,1000,2274,1274,127.4
Kamthi,Green Chilli,2015,1488,2762,1274,85.61827956989248
Risod,Black Gram,2015,10573,11847,1274,12.049560200510735
Mumbai,Green-Peas,2016,3154,4427,1273,40.36144578313253
Chandvad,Onion,2015,147,1420,1273,865.9863945578231
Karmala,Sorgum(Jawar),2015,1580,2853,1273,80.56962025316456
Pune,Elephant Root,2015,1486,2759,1273,85.66621803499326
Nashik,Capsicum,2015,1729,3002,1273,73.62637362637362
Karmala,Sorgum(Jawar),2016,1686,2959,1273,75.5041518386714
Karad,Green-Peas,2015,2364,3636,1272,53.807106598984774
Ratanagari,Tomato,2016,2005,3277,1272,63.44139650872818
Rahuri,Onion,2015,173,1445,1272,735.2601156069364
Nandura,Sesamum,2014,9821,11093,1272,12.95183789838102
Akluj,Ladies Finger,2014,2211,3483,1272,57.530529172320215
Kamthi,Cabbage,2014,829,2100,1271,153.31724969843185
Lasalgaon,Onion,2015,709,1980,1271,179.26657263751764
Pune-Manjri,Coriander  ,2015,635,1906,1271,200.15748031496062
Kolhapur,Jaggery,2016,2630,3901,1271,48.32699619771863
Nashik,Guava,2016,2033,3304,1271,62.518445646827345
Pune,Chavli (Shenga ),2015,1610,2881,1271,78.94409937888199
Nashik,Brinjal,2016,1124,2395,1271,113.07829181494662
Sangali,Jaggery,2014,2600,3871,1271,48.88461538461539
Solapur,Capsicum,2016,1658,2928,1270,76.59831121833534
Solapur,Capsicum,2015,678,1948,1270,187.3156342182891
Nashik,Shepu,2016,2080,3350,1270,61.05769230769231
Parner,Onion,2016,550,1820,1270,230.9090909090909
Kamthi,Carrot,2015,1565,2835,1270,81.15015974440895
Rahata,Garlic,2015,2615,3885,1270,48.565965583174
Mumbai,Tomato,2014,852,2122,1270,149.06103286384976
Sindi,Pigeon Pea (Tur),2015,5985,7255,1270,21.219715956558062
Kolhapur-Laxmipuri,Green Gram,2016,5988,7258,1270,21.209084836339347
Khed (Shel Pimpalgaon),Brinjal,2015,1203,2473,1270,105.5694098088113
Nashik,Grapes,2016,2090,3360,1270,60.76555023923445
Karanja,GRAM,2016,7640,8910,1270,16.623036649214658
Pune-Manjri,Kanda Pat,2014,877,2146,1269,144.69783352337515
Khamgaon,Ground Nut Pods (Dry),2015,3425,4694,1269,37.051094890510946
Phaltan,Onion,2015,375,1644,1269,338.4
Mandhal,Chillies(Red),2016,6574,7843,1269,19.303316093702463
Pune,Dhemse,2016,1308,2577,1269,97.01834862385321
Akluj,Ladies Finger,2016,1694,2963,1269,74.91145218417945
Pune,Mango(Raw),2015,663,1932,1269,191.40271493212668
Akluj,Ladies Finger,2015,1375,2644,1269,92.2909090909091
Jalgaon,Green Chilli,2015,1426,2695,1269,88.99018232819074
Kamthi,Chavli (Shenga ),2015,1304,2573,1269,97.3159509202454
Mangalwedha,Bitter Gourd,2015,1452,2720,1268,87.32782369146005
Umarga,Black Gram,2014,3814,5082,1268,33.24593602517042
Sinner,Onion,2016,158,1426,1268,802.5316455696203
Achalpur,Pigeon Pea (Tur),2015,5988,7256,1268,21.17568470273881
Kolhapur,Pineapple,2015,823,2091,1268,154.07047387606318
Kurdwadi-Modnimb,Onion,2016,71,1338,1267,1784.5070422535211
Pune-Manjri,Other Vegetables,2016,533,1800,1267,237.7110694183865
Risod,Gram,2016,6880,8147,1267,18.415697674418606
Nilanga,Pigeon Pea (Tur),2015,8522,9789,1267,14.867402018305562
Kada,Onion,2014,433,1700,1267,292.6096997690531
Kada (Ashti),Black Gram,2014,4800,6067,1267,26.395833333333332
Kolhapur,Jaggery,2015,2614,3881,1267,48.46977811782708
Amarawati,Sesamum,2015,8468,9735,1267,14.962210675484176
Mumbai,Green Peas (Dry),2015,2533,3800,1267,50.01973943939992
Kalyan,Gram,2016,5300,6567,1267,23.90566037735849
Solapur,Green Chilli,2015,1383,2650,1267,91.61243673174259
Kamthi,Cucumber,2016,653,1920,1267,194.02756508422664
Mumbai,Orange,2015,800,2067,1267,158.375
Mangalwedha,Bitter Gourd,2016,5038,6305,1267,25.148868598650257
Kolhapur-Malkapur,Flower,2016,350,1617,1267,362.0
Jamkhed,Green Gram,2015,6233,7500,1267,20.327290229424033
Akola,Black Gram,2016,8443,9710,1267,15.006514272178135
Pune,Ghosali(Bhaji),2014,1233,2500,1267,102.75750202757501
Shirpur,Green Gram,2015,6006,7273,1267,21.095571095571096
Ahmedpur,Sesamum,2014,8867,10133,1266,14.277658734634036
Mehkar,Black Gram,2015,6167,7433,1266,20.528620074590563
Ahmednagar,Carrot,2016,1667,2933,1266,75.94481103779245
Pimpalgaon Basawant,Onion,2014,658,1924,1266,192.4012158054711
Aurangabad,Mosambi,2014,1105,2371,1266,114.57013574660634
Kolhapur,Pineapple,2015,781,2047,1266,162.0998719590269
Chandrapur,Mosambi,2016,1667,2933,1266,75.94481103779245
Kolhapur,Ground Nut Pods (Dry),2015,2626,3891,1265,48.172124904798174
Shirpur,Onion,2014,368,1633,1265,343.75
Kamthi,Bottle Gourd,2014,800,2064,1264,158.0
Nashik,Ginger (Fresh),2016,2100,3364,1264,60.19047619047619
Kolhapur,Carrot,2016,1100,2364,1264,114.9090909090909
Nagpur,Grapes,2016,3286,4550,1264,38.46622032866707
Solapur,Ghevda,2015,1619,2883,1264,78.07288449660284
Nandura,Black Gram,2016,10806,12069,1263,11.687951138256524
Phaltan,Gram,2015,3375,4638,1263,37.422222222222224
Indapur-Bhigwan,Sorgum(Jawar),2015,1588,2851,1263,79.53400503778337
Malkapur,Pigeon Pea (Tur),2016,7947,9210,1263,15.89278973197433
Barshi,GRAM,2016,7025,8288,1263,17.97864768683274
Balapur,Green Gram,2015,5075,6338,1263,24.886699507389164
Pune-Manjri,Onion,2015,300,1563,1263,421.0
Manchar,Brinjal,2016,1575,2838,1263,80.19047619047619
Pune,Ladies Finger,2016,855,2118,1263,147.71929824561403
Pune,Wal Papdi,2014,2031,3294,1263,62.186115214180205
Akluj,Carrot,2015,1206,2469,1263,104.72636815920399
Nandgaon,Onion,2014,525,1787,1262,240.38095238095238
Indapur,Onion,2015,369,1631,1262,342.00542005420056
Daryapur,Gram,2015,3819,5081,1262,33.04529981670594
Nandurbar,Chillies(Red),2015,1526,2788,1262,82.69986893840105
Kamthi,Small Gourd,2015,738,2000,1262,171.00271002710028
Kamthi,Cucumber,2015,969,2231,1262,130.2373581011352
Aurangabad,Garlic,2015,1413,2675,1262,89.31351733899504
Kamthi,Papai,2016,888,2150,1262,142.11711711711712
Pune,Green Peas (Dry),2016,2892,4154,1262,43.63762102351314
Malegaon,Green Gram,2015,6921,8182,1261,18.219910417569714
Aurangabad,Fig,2015,2308,3569,1261,54.636048526863085
Aarni,Pigeon Pea (Tur),2016,8050,9311,1261,15.664596273291925
Aurangabad,Shevga,2015,4508,5769,1261,27.972493345164153
Nashik,Potato,2016,454,1715,1261,277.7533039647577
Vadgaon Peth,Tomato,2016,1096,2356,1260,114.96350364963503
Ahmednagar,Capsicum,2016,760,2020,1260,165.78947368421052
Pune-Manjri,Ambat Chuka,2014,180,1440,1260,700.0
Mehkar,Pigeon Pea (Tur),2016,7180,8440,1260,17.54874651810585
Pune,Rice(Paddy-Hus),2014,5280,6540,1260,23.863636363636363
Nashik,PAPAI,2016,980,2240,1260,128.57142857142858
Pune,Tamarind,2015,3700,4960,1260,34.054054054054056
Khamgaon,Pigeon Pea (Tur),2016,7743,9003,1260,16.272762495156915
Kolhapur-Laxmipuri,Gr.Nut Kernels,2015,6120,7380,1260,20.58823529411765
Nandura,Sesamum,2015,5639,6899,1260,22.344387302713248
Satana,Gram,2015,3687,4947,1260,34.17412530512612
Phaltan,Ladies Finger,2016,1500,2760,1260,84.0
Pune-Manjri,Ladies Finger,2015,1605,2865,1260,78.50467289719626
Baramati,Ground Nut Pods (Dry),2014,2300,3560,1260,54.78260869565217
Amarawati,Chikoo,2015,1227,2487,1260,102.68948655256723
Kej,Black Gram,2016,5710,6969,1259,22.049036777583186
Mehkar,Pigeon Pea (Tur),2015,6300,7559,1259,19.984126984126984
Pune-Manjri,Kardai,2016,0,1258,1258,inf
Pune,Green Peas (Dry),2016,2879,4137,1258,43.69572768322334
Pune-Manjri,Brinjal,2015,1188,2446,1258,105.89225589225589
Barshi,Sorgum(Jawar),2014,1408,2666,1258,89.3465909090909
Mangalwedha,Bitter Gourd,2016,2208,3465,1257,56.92934782608695
Mumbai,Split Gram,2016,11052,12309,1257,11.373507057546146
Gevrai,Pigeon Pea (Tur),2015,8793,10050,1257,14.295462299556466
Kurdwadi,Sorgum(Jawar),2014,1353,2610,1257,92.90465631929047
Pandharpur,Onion,2015,263,1520,1257,477.9467680608365
Jalgaon,Ginger (Fresh),2016,1952,3209,1257,64.39549180327869
Kamthi,Cabbage,2015,686,1943,1257,183.23615160349854
Beed,Pigeon Pea (Tur),2015,5433,6690,1257,23.136388735505246
Aurangabad,Ginger (Fresh),2015,1643,2900,1257,76.50639074863055
Pune-Manjri,Raddish,2016,935,2192,1257,134.4385026737968
Kamthi,Green Chilli,2015,814,2071,1257,154.42260442260442
Mumbai,Ginger (Dry),2014,3808,5064,1256,32.983193277310924
Manmad,Onion,2014,512,1768,1256,245.3125
Nandurbar,Chillies(Red),2015,1670,2926,1256,75.20958083832335
Barshi,Sorgum(Jawar),2015,1429,2685,1256,87.89363191042688
Tumsar,Green Gram,2015,4453,5709,1256,28.20570401976196
Indapur (Nimgaon Ketki),Gram,2015,2563,3819,1256,49.005072181037846
Satana,Gram,2016,4059,5315,1256,30.94358216309436
Mumbai,Green Chilli,2014,2232,3488,1256,56.272401433691755
Telhara,Pigeon Pea (Tur),2016,7777,9033,1256,16.15018644721615
Pune-Manjri,Kanda Pat,2014,1275,2531,1256,98.50980392156863
Lasur Station,Onion,2016,210,1466,1256,598.0952380952381
Phaltan,Sorgum(Jawar),2016,1570,2825,1255,79.93630573248407
Dhule,Pigeon Pea (Tur),2015,7047,8302,1255,17.808996736199802
Ashti-Karanja,Pigeon Pea (Tur),2016,7415,8670,1255,16.925151719487527
Jalgaon,BITTER GOURD,2016,1605,2860,1255,78.19314641744548
Kamthi,Chavli (Shenga ),2015,717,1972,1255,175.03486750348674
Solapur,Green Chilli,2015,804,2059,1255,156.09452736318408
Kamthi,Wal Bhaji,2015,1882,3136,1254,66.63124335812965
Devala,Gram,2016,4961,6215,1254,25.277161862527716
Umared,Coriander (Dry),2016,6165,7419,1254,20.340632603406327
Indapur-Bhigwan,Sorgum(Jawar),2016,1672,2926,1254,75.0
Kamthi,Pumpkin,2014,853,2107,1254,147.010550996483
Shegaon,Pigeon Pea (Tur),2015,5630,6884,1254,22.27353463587922
Ghatanji,Pigeon Pea (Tur),2015,7090,8344,1254,17.686882933709448
Amarawati,Ginger (Fresh),2016,2093,3347,1254,59.91399904443383
Manmad,Green Gram,2014,6765,8019,1254,18.536585365853657
Dhule,GREEN GRAM,2016,3427,4681,1254,36.59177122847972
Pune-Manjri,Harbara(Pendi),2015,764,2018,1254,164.13612565445027
Ahmednagar,Onion,2016,100,1354,1254,1254.0
Manmad,Green Gram,2016,4846,6099,1253,25.85637639290136
Kamthi,Cabbage,2016,1804,3057,1253,69.45676274944567
Phaltan,Cluster Bean,2016,2429,3682,1253,51.585014409221905
Mangrulpeer,Pigeon Pea (Tur),2015,4592,5845,1253,27.286585365853657
Pune-Manjri,Brinjal,2015,1842,3095,1253,68.02388707926167
Ahmednagar,Pigeon Pea (Tur),2016,7062,8315,1253,17.742849051260265
Akola,BLACK GRAM,2016,5936,7189,1253,21.108490566037737
Kamthi,Bitter Gourd,2015,1797,3050,1253,69.72732331663885
Vadgaon Peth,Capsicum,2016,1604,2857,1253,78.11720698254364
Pune,Walvad,2014,2257,3510,1253,55.516171909614535
Indapur,Onion,2015,146,1398,1252,857.5342465753424
Jalna,Green Gram,2015,7764,9016,1252,16.125708397733128
Pune,Cucumber,2015,605,1857,1252,206.94214876033058
Pune,Elephant Root,2015,1416,2668,1252,88.4180790960452
Nashik,Tomato,2015,980,2232,1252,127.75510204081633
Dudhani,GRAM,2016,7369,8621,1252,16.990093635500067
Majalgaon,Pigeon Pea (Tur),2015,8363,9615,1252,14.970704292717924
Nashik,Ladies Finger,2016,2439,3690,1251,51.291512915129154
Pandharpur,Tomato,2014,256,1507,1251,488.671875
Ausa,Coriander (Dry),2015,8251,9502,1251,15.161798569870319
Barshi-Vairag,Ground Nut Pods (Dry),2015,3681,4932,1251,33.98533007334963
Phaltan,Onion,2016,433,1684,1251,288.9145496535797
Amalner,Gram,2015,3000,4251,1251,41.7
Pune,Brinjal,2014,1125,2375,1250,111.11111111111111
Mumbai,Mosambi,2015,1012,2262,1250,123.51778656126483
Lasur Station,Onion,2015,300,1550,1250,416.6666666666667
Pune-Manjri,Hemp,2016,0,1250,1250,inf
Sangli-Phale Bhajipalam,Pineapple,2015,416,1666,1250,300.4807692307692
Junnar (Alephata),Onion,2015,2333,3583,1250,53.57908272610373
Sangali,Coriander (Dry),2016,9750,11000,1250,12.820512820512821
Osmanabad,Cucumber,2016,925,2175,1250,135.13513513513513
Akluj,Shevga,2016,1343,2593,1250,93.07520476545048
Nagpur,Chikoo,2015,1575,2825,1250,79.36507936507937
Satara,Green-Peas,2016,6071,7321,1250,20.5896886839071
Palus,Ginger (Fresh),2015,2750,4000,1250,45.45454545454545
Sangali,Pigeon Pea (Tur),2016,6000,7250,1250,20.833333333333332
Pune-Manjri,Brinjal,2015,959,2209,1250,130.34410844629824
Anajngaon Surji,Chillies(Red),2015,10000,11250,1250,12.5
Palus,Shevga,2016,3500,4750,1250,35.714285714285715
Osmanabad,Cluster Bean,2016,1220,2470,1250,102.45901639344262
Karad,Garlic,2014,3438,4688,1250,36.35834787667248
Baramati,Onion,2014,850,2100,1250,147.05882352941177
Basmat,Turmeric,2016,7950,9200,1250,15.723270440251572
Satara,Shevga,2015,5375,6625,1250,23.25581395348837
Achalpur,Black Gram,2016,5325,6575,1250,23.474178403755868
Nandura,Black Gram,2014,4500,5750,1250,27.77777777777778
Sangali,Black Gram,2016,6000,7250,1250,20.833333333333332
Aurangabad,Tamarind,2015,3500,4750,1250,35.714285714285715
Chandrapur,Mosambi,2016,3250,4500,1250,38.46153846153846
Solapur,Capsicum,2016,1775,3025,1250,70.4225352112676
Pune-Manjri,Kanda Pat,2014,1033,2283,1250,121.00677637947724
Aurangabad,Bor,2015,850,2100,1250,147.05882352941177
Nanded,Green Gram,2015,7251,8501,1250,17.239001517032133
Vadgaon Peth,Ghevda,2014,1125,2375,1250,111.11111111111111
Jalgaon,Mosambi,2016,2250,3500,1250,55.55555555555556
Vadgaon Peth,Green-Peas,2014,2000,3250,1250,62.5
Aurangabad,Shevga,2016,2659,3909,1250,47.01015419330575
Newasa,Pigeon Pea (Tur),2016,5750,7000,1250,21.73913043478261
Ratanagari,Maize(Corn.),2016,3250,4500,1250,38.46153846153846
Nashik,Onion,2015,540,1790,1250,231.4814814814815
Pune,Chavli (Shenga ),2016,1154,2404,1250,108.31889081455806
Amarawati,Lemon,2016,2107,3357,1250,59.326056003796865
Sangli-Phale Bhajipalam,Custard Apple,2016,625,1875,1250,200.0
Dhule,Black Gram,2016,10000,11250,1250,12.5
Barshi,Pomegranate,2016,2693,3943,1250,46.41663572224285
Vadgaon Peth,Pavtta,2015,1750,3000,1250,71.42857142857143
Akluj,Chillies(Red),2015,1500,2750,1250,83.33333333333333
Barshi,Coriander (Dry),2015,8350,9600,1250,14.970059880239521
Karmala,Sorgum(Jawar),2016,1650,2900,1250,75.75757575757575
Barshi,Turmeric,2016,6707,7957,1250,18.637244669748025
Nagpur,Mosambi,2014,990,2240,1250,126.26262626262626
Osmanabad,Ginger (Fresh),2014,2750,4000,1250,45.45454545454545
Kalyan,Black Gram,2016,11250,12500,1250,11.11111111111111
Kolhapur,Wood Apple,2016,2000,3250,1250,62.5
Amarawati-Fruit And Vegetables,BOR,2016,1100,2350,1250,113.63636363636364
Akkolkot,Green Gram,2015,7951,9201,1250,15.721292919129668
Ratanagari,Maize(Corn.),2015,3500,4750,1250,35.714285714285715
Amarawati,Amba Koy,2016,4125,5375,1250,30.303030303030305
Karad,Shevga,2015,3875,5125,1250,32.25806451612903
Chalisgaon,Ground Nut Pods (Dry),2015,3450,4700,1250,36.231884057971016
Jalgaon,Methi (Bhaji),2015,1695,2945,1250,73.74631268436578
Ratanagari,Ginger (Fresh),2014,4000,5250,1250,31.25
Washim,Turmeric,2016,6900,8150,1250,18.115942028985508
Karad,Orange,2015,1500,2750,1250,83.33333333333333
Devala,Onion,2015,624,1874,1250,200.32051282051282
Kamthi,Small Gourd,2014,942,2192,1250,132.6963906581741
Kalyan,Lemon,2015,3250,4500,1250,38.46153846153846
Nashik,Guava,2016,1781,3031,1250,70.18528916339136
Sangali,Chillies(Red),2015,8500,9750,1250,14.705882352941176
Pune,Pavtta,2014,2104,3354,1250,59.4106463878327
Pombhurni,Pigeon Pea (Tur),2016,8250,9500,1250,15.151515151515152
Shrirampur,Green Gram,2015,6500,7750,1250,19.23076923076923
Ahmednagar,Lemon,2015,1500,2750,1250,83.33333333333333
Kamthi,Parwar,2014,1700,2950,1250,73.52941176470588
Amarawati,Jambhul,2016,3500,4750,1250,35.714285714285715
Amarawati,Jambhul,2016,3950,5200,1250,31.645569620253166
Rahata,Green Chilli,2015,3750,5000,1250,33.333333333333336
Lasalgaon,Soybean,2016,2282,3531,1249,54.732690622261174
Dhule,Onion,2015,421,1670,1249,296.6745843230404
Barshi,Tamarind,2015,4714,5963,1249,26.49554518455664
Kurdwadi,Onion,2014,650,1898,1248,192.0
Pune,Pavtta,2015,2033,3281,1248,61.38711264141663
Pune,Small Gourd,2016,1478,2726,1248,84.4384303112314
Akluj,Brinjal,2016,1942,3189,1247,64.21215242018538
Ahmednagar,Ghevda,2016,1293,2540,1247,96.44238205723124
Pune-Manjri,Cabbage,2014,318,1565,1247,392.1383647798742
Phaltan,Gram,2016,3425,4672,1247,36.40875912408759
Kamthi,Methi (Bhaji),2016,1538,2785,1247,81.07932379713914
Satana,GREEN GRAM,2016,3247,4494,1247,38.404681244225436
Latur,Pigeon Pea (Tur),2016,6000,7246,1246,20.766666666666666
Pandharpur,Tomato,2016,409,1655,1246,304.6454767726161
Mangaon(Bhadav),Nachani,2015,1345,2591,1246,92.63940520446097
Yeola,Onion,2015,328,1574,1246,379.8780487804878
Pune,Dhemse,2015,1500,2746,1246,83.06666666666666
Amarawati,Mosambi,2016,2523,3769,1246,49.38565200158541
Akluj,Chillies(Red),2014,2323,3569,1246,53.63753766681016
Pusad,Gram,2015,3453,4699,1246,36.08456414711845
Majalgaon,Sorgum(Jawar),2014,1124,2370,1246,110.8540925266904
Pune,Snake Gourd,2015,1008,2254,1246,123.61111111111111
Kamthi,Ladies Finger,2016,777,2023,1246,160.36036036036037
Pachora,Black Gram,2016,5867,7112,1245,21.22038520538606
Kamthi,Parwar,2016,1444,2689,1245,86.21883656509695
Dudhani,Black Gram,2016,6299,7544,1245,19.76504207016987
Nandura,Onion,2016,1756,3001,1245,70.8997722095672
Barshi,Turmeric,2016,7448,8693,1245,16.715896885069817
Sangamner,Tomato,2014,1591,2836,1245,78.25267127592709
Nandura,Sesamum,2015,5587,6832,1245,22.28387327725076
Kalvan,Onion,2015,303,1548,1245,410.8910891089109
Rahata,Onion,2015,222,1467,1245,560.8108108108108
Pune,Wal Papdi,2015,1822,3067,1245,68.33150384193195
Vasai,Rice(Paddy-Hus),2016,2215,3460,1245,56.207674943566595
Varora,Pigeon Pea (Tur),2016,7700,8945,1245,16.16883116883117
Mumbai,SMALL GOURD,2016,1200,2445,1245,103.75
Nandura,Sesamum,2015,8106,9350,1244,15.346656797434
Pune,Bitter Gourd,2014,1856,3100,1244,67.02586206896552
Nashik,Shepu,2016,2193,3437,1244,56.72594619243046
Nashik,Ghosali(Bhaji),2015,1249,2493,1244,99.59967974379504
Vadgaon Peth,Bitter Gourd,2016,1356,2600,1244,91.74041297935104
Kamthi,Flower,2014,1517,2761,1244,82.00395517468688
Jalgaon,Bitter Gourd,2015,2104,3348,1244,59.125475285171106
Jalgaon,Methi (Bhaji),2014,2406,3650,1244,51.70407315045719
Kamthi,Cucumber,2014,1052,2296,1244,118.25095057034221
Barshi,Black Gram,2014,4214,5457,1243,29.496915045087803
Lonand,Onion,2015,850,2093,1243,146.23529411764707
Jamkhed,Sorgum(Jawar),2015,1605,2848,1243,77.44548286604362
Solapur,Black Gram,2015,7845,9088,1243,15.84448693435309
Karmala,Sorgum(Jawar),2015,1616,2859,1243,76.91831683168317
Akluj,Onion,2015,1443,2686,1243,86.13998613998614
Kamthi,Ladies Finger,2016,1811,3054,1243,68.63611264494754
Mumbai,Ginger (Dry),2016,2748,3991,1243,45.232896652110625
Satana,Onion,2015,830,2073,1243,149.75903614457832
Jalna,Sorgum(Jawar),2016,1292,2535,1243,96.20743034055728
Dondaicha,Chillies(Red),2016,2793,4036,1243,44.50411743644826
Lonar,Green Gram,2015,7691,8934,1243,16.161747497074504
Pune-Manjri,Bottle Gourd,2014,884,2126,1242,140.49773755656108
Bhivandi,Rice(Paddy-Hus),2016,2252,3494,1242,55.150976909413856
Ausa,Wheat(Husked),2015,1426,2668,1242,87.09677419354838
Khed,Ladies Finger,2016,2191,3433,1242,56.68644454586946
Sindi,Pigeon Pea (Tur),2015,5595,6837,1242,22.198391420911527
Shahada,Gram,2015,3100,4341,1241,40.03225806451613
Nandurbar,Chillies(Red),2015,2223,3464,1241,55.82546108861899
Chandrapur-Ganjwad,Green Chilli,2016,1545,2786,1241,80.32362459546925
Shirpur,Sunflower,2016,2609,3850,1241,47.5661172863166
Aurangabad,Onion,2015,972,2213,1241,127.67489711934157
Pune,Onion,2014,738,1979,1241,168.15718157181573
Karad,Pomegranate,2016,4185,5426,1241,29.65352449223417
Varud-Rajura Bazar,Gram,2015,3768,5009,1241,32.93524416135881
Dharmabad,Black Gram,2016,7500,8740,1240,16.533333333333335
Chandrapur-Ganjwad,Tomato,2016,1510,2750,1240,82.11920529801324
Pune-Manjri,Goosefoot,2014,100,1340,1240,1240.0
Pune,PAVTTA,2016,2260,3500,1240,54.86725663716814
Kamthi,Mosambi,2014,1760,3000,1240,70.45454545454545
Latur,Black Gram,2016,9280,10520,1240,13.362068965517242
Manchar,Ghevda,2016,4040,5280,1240,30.693069306930692
Umarga,Gram,2016,7770,9010,1240,15.95881595881596
Nagpur,Pigeon Pea (Tur),2016,6678,7918,1240,18.568433662773284
Pune,Rice(Paddy-Hus),2016,4246,5486,1240,29.203956665096563
Pune,Pavtta,2015,1605,2845,1240,77.25856697819314
Pune,Capsicum,2016,2065,3304,1239,60.0
Kamthi,Kanda Pat,2014,1819,3058,1239,68.11434854315559
Devala,Gram,2015,3730,4969,1239,33.2171581769437
Daryapur,Soybean,2014,2027,3266,1239,61.1248149975333
Pune,Dhemse,2015,1028,2267,1239,120.52529182879377
Pune,Shevga,2016,1683,2922,1239,73.61853832442068
Khed-Chakan,Squash Gourd,2016,5196,6435,1239,23.84526558891455
Satara,Cluster Bean,2014,3391,4630,1239,36.53789442642288
Nandura,Green Gram,2015,7000,8238,1238,17.685714285714287
Akkolkot,Green Gram,2014,6195,7433,1238,19.983857949959646
Mumbai,Orange,2015,1000,2238,1238,123.8
Solapur,Bitter Gourd,2016,581,1819,1238,213.08089500860586
Umared,Rice(Paddy-Hus),2015,2000,3238,1238,61.9
Aurangabad,Green Chilli,2015,3033,4271,1238,40.817672271678205
Kurdwadi-Modnimb,Sorgum(Jawar),2016,1317,2555,1238,94.00151860288534
Palus,Ghevda,2016,3125,4363,1238,39.616
Basmat,Turmeric,2016,6922,8160,1238,17.88500433400751
Barshi,CLUSTER BEAN,2016,2150,3388,1238,57.58139534883721
Baramati,Onion,2015,500,1738,1238,247.6
Ahmednagar,Squash Gourd,2016,647,1884,1237,191.1901081916538
Kamthi,Capsicum,2016,1074,2311,1237,115.17690875232775
Kamthi,Capsicum,2016,989,2226,1237,125.07583417593528
Sangali,Jaggery,2015,2229,3466,1237,55.49573799910274
Pune,Pavtta,2015,2469,3706,1237,50.1012555690563
Dhule,Green Gram,2015,5566,6803,1237,22.22421846927776
Jalgaon,Ladies Finger,2016,1894,3131,1237,65.31151003167899
Pune,Brinjal,2015,789,2026,1237,156.78073510773132
Sinner,Gram,2014,1882,3119,1237,65.7279489904357
Ambejogai,Gram,2016,5565,6802,1237,22.228212039532796
Solapur,Matki,2015,6713,7950,1237,18.42693281692239
Mumbai,Pineapple,2014,1373,2609,1236,90.02184996358339
Lasalgaon-Vinchur,Gram,2015,3064,4300,1236,40.33942558746736
Manchar,Flower,2016,1005,2241,1236,122.98507462686567
Solapur,Matki,2015,5097,6333,1236,24.249558563861093
Kolhapur,Bor,2016,764,2000,1236,161.7801047120419
Nashik,Ginger (Fresh),2016,2329,3564,1235,53.02705023615285
Manchar,Flower,2014,325,1560,1235,380.0
Udgir,Pigeon Pea (Tur),2015,4837,6072,1235,25.532354765350423
Jalgaon,Coriander  ,2016,1413,2648,1235,87.40268931351734
Jalgaon,Brinjal,2016,974,2209,1235,126.79671457905545
Kalyan,Custard Apple,2015,3044,4278,1234,40.53876478318003
Ahmednagar,Ground Nut Pods (Dry),2015,2733,3967,1234,45.15184778631541
Nashik,Capsicum,2016,1387,2621,1234,88.9689978370584
Kurdwadi-Modnimb,Bor,2015,933,2167,1234,132.2615219721329
Balapur,Black Gram,2015,7333,8567,1234,16.82803763807446
Indapur-Bhigwan,SORGUM(JAWAR),2016,1800,3034,1234,68.55555555555556
Basmat,Turmeric,2015,7650,8884,1234,16.130718954248366
Manchar,Ground Nut Pods (Dry),2016,3167,4400,1233,38.932743921692456
Kolhapur,Strawberi,2015,1100,2333,1233,112.0909090909091
Rahuri-Songaon,Brinjal,2016,867,2100,1233,142.21453287197232
Kolhapur-Laxmipuri,Spilt Pigeon Pea,2016,10500,11733,1233,11.742857142857142
Kamthi,Lemon,2014,1400,2633,1233,88.07142857142857
Pune,Ladies Finger,2015,774,2007,1233,159.30232558139534
Pune-Manjri,Methi (Bhaji),2016,689,1922,1233,178.95500725689405
Kamthi,Tomato,2015,1219,2452,1233,101.14848236259229
Palus,Bitter Gourd,2016,3500,4733,1233,35.22857142857143
Palus,Brinjal,2016,767,2000,1233,160.7561929595828
Kamthi,Cucumber,2015,1468,2700,1232,83.92370572207085
Dhule,Pigeon Pea (Tur),2016,6572,7804,1232,18.746195982958003
Barshi,Onion,2014,189,1421,1232,651.8518518518518
Manchar,Coriander  ,2015,538,1770,1232,228.99628252788105
Bhokar,Turmeric,2015,6100,7332,1232,20.19672131147541
Mumbai,Orange,2014,1404,2636,1232,87.74928774928775
Mangalwedha,Green Chilli,2015,3000,4232,1232,41.06666666666667
Nashik,Ginger (Fresh),2016,2373,3605,1232,51.91740412979351
Barshi-Vairag,Sorgum(Jawar),2015,1217,2449,1232,101.23253903040263
Mangalwedha,Green Chilli,2014,1248,2480,1232,98.71794871794872
Mumbai,Spilt Gerrn Gram,2014,8016,9247,1231,15.356786427145709
Pune,Elephant Root,2015,1500,2731,1231,82.06666666666666
Pune,Rice(Paddy-Hus),2016,4250,5481,1231,28.96470588235294
Kamthi,Flower,2015,1004,2235,1231,122.60956175298804
Jamkhed,Coriander (Dry),2014,8346,9577,1231,14.749580637431105
Nashik,Banana,2016,1024,2255,1231,120.21484375
Ramtek,Pigeon Pea (Tur),2016,6928,8158,1230,17.754041570438797
Dhule,Onion,2015,358,1588,1230,343.5754189944134
Karad,Garlic,2016,7212,8442,1230,17.054908485856906
Kamthi,Potato,2014,1820,3050,1230,67.58241758241758
Paranda,Gram,2015,3000,4230,1230,41.0
Lasalgaon-Vinchur,Gram,2016,3050,4280,1230,40.32786885245902
Pune,Chavli (Shenga ),2015,1085,2315,1230,113.36405529953917
Paithan,Pigeon Pea (Tur),2016,6736,7966,1230,18.260095011876484
Armori,Ground Nut Pods (Dry),2015,3274,4504,1230,37.56872327428222
Ahmednagar,Ghosali(Bhaji),2016,500,1730,1230,246.0
Solapur,Chikoo,2016,788,2018,1230,156.09137055837564
Rahata,Tomato,2015,1170,2400,1230,105.12820512820512
Lasur Station,Gram,2016,6354,7584,1230,19.357884796978283
Pune,Rice(Paddy-Hus),2016,4414,5643,1229,27.84322609877662
Pune,Bitter Gourd,2015,1933,3162,1229,63.57992757371961
Basmat,Turmeric,2015,9617,10846,1229,12.779453051887282
Kalamb (Os),Gram,2015,3816,5045,1229,32.206498951781974
Parner,Onion,2015,500,1728,1228,245.6
Kille Dharur,Pigeon Pea (Tur),2015,5170,6398,1228,23.752417794970988
Karmala,Black Gram,2016,5765,6993,1228,21.300954032957502
Kolhapur,Tomato,2015,386,1614,1228,318.13471502590676
Kalamb (Os),Pigeon Pea (Tur),2015,7832,9060,1228,15.67926455566905
Pune,Green-Peas,2015,2000,3228,1228,61.4
Kamthi,Lemon,2015,586,1814,1228,209.55631399317406
Kamthi,Wal Bhaji,2015,1368,2596,1228,89.76608187134502
Jalgaon,Green Chilli,2014,1577,2805,1228,77.86937222574508
Kamthi,Raddish,2015,883,2110,1227,138.9580973952435
Kamthi,Lemon,2016,1268,2495,1227,96.76656151419559
Shirpur,Black Gram,2015,8500,9727,1227,14.435294117647059
Mumbai,Cowpea,2016,5173,6400,1227,23.71931181132805
Dondaicha,Gram,2016,7942,9169,1227,15.449508939813649
Sindi,Pigeon Pea (Tur),2016,6785,8012,1227,18.08400884303611
Kalyan,APPLE,2016,3155,4382,1227,38.890649762282095
Mumbai,Split Black Gram,2015,6835,8062,1227,17.95171909290417
Pune,Green Peas (Dry),2016,3268,4495,1227,37.545899632802936
Kalamb (Os),Pigeon Pea (Tur),2016,6720,7946,1226,18.24404761904762
Chalisgaon,Wheat(Husked),2016,1444,2670,1226,84.90304709141274
Nashik,Capsicum,2015,1549,2775,1226,79.14783731439638
Nashik,Ghosali(Bhaji),2016,1668,2894,1226,73.50119904076739
Kamthi,Tomato,2015,619,1845,1226,198.06138933764134
Pachora,Pigeon Pea (Tur),2016,7000,8226,1226,17.514285714285716
Vadgaon Peth,Ladies Finger,2016,1448,2674,1226,84.66850828729282
Kada,Sorgum(Jawar),2014,1536,2761,1225,79.75260416666667
Jalgaon,Brinjal,2016,1405,2630,1225,87.18861209964413
Pandharpur,Coriander  ,2015,442,1667,1225,277.14932126696834
Kolhapur-Malkapur,Cabbage,2016,750,1975,1225,163.33333333333334
Ahmednagar,Black Gram,2015,5950,7175,1225,20.58823529411765
Umared,Pigeon Pea (Tur),2016,7074,8299,1225,17.316935255866554
Chandrapur-Ganjwad,Garlic,2015,6250,7475,1225,19.6
Chandrapur-Ganjwad,Coriander  ,2016,700,1925,1225,175.0
Jalgaon Jamod-Aasalgaon,Pigeon Pea (Tur),2015,5050,6275,1225,24.257425742574256
Satara,Ginger (Fresh),2015,1775,3000,1225,69.01408450704226
Mumbai,Guava,2015,1021,2246,1225,119.98041136141038
Kolhapur,Kanda Pat,2016,1575,2800,1225,77.77777777777777
Sangrampur-Varvatbakal,Pigeon Pea (Tur),2016,7342,8567,1225,16.684827022609642
Akluj,Bitter Gourd,2016,1638,2863,1225,74.78632478632478
Sinner,Black Gram,2015,7275,8500,1225,16.83848797250859
Aurangabad,Orange,2015,1125,2350,1225,108.88888888888889
Jalgaon,Coriander  ,2015,981,2206,1225,124.87257900101937
Mumbai,Mosambi,2014,1529,2754,1225,80.11772400261609
Pune,Ridge Gourd,2015,1246,2471,1225,98.31460674157303
Barshi,Sorgum(Jawar),2015,1432,2657,1225,85.54469273743017
Chandrapur,Banana,2014,800,2025,1225,153.125
Ahmednagar,Cabbage,2016,420,1645,1225,291.6666666666667
Manchar,Squash Gourd,2016,3900,5125,1225,31.41025641025641
Sangamner,ONION,2016,373,1597,1224,328.15013404825737
Kamthi,Carrot,2016,1294,2518,1224,94.5904173106646
Vaijapur,Ground Nut Pods (Dry),2015,4873,6097,1224,25.117997127026474
Barshi,Sorgum(Jawar),2014,1358,2582,1224,90.13254786450663
Kalyan,Small Gourd,2015,1624,2848,1224,75.36945812807882
Nagpur,Mosambi,2015,1156,2380,1224,105.88235294117646
Barshi,SORGUM(JAWAR),2016,1790,3013,1223,68.32402234636872
Pune-Manjri,Bitter Gourd,2014,2854,4077,1223,42.85213735108619
Latur-Murud,Gram,2015,3242,4465,1223,37.72362739049969
Pune-Manjri,Cucumber,2016,1657,2880,1223,73.80808690404345
Latur,Green Gram,2015,6938,8161,1223,17.62755837417123
Satara,Onion,2015,3633,4856,1223,33.66363886595101
Solapur,Bor,2014,333,1556,1223,367.26726726726724
Kalamb (Os),Wheat(Husked),2016,2920,4143,1223,41.88356164383562
Pune-Manjri,Bottle Gourd,2016,1017,2240,1223,120.25565388397247
Mumbai,Brinjal,2015,1356,2578,1222,90.11799410029498
Kamthi,Orange,2015,778,2000,1222,157.0694087403599
Shirpur,Onion,2014,347,1569,1222,352.1613832853026
Kamthi,Onion,2014,1111,2333,1222,109.99099909990998
Osmanabad,Flower,2016,1406,2628,1222,86.91322901849217
Satara,Green Chilli,2016,4537,5759,1222,26.93409742120344
Vadgaon Peth,Cucumber,2016,1611,2833,1222,75.85350713842334
Akluj,Carrot,2015,2278,3500,1222,53.64354697102722
Vadgaon Peth,Ladies Finger,2016,1407,2629,1222,86.85145700071074
Karad,Garlic,2016,5815,7037,1222,21.0146173688736
Karad,Green-Peas,2016,6056,7278,1222,20.178335535006607
Mumbai,Guava,2016,873,2095,1222,139.9770904925544
Kamthi,Methi (Bhaji),2016,1339,2561,1222,91.2621359223301
Vadgaon Peth,Pavtta,2015,1806,3028,1222,67.66334440753046
Khed,Farshi,2016,1071,2293,1222,114.09897292250234
Satara,Ginger (Fresh),2016,1400,2622,1222,87.28571428571429
Dhule,Gram,2016,3541,4763,1222,34.510025416549
Amarawati,Sorgum(Jawar),2016,1800,3021,1221,67.83333333333333
Shirpur,Ground Nut Pods (Dry),2015,3310,4531,1221,36.88821752265861
Kolhapur,Capsicum,2016,542,1763,1221,225.27675276752768
Rahata,Tomato,2015,850,2071,1221,143.64705882352942
Udgir,Gram,2015,2542,3763,1221,48.033044846577496
Pune-Manjri,Ambat Chuka,2015,0,1221,1221,inf
Sangli-Phale Bhajipalam,Potato,2016,996,2217,1221,122.59036144578313
Manwat,Green Gram,2015,7818,9039,1221,15.617805065234075
Pune,Brinjal,2015,742,1963,1221,164.55525606469
Nandura,Gram,2016,5536,6756,1220,22.03757225433526
Mumbai,Small Gourd,2016,1232,2452,1220,99.02597402597402
Solapur,Green Chilli,2016,2899,4119,1220,42.08347706105554
Kalvan,Ground Nut Pods (Dry),2015,4150,5370,1220,29.397590361445783
Mumbai,Split Lentil,2016,5888,7108,1220,20.720108695652176
Vadgaon Peth,Pavtta,2015,1967,3187,1220,62.023385866802236
Phaltan,Sorgum(Jawar),2014,1588,2808,1220,76.82619647355163
Karad,Pomegranate,2016,4000,5220,1220,30.5
Osmanabad,Cucumber,2016,700,1920,1220,174.28571428571428
Osmanabad,Capsicum,2016,1760,2980,1220,69.31818181818181
Sailu,Green Gram,2014,5043,6263,1220,24.191949236565538
Sangamner,Tomato,2016,805,2025,1220,151.5527950310559
Kamthi,Potato,2016,540,1760,1220,225.92592592592592
Lasur Station,Pigeon Pea (Tur),2015,6950,8169,1219,17.53956834532374
Sailu,Cotton,2016,3981,5200,1219,30.620447123838233
Jalna,Sorgum(Jawar),2016,1551,2770,1219,78.59445519019987
Solapur,Chikoo,2016,552,1771,1219,220.83333333333334
Kamthi,Raddish,2014,1043,2261,1218,116.77852348993288
Kolhapur,Pineapple,2015,418,1636,1218,291.3875598086124
Nashik,Kharbuj,2016,1100,2318,1218,110.72727272727273
Vadgaon Peth,Brinjal,2016,1141,2359,1218,106.74846625766871
Kamthi,Lemon,2015,1327,2545,1218,91.78598342125095
Kamthi,Beet Root,2015,1555,2773,1218,78.32797427652733
Dhule,Onion,2014,558,1776,1218,218.27956989247312
Tasgaon,Tamarind,2015,4148,5366,1218,29.36354869816779
Sangali,Lentil,2015,6500,7717,1217,18.723076923076924
Udgir,Black Gram,2015,4573,5790,1217,26.612726875136673
Solapur,Guava,2014,1030,2247,1217,118.15533980582525
Kalyan,CAPSICUM,2016,1175,2392,1217,103.57446808510639
Pune,Ghosali(Bhaji),2015,983,2200,1217,123.80467955239064
Pune-Manjri,Walvad,2015,2557,3774,1217,47.59483770043019
Akluj,Onion,2016,918,2135,1217,132.57080610021785
Kamthi,Lemon,2016,961,2178,1217,126.63891779396462
Jalgaon,Bitter Gourd,2016,3083,4300,1217,39.47453778786896
Osmanabad,Kharbuj,2016,1117,2333,1216,108.86302596239928
Kolhapur,Bottle Gourd,2016,547,1763,1216,222.3034734917733
Mumbai,Green-Peas,2014,5588,6804,1216,21.760916249105225
Manchar,Methi (Bhaji),2016,463,1679,1216,262.6349892008639
Mangalwedha,Ridge Gourd,2015,819,2035,1216,148.4737484737485
Mumbai,Ladies Finger,2014,1048,2264,1216,116.03053435114504
Mumbai,Ginger (Dry),2015,2088,3304,1216,58.23754789272031
Mumbai,Ginger (Dry),2015,1919,3135,1216,63.366336633663366
Mangalwedha,Tomato,2015,248,1463,1215,489.9193548387097
Lasalgaon,Soybean,2016,2525,3740,1215,48.118811881188115
Karad,GREEN-PEAS,2016,5714,6929,1215,21.263563178158908
Nashik,Methi (Bhaji),2016,937,2152,1215,129.6691568836713
Mumbai,Split Black Gram,2015,10452,11667,1215,11.624569460390356
Solapur,Guava,2015,877,2092,1215,138.54047890535918
Parner,Onion,2015,600,1815,1215,202.5
Pune-Manjri,Goosefoot,2014,90,1305,1215,1350.0
Karad,Shevga,2014,4714,5929,1215,25.77428935086975
Telhara,GRAM,2016,6915,8130,1215,17.570498915401302
Jamkhed,Sorgum(Jawar),2014,1741,2956,1215,69.7874784606548
Kopargaon,Onion,2015,303,1518,1215,400.990099009901
Dhule,Green Gram,2016,4143,5357,1214,29.302437846970793
Mumbai,Guava,2014,1377,2591,1214,88.16267247639797
Chandrapur-Ganjwad,Capsicum,2016,3036,4250,1214,39.98682476943347
Umarga,Sesamum,2015,5675,6889,1214,21.3920704845815
Jalgaon,Ginger (Fresh),2016,2329,3543,1214,52.125375697724344
Pune,Walvad,2015,1809,3023,1214,67.10889994472085
Gevrai,Sesamum,2014,10925,12138,1213,11.102974828375286
Pune-Manjri,Chavli (Shenga ),2014,1260,2473,1213,96.26984126984127
Phaltan,Ladies Finger,2016,2675,3888,1213,45.345794392523366
Kalvan,Onion,2015,330,1543,1213,367.57575757575756
Ahmednagar,Ground Nut Pods (Dry),2016,3114,4327,1213,38.953114964675656
Akluj,Brinjal,2016,1629,2842,1213,74.46286065070595
Katol,Ground Nut Pods (Dry),2016,4147,5360,1213,29.250060284543043
Sakri,Ground Nut Pods (Dry),2015,2834,4047,1213,42.80169371912491
Nashik,LADIES FINGER,2016,1672,2884,1212,72.48803827751196
Chikhali,Gram,2016,6360,7572,1212,19.056603773584907
Satara,Ginger (Fresh),2014,3313,4525,1212,36.58315725928162
Ambejogai,Pigeon Pea (Tur),2016,7292,8504,1212,16.62095447065277
Balapur,Pigeon Pea (Tur),2015,4388,5600,1212,27.620783956244303
Indapur-Bhigwan,Black Gram,2016,10138,11350,1212,11.955020714144801
Balapur,Green Gram,2016,6038,7250,1212,20.07287181185823
Pune-Manjri,Cabbage,2016,546,1758,1212,221.97802197802199
Kolhapur,Shepu,2015,1265,2477,1212,95.81027667984189
Chandrapur,Papai,2016,1513,2725,1212,80.10575016523464
Kamthi,Kanda Pat,2016,621,1832,1211,195.00805152979066
Barshi-Vairag,Sorgum(Jawar),2015,1307,2518,1211,92.65493496557
Katol,Pigeon Pea (Tur),2016,7274,8485,1211,16.648336541105305
Pune-Manjri,Ridge Gourd,2014,1742,2953,1211,69.51779563719862
Sangali,Wheat(Husked),2014,1611,2822,1211,75.17070142768466
Kurdwadi-Modnimb,Onion,2015,205,1416,1211,590.7317073170732
Nashik,Ginger (Fresh),2016,2383,3594,1211,50.81829626521192
Vadgaon Peth,Ladies Finger,2016,1589,2800,1211,76.2114537444934
Akkolkot,Pigeon Pea (Tur),2015,10859,12070,1211,11.152039782668753
Kamthi,Pumpkin,2015,550,1761,1211,220.1818181818182
Pune-Manjri,Raddish,2016,1027,2238,1211,117.91626095423564
Kolhapur,Papai,2015,447,1657,1210,270.69351230425053
Pune-Manjri,SHEPU,2016,890,2100,1210,135.95505617977528
Kolhapur,Spinach,2015,1495,2705,1210,80.93645484949833
Pune,Black Gram,2016,13200,14410,1210,9.166666666666666
Amarawati,Lemon,2016,1979,3189,1210,61.14199090449722
Kada,ONION,2016,110,1320,1210,1100.0
Mangalwedha,Tomato,2014,298,1508,1210,406.0402684563758
Pune,Capsicum,2016,1840,3050,1210,65.76086956521739
Junnar (Narayangaon),Tomato,2015,2306,3516,1210,52.47181266261926
Phaltan,Onion,2015,440,1650,1210,275.0
Ausa,Wheat(Husked),2016,1591,2801,1210,76.05279698302954
Sangrampur,Green Gram,2015,6270,7480,1210,19.29824561403509
Ashti-Karanja,Pigeon Pea (Tur),2016,7506,8715,1209,16.107114308553157
Tumsar,Rice(Paddy-Hus),2014,2394,3603,1209,50.50125313283208
Pune,Parwar,2016,1967,3176,1209,61.46415861718353
Ahmednagar,Ground Nut Pods (Dry),2016,3077,4286,1209,39.2915177120572
Katol,Ground Nut Pods (Dry),2014,2998,4207,1209,40.32688458972648
Kalamb (Os),Pigeon Pea (Tur),2016,6215,7424,1209,19.452936444086887
Karad,Garlic,2014,3083,4292,1209,39.21505027570548
Kamthi,Chavli (Pala),2014,952,2161,1209,126.99579831932773
Mumbai,Pineapple,2015,1000,2208,1208,120.8
Newasa-Ghodegaon,ONION,2016,177,1385,1208,682.4858757062146
Nashik,Ghosali(Bhaji),2015,1482,2690,1208,81.5114709851552
Ulhasnagar,Gr.Nut Kernels,2016,7375,8583,1208,16.379661016949154
Pune-Manjri,Squash Gourd,2016,3625,4833,1208,33.324137931034485
Rahata,Tomato,2015,675,1883,1208,178.96296296296296
Mumbai,Pineapple,2014,1320,2528,1208,91.51515151515152
Nandgaon,Ground Nut Pods (Dry),2014,2368,3576,1208,51.013513513513516
Osmanabad,Carrot,2015,846,2054,1208,142.78959810874704
Sailu,Cotton,2016,3799,5007,1208,31.797841537246644
Vadgaon Peth,Brinjal,2015,925,2132,1207,130.48648648648648
Barshi,Green Gram,2014,6366,7573,1207,18.96010053408734
Jalna,Green Gram,2014,6864,8071,1207,17.584498834498834
Dound,Green Gram,2015,5988,7195,1207,20.15698062792251
Sangali,Sorgum(Jawar),2014,1620,2827,1207,74.50617283950618
Indapur (Nimgaon Ketki),Gram,2015,2784,3991,1207,43.354885057471265
Latur,Wheat(Husked),2014,1576,2783,1207,76.58629441624366
Mehkar,Gram,2016,5656,6863,1207,21.34016973125884
Khamgaon,Green Gram,2015,6088,7295,1207,19.82588699080158
Pune-Manjri,Cucumber,2016,1208,2415,1207,99.91721854304636
Kamthi,Capsicum,2015,1489,2696,1207,81.06111484217595
Kamthi,Guava,2015,739,1946,1207,163.32882273342355
Jalgaon,Lemon,2014,2383,3589,1206,50.60847671002937
Ahmednagar,Ground Nut Pods (Dry),2016,3569,4775,1206,33.79097786494817
Dondaicha-Sindkheda,Gram,2016,3966,5172,1206,30.408472012102873
Pandharpur,Onion,2014,450,1656,1206,268.0
Aurangabad,Mango,2016,2019,3225,1206,59.73254086181278
Pune,Chavli (Shenga ),2016,1924,3129,1205,62.62993762993763
Nagpur,Potato,2014,1285,2490,1205,93.77431906614785
Sangli-Phale Bhajipalam,Water Melon,2016,325,1530,1205,370.7692307692308
Indapur-Bhigwan,Wheat(Husked),2015,1345,2550,1205,89.59107806691449
Pune,Rice(Paddy-Hus),2015,4204,5409,1205,28.663177925784968
Khamgaon,Pigeon Pea (Tur),2016,5367,6572,1205,22.452021613564376
Kalvan,Onion,2015,450,1655,1205,267.77777777777777
Pune-Pimpri,Rice(Paddy-Hus),2015,3800,5005,1205,31.710526315789473
Jintur,Turmeric,2015,7065,8270,1205,17.05590941259731
Solapur,Brinjal,2016,254,1458,1204,474.01574803149606
Pune,Beet Root,2016,848,2052,1204,141.9811320754717
Pune,Tomato,2014,948,2152,1204,127.0042194092827
Pune-Manjri,Ridge Gourd,2015,1586,2790,1204,75.91424968474149
Latur,Black Gram,2015,6965,8169,1204,17.28643216080402
Ulhasnagar,Gr.Nut Kernels,2016,7364,8568,1204,16.34980988593156
Pune-Manjri,Cucumber,2016,1721,2925,1204,69.95932597327135
Dhule,Onion,2014,214,1418,1204,562.6168224299065
Kalyan,Ghevda,2016,7440,8644,1204,16.182795698924732
Nilanga,Green Gram,2015,6744,7948,1204,17.852906287069988
Mangalwedha,Cucumber,2015,304,1508,1204,396.05263157894734
Pune,Green Peas (Dry),2016,3200,4403,1203,37.59375
Shegaon,Pigeon Pea (Tur),2015,4672,5875,1203,25.749143835616437
Solapur,Tomato,2015,215,1417,1202,559.0697674418604
Ambad(Vadi Godri),Pigeon Pea (Tur),2016,7051,8253,1202,17.0472273436392
Nashik,Brinjal,2016,1990,3192,1202,60.402010050251256
Kurdwadi-Modnimb,Sorgum(Jawar),2016,1346,2548,1202,89.30163447251114
Mandhal,CHILLIES(RED),2016,3945,5147,1202,30.46894803548796
Dhule,Onion,2015,420,1622,1202,286.1904761904762
Dondaicha,Green Gram,2015,7450,8652,1202,16.13422818791946
Shahada,Gram,2015,3505,4707,1202,34.29386590584879
Solapur,Capsicum,2015,1087,2289,1202,110.57957681692733
Jalna,Pigeon Pea (Tur),2015,4779,5981,1202,25.15170537769408
Latur-Murud,Wheat(Husked),2015,1300,2501,1201,92.38461538461539
Indapur,Wheat(Husked),2015,1400,2601,1201,85.78571428571429
Amalner,Sesamum,2014,9800,11001,1201,12.255102040816327
Hinganghat,Gram,2015,3263,4464,1201,36.80661967514557
Shegaon,Black Gram,2016,5930,7131,1201,20.252951096121418
Nagpur,GREEN GRAM,2016,5000,6200,1200,24.0
Pune-Manjri,Flower,2014,995,2195,1200,120.60301507537689
Pune-Manjri,Chavli (Pala),2016,300,1500,1200,400.0
Kamthi,Mosambi,2016,800,2000,1200,150.0
Mumbai,Coconut,2016,633,1833,1200,189.5734597156398
Sangli-Phale Bhajipalam,Bor,2015,800,2000,1200,150.0
Kada,Onion,2015,300,1500,1200,400.0
Satara,Ginger (Fresh),2016,1333,2533,1200,90.0225056264066
Pune-Manjri,Other Vegetables,2016,0,1200,1200,inf
Pune-Manjri,Cucumber,2015,971,2171,1200,123.58393408856848
Mumbai,Mosambi,2014,1442,2642,1200,83.21775312066575
Kamthi,Mosambi,2015,800,2000,1200,150.0
Osmanabad,Ridge Gourd,2015,1050,2250,1200,114.28571428571429
Jalgaon,Chavli (Shenga ),2016,3565,4765,1200,33.66058906030855
Kalyan,Mango,2016,4200,5400,1200,28.571428571428573
Kamthi,Small Gourd,2015,467,1667,1200,256.9593147751606
Ahmednagar,Pigeon Pea (Tur),2016,5000,6200,1200,24.0
Sangli-Phale Bhajipalam,Bor,2015,800,2000,1200,150.0
Shrirampur,Mosambi,2015,2200,3400,1200,54.54545454545455
Vadgaon Peth,Ridge Gourd,2015,1850,3050,1200,64.86486486486487
Hingna,Pigeon Pea (Tur),2015,5200,6400,1200,23.076923076923077
Pune-Pimpri,Parwar,2016,2000,3200,1200,60.0
Akkalkuwa,Green Gram,2015,6000,7200,1200,20.0
Kamthi,Papai,2015,800,2000,1200,150.0
Nashik,Orange,2015,800,2000,1200,150.0
Mangrulpeer,Black Gram,2016,8100,9300,1200,14.814814814814815
Pune,Wal Bhaji,2015,1500,2700,1200,80.0
Pune,WALVAD,2016,1012,2212,1200,118.57707509881423
Solapur,Matki,2016,5167,6367,1200,23.224308109154247
Pune-Manjri,Hemp,2014,71,1271,1200,1690.1408450704225
Kamthi,Amla,2016,1800,3000,1200,66.66666666666667
Pachora,Green Gram,2016,5767,6967,1200,20.808045777700713
Chandrapur,Kharbuj,2016,800,2000,1200,150.0
Nandurbar,Chillies(Red),2016,10000,11200,1200,12.0
Kamthi,Beet Root,2016,1700,2900,1200,70.58823529411765
Akole,Gram,2016,3300,4500,1200,36.36363636363637
Ahmednagar,Ginger (Fresh),2015,1800,3000,1200,66.66666666666667
Raver,Black Gram,2016,5066,6266,1200,23.68732727990525
Nanded,Green Gram,2016,6000,7200,1200,20.0
Mumbai,Coconut,2016,800,2000,1200,150.0
Karmala,SORGUM(JAWAR),2016,1713,2913,1200,70.05253940455341
Kolhapur,Bitter Gourd,2015,1800,3000,1200,66.66666666666667
Patur,Pigeon Pea (Tur),2015,4500,5700,1200,26.666666666666668
Pune,Chillies(Red),2016,13350,14550,1200,8.98876404494382
Pune,Chavli (Pala),2015,800,2000,1200,150.0
Kamthi,Beet Root,2016,1057,2257,1200,113.52885525070955
Patur,Green Gram,2015,5500,6700,1200,21.818181818181817
Ratanagari,Bottle Gourd,2016,800,2000,1200,150.0
Akluj,Ladies Finger,2015,1467,2667,1200,81.79959100204499
Pune-Pimpri,Dhemse,2016,2000,3200,1200,60.0
Akluj,Bitter Gourd,2016,1563,2763,1200,76.77543186180422
Ahmednagar,CARROT,2016,1000,2200,1200,120.0
Chalisgaon,Flower,2016,900,2100,1200,133.33333333333334
Pune,Wal Bhaji,2016,1800,3000,1200,66.66666666666667
Kamthi,Chavli (Pala),2015,800,2000,1200,150.0
Nira-Saswad,Ghevda Seed,2016,1350,2550,1200,88.88888888888889
Mumbai,Coconut,2016,300,1500,1200,400.0
Mumbai,French Bean,2014,1000,2200,1200,120.0
Mantha,Sesamum,2016,5667,6867,1200,21.175224986765485
Pune-Manjri,Methi (Bhaji),2015,980,2180,1200,122.44897959183673
Kamthi,Cluster Bean,2016,1200,2400,1200,100.0
Kalyan,Black Gram,2015,10500,11700,1200,11.428571428571429
Pune,Sweet Potato,2015,1294,2494,1200,92.73570324574962
Kamthi,Lemon,2015,1281,2481,1200,93.6768149882904
Chandrapur,Mosambi,2015,1000,2200,1200,120.0
Pune-Manjri,Shepu,2016,900,2100,1200,133.33333333333334
Osmanabad,BOR,2016,950,2150,1200,126.3157894736842
Dhule,Sesamum,2016,4788,5988,1200,25.06265664160401
Osmanabad,Brinjal,2016,720,1920,1200,166.66666666666666
Chalisgaon,Ginger (Fresh),2016,2000,3200,1200,60.0
Mumbai,Green Peas (Dry),2016,2800,4000,1200,42.857142857142854
Akluj,Coriander  ,2015,2000,3200,1200,60.0
Mumbai,Green Peas (Dry),2016,2800,4000,1200,42.857142857142854
Kamthi,Wal Bhaji,2016,1264,2464,1200,94.9367088607595
Akluj,Garlic,2015,3050,4250,1200,39.34426229508197
Pune-Manjri,WALVAD,2016,1314,2514,1200,91.32420091324201
Jalgaon,Custard Apple,2014,5100,6300,1200,23.529411764705884
Balapur,Pigeon Pea (Tur),2016,7100,8300,1200,16.901408450704224
Manchar,Flower,2016,332,1532,1200,361.4457831325301
Osmanabad,Chikoo,2015,1175,2375,1200,102.12765957446808
Mumbai,COCONUT,2016,800,2000,1200,150.0
Pune-Pimpri,Black Gram,2016,10800,12000,1200,11.11111111111111
Indapur-Bhigwan,Black Gram,2016,7667,8867,1200,15.651493413329856
Kamthi,Amla,2015,800,2000,1200,150.0
Nashik,Bottle Gourd,2016,1288,2488,1200,93.16770186335404
Jalgaon,Mosambi,2014,1000,2200,1200,120.0
Pathardi,Gram,2016,6500,7700,1200,18.46153846153846
Pune-Manjri,Hemp,2015,0,1200,1200,inf
Kolhapur,Maize(Corn.),2016,300,1500,1200,400.0
Nashik,Tomato,2015,800,2000,1200,150.0
Akluj,Garlic,2014,2925,4125,1200,41.02564102564103
Kurdwadi-Modnimb,Gram,2015,3151,4351,1200,38.08314820691844
Patan,Cluster Bean,2015,2300,3500,1200,52.17391304347826
Kalyan,Green-Peas,2016,9600,10800,1200,12.5
Mumbai,Onion,2015,3917,5117,1200,30.635690579525146
Pathari,Soybean,2016,2588,3788,1200,46.36785162287481
Chandrapur,Water Melon,2016,800,2000,1200,150.0
Osmanabad,Ghevda,2015,1500,2700,1200,80.0
Jamkhed,Gram,2016,4027,5227,1200,29.79885771045443
Pune-Manjri,Shepu,2014,900,2100,1200,133.33333333333334
Ghoti,Ladies Finger,2016,1800,3000,1200,66.66666666666667
Basmat (Kurunda),Turmeric,2016,6500,7700,1200,18.46153846153846
Kalyan,Gr.Nut Kernels,2015,6875,8075,1200,17.454545454545453
Kalyan,Gr.Nut Kernels,2015,6800,8000,1200,17.647058823529413
Kamthi,Mint,2016,1554,2754,1200,77.22007722007721
Karad,Shevga,2015,5400,6600,1200,22.22222222222222
Pune-Manjri,Spinach,2015,967,2167,1200,124.09513960703205
Satara,Capsicum,2016,4675,5875,1200,25.668449197860962
Nandgaon,Pigeon Pea (Tur),2015,6501,7700,1199,18.44331641285956
Nandura,Pigeon Pea (Tur),2016,7991,9190,1199,15.004379927418345
Devala,Gram,2015,3862,5061,1199,31.04609010875194
Kurdwadi,Onion,2016,144,1342,1198,831.9444444444445
Solapur,Potato,2014,1473,2671,1198,81.3306177868296
Nandura,Gram,2016,8079,9277,1198,14.82856789206585
Nashik,Potato,2016,590,1787,1197,202.88135593220338
Amarawati,Sesamum,2016,6913,8110,1197,17.315203240271952
Satana,Green Gram,2016,4073,5270,1197,29.38865700957525
Pune-Manjri,Coriander  ,2016,667,1863,1196,179.31034482758622
Malegaon,Gram,2016,3483,4679,1196,34.338214183175424
Pune,Green-Peas,2015,1614,2810,1196,74.10161090458489
Pune,Ghevda,2016,2000,3196,1196,59.8
Pune,CUCUMBER,2016,929,2125,1196,128.740581270183
Pune,Ginger (Fresh),2015,2354,3550,1196,50.8071367884452
Mangalwedha,Tomato,2015,250,1446,1196,478.4
Kamthi,Cabbage,2016,1347,2543,1196,88.78990348923534
Mumbai,Orange,2014,1776,2972,1196,67.34234234234235
Nagpur,Grapes,2015,2580,3776,1196,46.35658914728682
Pune-Manjri,Bitter Gourd,2015,1876,3072,1196,63.75266524520256
Kolhapur-Laxmipuri,Split Black Gram,2015,15972,17167,1195,7.481843225644878
Mumbai,Guava,2014,1529,2724,1195,78.15565729234794
Risod,Turmeric,2016,7605,8800,1195,15.713346482577252
Pathardi,Onion,2015,238,1433,1195,502.10084033613447
Pune-Manjri,Pavtta,2014,2621,3816,1195,45.593285005723004
Vadgaon Peth,Flower,2015,843,2038,1195,141.7556346381969
Shrirampur,Onion,2015,200,1395,1195,597.5
Jamkhed,Sorgum(Jawar),2014,1867,3062,1195,64.00642742367434
Shirpur,Green Gram,2015,7096,8291,1195,16.840473506200677
Pune,Flower,2016,748,1943,1195,159.75935828877004
Vadgaon Peth,Capsicum,2016,1333,2528,1195,89.64741185296324
Sangali,Jaggery,2015,2035,3229,1194,58.67321867321867
Malkapur,Green Gram,2014,6609,7803,1194,18.066273263731276
Jamkhed,Onion,2016,106,1300,1194,1126.4150943396226
Pune-Manjri,Pavtta,2016,3416,4610,1194,34.95316159250586
Dudhani,Black Gram,2016,6266,7460,1194,19.05521864028088
Akole,Onion,2015,138,1332,1194,865.2173913043479
Gevrai,Pigeon Pea (Tur),2015,5067,6261,1194,23.564239194789817
Telhara,Pigeon Pea (Tur),2015,7089,8283,1194,16.842996191282268
Palghar(Bevur),Rice(Paddy-Hus),2016,2269,3462,1193,52.57822829440282
Kamthi,Chavli (Shenga ),2016,1088,2281,1193,109.65073529411765
Aurangabad,Fig,2015,2870,4063,1193,41.56794425087108
Nashik,Mango(Raw),2016,2187,3380,1193,54.549611339734795
Mangrulpeer,Pigeon Pea (Tur),2015,8315,9508,1193,14.347564642212868
Ratanagari,Tomato,2014,1280,2473,1193,93.203125
Amalner,Gram,2016,7685,8878,1193,15.523747560182173
Kamthi,Potato,2016,1021,2214,1193,116.8462291870715
Junnar-Otur,Ground Nut Pods (Dry),2016,1663,2856,1193,71.73782321106434
Vai,Green-Peas,2014,3615,4808,1193,33.00138312586446
Phaltan,Tomato,2016,1719,2912,1193,69.40081442699244
Mumbai,Chikoo,2016,1272,2465,1193,93.78930817610063
Kada,Sorgum(Jawar),2015,1771,2963,1192,67.30660643704122
Pune-Manjri,Chavli (Shenga ),2015,1379,2571,1192,86.4394488759971
Satara,Green-Peas,2014,4808,6000,1192,24.792013311148086
Karanja,Green Gram,2014,5061,6253,1192,23.552657577553845
Pune,SQUASH GOURD,2016,1488,2680,1192,80.10752688172043
Kamthi,Small Gourd,2015,1343,2535,1192,88.75651526433359
Kamthi,Kanda Pat,2016,575,1767,1192,207.30434782608697
Yeola,Onion,2014,446,1638,1192,267.2645739910314
Vadgaon Peth,Green Chilli,2016,1923,3115,1192,61.98647945917837
Mangrulpeer,Pigeon Pea (Tur),2015,4904,6096,1192,24.306688417618272
Pachora,Gram,2016,3931,5123,1192,30.32307300941236
Nashik,Ginger (Fresh),2015,2984,4176,1192,39.94638069705094
Daryapur,Soybean,2015,2529,3720,1191,47.09371293001186
Phaltan,Ladies Finger,2016,1442,2633,1191,82.59361997226075
Pune,Gram,2015,3182,4373,1191,37.42928975487115
Kamthi,Ladies Finger,2014,1952,3143,1191,61.01434426229508
Barshi,Sorgum(Jawar),2016,1652,2843,1191,72.09443099273608
Sinner,Onion,2015,178,1369,1191,669.1011235955057
Solapur,Capsicum,2015,924,2115,1191,128.8961038961039
Khamgaon,Black Gram,2016,7950,9141,1191,14.981132075471699
Jalgaon,Wal Papdi,2016,2300,3491,1191,51.78260869565217
Kolhapur,Carrot,2015,1509,2700,1191,78.92644135188867
Vadgaon Peth,Flower,2016,918,2109,1191,129.73856209150327
Ramtek,Green Chilli,2016,3818,5009,1191,31.194342587742273
Ahmedpur,Sesamum,2015,5990,7180,1190,19.86644407345576
Pusad,Pigeon Pea (Tur),2015,6300,7490,1190,18.88888888888889
Lasalgaon,Gram,2015,3405,4595,1190,34.948604992657856
Mangaon(Bhadav),Nachani,2015,1310,2500,1190,90.83969465648855
Jalna,Mosambi,2016,2011,3201,1190,59.1745400298359
Lonar,Black Gram,2015,7715,8905,1190,15.42449773169151
Kolhapur-Malkapur,Flower,2016,380,1570,1190,313.1578947368421
Shirpur,Onion,2015,726,1916,1190,163.91184573002755
Indapur-Bhigwan,Sorgum(Jawar),2016,1640,2830,1190,72.5609756097561
Ramtek,Coriander  ,2015,4048,5238,1190,29.397233201581027
Pune-Manjri,Ridge Gourd,2015,1680,2870,1190,70.83333333333333
Solapur,Pigeon Pea (Tur),2016,7467,8657,1190,15.93678853622606
Beed,Black Gram,2015,7951,9141,1190,14.966670859011446
Pune,Tamarind,2015,3655,4845,1190,32.55813953488372
Mumbai,Orange,2016,800,1990,1190,148.75
Rahata,Ladies Finger,2016,1455,2645,1190,81.78694158075601
Manchar,Methi (Bhaji),2014,480,1669,1189,247.70833333333334
Ulhasnagar,OTHER CEREALS,2016,1900,3089,1189,62.578947368421055
Solapur,Guava,2015,839,2028,1189,141.71632896305124
Kamthi,Flower,2015,859,2048,1189,138.41676367869616
Pune-Manjri,Squash Gourd,2016,1925,3114,1189,61.76623376623377
Pune-Manjri,Kardai,2014,100,1288,1188,1188.0
Malkapur,Green Gram,2016,4175,5363,1188,28.45508982035928
Nagpur,Onion,2015,1327,2515,1188,89.52524491333835
Sangali,Sorgum(Jawar),2014,1620,2808,1188,73.33333333333333
Basmat,Turmeric,2016,9349,10537,1188,12.707241416194245
Jalgaon,Bitter Gourd,2014,2600,3788,1188,45.69230769230769
Lonar,Pigeon Pea (Tur),2015,7472,8660,1188,15.899357601713062
Indapur-Bhigwan,Pigeon Pea (Tur),2015,5625,6813,1188,21.12
Mumbai-Fruit Market,Pomegranate,2016,5583,6771,1188,21.278882321332617
Risod,Gram,2015,5612,6800,1188,21.168923734853884
Chandrapur,Kharbuj,2016,938,2125,1187,126.54584221748401
Kolhapur,Ground Nut Pods (Dry),2015,2169,3356,1187,54.725680036883354
Mangalwedha,Ladies Finger,2016,685,1872,1187,173.28467153284672
Raver,BLACK GRAM,2016,5563,6750,1187,21.33740787344958
Karad,Ginger (Fresh),2014,3188,4375,1187,37.23337515683814
Pune-Manjri,Ladies Finger,2015,1757,2943,1186,67.50142287990893
Malkapur,Gram,2016,6697,7883,1186,17.709422129311633
Lasalgaon-Niphad,Onion,2015,1657,2843,1186,71.57513578756789
Akluj,Garlic,2015,2647,3833,1186,44.805440120891575
Pune-Manjri,Ghevda,2016,3327,4513,1186,35.64773068830778
Barshi,Gram,2015,3628,4814,1186,32.69018743109151
Nagpur,Grapes,2016,2667,3853,1186,44.46944131983502
Akluj,Bitter Gourd,2015,2171,3357,1186,54.62920313219714
Satara,Ginger (Fresh),2016,1071,2257,1186,110.73762838468721
Kada (Ashti),Black Gram,2016,6043,7229,1186,19.62601356941916
Karad,Garlic,2016,4833,6019,1186,24.539623422304988
Nashik-Devlali,Coriander  ,2016,2217,3403,1186,53.495714930085704
Osmanabad,Ground Nut Pods (Dry),2016,3214,4400,1186,36.90105787181083
Pune-Manjri,CUCUMBER,2016,1297,2483,1186,91.44178874325367
Jalgaon,Lemon,2015,2115,3300,1185,56.02836879432624
Junnar-Otur,Brinjal,2016,929,2114,1185,127.55651237890204
Barshi,Black Gram,2015,7852,9037,1185,15.091696383087111
Vadgaon Peth,LADIES FINGER,2016,1279,2464,1185,92.6505082095387
Ausa,Wheat(Husked),2015,1689,2874,1185,70.15985790408526
Shrirampur,Onion,2015,262,1446,1184,451.9083969465649
Akluj,Garlic,2015,2658,3842,1184,44.54477050413845
Manchar,Ladies Finger,2016,2769,3953,1184,42.759118815456844
Kolhapur,Flower,2016,486,1670,1184,243.62139917695472
Yeotmal,Wheat(Husked),2015,1572,2756,1184,75.31806615776081
Chandur Rly.,Pigeon Pea (Tur),2015,7341,8525,1184,16.128592834763655
Parbhani,Soybean,2014,3125,4309,1184,37.888
Aurangabad,Green Chilli,2014,1824,3008,1184,64.91228070175438
Dhamangaon-Rly,Pigeon Pea (Tur),2016,7400,8584,1184,16.0
Osmanabad,LADIES FINGER,2016,1200,2383,1183,98.58333333333333
Akot,Pigeon Pea (Tur),2015,5968,7151,1183,19.822386058981234
Pune,Parwar,2016,2176,3359,1183,54.36580882352941
Pune,WAL BHAJI,2016,1038,2221,1183,113.96917148362235
Nandura,SESAMUM,2016,4784,5967,1183,24.72826086956522
Pimpalgaon Basawant,Tomato,2015,345,1527,1182,342.60869565217394
Varud-Rajura Bazar,Pigeon Pea (Tur),2015,7167,8349,1182,16.492256174131438
Nashik,Mango(Raw),2016,1525,2707,1182,77.50819672131148
Yeola,Green Gram,2015,6611,7793,1182,17.87929208894267
Lasalgaon,Onion,2015,1209,2391,1182,97.76674937965261
Nagpur,Potato,2014,1398,2580,1182,84.54935622317596
Mumbai,Pineapple,2014,1156,2338,1182,102.24913494809688
Ramtek,Coriander  ,2016,4696,5878,1182,25.170357751277685
Kolhapur,Flower,2015,480,1661,1181,246.04166666666666
Daryapur,Pigeon Pea (Tur),2016,7645,8826,1181,15.448005232177895
Osmanabad,Ghevda,2015,1555,2736,1181,75.94855305466238
Daryapur,Black Gram,2014,3600,4781,1181,32.80555555555556
Daryapur,Gram,2015,3200,4381,1181,36.90625
Nagpur,Mosambi,2015,1038,2219,1181,113.77649325626204
Jalna,Black Gram,2015,7644,8825,1181,15.450026164311879
Nashik,Methi (Bhaji),2015,1390,2571,1181,84.96402877697842
Vadgaon Peth,Ladies Finger,2016,1653,2833,1180,71.38535995160315
Pune,Gram,2015,3100,4280,1180,38.064516129032256
Chandrapur-Ganjwad,Onion,2015,3300,4480,1180,35.75757575757576
Kolhapur-Laxmipuri,Chillies(Red),2015,14400,15580,1180,8.194444444444445
Kalamb (Os),Black Gram,2015,6340,7520,1180,18.61198738170347
Akot,Pigeon Pea (Tur),2015,8220,9400,1180,14.355231143552311
Karad,Garlic,2016,4940,6120,1180,23.88663967611336
Mangaon(Bhadav),Nagali,2015,1420,2600,1180,83.09859154929578
Pune,Gram,2015,3855,5035,1180,30.609597924773023
Ahmednagar,Capsicum,2015,1300,2480,1180,90.76923076923077
Barshi,Turmeric,2015,6490,7670,1180,18.181818181818183
Aurangabad,Tomato,2015,985,2165,1180,119.79695431472081
Khed,Flower,2016,950,2130,1180,124.21052631578948
Pune,Dhemse,2016,2058,3238,1180,57.33722060252673
Pune-Manjri,Brinjal,2015,1495,2674,1179,78.8628762541806
Pune-Pimpri,Green Peas (Dry),2016,2671,3850,1179,44.14077124672407
Indapur,Onion,2015,517,1696,1179,228.04642166344294
Nashik,Mosambi,2016,1292,2471,1179,91.25386996904025
Akluj,Garlic,2014,3157,4336,1179,37.345581248020274
Lasalgaon-Niphad,Onion,2015,673,1852,1179,175.18573551263
Patan,Green Chilli,2016,4536,5714,1178,25.970017636684304
Sangali,Wheat(Husked),2016,1762,2940,1178,66.85584562996594
Vadgaon Peth,Capsicum,2015,1128,2306,1178,104.43262411347517
Pune,Ginger (Fresh),2016,1422,2600,1178,82.84106891701829
Nagpur,Potato,2014,1262,2440,1178,93.34389857369256
Jalgaon,Coriander  ,2015,1200,2378,1178,98.16666666666667
Anajngaon Surji,Pigeon Pea (Tur),2015,7900,9078,1178,14.91139240506329
Pune,Wal Papdi,2015,1477,2654,1177,79.68855788761002
Pune-Manjri,Methi (Bhaji),2016,900,2077,1177,130.77777777777777
Jalgaon,Lemon,2016,2435,3612,1177,48.336755646817245
Shirpur,Gram,2016,5705,6882,1177,20.63102541630149
Pune-Manjri,Brinjal,2016,1808,2985,1177,65.09955752212389
Pandharpur,Capsicum,2016,1431,2608,1177,82.25017470300489
Nandgaon,Green Gram,2014,6506,7683,1177,18.09099292960344
Akot,Pigeon Pea (Tur),2015,6564,7741,1177,17.931139549055455
Shirpur,Chillies(Red),2016,3099,4276,1177,37.97999354630526
Barshi,Black Gram,2014,4088,5265,1177,28.791585127201564
Sangrampur-Varvatbakal,Gram,2016,4021,5198,1177,29.271325540910222
Pune,Ginger (Fresh),2016,1061,2237,1176,110.83883129123468
Mumbai,Orange,2014,980,2156,1176,120.0
Solapur,Onion,2016,104,1280,1176,1130.7692307692307
Dudhani,Black Gram,2014,4418,5594,1176,26.618379357175193
Latur,Green Gram,2015,4915,6091,1176,23.92675483214649
Nandurbar,Sunflower,2015,2755,3931,1176,42.686025408348456
Pimpalgaon Basawant,Onion,2014,713,1889,1176,164.93688639551192
Ulhasnagar,Wheat(Husked),2016,1771,2947,1176,66.40316205533597
Malegaon,Onion,2015,413,1588,1175,284.5036319612591
Chandur Bajar,Pigeon Pea (Tur),2015,5400,6575,1175,21.75925925925926
Vadgaon Peth,Pavtta,2014,1517,2692,1175,77.45550428477257
Pune,Sweet Potato,2014,1025,2200,1175,114.63414634146342
Akluj,Bitter Gourd,2015,1469,2644,1175,79.9863852961198
Solapur,Matki,2015,6738,7913,1175,17.438409023449093
Manchar,CUCUMBER,2016,467,1642,1175,251.60599571734474
Gangapur,Onion,2014,379,1554,1175,310.0263852242744
Akkolkot,Wheat(Unhusked),2014,2701,3876,1175,43.50240651610515
Nashik,Lemon,2014,1236,2411,1175,95.06472491909385
Mumbai,Orange,2015,492,1667,1175,238.8211382113821
Rahuri-Vambori,Onion,2015,325,1500,1175,361.53846153846155
Umared,Gram,2016,5300,6475,1175,22.169811320754718
Nira-Saswad,GHEVDA SEED,2016,4100,5275,1175,28.658536585365855
Pathardi,Onion,2015,150,1325,1175,783.3333333333334
Kamthi,Small Gourd,2016,837,2011,1174,140.26284348864993
Ausa,Wheat(Husked),2015,1608,2782,1174,73.00995024875621
Solapur,Chikoo,2015,500,1674,1174,234.8
Indapur-Bhigwan,Sorgum(Jawar),2016,1600,2774,1174,73.375
Kamthi,Chavli (Shenga ),2015,878,2052,1174,133.7129840546697
Mumbai,Split Lentil,2016,5748,6922,1174,20.424495476687543
Mumbai,Brinjal,2016,688,1862,1174,170.63953488372093
Varud-Rajura Bazar,Pigeon Pea (Tur),2016,7263,8437,1174,16.16411950984442
Shahada,Gram,2016,3944,5118,1174,29.766734279918865
Shirpur,Ground Nut Pods (Dry),2015,3444,4618,1174,34.088269454123115
Nandurbar,Green Gram,2015,7449,8623,1174,15.760504765740368
Aurangabad,Cluster Bean,2016,3442,4615,1173,34.07902382335851
Sinner,Onion,2015,113,1286,1173,1038.0530973451328
Mumbai,Coconut,2015,1000,2173,1173,117.3
Sonpeth,Pigeon Pea (Tur),2016,7399,8572,1173,15.853493715366941
Karad,Mosambi,2016,5942,7115,1173,19.740828004039045
Jalgaon,Lemon,2016,1832,3005,1173,64.02838427947599
Lasalgaon,Soybean,2015,2478,3651,1173,47.336561743341406
Satana,Green Gram,2015,7050,8223,1173,16.638297872340427
Jalna,Pigeon Pea (Tur),2016,7832,9005,1173,14.977017364657813
Pune,Walvad,2015,1827,3000,1173,64.20361247947454
Mangrulpeer,Pigeon Pea (Tur),2016,7081,8254,1173,16.56545685637622
Barshi,Sorgum(Jawar),2016,1591,2764,1173,73.7272155876807
Pune,Chavli (Shenga ),2015,1306,2478,1172,89.739663093415
Kolhapur,Papai,2016,403,1575,1172,290.81885856079407
Nagpur,Potato,2014,1071,2243,1172,109.43043884220354
Jalna,Sorgum(Jawar),2016,1404,2576,1172,83.47578347578347
Telhara,Gram,2016,7707,8879,1172,15.2069547164915
Karanja,Black Gram,2015,6838,8010,1172,17.13951447791752
Aurangabad,Cluster Bean,2016,3621,4792,1171,32.339132836233084
Barshi,Bitter Gourd,2016,1985,3156,1171,58.99244332493703
Kolhapur,Small Gourd,2015,1000,2171,1171,117.1
Shirpur,Onion,2014,505,1676,1171,231.88118811881188
Pandharpur,Onion,2015,213,1384,1171,549.7652582159625
Nandgaon Khandeshwar,Green Gram,2015,7956,9127,1171,14.718451483157365
Mumbai,Onion,2015,2300,3470,1170,50.869565217391305
Mumbai,Shevga,2014,6404,7574,1170,18.26983135540287
Latur,Wheat(Husked),2014,1513,2683,1170,77.32980832782552
Palghar(Bevur),Rice(Paddy-Hus),2015,2217,3387,1170,52.77401894451962
Osmanabad,Onion,2015,1019,2189,1170,114.81844946025515
Latur,Wheat(Husked),2015,1518,2688,1170,77.07509881422925
Nashik-Devlali,Raddish,2016,1462,2632,1170,80.02735978112175
Indapur-Bhigwan,Sorgum(Jawar),2015,1546,2716,1170,75.67917205692109
Solapur,Wheat(Husked),2015,1650,2819,1169,70.84848484848484
Kamthi,Carrot,2015,1926,3095,1169,60.6957424714434
Solapur,Capsicum,2015,1150,2319,1169,101.65217391304348
Nashik,Coriander  ,2015,769,1938,1169,152.01560468140443
Pimpalgaon (B)-Saykheda,Onion,2014,431,1600,1169,271.22969837587004
Kamthi,Custard Apple,2016,2436,3605,1169,47.98850574712644
Pune,Pavtta,2016,1927,3096,1169,60.664244940321744
Rahuri,Kharbuj,2016,275,1444,1169,425.09090909090907
Lasalgaon-Vinchur,Soybean,2016,2932,4101,1169,39.870395634379264
Pune-Manjri,KANDA PAT,2016,921,2090,1169,126.9272529858849
Kamthi,METHI (BHAJI),2016,1179,2348,1169,99.15182357930449
Pune,Wal Bhaji,2016,2094,3263,1169,55.8261700095511
Kamthi,Small Gourd,2015,1612,2780,1168,72.45657568238214
Pune,Green Peas (Dry),2016,2700,3868,1168,43.25925925925926
Sangali,BLACK GRAM,2016,5532,6700,1168,21.11352133044107
Aurangabad,Lemon,2016,2350,3518,1168,49.702127659574465
Ramtek,Pigeon Pea (Tur),2016,6959,8127,1168,16.78402069262825
Pune-Manjri,Bottle Gourd,2015,591,1759,1168,197.63113367174282
Mehkar,Pigeon Pea (Tur),2015,4795,5963,1168,24.35870698644421
Pune-Moshi,Cluster Bean,2016,3000,4167,1167,38.9
Aurangabad,Tamarind,2016,3500,4667,1167,33.34285714285714
Sangali,Coriander (Dry),2016,7833,9000,1167,14.898506319417848
Akole,Gram,2016,4333,5500,1167,26.93284098776829
Chandrapur,Pomegranate,2015,2500,3667,1167,46.68
Kolhapur,Grapes,2016,2025,3192,1167,57.629629629629626
Kamthi,Chavli (Shenga ),2016,1671,2838,1167,69.83842010771993
Vai,Onion,2015,3500,4667,1167,33.34285714285714
Karad,Mosambi,2015,4083,5250,1167,28.581925055106538
Pune,Chavli (Shenga ),2015,1033,2200,1167,112.97192642787996
Amarawati,Mosambi,2016,2320,3487,1167,50.30172413793103
Lasalgaon,Soybean,2015,2789,3956,1167,41.842954463965576
Khed-Chakan,Cluster Bean,2016,3685,4852,1167,31.668928086838534
Chandrapur-Ganjwad,Capsicum,2016,2500,3667,1167,46.68
Ausa,Tamarind,2016,5667,6834,1167,20.592906299629433
Satara,Green Chilli,2016,5476,6643,1167,21.31117604090577
Palus,Bitter Gourd,2016,4000,5167,1167,29.175
Osmanabad,Mango,2016,2500,3667,1167,46.68
Ahmednagar,Flower,2015,1083,2250,1167,107.75623268698061
Parli-Vaijnath,Pigeon Pea (Tur),2016,7638,8805,1167,15.278868813825609
Ahmednagar,Bottle Gourd,2016,433,1600,1167,269.5150115473441
Udgir,Pigeon Pea (Tur),2015,4621,5788,1167,25.254273966673882
Dindori-Vani,Onion,2015,1213,2380,1167,96.20774938169826
Kolhapur,Sweet Potato,2015,983,2150,1167,118.71820956256359
Ahmednagar,Ginger (Fresh),2016,1000,2167,1167,116.7
Ratanagari,Green Chilli,2014,2972,4139,1167,39.26648721399731
Khed-Chakan,Walvad,2016,3833,5000,1167,30.446125750065224
Sangli-Phale Bhajipalam,Ginger (Fresh),2016,3000,4167,1167,38.9
Amarawati,Lemon,2016,2767,3933,1166,42.13950126490784
Amarawati,Orange,2016,1667,2833,1166,69.94601079784043
Rahuri,Melon,2016,292,1458,1166,399.3150684931507
Lasalgaon,Pigeon Pea (Tur),2015,4609,5775,1166,25.29832935560859
Lasalgaon,Ground Nut Pods (Dry),2016,3735,4901,1166,31.218206157965195
Sangali,Wheat(Unhusked),2015,2295,3461,1166,50.80610021786492
Ulhasnagar,GR.NUT KERNELS,2016,7667,8833,1166,15.20803443328551
Karad,Shevga,2014,4917,6083,1166,23.713646532438478
Kamthi,Leafy Vegetable,2016,3667,4833,1166,31.79710935369512
Kolhapur-Laxmipuri,Split Black Gram,2015,15915,17081,1166,7.326421614828778
Nira-Saswad,Rice(Paddy-Hus),2015,2067,3233,1166,56.41025641025641
Pune,Wal Papdi,2016,1905,3071,1166,61.20734908136483
Jalgaon,Bitter Gourd,2015,2150,3316,1166,54.23255813953488
Karad,Custard Apple,2014,2667,3833,1166,43.719535058117735
Patan,Ginger (Fresh),2015,3267,4433,1166,35.69023569023569
Shirpur,Onion,2015,429,1595,1166,271.79487179487177
Ahmednagar,Ghosali(Bhaji),2015,2167,3333,1166,53.807106598984774
Pune,Brinjal,2016,857,2022,1165,135.93932322053675
Pune-Manjri,Cucumber,2015,1490,2655,1165,78.18791946308725
Solapur,Onion,2016,100,1265,1165,1165.0
Nashik,Green Chilli,2014,1382,2547,1165,84.29811866859623
Karmala,Sorgum(Jawar),2015,1635,2800,1165,71.25382262996942
Pune,Black Gram,2016,8546,9711,1165,13.63210858881348
Sinner,Gram,2016,5201,6366,1165,22.39953855027879
Rahuri,Onion,2016,200,1365,1165,582.5
Mehkar,Green Gram,2014,7200,8365,1165,16.180555555555557
Beed,Green Gram,2015,6764,7928,1164,17.20875221762271
Khed,Ladies Finger,2016,2903,4067,1164,40.09645194626248
Kurdwadi,Sorgum(Jawar),2016,1352,2516,1164,86.09467455621302
Manchar,Methi (Bhaji),2015,1083,2247,1164,107.4792243767313
Pune,CHAVLI (SHENGA ),2016,1436,2600,1164,81.05849582172702
Chandrapur,Mango,2015,1245,2409,1164,93.49397590361446
Kalamb (Os),Gram,2015,3700,4864,1164,31.45945945945946
Pune,Black Gram,2016,7900,9064,1164,14.734177215189874
Daryapur,Gram,2016,4698,5861,1163,24.755214985100043
Solapur,Bor,2014,310,1473,1163,375.16129032258067
Lasalgaon,Soybean,2016,2515,3678,1163,46.24254473161034
Indapur-Bhigwan,Pigeon Pea (Tur),2016,5725,6888,1163,20.314410480349345
Pune,Wal Papdi,2016,1808,2971,1163,64.32522123893806
Akola,Gram,2015,4117,5280,1163,28.248724799611367
Jamkhed,Sorgum(Jawar),2016,1777,2940,1163,65.4473832301632
Rahuri-Vambori,Pigeon Pea (Tur),2016,7231,8394,1163,16.08352924906652
Solapur,Green Chilli,2016,2454,3617,1163,47.3920130399348
Tuljapur,Green Gram,2015,7767,8930,1163,14.973606282992145
Pune,Carrot,2015,671,1833,1162,173.17436661698957
Babhulgaon,Pigeon Pea (Tur),2015,6026,7188,1162,19.283106538333886
Jamkhed,Sorgum(Jawar),2016,1786,2948,1162,65.0615901455767
Kamthi,Chavli (Shenga ),2016,543,1705,1162,213.9963167587477
Pune-Manjri,Walvad,2015,2167,3329,1162,53.62251961236733
Solapur,GRAM,2016,7138,8300,1162,16.27906976744186
Jalgaon,Methi (Bhaji),2016,2071,3233,1162,56.10816030902946
Udgir,Black Gram,2014,4424,5586,1162,26.265822784810126
Manchar,Ground Nut Pods (Dry),2016,3119,4281,1162,37.25553061878807
Nandurbar,Green Gram,2014,5650,6812,1162,20.56637168141593
Pune-Moshi,Cucumber,2016,1060,2222,1162,109.62264150943396
Dondaicha,Gram,2016,3646,4808,1162,31.870543060888647
Chandvad,Tomato,2016,308,1469,1161,376.94805194805195
Indapur,Onion,2016,102,1263,1161,1138.235294117647
Pandharpur,Brinjal,2016,500,1661,1161,232.2
Solapur,Ghevda,2015,2065,3226,1161,56.2227602905569
Jamkhed,Gram,2016,4000,5161,1161,29.025
Shrigonda,Lemon,2016,4777,5938,1161,24.30395645802805
Ahmedpur,Sesamum,2016,4367,5527,1160,26.562857797114724
Solapur,BITTER GOURD,2016,513,1673,1160,226.12085769980507
Basmat,Turmeric,2015,8179,9339,1160,14.182662917227045
Umarga,Pigeon Pea (Tur),2015,9772,10932,1160,11.870650839132214
Akot,Ground Nut Pods (Dry),2015,4420,5580,1160,26.244343891402714
Amalner,Coriander (Dry),2016,8100,9260,1160,14.320987654320987
Indapur-Bhigwan,Pigeon Pea (Tur),2014,2626,3786,1160,44.17364813404417
Solapur,Black Gram,2015,8420,9580,1160,13.776722090261282
Mehkar,Green Gram,2015,5600,6760,1160,20.714285714285715
Beed,Black Gram,2016,5694,6854,1160,20.372321742184756
Sangamner,Onion,2015,428,1588,1160,271.02803738317755
Kamthi,Small Gourd,2016,1073,2233,1160,108.10810810810811
Dhamangaon-Rly,Pigeon Pea (Tur),2016,8018,9178,1160,14.467448241456722
Pune,Wal Papdi,2015,1523,2682,1159,76.09980302035456
Kalyan,Green Chilli,2015,3200,4359,1159,36.21875
Nashik,Bor,2015,683,1842,1159,169.69253294289896
Jalkot,Black Gram,2015,8542,9700,1158,13.55654413486303
Udgir,Tamarind,2016,7031,8189,1158,16.46991893045086
Achalpur,Pigeon Pea (Tur),2015,4767,5925,1158,24.292007551919447
Pune-Pimpri,Rice(Paddy-Hus),2016,3796,4954,1158,30.505795574288726
Nagpur,Grapes,2015,2096,3254,1158,55.24809160305343
Pune-Manjri,Cabbage,2015,684,1842,1158,169.2982456140351
Pune,Rice(Paddy-Hus),2016,4552,5710,1158,25.439367311072058
Dondaicha,Chillies(Red),2015,1793,2951,1158,64.58449525934188
Jamkhed,GRAM,2016,6071,7229,1158,19.074287596771537
Osmanabad,Cluster Bean,2015,910,2067,1157,127.14285714285714
Kalyan,Mosambi,2015,2929,4086,1157,39.501536360532604
Phaltan,Sorgum(Jawar),2015,1575,2732,1157,73.46031746031746
Pandharpur,Capsicum,2014,657,1814,1157,176.103500761035
Pune-Manjri,Kanda Pat,2015,1243,2400,1157,93.08125502815768
Amarawati,Mosambi,2016,2181,3338,1157,53.04906006419074
Lohara,Pigeon Pea (Tur),2016,8267,9424,1157,13.995403411152775
Pune-Manjri,Bottle Gourd,2015,813,1970,1157,142.31242312423123
Nashik,Potato,2016,542,1699,1157,213.46863468634686
Pune-Manjri,Ambat Chuka,2016,129,1286,1157,896.8992248062016
Pune-Manjri,Coriander  ,2016,544,1700,1156,212.5
Buldhana,Pigeon Pea (Tur),2015,7419,8575,1156,15.581614772880442
Karad,Pomegranate,2014,3033,4189,1156,38.11407847016156
Dudhani,Pigeon Pea (Tur),2016,8003,9159,1156,14.444583281269525
Kamthi,Pumpkin,2015,622,1778,1156,185.85209003215434
Majalgaon,Soybean,2016,2363,3519,1156,48.92086330935252
Nashik,Bottle Gourd,2014,905,2061,1156,127.73480662983425
Khed-Chakan,Green-Peas,2016,6375,7531,1156,18.133333333333333
Mehkar,Green Gram,2015,6238,7394,1156,18.53158063481885
Nashik,Guava,2016,1802,2958,1156,64.15094339622641
Chalisgaon,Green Gram,2015,5770,6925,1155,20.01733102253033
Lasalgaon,Soybean,2014,2111,3266,1155,54.713405968735195
Latur,Green Gram,2015,6086,7241,1155,18.977982254354256
Pune,Chavli (Shenga ),2015,1256,2411,1155,91.95859872611464
Malkapur,Black Gram,2014,4313,5468,1155,26.779503825643403
Kamthi,Brinjal,2015,742,1897,1155,155.66037735849056
Shirpur,Ground Nut Pods (Dry),2014,3168,4323,1155,36.458333333333336
Dondaicha,Matki,2015,6650,7805,1155,17.36842105263158
Manchar,Coriander  ,2014,368,1523,1155,313.85869565217394
Pune-Pimpri,Tomato,2015,2109,3264,1155,54.76529160739687
Vadgaon Peth,Ridge Gourd,2015,1967,3122,1155,58.718861209964416
Chopda,Green Gram,2015,5723,6878,1155,20.181722872619254
Latur-Murud,Gram,2016,4006,5161,1155,28.831752371442835
Vaijapur,Onion,2015,400,1554,1154,288.5
Hinganghat,Pigeon Pea (Tur),2016,7865,9019,1154,14.672600127145582
Latur,Wheat(Husked),2016,1556,2710,1154,74.16452442159382
Nashik,Ginger (Fresh),2014,3238,4392,1154,35.63928350833848
Mumbai,Mosambi,2014,1200,2354,1154,96.16666666666667
Rahata,Onion,2015,375,1529,1154,307.73333333333335
Osmanabad,Cabbage,2016,1473,2627,1154,78.34351663272234
Katol,Pigeon Pea (Tur),2016,6639,7793,1154,17.382135863834915
Shirpur,Matki,2015,5937,7091,1154,19.437426309583966
Chandur Bajar,Pigeon Pea (Tur),2015,4843,5997,1154,23.828205657650216
Dondaicha,Chillies(Red),2015,2796,3950,1154,41.273247496423465
Mumbai,Spilt Pigeon Pea,2015,6408,7562,1154,18.008739076154807
Sangali,Wheat(Husked),2014,1625,2779,1154,71.01538461538462
Barshi-Vairag,Green Gram,2014,5212,6365,1153,22.122026093630083
Vaijapur,Onion,2015,518,1671,1153,222.58687258687257
Nagpur,Grapes,2014,1657,2810,1153,69.58358479179239
Dhule,Ground Nut Pods (Dry),2016,3261,4414,1153,35.3572523765716
Malegaon,Gram,2016,3675,4828,1153,31.374149659863946
Pune,Elephant Root,2015,1468,2621,1153,78.54223433242507
Sinner,Gram,2015,3279,4432,1153,35.16315949984752
Vadgaon Peth,Green-Peas,2016,2385,3538,1153,48.343815513626836
Kolhapur-Laxmipuri,Spilt Gerrn Gram,2016,7014,8167,1153,16.43855146849159
Jalna,Pigeon Pea (Tur),2015,9675,10827,1152,11.906976744186046
Kamthi,Kand,2015,824,1976,1152,139.80582524271844
Sangali,Sorgum(Jawar),2014,1653,2805,1152,69.69147005444646
Solapur,Potato,2015,705,1857,1152,163.40425531914894
Varud-Rajura Bazar,Gram,2015,4148,5300,1152,27.772420443587272
Satara,Ladies Finger,2015,3239,4391,1152,35.56653288051868
Pune-Manjri,Cucumber,2015,952,2104,1152,121.00840336134453
Ulhasnagar,Wheat(Husked),2016,2000,3152,1152,57.6
Mumbai,Papai,2014,700,1852,1152,164.57142857142858
Amarawati,Ginger (Fresh),2016,1778,2930,1152,64.79190101237346
Kalvan,Onion,2015,264,1415,1151,435.9848484848485
Khed,Cabbage,2016,1212,2363,1151,94.96699669966996
Mangrulpeer,Green Gram,2016,6200,7351,1151,18.56451612903226
Shahada,Gram,2016,4300,5451,1151,26.767441860465116
Kolhapur,Cabbage,2015,350,1500,1150,328.57142857142856
Malkapur,Green Gram,2016,4550,5700,1150,25.274725274725274
Ahmednagar,Green Gram,2015,6580,7730,1150,17.477203647416413
Jalgaon,Brinjal,2015,1200,2350,1150,95.83333333333333
Vai,Turmeric,2016,9250,10400,1150,12.432432432432432
Kolhapur,Tomato,2015,368,1518,1150,312.5
Babhulgaon,Gram,2015,3200,4350,1150,35.9375
Pune,Pavtta,2015,2900,4050,1150,39.6551724137931
Indapur-Bhigwan,Cowpea,2016,2250,3400,1150,51.111111111111114
Pune-Manjri,Hemp,2015,0,1150,1150,inf
Kalyan,Matki,2016,5500,6650,1150,20.90909090909091
Pune-Manjri,Bitter Gourd,2015,2175,3325,1150,52.87356321839081
Baramati,Gram,2015,3550,4700,1150,32.394366197183096
Malegaon,Green Gram,2015,4650,5800,1150,24.731182795698924
Palus,Squash Gourd,2016,1750,2900,1150,65.71428571428571
Palus,Brinjal,2016,850,2000,1150,135.2941176470588
Ulhasnagar,Wheat(Husked),2016,1875,3025,1150,61.333333333333336
Baramati,Soybean,2014,2000,3150,1150,57.5
Armori,Ground Nut Pods (Dry),2016,3761,4911,1150,30.57697420898697
Kamthi,Kanda Pat,2016,650,1800,1150,176.92307692307693
Mumbai-Onion And Potato Mkt,Garlic,2016,5414,6564,1150,21.241226449944588
Pune-Manjri,Shepu,2015,1950,3100,1150,58.97435897435897
Pune-Manjri,Ambat Chuka,2015,50,1200,1150,2300.0
Balapur,Black Gram,2015,4350,5500,1150,26.436781609195403
Rahuri-Vambori,ONION,2016,150,1300,1150,766.6666666666666
Ahmednagar,Carrot,2015,813,1963,1150,141.45141451414514
Nashik,Bor,2014,1300,2450,1150,88.46153846153847
Pune,Flower,2014,683,1833,1150,168.3748169838946
Amarawati,Black Gram,2015,6083,7233,1150,18.90514548742397
Sangrampur,Black Gram,2015,6750,7900,1150,17.037037037037038
Manchar,Methi (Bhaji),2014,321,1471,1150,358.25545171339564
Barshi,Sorgum(Jawar),2016,1679,2829,1150,68.4931506849315
Akot,Pigeon Pea (Tur),2016,6951,8101,1150,16.54438210329449
Akluj,Ladies Finger,2015,2450,3600,1150,46.93877551020408
Kolhapur,Wal Bhaji,2016,2300,3450,1150,50.0
Kamthi,Jack Fruit(Raw),2015,875,2025,1150,131.42857142857142
Pune-Pimpri,Green-Peas,2015,2850,4000,1150,40.35087719298246
Solapur,Capsicum,2016,979,2129,1150,117.46680286006129
Vadgaon Peth,Green Chilli,2016,2080,3230,1150,55.28846153846154
Ratanagari,Cluster Bean,2016,2600,3750,1150,44.23076923076923
Junnar-Otur,Ladies Finger,2016,1157,2307,1150,99.39498703543647
Nandgaon,Gram,2015,3176,4326,1150,36.20906801007557
Koregaon,Onion,2014,540,1690,1150,212.96296296296296
Murtizapur,Black Gram,2015,9355,10504,1149,12.282202030999466
Indapur-Bhigwan,Sorgum(Jawar),2014,2040,3189,1149,56.3235294117647
Latur,Black Gram,2014,4223,5372,1149,27.208145867866445
Kolhapur,Flower,2015,348,1497,1149,330.17241379310343
Manmad,Horse Gram,2016,3063,4212,1149,37.51224289911851
Yeola,Onion,2014,475,1623,1148,241.68421052631578
Pune-Manjri,METHI (BHAJI),2016,807,1955,1148,142.2552664188352
Pune,Chavli (Shenga ),2015,1387,2535,1148,82.76856524873828
Khamgaon,Green Gram,2015,5640,6788,1148,20.354609929078013
Murum,Green Gram,2015,7496,8644,1148,15.314834578441836
Kamthi,Carrot,2015,837,1985,1148,137.15651135005973
Jintur,Pigeon Pea (Tur),2015,5373,6521,1148,21.36608970779825
Pune,Walvad,2016,1744,2892,1148,65.8256880733945
Kamthi,Carrot,2016,1004,2152,1148,114.34262948207171
Barshi,Gram,2015,2368,3516,1148,48.479729729729726
Aurangabad,Orange,2016,1576,2724,1148,72.84263959390863
Daryapur,Pigeon Pea (Tur),2016,7154,8302,1148,16.046966731898237
Vadgaon Peth,Capsicum,2016,1578,2726,1148,72.75031685678074
Jamkhed,Pigeon Pea (Tur),2016,6206,7353,1147,18.482114083145344
Kille Dharur,Pigeon Pea (Tur),2016,6786,7933,1147,16.90244621279104
Pune-Manjri,Raddish,2015,1182,2329,1147,97.0389170896785
Armori,Ground Nut Pods (Dry),2015,3275,4422,1147,35.02290076335878
Khed,FARSHI,2016,1225,2372,1147,93.63265306122449
Pune,Ground Nut Pods (Dry),2016,3021,4168,1147,37.96756041046011
Morshi,Black Gram,2016,4016,5163,1147,28.560756972111555
Kolhapur,Flower,2016,517,1664,1147,221.8568665377176
Savner,Pigeon Pea (Tur),2016,7653,8800,1147,14.987586567359205
Kolhapur,Maize(Corn.),2016,353,1500,1147,324.92917847025495
Kurdwadi-Modnimb,Sorgum(Jawar),2015,1025,2172,1147,111.90243902439025
Indapur-Bhigwan,Sorgum(Jawar),2015,1544,2691,1147,74.28756476683938
Ausa,Wheat(Husked),2016,1750,2897,1147,65.54285714285714
Loha,Green Gram,2014,6429,7575,1146,17.82547830144657
Pachora,Green Gram,2016,4059,5205,1146,28.233555062823356
Khed-Chakan,Ladies Finger,2016,2302,3448,1146,49.78279756733276
Chopda,Sesamum,2016,4948,6094,1146,23.160873080032335
Solapur,BRINJAL,2016,214,1360,1146,535.5140186915888
Mumbai,Brinjal,2016,900,2046,1146,127.33333333333333
Mumbai,Coconut,2015,745,1891,1146,153.8255033557047
Satara,Green Chilli,2016,4458,5604,1146,25.706594885598925
Nashik,Ladies Finger,2016,2276,3422,1146,50.35149384885764
Kamthi,Chavli (Shenga ),2015,1827,2973,1146,62.725779967159276
Nandurbar,Sunflower,2015,3423,4569,1146,33.47940403155127
Mumbai,Cowpea,2016,4892,6038,1146,23.426001635322976
Kamthi,Small Gourd,2014,867,2013,1146,132.17993079584775
Parli-Vaijnath,Green Gram,2014,5179,6325,1146,22.127823904228617
Mumbai,Fenugreek,2014,7145,8291,1146,16.03918824352694
Sangli-Phale Bhajipalam,Pineapple,2015,1041,2187,1146,110.0864553314121
Murum,Black Gram,2014,4885,6031,1146,23.45957011258956
Pune-Manjri,Ambat Chuka,2014,109,1255,1146,1051.3761467889908
Kolhapur,Guava,2016,395,1540,1145,289.873417721519
Kamthi,Green Chilli,2015,776,1921,1145,147.55154639175257
Latur,Green Gram,2016,5868,7013,1145,19.512610770279483
Pune,DHEMSE,2016,1150,2295,1145,99.56521739130434
Kalyan,GREEN-PEAS,2016,6173,7318,1145,18.5485177385388
Nagpur,Mosambi,2015,1013,2158,1145,113.03060217176703
Lasur Station,Sorgum(Jawar),2016,1357,2502,1145,84.37730287398674
Sangali,Wheat(Husked),2014,1660,2805,1145,68.97590361445783
Nashik,Kanda Pat,2014,713,1858,1145,160.5890603085554
Murum,Pigeon Pea (Tur),2016,8461,9605,1144,13.520860418390262
Solapur,Tomato,2015,169,1313,1144,676.9230769230769
Khed-Chakan,Bitter Gourd,2016,4500,5644,1144,25.42222222222222
Dondaicha,Gram,2016,5685,6829,1144,20.123131046613896
Pune,Sweet Potato,2016,1375,2519,1144,83.2
Pune,Mula Shenga,2016,1456,2600,1144,78.57142857142857
Achalpur,Black Gram,2016,5933,7077,1144,19.281982133827743
Barshi-Vairag,Pigeon Pea (Tur),2016,6330,7474,1144,18.072669826224327
Kolhapur,Tomato,2016,256,1400,1144,446.875
Kamthi,Tomato,2016,1300,2443,1143,87.92307692307692
Ulhasnagar,Green Gram,2016,7857,9000,1143,14.547537227949599
Shirpur,Ground Nut Pods (Dry),2016,3853,4996,1143,29.66519595120685
Ahmednagar,Ginger (Fresh),2015,1857,3000,1143,61.55088852988691
Vaijapur,Onion,2015,200,1343,1143,571.5
Kamthi,Dhemse,2016,1471,2614,1143,77.70224337185589
Ramtek,Ginger (Fresh),2016,4143,5286,1143,27.588703837798697
Nashik,Cabbage,2015,892,2035,1143,128.1390134529148
Ramtek,Garlic,2015,5714,6857,1143,20.00350017500875
Junnar,Onion,2015,800,1943,1143,142.875
Kolhapur,Orange,2016,2686,3829,1143,42.55398361876396
Jalna,Pigeon Pea (Tur),2016,7758,8901,1143,14.733178654292344
Pune,Ladies Finger,2016,865,2008,1143,132.1387283236994
Karad,Ginger (Fresh),2014,3071,4214,1143,37.21914685770108
Ahmednagar,Cabbage,2016,336,1479,1143,340.17857142857144
Baramati,Onion,2015,417,1559,1142,273.8609112709832
Loha,Green Gram,2014,5422,6564,1142,21.062338620435263
Khamgaon,Sesamum,2014,7944,9086,1142,14.375629405840886
Vadgaon Peth,Brinjal,2014,1476,2618,1142,77.37127371273712
Kolhapur,Spinach,2015,975,2117,1142,117.12820512820512
Pune,Carrot,2015,781,1923,1142,146.22279129321382
Pandharpur,Onion,2014,185,1327,1142,617.2972972972973
Naigaon,Pigeon Pea (Tur),2016,7916,9057,1141,14.413845376452754
Aurangabad,Bor,2014,1335,2476,1141,85.46816479400749
Devala,Green Gram,2014,5943,7084,1141,19.199057714958776
Kurdwadi,Onion,2014,567,1708,1141,201.23456790123456
Udgir,Black Gram,2014,4721,5862,1141,24.168608345689474
Mumbai,Green-Peas,2016,6000,7141,1141,19.016666666666666
Malegaon,SOYBEAN,2016,1500,2641,1141,76.06666666666666
Ambejogai,Pigeon Pea (Tur),2015,4811,5952,1141,23.71648305965496
Pune-Manjri,Ambat Chuka,2015,0,1140,1140,inf
Kolhapur,Pineapple,2016,485,1625,1140,235.05154639175257
Sangali,Chillies(Red),2014,8880,10020,1140,12.837837837837839
Ahmednagar,Flower,2015,1100,2240,1140,103.63636363636364
Pune,Ghosali(Bhaji),2014,1400,2540,1140,81.42857142857143
Umared,Other Pulses,2015,6626,7766,1140,17.2049501961968
Kamthi,Bitter Gourd,2016,1620,2760,1140,70.37037037037037
Pune,Bottle Gourd,2014,515,1655,1140,221.35922330097088
Vadgaon Peth,Ladies Finger,2015,860,2000,1140,132.5581395348837
Kurdwadi-Modnimb,Green Gram,2016,4000,5140,1140,28.5
Jalna,MOSAMBI,2016,2208,3348,1140,51.630434782608695
Gevrai,Pigeon Pea (Tur),2015,8002,9142,1140,14.2464383904024
Ratanagari,Green Chilli,2016,3767,4907,1140,30.26280860100876
Chandrapur-Ganjwad,Chavli (Shenga ),2016,1660,2800,1140,68.67469879518072
Nagpur,Orange,2014,735,1875,1140,155.10204081632654
Barshi,Chikoo,2016,2740,3880,1140,41.605839416058394
Vadgaon Peth,CLUSTER BEAN,2016,1660,2800,1140,68.67469879518072
Ramtek,Green Chilli,2016,4413,5552,1139,25.81010650351235
Pune,Rice(Paddy-Hus),2015,4523,5662,1139,25.182401061242537
Junnar-Otur,Green Chilli,2016,669,1808,1139,170.25411061285502
Chandvad,Onion,2015,220,1359,1139,517.7272727272727
Amarawati,Sesamum,2015,7238,8377,1139,15.736391268306162
Aurangabad,Green Chilli,2015,1765,2904,1139,64.53257790368272
Deglur,Pigeon Pea (Tur),2016,6900,8039,1139,16.507246376811594
Chandvad,Tomato,2016,410,1549,1139,277.8048780487805
Pune,Green Gram,2016,7251,8390,1139,15.70817818231968
Ambad(Vadi Godri),Sorgum(Jawar),2014,1292,2431,1139,88.15789473684211
Kamthi,Lemon,2015,815,1954,1139,139.75460122699386
Sangamner,Tomato,2015,275,1413,1138,413.8181818181818
Shirpur,Green Gram,2016,4164,5302,1138,27.32949087415946
Balapur,Pigeon Pea (Tur),2016,5500,6638,1138,20.69090909090909
Pune-Manjri,Hemp,2016,0,1138,1138,inf
Ulhasnagar,Gram,2015,4806,5944,1138,23.678734914689972
Nashik,Coriander  ,2015,1255,2393,1138,90.67729083665338
Solapur,Potato,2014,1629,2767,1138,69.85880908532842
Balapur,Pigeon Pea (Tur),2016,7975,9113,1138,14.269592476489029
Pimpalgaon (B)-Saykheda,Onion,2014,497,1635,1138,228.9738430583501
Kamthi,Flower,2016,834,1972,1138,136.45083932853717
Nagpur,Potato,2016,779,1917,1138,146.0847240051348
Pune-Manjri,Pavtta,2015,2325,3463,1138,48.946236559139784
Solapur,Guava,2015,1355,2493,1138,83.98523985239852
Mumbai,Green-Peas,2016,4900,6038,1138,23.224489795918366
Ausa,Gram,2016,5398,6536,1138,21.08188217858466
Yeotmal,Pigeon Pea (Tur),2015,8222,9359,1137,13.828752128435903
Ratanagari,Flower,2016,2636,3773,1137,43.13353566009105
Shrirampur,Pomegranate,2016,2928,4065,1137,38.83196721311475
Ratanagari,Flower,2016,2636,3773,1137,43.13353566009105
Solapur,Brinjal,2015,246,1383,1137,462.1951219512195
Nampur,Pomegranate,2016,43,1180,1137,2644.186046511628
Kolhapur,Ginger (Fresh),2016,2058,3195,1137,55.24781341107872
Pune,Ghosali(Bhaji),2014,995,2132,1137,114.2713567839196
Nashik,Capsicum,2016,2288,3424,1136,49.65034965034965
Ramtek,Coriander  ,2015,3682,4818,1136,30.852797392721346
Osmanabad,Ghevda,2014,1593,2729,1136,71.31198995605776
Pune-Manjri,Spinach,2015,321,1457,1136,353.8940809968847
Pune-Moshi,Ghevda,2016,3875,5011,1136,29.316129032258065
Umarga,Green Gram,2014,6283,7419,1136,18.08053477638071
Pune,Ghosali(Bhaji),2015,1312,2448,1136,86.58536585365853
Pune-Manjri,Cucumber,2014,1693,2829,1136,67.09982279976373
Manmad,Gram,2015,3798,4934,1136,29.910479199578727
Kamthi,Coriander  ,2016,1525,2661,1136,74.49180327868852
Kolhapur,Carrot,2015,1612,2747,1135,70.40942928039702
Karad,JAGGERY,2016,3031,4166,1135,37.44638733091389
Pune,Ghosali(Bhaji),2016,1426,2561,1135,79.59326788218794
Amarawati-Fruit And Vegetables,ORANGE,2016,1536,2671,1135,73.89322916666667
Solapur,Capsicum,2016,548,1683,1135,207.1167883211679
Kamthi,Guava,2016,810,1945,1135,140.12345679012347
Vadgaon Peth,Ladies Finger,2016,1690,2825,1135,67.15976331360947
Amarawati-Fruit And Vegetables,Mango,2016,2755,3890,1135,41.1978221415608
Nagpur,Mosambi,2015,944,2078,1134,120.12711864406779
Jintur,BLACK GRAM,2016,4725,5859,1134,24.0
Phaltan,Gram,2015,3133,4267,1134,36.19533992977976
Osmanabad,Bitter Gourd,2016,933,2067,1134,121.54340836012862
Savner,Gram,2015,3623,4757,1134,31.300027601435275
Newasa,Gram,2016,6333,7467,1134,17.906205589767882
Pune-Manjri,Brinjal,2015,890,2024,1134,127.41573033707866
Karad,Green-Peas,2016,5833,6967,1134,19.441110920624034
Beed,BLACK GRAM,2016,5750,6884,1134,19.721739130434784
Phaltan,Onion,2015,533,1667,1134,212.7579737335835
Osmanabad,Ginger (Fresh),2016,1867,3000,1133,60.68559185859668
Pune-Manjri,Guava,2014,1650,2783,1133,68.66666666666667
Pune-Manjri,Kanda Pat,2015,700,1833,1133,161.85714285714286
Kamthi,Beet Root,2016,1800,2933,1133,62.94444444444444
Shegaon,Pigeon Pea (Tur),2015,7875,9008,1133,14.387301587301588
Jawala-Bajar,Turmeric,2015,6900,8033,1133,16.420289855072465
Shirur,Green Gram,2015,5967,7100,1133,18.987766046589577
Mumbai,Spilt Gerrn Gram,2016,8142,9275,1133,13.915499877180054
Murtizapur,GRAM,2016,7300,8433,1133,15.520547945205479
Shirur,Indian Bean,2014,3417,4550,1133,33.157740708223585
Majalgaon,Sorgum(Jawar),2015,1046,2179,1133,108.31739961759082
Kurdwadi,Sorgum(Jawar),2014,1212,2345,1133,93.48184818481849
Kalyan,Mosambi,2016,2867,4000,1133,39.51866062085804
Jalgaon,Mosambi,2014,1167,2300,1133,97.08654670094259
Pune,Walvad,2014,1896,3029,1133,59.757383966244724
Osmanabad,Cluster Bean,2015,900,2033,1133,125.88888888888889
Kalvan,Onion,2015,296,1429,1133,382.77027027027026
Mumbai,Jaggery,2015,2800,3933,1133,40.464285714285715
Kamthi,Beet Root,2015,1367,2500,1133,82.88222384784198
Rahuri,Cucumber,2015,500,1633,1133,226.6
Sangali,Coriander (Dry),2016,8367,9500,1133,13.541293175570694
Solapur,Capsicum,2015,979,2112,1133,115.73033707865169
Balapur,Green Gram,2015,5700,6833,1133,19.87719298245614
Yeotmal,Gram,2016,6849,7982,1133,16.54256095780406
Manwat,Green Gram,2015,7075,8207,1132,16.0
Kolhapur,Ginger (Fresh),2016,1668,2800,1132,67.86570743405275
Pandharpur,Capsicum,2016,3186,4318,1132,35.530445699937225
Mehkar,Pigeon Pea (Tur),2016,7816,8948,1132,14.483111566018424
Shirpur,Cowpea,2016,5686,6818,1132,19.90854730918044
Aurangabad,Lemon,2015,1736,2868,1132,65.2073732718894
Majalgaon,Gram,2015,3355,4487,1132,33.74068554396423
Akluj,Ground Nut Pods (Dry),2016,3604,4736,1132,31.409544950055494
Lasalgaon,Pigeon Pea (Tur),2016,6260,7391,1131,18.06709265175719
Phaltan,Sorgum(Jawar),2015,1438,2569,1131,78.65090403337969
Purna,Pigeon Pea (Tur),2015,5149,6280,1131,21.965430180617595
Barshi,Sorgum(Jawar),2015,1332,2463,1131,84.90990990990991
Vai,Ginger (Fresh),2014,4391,5522,1131,25.75723069915737
Nashik,Potato,2016,453,1584,1131,249.66887417218544
Risod,Pigeon Pea (Tur),2016,7943,9074,1131,14.238952536824877
Ambad(Vadi Godri),Pigeon Pea (Tur),2016,7803,8933,1130,14.48160963731898
Vadgaon Peth,Cucumber,2016,1320,2450,1130,85.60606060606061
Nashik,Banana,2016,908,2038,1130,124.44933920704845
Kamthi,Mint,2015,1695,2825,1130,66.66666666666667
Amarawati,Onion,2015,1330,2460,1130,84.9624060150376
Sangali,Black Gram,2016,5970,7100,1130,18.927973199329983
Aurangabad,Green Chilli,2016,5196,6326,1130,21.74749807544265
Darwha,Ground Nut Pods (Dry),2014,2800,3930,1130,40.357142857142854
Vadgaon Peth,Capsicum,2014,1880,3010,1130,60.1063829787234
Pune,Dhemse,2015,1050,2180,1130,107.61904761904762
Baramati,Gram,2015,4033,5163,1130,28.018844532606
Jalgaon Jamod-Aasalgaon,Pigeon Pea (Tur),2016,5200,6329,1129,21.71153846153846
Chandrapur,Pomegranate,2015,2064,3193,1129,54.69961240310077
Majalgaon,Pigeon Pea (Tur),2015,4774,5903,1129,23.648931713447844
Sangli-Phale Bhajipalam,ONION,2016,200,1329,1129,564.5
Ratanagari,Cucumber,2016,1300,2429,1129,86.84615384615384
Dhamangaon-Rly,Gram,2016,5913,7042,1129,19.093522746490784
Raver,Green Gram,2014,5318,6447,1129,21.229785633696878
Kurdwadi-Modnimb,Gram,2015,3096,4225,1129,36.46640826873385
Jalgaon,Methi (Bhaji),2014,2324,3453,1129,48.580034423407916
Sinner,Pigeon Pea (Tur),2015,3830,4959,1129,29.47780678851175
Kamthi,Brinjal,2015,1139,2268,1129,99.12203687445127
Rahata,Onion,2016,200,1329,1129,564.5
Solapur,Capsicum,2014,603,1732,1129,187.23051409618574
Pandharpur,Capsicum,2015,1050,2178,1128,107.42857142857143
Osmanabad,Sorgum(Jawar),2016,1464,2592,1128,77.04918032786885
Solapur,Ghevda,2016,1200,2328,1128,94.0
Akole,ONION,2016,143,1271,1128,788.8111888111888
Majalgaon,Sorgum(Jawar),2015,1237,2365,1128,91.18835893290218
Nampur,Pomegranate,2016,48,1176,1128,2350.0
Varud-Rajura Bazar,Soybean,2016,1816,2944,1128,62.11453744493392
Latur,Sorgum(Jawar),2014,1232,2360,1128,91.55844155844156
Nandura,Pigeon Pea (Tur),2015,4941,6069,1128,22.829386763812995
Nandurbar,Sunflower,2016,3264,4392,1128,34.55882352941177
Bhokar,Turmeric,2015,6240,7368,1128,18.076923076923077
Mehkar,Black Gram,2015,4610,5738,1128,24.468546637744033
Vasai,Tomato,2015,983,2111,1128,114.75076297049847
Udgir,Gram,2015,2994,4121,1127,37.64195056780227
Nagpur,Grapes,2014,1830,2957,1127,61.58469945355191
Kamthi,Chavli (Pala),2015,591,1718,1127,190.6937394247039
Sangli-Phale Bhajipalam,Onion,2016,204,1331,1127,552.4509803921569
Akluj,Chillies(Red),2015,2773,3900,1127,40.641904075009016
Ahmednagar,Ginger (Fresh),2016,1818,2945,1127,61.99119911991199
Nashik,Bottle Gourd,2014,991,2118,1127,113.72351160443996
Nandgaon,Ground Nut Pods (Dry),2014,2610,3737,1127,43.18007662835249
Ausa,Tamarind,2016,6700,7827,1127,16.82089552238806
Rahuri-Vambori,GRAM,2016,6569,7696,1127,17.15634038666464
Chandrapur-Ganjwad,Tomato,2015,964,2091,1127,116.90871369294605
Mehkar,Gram,2015,4000,5126,1126,28.15
Barshi,Onion,2015,238,1364,1126,473.109243697479
Kolhapur,Ground Nut Pods (Dry),2016,2479,3605,1126,45.421540943929
Murum,Pigeon Pea (Tur),2016,7388,8514,1126,15.240931239848402
Manchar,Cucumber,2016,948,2074,1126,118.77637130801688
Satana,Onion,2014,800,1926,1126,140.75
Kamthi,Ladies Finger,2014,830,1956,1126,135.66265060240963
Akluj,Ladies Finger,2016,1587,2713,1126,70.95148078134845
Ratanagari,Cucumber,2016,1375,2500,1125,81.81818181818181
Latur-Murud,Gram,2016,5227,6352,1125,21.52286206236847
Pune,Arvi,2015,1875,3000,1125,60.0
Pune-Manjri,Custard Apple,2016,3900,5025,1125,28.846153846153847
Akluj,Chikoo,2016,1838,2963,1125,61.20783460282916
Amarawati,Ground Nut Pods (Dry),2016,3759,4884,1125,29.928172386272944
Jalgaon,Mosambi,2016,1475,2600,1125,76.27118644067797
Kada (Ashti),Sorgum(Jawar),2016,1600,2725,1125,70.3125
Ulhasnagar,Gr.Nut Kernels,2015,7875,9000,1125,14.285714285714286
Pune,Cucumber,2015,546,1671,1125,206.04395604395606
Akola,Black Gram,2015,5775,6900,1125,19.48051948051948
Ulhasnagar,Gr.Nut Kernels,2016,7925,9050,1125,14.195583596214512
Vadgaon Peth,Pavtta,2016,2500,3625,1125,45.0
Pathardi,COTTON,2016,3875,5000,1125,29.032258064516128
Phaltan,Bitter Gourd,2016,3450,4575,1125,32.608695652173914
Ahmednagar,Ginger (Fresh),2016,1875,3000,1125,60.0
Sangli-Phale Bhajipalam,Ginger (Fresh),2016,3000,4125,1125,37.5
Akluj,Chillies(Red),2015,2750,3875,1125,40.90909090909091
Pune,Onion,2016,604,1729,1125,186.25827814569536
Ratanagari,Ginger (Fresh),2015,3875,5000,1125,29.032258064516128
Nira,Rice(Paddy-Hus),2015,2400,3525,1125,46.875
Karad,Pomegranate,2015,3042,4167,1125,36.98224852071006
Karad,Mosambi,2015,4750,5875,1125,23.68421052631579
Vai,Cluster Bean,2014,3500,4625,1125,32.142857142857146
Umared,Gram,2016,3286,4411,1125,34.236153377967135
Rahata,Capsicum,2016,1813,2938,1125,62.05184776613348
Ramtek,Ginger (Fresh),2016,3000,4125,1125,37.5
Ramtek,Garlic,2016,4625,5750,1125,24.324324324324323
Palus,Ladies Finger,2016,2000,3125,1125,56.25
Chalisgaon,Math (Bhaji),2016,1365,2490,1125,82.41758241758242
Nira-Saswad,Rice(Paddy-Hus),2016,2400,3525,1125,46.875
Jamkhed,Onion,2016,100,1225,1125,1125.0
Pune,Mula Shenga,2015,1000,2125,1125,112.5
Sangali,Coriander (Dry),2016,8375,9500,1125,13.432835820895523
Kada,Pigeon Pea (Tur),2015,7900,9025,1125,14.240506329113924
Amarawati-Fruit And Vegetables,Mosambi,2016,2175,3300,1125,51.724137931034484
Kolhapur,Wal Bhaji,2015,1663,2788,1125,67.64882742032471
Navapur,Tomato,2016,1425,2550,1125,78.94736842105263
Kamthi,Small Gourd,2015,1406,2531,1125,80.01422475106686
Aurangabad,Shevga,2015,2447,3571,1124,45.93379648549244
Chandrapur-Ganjwad,Potato,2014,1576,2700,1124,71.31979695431473
Aurangabad,Mosambi,2015,1220,2344,1124,92.1311475409836
Lasalgaon-Vinchur,Gram,2015,3325,4449,1124,33.80451127819549
Jalna,Sorgum(Jawar),2015,1163,2287,1124,96.64660361134996
Lasalgaon,Green Gram,2016,5108,6232,1124,22.00469851213782
Kamthi,Ladies Finger,2015,787,1910,1123,142.69377382465058
Kalamb (Os),Wheat(Husked),2016,2492,3615,1123,45.064205457463885
Ambad(Vadi Godri),Wheat(Husked),2015,1500,2623,1123,74.86666666666666
Solapur,Green Chilli,2015,835,1958,1123,134.49101796407186
Kamthi,Chavli (Pala),2014,1185,2308,1123,94.76793248945148
Chandrapur-Ganjwad,WAL BHAJI,2016,1462,2585,1123,76.812585499316
Pune-Moshi,Brinjal,2016,1677,2800,1123,66.96481812760882
Sangali,Wheat(Husked),2014,1702,2825,1123,65.98119858989425
Jalgaon,Brinjal,2014,1365,2488,1123,82.27106227106228
Aurangabad,Maize(Corn.),2015,600,1722,1122,187.0
Pune,Carrot,2015,905,2027,1122,123.97790055248619
Sangrampur,Ground Nut Pods (Dry),2016,4264,5386,1122,26.313320825515948
Udgir,Black Gram,2014,4479,5601,1122,25.050234427327528
Kopargaon,Onion,2015,466,1588,1122,240.7725321888412
Mangalwedha,Gram,2014,2220,3342,1122,50.54054054054054
Pune,Parwar,2016,1978,3100,1122,56.72396359959555
Chandrapur,Chikoo,2015,1411,2533,1122,79.51807228915662
Sangali,Jaggery,2015,2119,3240,1121,52.90231241151486
Jalgaon,Methi (Bhaji),2016,2011,3132,1121,55.74341123818996
Manchar,Beet Root,2016,1343,2464,1121,83.469843633656
Jalgaon,Ladies Finger,2016,1863,2984,1121,60.17176596886742
Jalgaon,Ladies Finger,2016,1679,2800,1121,66.76593210244192
Kamthi,Cluster Bean,2015,1736,2857,1121,64.57373271889401
Nandura,Black Gram,2015,6820,7941,1121,16.436950146627566
Pune,Carrot,2016,996,2117,1121,112.55020080321285
Bhokar,Sesamum,2015,7039,8160,1121,15.925557607614717
Solapur,Onion,2016,100,1221,1121,1121.0
Jalgaon,Methi (Bhaji),2015,2574,3695,1121,43.55089355089355
Jalgaon,Methi (Bhaji),2015,2158,3279,1121,51.946246524559776
Chandrapur-Ganjwad,Onion,2014,1079,2200,1121,103.89249304911955
Osmanabad,Capsicum,2016,1510,2630,1120,74.17218543046357
Mangaon(Bhadav),Nachani,2015,1320,2440,1120,84.84848484848484
Akluj,Carrot,2015,1947,3067,1120,57.524396507447356
Pune,Mula Shenga,2016,1420,2540,1120,78.87323943661971
Pune,Ghosali(Bhaji),2015,1340,2460,1120,83.58208955223881
Phaltan,Onion,2015,300,1420,1120,373.3333333333333
Nagpur,Chillies(Red),2014,7380,8500,1120,15.176151761517616
Hinganghat,Gram,2015,3335,4455,1120,33.583208395802096
Sonpeth,Pigeon Pea (Tur),2016,7125,8245,1120,15.719298245614034
Malkapur,Gram,2015,3875,4995,1120,28.903225806451612
Sangrampur,Green Gram,2014,6000,7120,1120,18.666666666666668
Akole,Onion,2016,120,1240,1120,933.3333333333334
Umarga,Green Gram,2016,3819,4939,1120,29.327048965697827
Pune,Chavli (Shenga ),2015,1413,2533,1120,79.26397735314933
Karanja,Pigeon Pea (Tur),2015,7955,9075,1120,14.079195474544312
Pune,Green Peas (Dry),2016,2839,3958,1119,39.415287072912996
Lonar,Pigeon Pea (Tur),2015,7440,8559,1119,15.040322580645162
Malkapur,Onion,2015,909,2028,1119,123.1023102310231
Patan,Green Chilli,2016,3855,4974,1119,29.027237354085603
Umarga,Black Gram,2015,7370,8489,1119,15.183175033921303
Jamkhed,Sorgum(Jawar),2015,1626,2745,1119,68.81918819188192
Rahata,Tomato,2016,1057,2175,1118,105.77105014191108
Pune,Double Bee,2015,2176,3294,1118,51.37867647058823
Mangalwedha,Gram,2014,2172,3290,1118,51.47329650092081
Babhulgaon,Pigeon Pea (Tur),2016,5758,6876,1118,19.416464050017368
Osmanabad,Lemon,2015,838,1956,1118,133.4128878281623
Lasur Station,Gram,2015,3854,4972,1118,29.008822003113647
Mandhal,Chillies(Red),2015,3878,4996,1118,28.82929345023208
Ahmednagar,Green Gram,2015,6670,7788,1118,16.761619190404797
Junnar,Onion,2014,1170,2288,1118,95.55555555555556
Akot,Pigeon Pea (Tur),2015,5279,6397,1118,21.178253457094147
Kamthi,Guava,2014,1015,2133,1118,110.14778325123153
Nashik,Green Chilli,2015,1385,2503,1118,80.72202166064982
Newasa-Ghodegaon,Onion,2015,273,1391,1118,409.5238095238095
Kamthi,Spinach,2016,1123,2240,1117,99.46571682991986
Solapur,Wheat(Husked),2014,1553,2670,1117,71.92530585962653
Pune,Green Peas (Dry),2016,2860,3977,1117,39.05594405594405
Aurangabad,Lemon,2014,3509,4626,1117,31.832430891992022
Nashik,Dhemse,2016,1967,3084,1117,56.786985256736145
Manmad,Onion,2015,459,1576,1117,243.35511982570807
Pune-Manjri,Chavli (Pala),2015,711,1828,1117,157.10267229254572
Nashik-Devlali,Methi (Bhaji),2016,1761,2878,1117,63.429869392390685
Rahuri,Bor,2016,506,1623,1117,220.7509881422925
Ramtek,Green Chilli,2016,4213,5329,1116,26.489437455494897
Paithan,Pigeon Pea (Tur),2015,7978,9094,1116,13.988468287791427
Ahmedpur,Green Gram,2015,7778,8894,1116,14.34816148110054
Manchar,Methi (Bhaji),2015,581,1697,1116,192.08261617900172
Dondaicha,Matki,2016,5787,6903,1116,19.2846034214619
Kamthi,Potato,2015,767,1883,1116,145.5019556714472
Udgir,Green Gram,2014,5844,6960,1116,19.096509240246405
Kamthi,Potato,2015,567,1683,1116,196.82539682539684
Sangali,Chillies(Red),2015,11692,12808,1116,9.544988026000684
Jalna,Sorgum(Jawar),2015,1140,2256,1116,97.89473684210526
Nira-Saswad,Rice(Paddy-Hus),2016,2150,3266,1116,51.906976744186046
Kamthi,Onion,2015,958,2074,1116,116.49269311064718
Wardha,Gram,2016,7231,8346,1115,15.419720647213387
Daryapur,Gram,2015,3311,4426,1115,33.67562669888251
Vadgaon Peth,Green Chilli,2015,1471,2586,1115,75.79877634262407
Sangli-Phale Bhajipalam,Ginger (Fresh),2016,2654,3769,1115,42.0120572720422
Pune,Cucumber,2015,840,1955,1115,132.73809523809524
Lonand,Onion,2014,845,1960,1115,131.9526627218935
Barshi,Gram,2015,3609,4724,1115,30.894984760321417
Ratanagari,Brinjal,2016,1132,2247,1115,98.4982332155477
Ahmednagar,Tomato,2015,371,1486,1115,300.53908355795147
Vadgaon Peth,Capsicum,2016,1255,2370,1115,88.84462151394422
Jalgaon,Cluster Bean,2015,1745,2860,1115,63.89684813753582
Jalgaon,Cluster Bean,2015,1770,2885,1115,62.994350282485875
Dhule,Onion,2015,189,1303,1114,589.4179894179895
Chandrapur,Chikoo,2016,1443,2557,1114,77.2002772002772
Nashik,Kanda Pat,2014,650,1764,1114,171.3846153846154
Lasalgaon,Gram,2016,3296,4410,1114,33.79854368932039
Pune-Manjri,Green Chilli,2015,2786,3900,1114,39.985642498205316
Akluj,Garlic,2014,2133,3247,1114,52.22691045475855
Malegaon,Pigeon Pea (Tur),2016,6286,7400,1114,17.721921730830417
Kurdwadi-Modnimb,Onion,2015,140,1254,1114,795.7142857142857
Barshi,Sorgum(Jawar),2015,1391,2505,1114,80.0862688713156
Dound,Gram,2016,7364,8478,1114,15.127648017381858
Lasalgaon-Vinchur,Gram,2015,3150,4263,1113,35.333333333333336
Kopargaon,Gram,2016,5504,6617,1113,20.221656976744185
Kolhapur-Laxmipuri,Wheat(Husked),2014,1625,2738,1113,68.49230769230769
Sangali,Sorgum(Jawar),2015,1590,2703,1113,70.0
Chikhali,Pigeon Pea (Tur),2016,4982,6095,1113,22.340425531914892
Purna,Pigeon Pea (Tur),2016,7890,9003,1113,14.106463878326997
Indapur-Bhigwan,Gram,2015,3750,4863,1113,29.68
Ahmednagar,Pigeon Pea (Tur),2016,6225,7338,1113,17.879518072289155
Kada,Gram,2016,7287,8400,1113,15.27377521613833
Nandurbar,Chillies(Red),2015,2091,3204,1113,53.22812051649928
Bhivandi,Rice(Paddy-Hus),2016,2372,3484,1112,46.880269814502526
Nagpur,Ginger (Fresh),2015,3200,4312,1112,34.75
Akluj,Chillies(Red),2014,2253,3365,1112,49.35641367066134
Sangali,Jaggery,2014,2495,3607,1112,44.569138276553105
Barshi,Pigeon Pea (Tur),2015,8656,9768,1112,12.846580406654343
Aurangabad,Mosambi,2014,1408,2520,1112,78.97727272727273
Karad,Pomegranate,2015,3444,4556,1112,32.28803716608595
Barshi,Cluster Bean,2016,1763,2875,1112,63.07430516165627
Nagpur,Pineapple,2015,1000,2112,1112,111.2
Shirpur,Gram,2016,5043,6155,1112,22.050366845131865
Kurdwadi,Pigeon Pea (Tur),2015,3879,4990,1111,28.641402423304974
Nanded,Green Gram,2015,7300,8411,1111,15.219178082191782
Ramtek,Garlic,2016,6889,8000,1111,16.127159239367106
Jalgaon,Ladies Finger,2014,1518,2629,1111,73.18840579710145
Kamthi,Capsicum,2015,1667,2778,1111,66.64667066586682
Akkolkot,Gram,2015,4000,5111,1111,27.775
Malegaon,ONION,2016,407,1518,1111,272.97297297297297
Phaltan,Brinjal,2016,1412,2523,1111,78.6827195467422
Kolhapur-Malkapur,Brinjal,2016,289,1400,1111,384.42906574394465
Mumbai,Mosambi,2014,985,2096,1111,112.79187817258884
Solapur,Brinjal,2015,275,1386,1111,404.0
Chandur Bajar,Gram,2016,6750,7861,1111,16.45925925925926
Barshi,Brinjal,2016,1827,2938,1111,60.81007115489874
Sakri,Ground Nut Pods (Dry),2016,3532,4643,1111,31.455266138165346
Chalisgaon,Gram,2015,3834,4945,1111,28.977569118414188
Kalamb (Os),Gram,2016,5443,6554,1111,20.41153775491457
Sailu,Pigeon Pea (Tur),2015,5631,6742,1111,19.730065707689576
Sengaon,Turmeric,2015,8126,9236,1110,13.659857248338666
Pune-Manjri,Raddish,2016,1200,2310,1110,92.5
Kurdwadi-Modnimb,Sorgum(Jawar),2016,1407,2517,1110,78.89125799573561
Osmanabad,Tomato,2015,675,1785,1110,164.44444444444446
Pune-Manjri,Goosefoot,2016,0,1110,1110,inf
Jalna,Pigeon Pea (Tur),2016,7029,8139,1110,15.79172001707213
Pune,Pumpkin,2016,1170,2280,1110,94.87179487179488
Pune,Ridge Gourd,2014,1170,2280,1110,94.87179487179488
Aurangabad,Mosambi,2015,1811,2921,1110,61.292103810049696
Pune-Manjri,Rajgira,2015,0,1110,1110,inf
Dondaicha,Black Gram,2014,4091,5201,1110,27.13273038376925
Pune,Chavli (Shenga ),2016,1591,2700,1109,69.70458830923947
Pimpalgaon (B)-Saykheda,Onion,2014,531,1640,1109,208.8512241054614
Vasai,Tomato,2015,1053,2162,1109,105.31813865147198
Osmanabad,Capsicum,2015,1664,2773,1109,66.64663461538461
Kalyan,Ghevda,2016,6543,7652,1109,16.94941158489989
Udgir,Tamarind,2016,7933,9042,1109,13.979578973906467
Rahata,Potato,2016,727,1836,1109,152.54470426409904
Udgir,Gram,2015,2594,3703,1109,42.75250578257517
Mumbai,Orange,2016,848,1957,1109,130.77830188679246
Pune,Carrot,2016,920,2028,1108,120.43478260869566
Sangamner,Onion,2015,362,1470,1108,306.0773480662983
Umarga,Sesamum,2014,8128,9236,1108,13.631889763779528
Jalgaon,Orange,2014,1057,2165,1108,104.82497634815516
Pune-Manjri,Ladies Finger,2015,2421,3529,1108,45.76621230896324
Khed-Chakan,Cucumber,2016,1220,2328,1108,90.81967213114754
Malkapur,Gram,2016,5668,6776,1108,19.54834156669019
Nashik,Guava,2016,1597,2705,1108,69.38008766437069
Lonand,Onion,2015,1380,2488,1108,80.28985507246377
Pune,Capsicum,2016,1696,2804,1108,65.33018867924528
Anajngaon Surji,Black Gram,2015,9050,10158,1108,12.243093922651934
Chandvad,Onion,2014,426,1534,1108,260.09389671361504
Sonpeth,Pigeon Pea (Tur),2016,7566,8674,1108,14.644462067142479
Umared,Other Pulses,2016,8645,9753,1108,12.816657027183343
Pune-Manjri,Brinjal,2016,1817,2925,1108,60.97963676389653
Shirpur,SESAMUM,2016,4523,5630,1107,24.474906035816936
Ratanagari,Green Chilli,2016,3893,5000,1107,28.435653737477523
Pune-Manjri,Raddish,2014,1131,2238,1107,97.87798408488064
Kopargaon,Onion,2016,428,1535,1107,258.6448598130841
Pusad,Green Gram,2015,6553,7660,1107,16.89302609491836
Lasalgaon,Ground Nut Pods (Dry),2016,3542,4649,1107,31.253529079616037
Vadgaon Peth,Ridge Gourd,2016,1214,2321,1107,91.18616144975289
Karmala,Sorgum(Jawar),2016,1620,2727,1107,68.33333333333333
Sangli-Phale Bhajipalam,Water Melon,2016,83,1189,1106,1332.5301204819277
Malegaon,Green Gram,2014,6204,7310,1106,17.827208252740167
Nandurbar,Gram,2016,3919,5025,1106,28.221485072722633
Kolhapur,Flower,2015,430,1536,1106,257.2093023255814
Ratanagari,Ladies Finger,2016,3222,4328,1106,34.326505276225944
Pune,Black Gram,2016,12244,13350,1106,9.032995753021888
Ulhasnagar,Gr.Nut Kernels,2016,7718,8824,1106,14.330137341280125
Kolhapur-Laxmipuri,Spilt Pigeon Pea,2014,5727,6833,1106,19.31203073162214
Lonar,Green Gram,2015,7152,8258,1106,15.46420581655481
Sinner,Gram,2016,3670,4776,1106,30.13623978201635
Kalyan,Green Chilli,2016,5490,6595,1105,20.127504553734063
Akole,Onion,2016,159,1264,1105,694.9685534591194
Dondaicha,Pigeon Pea (Tur),2015,7288,8393,1105,15.161909989023052
Mehkar,Pigeon Pea (Tur),2015,5018,6123,1105,22.020725388601036
Pune,Curry Leaves,2014,991,2096,1105,111.50353178607467
Jalna,Green Gram,2014,6743,7848,1105,16.387364674477237
Latur,Soybean,2016,2122,3227,1105,52.07351555136663
Ausa,Wheat(Husked),2015,1888,2993,1105,58.527542372881356
Nashik,Orange,2016,1465,2570,1105,75.42662116040955
Kamthi,Chavli (Shenga ),2015,639,1743,1104,172.7699530516432
Barshi-Vairag,Sorgum(Jawar),2014,1104,2208,1104,100.0
Solapur,Ghevda,2016,2775,3879,1104,39.78378378378378
Sangamner,Tomato,2015,682,1786,1104,161.87683284457478
Osmanabad,Sorgum(Jawar),2016,1407,2511,1104,78.46481876332622
Amarawati,Black Gram,2015,7412,8516,1104,14.894765245547761
Sangli-Phale Bhajipalam,POTATO,2016,408,1512,1104,270.5882352941176
Nashik,Potato,2016,397,1501,1104,278.08564231738035
Mumbai,Shevga,2015,2742,3846,1104,40.26258205689278
Ambad(Vadi Godri),Pigeon Pea (Tur),2015,5527,6631,1104,19.974669802786323
Vadgaon Peth,Brinjal,2015,1200,2304,1104,92.0
Nashik,Onion,2016,372,1476,1104,296.7741935483871
Pathardi,Gram,2016,4240,5343,1103,26.014150943396228
Mangrulpeer,Gram,2016,5714,6817,1103,19.30346517325866
Malegaon,Ground Nut Pods (Dry),2015,3778,4881,1103,29.195341450502912
Nashik,Bottle Gourd,2016,817,1920,1103,135.0061199510404
Pune,Small Gourd,2015,1156,2259,1103,95.41522491349481
Dondaicha,Gram,2016,5200,6303,1103,21.21153846153846
Pune-Manjri,GHEVDA,2016,3543,4646,1103,31.131809201241886
Kamthi,Flower,2015,852,1955,1103,129.4600938967136
Majalgaon,Bajri,2015,1065,2168,1103,103.5680751173709
Khamgaon,Pigeon Pea (Tur),2016,5884,6986,1102,18.728755948334467
Sangrampur,Gram,2015,2888,3990,1102,38.1578947368421
Savner,Gram,2016,6175,7277,1102,17.846153846153847
Kalamb (Os),Green Gram,2014,5481,6583,1102,20.105820105820104
Nilanga,Pigeon Pea (Tur),2016,7317,8419,1102,15.060817274839415
Malegaon,Ground Nut Pods (Dry),2015,3686,4788,1102,29.896907216494846
Bhokar,Turmeric,2016,6832,7934,1102,16.129976580796253
Osmanabad,Cucumber,2014,830,1931,1101,132.65060240963857
Nandgaon,Tamarind,2016,6699,7800,1101,16.435288849081953
Mangalwedha,Sorgum(Jawar),2015,1150,2251,1101,95.73913043478261
Lonand,Onion,2014,644,1745,1101,170.96273291925465
Manmad,Black Gram,2016,5600,6701,1101,19.660714285714285
Taloda,Gram,2015,2827,3928,1101,38.94587902370004
Indapur-Bhigwan,Sorgum(Jawar),2015,1525,2626,1101,72.19672131147541
Vadgaon Peth,Tomato,2014,513,1613,1100,214.42495126705654
Vadgaon Peth,Bitter Gourd,2015,1178,2278,1100,93.3786078098472
Telhara,Black Gram,2015,7250,8350,1100,15.172413793103448
Kada,Black Gram,2015,7667,8767,1100,14.347202295552368
Jalgaon,Bitter Gourd,2015,1847,2947,1100,59.55603681645912
Hingna,Pigeon Pea (Tur),2016,6000,7100,1100,18.333333333333332
Khed-Chakan,Cluster Bean,2016,4120,5220,1100,26.699029126213592
Gangapur,Onion,2015,550,1650,1100,200.0
Jalgaon,Chavli (Shenga ),2016,2518,3618,1100,43.68546465448769
Basmat (Kurunda),TURMERIC,2016,6900,8000,1100,15.942028985507246
Phaltan,Sorgum(Jawar),2015,1333,2433,1100,82.52063015753939
Kolhapur,Carrot,2016,1800,2900,1100,61.111111111111114
Mumbai,Spilt Pigeon Pea,2015,6723,7823,1100,16.361743269373793
Pachora,BLACK GRAM,2016,5000,6100,1100,22.0
Mumbai,Wheat(Husked),2014,1800,2900,1100,61.111111111111114
Sakri,Rice(Paddy-Hus),2016,2000,3100,1100,55.0
Mukhed,BLACK GRAM,2016,6050,7150,1100,18.181818181818183
Koregaon,Potato,2016,400,1500,1100,275.0
Pune-Manjri,Hemp,2014,267,1367,1100,411.98501872659176
Sillod-Bharadi,Gram,2016,6200,7300,1100,17.741935483870968
Pune,Dhemse,2015,1000,2100,1100,110.0
Pune-Manjri,Goosefoot,2015,0,1100,1100,inf
Nashik,Brinjal,2015,700,1800,1100,157.14285714285714
Akluj,Chillies(Red),2015,1617,2717,1100,68.02721088435374
Palus,Flower,2016,650,1750,1100,169.23076923076923
Patur,Pigeon Pea (Tur),2015,7950,9050,1100,13.836477987421384
Pune-Manjri,Bottle Gourd,2016,1021,2121,1100,107.73751224289911
Jamkhed,Sorgum(Jawar),2016,1771,2871,1100,62.11180124223603
Rahata,ONION,2016,163,1263,1100,674.8466257668712
Mangaon(Bhadav),NAGALI,2016,1350,2450,1100,81.48148148148148
Kada,Pigeon Pea (Tur),2016,7000,8100,1100,15.714285714285714
Akola,Sesamum,2015,5500,6600,1100,20.0
Lasur Station,Pigeon Pea (Tur),2015,5277,6377,1100,20.845177184006065
Pune,Beet Root,2015,465,1565,1100,236.55913978494624
Kolhapur,Ground Nut Pods (Dry),2016,2800,3900,1100,39.285714285714285
Manora,Pigeon Pea (Tur),2015,10050,11150,1100,10.945273631840797
Chandrapur,Green Gram,2016,5200,6300,1100,21.153846153846153
Pandharpur,Cucumber,2015,200,1300,1100,550.0
Karad,Jaggery,2016,2482,3582,1100,44.31909750201451
Karad,Onion,2015,2875,3975,1100,38.26086956521739
Kalyan,Black Gram,2015,8067,9167,1100,13.635800173546547
Barshi-Vairag,Gram,2016,7986,9086,1100,13.774104683195592
Jalgaon,Wal Papdi,2016,1950,3050,1100,56.41025641025641
Chandrapur,Mosambi,2015,1000,2100,1100,110.0
Nashik,Orange,2015,650,1750,1100,169.23076923076923
Osmanabad,Ginger (Fresh),2015,2380,3480,1100,46.21848739495798
Junnar-Otur,Shevga,2016,1500,2600,1100,73.33333333333333
Ahmednagar,Pigeon Pea (Tur),2015,4500,5600,1100,24.444444444444443
Pune-Manjri,Walvad,2015,1912,3012,1100,57.53138075313807
Pune,Chavli (Shenga ),2014,1358,2458,1100,81.00147275405007
Shirpur,Chillies(Red),2015,2652,3752,1100,41.47812971342383
Indapur-Bhigwan,Green Gram,2016,6000,7100,1100,18.333333333333332
Osmanabad,Capsicum,2015,1450,2550,1100,75.86206896551724
Aurangabad,Zendu,2014,2300,3400,1100,47.82608695652174
Osmanabad,Awala,2015,550,1650,1100,200.0
Kurdwadi-Modnimb,Bor,2016,500,1600,1100,220.0
Pune,Wal Papdi,2014,1707,2807,1100,64.44053895723492
Kamthi,Lemon,2015,1567,2667,1100,70.19783024888322
Kopargaon,Onion,2015,338,1438,1100,325.4437869822485
Devala,Pigeon Pea (Tur),2015,4805,5905,1100,22.892819979188346
Kolhapur,Ground Nut Pods (Dry),2016,2750,3850,1100,40.0
Nashik,Papai,2016,900,2000,1100,122.22222222222223
Kalyan,Mosambi,2016,4175,5275,1100,26.347305389221557
Ahmednagar,Cucumber,2015,500,1600,1100,220.0
Kolhapur-Malkapur,Flower,2016,450,1550,1100,244.44444444444446
Parshiwani,Other Vegetables,2016,775,1875,1100,141.93548387096774
Ratanagari,Green Chilli,2015,2725,3825,1100,40.36697247706422
Tumsar,Rice(Paddy-Hus),2016,2091,3191,1100,52.60640841702535
Bhokar,Green Gram,2014,4700,5800,1100,23.404255319148938
Chalisgaon,Matki,2015,6000,7100,1100,18.333333333333332
Rahuri-Songaon,Tomato,2016,1000,2100,1100,110.0
Ulhasnagar,Wheat(Husked),2016,1984,3084,1100,55.443548387096776
Rahuri,Flower,2016,2000,3100,1100,55.0
Achalpur,Gram,2016,5425,6525,1100,20.276497695852534
Nashik,Kanda Pat,2015,1000,2100,1100,110.0
Solapur,Cabbage,2016,894,1994,1100,123.04250559284117
Nashik,Melon,2016,400,1500,1100,275.0
Udgir,Black Gram,2014,4127,5227,1100,26.65374363944754
Jalgaon,Orange,2016,700,1800,1100,157.14285714285714
Pune,Green Peas (Dry),2016,3382,4482,1100,32.52513305736251
Vadgaon Peth,Ladies Finger,2015,1333,2433,1100,82.52063015753939
Osmanabad,Flower,2015,983,2083,1100,111.90233977619532
Kolhapur,Ginger (Fresh),2016,2142,3242,1100,51.35387488328665
Vadgaon Peth,Carrot,2016,570,1670,1100,192.98245614035088
Kolhapur-Laxmipuri,Wheat(Husked),2014,1700,2800,1100,64.70588235294117
Satara,Onion,2015,750,1850,1100,146.66666666666666
Kamthi,Wal Bhaji,2016,1386,2486,1100,79.36507936507937
Pune,Pavtta,2016,1430,2530,1100,76.92307692307692
Kolhapur,Ground Nut Pods (Dry),2016,2424,3524,1100,45.37953795379538
Kamthi,Wal Bhaji,2016,1158,2258,1100,94.99136442141624
Nashik,Carrot,2015,2575,3675,1100,42.71844660194175
Kalyan,Garlic,2014,2500,3600,1100,44.0
Mangrulpeer,Pigeon Pea (Tur),2016,8319,9419,1100,13.22274311816324
Junnar-Otur,Carrot,2016,700,1800,1100,157.14285714285714
Pandharpur,Ladies Finger,2015,800,1900,1100,137.5
Manchar,Brinjal,2014,1333,2433,1100,82.52063015753939
Shrirampur,Pigeon Pea (Tur),2014,3000,4100,1100,36.666666666666664
Sangamner,Gram,2016,4853,5952,1099,22.645786111683496
Pimpalgaon (B)-Saykheda,Onion,2015,374,1473,1099,293.85026737967917
Latur,Pigeon Pea (Tur),2014,4255,5354,1099,25.82843713278496
Ausa,Sorgum(Jawar),2015,1746,2845,1099,62.9438717067583
Nashik,Capsicum,2016,2851,3950,1099,38.547877937565765
Nashik,Cucumber,2016,1655,2754,1099,66.404833836858
Sangli-Phale Bhajipalam,Papai,2016,194,1293,1099,566.4948453608248
Chopda,Sesamum,2016,3701,4800,1099,29.694677114293434
Pimpalgaon (B)-Saykheda,Onion,2014,510,1609,1099,215.49019607843138
Kalmeshwar,Pigeon Pea (Tur),2016,7332,8431,1099,14.989088925259137
Dound,Pigeon Pea (Tur),2016,6160,7259,1099,17.84090909090909
Umared,Other Pulses,2016,7871,8969,1098,13.949942828103163
Kurdwadi-Modnimb,Pigeon Pea (Tur),2015,4500,5598,1098,24.4
Khamgaon,Sesamum,2014,10185,11283,1098,10.780559646539029
Osmanabad,Tomato,2015,822,1920,1098,133.57664233576642
Pandharpur,Capsicum,2015,634,1732,1098,173.18611987381703
Indapur (Nimgaon Ketki),Gram,2015,3043,4141,1098,36.08281301347355
Nashik,Methi (Bhaji),2014,589,1686,1097,186.2478777589134
Phaltan,Sorgum(Jawar),2016,1570,2667,1097,69.87261146496816
Khamgaon,Green Gram,2015,6746,7843,1097,16.261488289356656
Karad,Mosambi,2016,6038,7135,1097,18.168267638290825
Shirpur,Green Gram,2016,4579,5676,1097,23.957195894300064
Sangali,Wheat(Unhusked),2015,2329,3426,1097,47.101760412194075
Kamthi,Kanda Pat,2015,1089,2185,1096,100.64279155188247
Kurdwadi-Modnimb,Sorgum(Jawar),2015,1422,2518,1096,77.0745428973277
Pune,Snake Gourd,2016,1995,3091,1096,54.93734335839599
Aurangabad,Onion,2014,316,1412,1096,346.8354430379747
Khed-Chakan,Ladies Finger,2016,2923,4019,1096,37.49572357167294
Jalgaon,CORIANDER ,2016,1224,2319,1095,89.46078431372548
Satara,Cluster Bean,2016,3905,5000,1095,28.040973111395648
Basmat,Turmeric,2014,5510,6605,1095,19.872958257713247
Aurangabad,Onion,2014,468,1563,1095,233.97435897435898
Jalgaon,Coriander  ,2016,1680,2775,1095,65.17857142857143
Pune,Elephant Root,2016,1500,2595,1095,73.0
Pusad,Spilt Pigeon Pea,2015,9905,11000,1095,11.055022715800101
Sangali,Wheat(Unhusked),2015,3123,4218,1095,35.06243996157541
Ratanagari,Ladies Finger,2016,2643,3738,1095,41.43019296254256
Manmad,Green Gram,2015,7865,8960,1095,13.922441195168467
Anajngaon Surji,Pigeon Pea (Tur),2015,5245,6339,1094,20.857959961868445
Sangli-Phale Bhajipalam,Pineapple,2016,520,1614,1094,210.3846153846154
Pune,Rice(Paddy-Hus),2015,4417,5511,1094,24.76794204211003
Osmanabad,Chikoo,2015,989,2083,1094,110.61678463094034
Ambejogai,Gram,2015,3509,4603,1094,31.176973496722713
Udgir,Green Gram,2014,6600,7694,1094,16.575757575757574
Pusad,Pigeon Pea (Tur),2016,8323,9417,1094,13.144298930674037
Sangali,Wheat(Unhusked),2015,2476,3570,1094,44.18416801292407
Satara,Shevga,2014,3250,4344,1094,33.66153846153846
Barshi,Turmeric,2015,5496,6590,1094,19.90538573508006
Shirpur,Green Gram,2014,6378,7472,1094,17.152712449043587
Gevrai,Green Gram,2015,7590,8684,1094,14.413702239789197
Pune-Manjri,Green-Peas,2015,2824,3918,1094,38.73937677053824
Ahmednagar,Green Gram,2015,7356,8450,1094,14.872213159325721
Daryapur,Gram,2016,6976,8069,1093,15.668004587155963
Karanja,Pigeon Pea (Tur),2015,8385,9478,1093,13.035181872391174
Vadgaon Peth,Green Chilli,2016,1040,2133,1093,105.09615384615384
Aurangabad,Orange,2016,1060,2153,1093,103.11320754716981
Indapur,Sorgum(Jawar),2015,1246,2339,1093,87.7207062600321
Sangali,Wheat(Husked),2015,1681,2774,1093,65.02082093991672
Hinganghat,Pigeon Pea (Tur),2015,7126,8219,1093,15.338198147628402
Sangali,Sorgum(Jawar),2015,1584,2677,1093,69.00252525252525
Umared,Pigeon Pea (Tur),2015,5633,6726,1093,19.403515000887626
Vadgaon Peth,Capsicum,2016,1020,2113,1093,107.15686274509804
Pune,Curry Leaves,2015,1446,2538,1092,75.51867219917013
Hingoli-Kanegaon Naka,Pigeon Pea (Tur),2016,6087,7179,1092,17.939871858058158
Akluj,Carrot,2016,1229,2321,1092,88.8527257933279
Akola,Gram,2016,6162,7254,1092,17.72151898734177
Shirpur,Ground Nut Pods (Dry),2015,4773,5865,1092,22.878692646134507
Pune,Bitter Gourd,2015,2560,3652,1092,42.65625
Kolhapur-Laxmipuri,Split Black Gram,2016,15050,16142,1092,7.255813953488372
Khed (Shel Pimpalgaon),Ladies Finger,2014,1457,2549,1092,74.94852436513384
Jalgaon,Cluster Bean,2015,1927,3018,1091,56.61650233523612
Aurangabad,Onion,2014,395,1486,1091,276.2025316455696
Kalvan,Gram,2016,3900,4991,1091,27.974358974358974
Sangrampur,Gram,2015,2168,3259,1091,50.32287822878229
Kolhapur,Onion,2015,492,1583,1091,221.7479674796748
Mehkar,Pigeon Pea (Tur),2016,7413,8504,1091,14.717388371779307
Shrirampur,Green Chilli,2015,2591,3682,1091,42.107294480895405
Shirpur,Onion,2015,297,1388,1091,367.3400673400673
Rahata,Garlic,2015,3591,4682,1091,30.38150932887775
Mehkar,Green Gram,2015,7727,8818,1091,14.119321858418532
Varud-Rajura Bazar,Gram,2014,2094,3185,1091,52.10124164278892
Vadgaon Peth,Pavtta,2016,2136,3227,1091,51.07677902621723
Pune,Beet Root,2015,393,1483,1090,277.35368956743
Kamthi,Ladies Finger,2015,1555,2645,1090,70.09646302250803
Risod,Black Gram,2015,9213,10303,1090,11.831108216650385
Kamthi,Bitter Gourd,2016,1271,2361,1090,85.75924468922109
Nira-Saswad,Sorgum(Jawar),2016,1600,2690,1090,68.125
Kamthi,Mint,2015,1655,2745,1090,65.86102719033232
Kamthi,Potato,2015,870,1960,1090,125.28735632183908
Pune,Green-Peas,2015,2755,3845,1090,39.56442831215971
Pandharpur,Capsicum,2015,785,1875,1090,138.8535031847134
Aurangabad,Ground Nut Pods (Dry),2016,3000,4090,1090,36.333333333333336
Mangrulpeer,Pigeon Pea (Tur),2016,5476,6566,1090,19.905040175310447
Pandharpur,Tomato,2016,197,1287,1090,553.2994923857868
Pathardi,Onion,2014,114,1204,1090,956.140350877193
Kolhapur-Malkapur,Tomato,2016,378,1467,1089,288.0952380952381
Pune-Manjri,CORIANDER ,2016,732,1821,1089,148.7704918032787
Katol,Pigeon Pea (Tur),2015,7575,8664,1089,14.376237623762377
Jalgaon,Flower,2015,2398,3487,1089,45.41284403669725
Kolhapur,Ground Nut Pods (Dry),2015,2500,3589,1089,43.56
Pune-Manjri,Ridge Gourd,2015,1800,2889,1089,60.5
Latur,Wheat(Husked),2016,1567,2656,1089,69.49585194639438
Nashik,Flower,2016,938,2027,1089,116.09808102345416
Kille Dharur,Pigeon Pea (Tur),2015,5315,6404,1089,20.48918156161806
Nandura,Pigeon Pea (Tur),2015,7304,8393,1089,14.909638554216867
Jalna,Black Gram,2015,8243,9332,1089,13.211209511100327
Lasalgaon,Onion,2015,600,1688,1088,181.33333333333334
Satara,Ginger (Fresh),2016,1575,2663,1088,69.07936507936508
Nashik,Cucumber,2016,1714,2802,1088,63.477246207701285
Sangrampur,Soybean,2015,2425,3513,1088,44.865979381443296
Indapur-Bhigwan,Gram,2015,3188,4276,1088,34.12797992471769
Junnar-Otur,Mango(Raw),2016,747,1835,1088,145.64926372155287
Akot,GRAM,2016,7622,8710,1088,14.274468643400683
Umarga,Pigeon Pea (Tur),2015,4550,5638,1088,23.912087912087912
Kurdwadi-Modnimb,Gram,2015,3109,4197,1088,34.99517529752332
Karad,Green-Peas,2014,2375,3463,1088,45.810526315789474
Hinganghat,Gram,2016,6865,7953,1088,15.848506919155135
Mumbai-Fruit Market,Pomegranate,2016,3904,4992,1088,27.868852459016395
Pune,Ghosali(Bhaji),2015,1156,2244,1088,94.11764705882354
Jalgaon,Bitter Gourd,2014,2471,3559,1088,44.03075677863213
Dindori-Vani,Onion,2015,600,1688,1088,181.33333333333334
Murbad,GHEVDA,2016,3500,4588,1088,31.085714285714285
Mangaon(Bhadav),Nagali,2014,1300,2388,1088,83.6923076923077
Mumbai,Split Black Gram,2015,10152,11239,1087,10.707249802994484
Dondaicha-Sindkheda,Wheat(Husked),2016,1666,2753,1087,65.24609843937576
Malkapur,Pigeon Pea (Tur),2015,4483,5570,1087,24.24715592237341
Lasalgaon-Vinchur,Soybean,2016,2899,3986,1087,37.495688168333906
Kamthi,Flower,2016,733,1820,1087,148.29467939972716
Kada,Tamarind,2015,3430,4517,1087,31.690962099125365
Pimpalgaon Basawant,Onion,2016,364,1451,1087,298.6263736263736
Solapur,Bitter Gourd,2016,1921,3007,1086,56.53305570015617
Khed-Chakan,Cluster Bean,2016,4279,5365,1086,25.37976162654826
Lasalgaon-Niphad,Onion,2015,434,1520,1086,250.23041474654377
Majalgaon,Sorgum(Jawar),2015,1137,2223,1086,95.51451187335093
Sangali,Jaggery,2015,2370,3456,1086,45.822784810126585
Kamthi,Jack Fruit(Raw),2015,843,1929,1086,128.82562277580072
Jintur,Green Gram,2015,6880,7966,1086,15.784883720930232
Sangli-Phale Bhajipalam,Bor,2016,287,1373,1086,378.397212543554
Kamthi,CAPSICUM,2016,1176,2262,1086,92.34693877551021
Jalgaon,Brinjal,2014,1514,2600,1086,71.73051519154558
Kolhapur,Papai,2016,315,1400,1085,344.44444444444446
Bhokar,Green Gram,2015,6558,7643,1085,16.54467825556572
Barshi,Gram,2016,7397,8482,1085,14.668108692713263
Barshi,Lemon,2016,1649,2734,1085,65.79745300181928
Manchar,Brinjal,2016,838,1923,1085,129.4749403341289
Mumbai,Split Gram,2016,9545,10630,1085,11.367207962283919
Pune-Manjri,Green Chilli,2015,2315,3400,1085,46.868250539956804
Khamgaon,Ground Nut Pods (Dry),2016,4668,5753,1085,23.243359040274207
Dhamangaon-Rly,Ground Nut Pods (Dry),2016,4271,5356,1085,25.403886677593068
Kamthi,Wal Bhaji,2016,1086,2171,1085,99.90791896869244
Vadgaon Peth,Capsicum,2014,2010,3095,1085,53.98009950248756
Pune,Bitter Gourd,2014,2190,3275,1085,49.54337899543379
Latur,Green Gram,2015,5952,7037,1085,18.229166666666668
Palghar(Bevur),Rice(Paddy-Hus),2016,2431,3516,1085,44.63183874948581
Mangrulpeer,Green Gram,2015,5204,6289,1085,20.84934665641814
Mumbai,Spilt Pigeon Pea,2015,6886,7971,1085,15.756607609642753
Kannad,Ginger (Fresh),2016,1683,2767,1084,64.40879382055853
Kurdwadi-Modnimb,Gram,2015,3155,4239,1084,34.35816164817749
Indapur-Bhigwan,Gram,2016,4937,6021,1084,21.95665383836338
Jalna,Sorgum(Jawar),2016,1338,2422,1084,81.01644245142003
Rahata,Onion,2016,208,1292,1084,521.1538461538462
Pandharpur,Green-Peas,2015,2383,3467,1084,45.488879563575324
Karmala,Gram,2016,4920,6004,1084,22.03252032520325
Pune-Pimpri,Ridge Gourd,2015,2316,3400,1084,46.80483592400691
Satara,Bitter Gourd,2016,4944,6028,1084,21.92556634304207
Vadgaon Peth,Flower,2016,916,2000,1084,118.3406113537118
Gevrai,Pigeon Pea (Tur),2016,5147,6231,1084,21.060812123567125
Barshi-Vairag,Pigeon Pea (Tur),2015,8178,9262,1084,13.255074590364393
Kalyan,Gram,2016,7383,8467,1084,14.68237843694975
Katol,Cotton,2016,4144,5228,1084,26.158301158301157
Nashik,Wal Papdi,2016,1812,2896,1084,59.8233995584989
Amarawati,Custard Apple,2015,3283,4367,1084,33.01858056655498
Akluj,Brinjal,2014,2106,3189,1083,51.42450142450142
Mukhed,Sorgum(Jawar),2015,1634,2717,1083,66.27906976744185
Chalisgaon,Green Gram,2014,5350,6433,1083,20.242990654205606
Solapur,Guava,2015,763,1846,1083,141.9397116644823
Kamthi,Beet Root,2016,2017,3100,1083,53.693604362915224
Mangaon(Bhadav),Nachani,2015,1317,2400,1083,82.23234624145786
Kolhapur-Laxmipuri,Gram,2015,3500,4583,1083,30.942857142857143
Manchar,Coriander  ,2015,246,1329,1083,440.2439024390244
Indapur-Bhigwan,Sesamum,2015,6250,7333,1083,17.328
Kurdwadi,Onion,2015,249,1332,1083,434.93975903614455
Koregaon,Ghevda Seed,2014,5288,6371,1083,20.480332829046898
Pune-Moshi,Green Chilli,2016,3350,4433,1083,32.32835820895522
Aurangabad,Custard Apple,2015,1750,2833,1083,61.885714285714286
Pandharpur,Tomato,2015,280,1363,1083,386.7857142857143
Vadgaon Peth,Ridge Gourd,2015,2417,3500,1083,44.807612743069924
Jalna,Pigeon Pea (Tur),2016,7832,8915,1083,13.82788559754852
Pune,Capsicum,2015,1544,2626,1082,70.07772020725389
Aurangabad,Green Chilli,2015,1911,2993,1082,56.619570905285194
Nashik,LEMON,2016,1122,2204,1082,96.4349376114082
Shirpur,Ground Nut Pods (Dry),2016,3889,4971,1082,27.82206222679352
Kolhapur,BRINJAL,2016,312,1394,1082,346.79487179487177
Pune-Manjri,Green Chilli,2014,2071,3153,1082,52.24529212940608
Junnar,Onion,2015,944,2026,1082,114.61864406779661
Nandurbar,Gram,2015,3116,4198,1082,34.72400513478819
Rahata,Brinjal,2016,1173,2255,1082,92.24211423699914
Phaltan,Bajri,2016,1275,2357,1082,84.86274509803921
Sangali,Sorgum(Jawar),2015,1700,2782,1082,63.64705882352941
Pune,Brinjal,2015,818,1900,1082,132.27383863080684
Barshi,Sorgum(Jawar),2015,1436,2518,1082,75.34818941504179
Chikhali,Soybean,2016,2317,3399,1082,46.69831678895123
Satana,Onion,2014,888,1969,1081,121.73423423423424
Junnar-Otur,Beet Root,2016,840,1921,1081,128.6904761904762
Latur,Wheat(Husked),2014,1537,2618,1081,70.33181522446324
Katol,Ground Nut Pods (Dry),2016,5014,6095,1081,21.559633027522935
Satana,Gram,2016,5534,6615,1081,19.53379110950488
Kurdwadi,Sorgum(Jawar),2015,1140,2221,1081,94.82456140350877
Hinganghat,Gram,2015,3389,4470,1081,31.897314842136325
Indapur,Onion,2014,125,1206,1081,864.8
Ratanagari,BRINJAL,2016,1238,2319,1081,87.31825525040388
Nashik,Ground Nut Pods (Dry),2016,2941,4022,1081,36.75620537232234
Jalgaon,Green Chilli,2015,1200,2281,1081,90.08333333333333
Parola,Pigeon Pea (Tur),2015,6454,7535,1081,16.749302757979546
Pune-Manjri,Goosefoot,2015,0,1080,1080,inf
Pandharpur,Tomato,2015,358,1438,1080,301.67597765363126
Khed-Chakan,Bitter Gourd,2016,4280,5360,1080,25.233644859813083
Ahmednagar,Cucumber,2015,470,1550,1080,229.7872340425532
Mumbai,Small Gourd,2015,1430,2510,1080,75.52447552447552
Kurdwadi,Sorgum(Jawar),2015,1120,2200,1080,96.42857142857143
Barshi,Mango,2016,1915,2995,1080,56.39686684073107
Ahmednagar,Bottle Gourd,2016,480,1560,1080,225.0
Manchar,Brinjal,2016,375,1455,1080,288.0
Jalgaon,Grapes,2015,2660,3740,1080,40.6015037593985
Solapur,Bor,2016,375,1455,1080,288.0
Mangalwedha,Gram,2015,2247,3327,1080,48.06408544726302
Kolhapur-Malkapur,Flower,2016,370,1450,1080,291.8918918918919
Mumbai,Split Lentil,2016,6008,7088,1080,17.976031957390145
Jalna,SORGUM(JAWAR),2016,1763,2842,1079,61.20249574588769
Shrirampur,Gram,2015,3183,4262,1079,33.89883757461514
Sangali,Jaggery,2015,2195,3274,1079,49.15717539863326
Sindi (Selu),Gram,2016,4539,5618,1079,23.771755893368585
Satara,Cluster Bean,2015,3658,4737,1079,29.49699289229087
Sangrampur-Varvatbakal,Gram,2016,4638,5717,1079,23.264338076757223
Jalgaon,Methi (Bhaji),2016,1378,2457,1079,78.30188679245283
Pune,Brinjal,2015,695,1773,1078,155.10791366906474
Nashik,Carrot,2015,1136,2214,1078,94.8943661971831
Pune,Chavli (Shenga ),2016,1270,2348,1078,84.88188976377953
Manmad,Onion,2015,422,1500,1078,255.45023696682463
Ambejogai,GRAM,2016,6243,7321,1078,17.26733942015057
Bhivandi,Rice(Paddy-Hus),2014,1418,2496,1078,76.02256699576868
Akluj,Chikoo,2015,1744,2822,1078,61.81192660550459
Vadgaon Peth,Bitter Gourd,2015,1377,2455,1078,78.28612926652143
Vadgaon Peth,Pavtta,2014,1622,2700,1078,66.46115906288533
Katol,Gram,2016,7030,8108,1078,15.334281650071123
Nagpur,Orange,2016,1470,2548,1078,73.33333333333333
Vadgaon Peth,Ridge Gourd,2015,1305,2383,1078,82.60536398467433
Karad,Custard Apple,2015,1923,3000,1077,56.00624024960999
Majalgaon,Green Gram,2015,7619,8696,1077,14.135713348208427
Khed-Chakan,Capsicum,2016,4769,5846,1077,22.583350807297126
Nagpur,Pigeon Pea (Tur),2015,6157,7234,1077,17.492285203833035
Satara,Capsicum,2016,4077,5154,1077,26.416482707873435
Vadgaon Peth,Flower,2014,1000,2077,1077,107.7
Ratanagari,Brinjal,2016,1150,2227,1077,93.65217391304348
Paranda,Pigeon Pea (Tur),2016,7252,8329,1077,14.85107556536128
Kopargaon,Green Gram,2014,6834,7911,1077,15.75943810359965
Sangali,Jaggery,2016,3127,4204,1077,34.44195714742565
Amarawati-Fruit And Vegetables,Ginger (Fresh),2016,1500,2577,1077,71.8
Nashik,Raddish,2014,929,2006,1077,115.93110871905274
Jalgaon,Jambhul,2015,3492,4569,1077,30.84192439862543
Karad,Pomegranate,2016,4615,5692,1077,23.33694474539545
Sengaon,Pigeon Pea (Tur),2016,8124,9201,1077,13.257016248153619
Chikhali,Pigeon Pea (Tur),2014,3621,4697,1076,29.71554819110743
Ambejogai,Pigeon Pea (Tur),2016,6731,7807,1076,15.985737631852622
Mumbai,Guava,2015,824,1900,1076,130.58252427184465
Barshi,Onion,2015,948,2024,1076,113.50210970464136
Pune-Manjri,Raddish,2014,653,1729,1076,164.77794793261867
Kamthi,Chavli (Shenga ),2016,816,1892,1076,131.86274509803923
Aurangabad,Fig,2016,3072,4148,1076,35.026041666666664
Mehkar,BLACK GRAM,2016,5445,6521,1076,19.761248852157944
Malegaon,Onion,2015,363,1439,1076,296.41873278236915
Jalgaon,Ginger (Fresh),2016,2010,3086,1076,53.53233830845771
Pandharpur,ONION,2016,162,1238,1076,664.1975308641976
Barshi-Vairag,Gram,2016,6209,7285,1076,17.329682718634242
Chikhali,Black Gram,2016,5919,6995,1076,18.17874640986653
Nira-Saswad,Gram,2016,4575,5650,1075,23.497267759562842
Satara,Bottle Gourd,2014,879,1954,1075,122.2980659840728
Chandur Rly.,Black Gram,2016,5838,6913,1075,18.4138403562864
Hingoli-Kanegaon Naka,Turmeric,2016,7025,8100,1075,15.302491103202847
Balapur,Gram,2015,3525,4600,1075,30.49645390070922
Mumbai,Cowpea,2016,5745,6820,1075,18.711923411662315
Pune,Tomato,2014,713,1788,1075,150.77138849929875
Khamgaon,Black Gram,2015,5267,6342,1075,20.410100626542622
Satana,Onion,2014,788,1863,1075,136.42131979695432
Akole,Gram,2015,3300,4375,1075,32.57575757575758
Nashik,Kharbuj,2016,875,1950,1075,122.85714285714286
Pimpalgaon Basawant,Tomato,2016,441,1516,1075,243.7641723356009
Lasur Station,Green Gram,2014,6803,7878,1075,15.801852124062913
Pandharpur,Cucumber,2014,275,1350,1075,390.90909090909093
Nandurbar,SUNFLOWER,2016,2838,3913,1075,37.878787878787875
Barshi-Vairag,Black Gram,2014,3950,5025,1075,27.21518987341772
Kalyan,Green Peas (Dry),2016,3150,4225,1075,34.12698412698413
Pune,Wal Bhaji,2016,2275,3350,1075,47.252747252747255
Manchar,Cucumber,2016,475,1550,1075,226.31578947368422
Osmanabad,Ghevda,2015,1142,2217,1075,94.13309982486865
Shirpur,GROUND NUT PODS (DRY),2016,3407,4481,1074,31.52333431171118
Ausa,Pigeon Pea (Tur),2015,7901,8975,1074,13.593216048601443
Latur,Pigeon Pea (Tur),2014,4198,5272,1074,25.583611243449262
Kalyan,Green Chilli,2016,6296,7370,1074,17.058449809402795
Barshi,Onion,2015,417,1491,1074,257.55395683453236
Indapur,Banana,2015,558,1632,1074,192.4731182795699
Sindi (Selu),Gram,2016,6932,8006,1074,15.4933641084824
Manchar,Coriander  ,2015,220,1294,1074,488.1818181818182
Satara,Flower,2014,1261,2335,1074,85.17049960348929
Pune,Brinjal,2016,674,1748,1074,159.34718100890208
Vadgaon Peth,Brinjal,2016,1083,2156,1073,99.07663896583564
Indapur-Bhigwan,Sorgum(Jawar),2016,1594,2667,1073,67.31493099121707
Kolhapur,ONION,2016,256,1329,1073,419.140625
Mangaon(Bhadav),Nachani,2016,1440,2513,1073,74.51388888888889
Shirpur,Gram,2016,5710,6783,1073,18.791593695271455
Solapur,GHEVDA,2016,860,1933,1073,124.76744186046511
Osmanabad,GHEVDA,2016,945,2018,1073,113.54497354497354
Pune-Manjri,Shepu,2015,1114,2186,1072,96.22980251346499
Karad,Ginger (Fresh),2015,2455,3527,1072,43.66598778004073
Basmat (Kurunda),Turmeric,2016,7603,8675,1072,14.09969748783375
Pune-Manjri,Pavtta,2015,1555,2627,1072,68.93890675241157
Jalgaon,Mango(Raw),2015,1224,2296,1072,87.58169934640523
Chalisgaon,Pigeon Pea (Tur),2015,6445,7517,1072,16.633048875096975
Pune,Dhemse,2015,1055,2127,1072,101.61137440758294
Jamkhed,Sorgum(Jawar),2016,1861,2933,1072,57.60343901128426
Khed,CUCUMBER,2016,603,1675,1072,177.77777777777777
Sinner,Potato,2016,229,1301,1072,468.12227074235807
Murbad,Bitter Gourd,2016,6972,8044,1072,15.375788869764774
Newasa-Ghodegaon,Onion,2016,107,1179,1072,1001.8691588785047
Kalyan,Cluster Bean,2016,5264,6336,1072,20.364741641337385
Kamthi,Cluster Bean,2016,1211,2282,1071,88.4393063583815
Nagpur,Grapes,2015,1908,2979,1071,56.132075471698116
Satana,Ground Nut Pods (Dry),2016,3970,5041,1071,26.977329974811084
Chandrapur-Ganjwad,Coriander  ,2016,1429,2500,1071,74.94751574527642
Pune-Pimpri,Chillies(Red),2016,12643,13714,1071,8.471090722138733
Ulhasnagar,Wheat(Husked),2016,2000,3071,1071,53.55
Vadgaon Peth,Flower,2016,1267,2338,1071,84.5303867403315
Solapur,Guava,2016,729,1800,1071,146.91358024691357
Sinner,Gram,2015,3733,4804,1071,28.690061612643987
Chalisgaon,Gram,2016,3422,4492,1070,31.268264172998247
Mangaon(Bhadav),Nagali,2016,1424,2494,1070,75.14044943820225
Sangrampur,Gram,2015,3400,4470,1070,31.470588235294116
Pune-Manjri,Hemp,2015,0,1070,1070,inf
Pune,Bottle Gourd,2016,617,1687,1070,173.41977309562398
Jalgaon,Brinjal,2015,845,1915,1070,126.62721893491124
Mumbai-Fruit Market,Mosambi,2016,1342,2412,1070,79.73174366616989
Mehkar,Black Gram,2014,3935,5005,1070,27.19186785260483
Mumbai,GINGER (DRY),2016,1338,2408,1070,79.97010463378176
Mandhal,Chillies(Red),2015,6733,7803,1070,15.891875835437398
Majalgaon,Pigeon Pea (Tur),2015,4912,5981,1069,21.76302931596091
Kannad,Ginger (Fresh),2016,731,1800,1069,146.23803009575923
Dhule,Pigeon Pea (Tur),2015,4228,5297,1069,25.283822138126773
Aurangabad,Shevga,2015,3081,4150,1069,34.69652710159039
Jalna,Sorgum(Jawar),2015,1122,2191,1069,95.27629233511587
Chandrapur-Ganjwad,Onion,2014,927,1996,1069,115.31823085221143
Kamthi,Spinach,2015,962,2031,1069,111.12266112266113
Kolhapur,Green Chilli,2016,579,1648,1069,184.6286701208981
Pune-Manjri,Walvad,2015,2183,3252,1069,48.96930829134219
Sangali,Jaggery,2015,2470,3539,1069,43.27935222672065
Nashik,Methi (Bhaji),2016,2120,3188,1068,50.37735849056604
Amarawati-Fruit And Vegetables,Ginger (Fresh),2016,2704,3772,1068,39.49704142011834
Kamthi,Tomato,2015,1142,2210,1068,93.52014010507881
Sangali,Sorgum(Jawar),2014,1622,2690,1068,65.8446362515413
Chandrapur,Pigeon Pea (Tur),2016,7784,8852,1068,13.720452209660843
Indapur-Bhigwan,Gram,2016,6425,7493,1068,16.622568093385215
Shahada,Green Gram,2015,6500,7568,1068,16.43076923076923
Ambejogai,Pigeon Pea (Tur),2015,5055,6123,1068,21.12759643916914
Osmanabad,Capsicum,2015,1180,2247,1067,90.42372881355932
Pune,Pavtta,2015,1695,2762,1067,62.94985250737463
Kamthi,Jambhul,2015,1489,2556,1067,71.65883143049027
Nashik,Potato,2016,505,1572,1067,211.2871287128713
Jalna,Sorgum(Jawar),2016,1513,2580,1067,70.522141440846
Osmanabad,Capsicum,2015,2122,3189,1067,50.28275212064091
Kamthi,Zendu,2014,1000,2067,1067,106.7
Karad,Cluster Bean,2014,2433,3500,1067,43.855322646937935
Digras,Pigeon Pea (Tur),2015,7987,9054,1067,13.359208714160511
Kalyan,Green Gram,2016,5933,7000,1067,17.984156413281646
Kamthi,Cluster Bean,2015,1581,2648,1067,67.48893105629348
Kamthi,Cucumber,2015,1600,2667,1067,66.6875
Anajngaon Surji,Chillies(Red),2014,6000,7067,1067,17.783333333333335
Jamkhed,ONION,2016,100,1167,1067,1067.0
Indapur,Black Gram,2016,5517,6584,1067,19.340221134674643
Balapur,Green Gram,2015,7000,8067,1067,15.242857142857142
Ahmednagar,Ground Nut Pods (Dry),2015,2100,3167,1067,50.80952380952381
Nandurbar,Sunflower,2015,3698,4765,1067,28.85343428880476
Solapur,Carrot,2015,900,1967,1067,118.55555555555556
Karad,Chikoo,2014,1058,2125,1067,100.85066162570888
Indapur,Onion,2014,162,1229,1067,658.641975308642
Ulhasnagar,Wheat(Husked),2016,2000,3067,1067,53.35
Varud-Rajura Bazar,Pigeon Pea (Tur),2015,4740,5807,1067,22.51054852320675
Pandharpur,Bor,2014,538,1605,1067,198.3271375464684
Aurangabad,Garlic,2015,1667,2733,1066,63.947210557888425
Pune-Pimpri,Black Gram,2015,10267,11333,1066,10.382779779877277
Malegaon,Matki,2015,7010,8076,1066,15.206847360912981
Katol,Pigeon Pea (Tur),2015,8360,9426,1066,12.751196172248804
Jintur,Pigeon Pea (Tur),2015,7767,8833,1066,13.724732844083945
Chandrapur-Ganjwad,Capsicum,2016,2267,3333,1066,47.022496691662994
Manchar,Math (Bhaji),2015,536,1602,1066,198.88059701492537
Akole,Gram,2016,3767,4833,1066,28.29838067427661
Karad,Cluster Bean,2014,2467,3533,1066,43.21037697608431
Hingoli,Black Gram,2015,7655,8721,1066,13.925538863487917
Baramati,Gram,2016,3402,4468,1066,31.33450911228689
Barshi,Gram,2016,5671,6736,1065,18.77975665667431
Ramtek,Coriander  ,2015,4326,5391,1065,24.618585298196948
Pusad,Ground Nut Pods (Dry),2015,4580,5645,1065,23.253275109170307
Jalgaon,Ginger (Fresh),2016,2264,3329,1065,47.040636042402824
Pandharpur,Green Chilli,2016,583,1648,1065,182.67581475128645
Ahmednagar,Green Chilli,2016,635,1700,1065,167.71653543307087
Ratanagari,Green Chilli,2015,1360,2425,1065,78.30882352941177
Nilanga,SOYBEAN,2016,1815,2879,1064,58.62258953168044
Pune,GREEN CHILLI,2016,896,1960,1064,118.75
Aurangabad,Onion,2014,492,1556,1064,216.260162601626
Lasalgaon,Pigeon Pea (Tur),2015,3450,4514,1064,30.840579710144926
Mumbai,Papai,2014,644,1708,1064,165.2173913043478
Vadgaon Peth,Bitter Gourd,2015,1486,2550,1064,71.60161507402422
Vaijapur,Onion,2016,419,1483,1064,253.9379474940334
Mangrulpeer,Soybean,2016,2153,3217,1064,49.41941477008825
Jalgaon,Onion,2015,1068,2132,1064,99.62546816479401
Pune,Rice(Paddy-Hus),2016,4698,5761,1063,22.626649638143892
Pune,Walvad,2015,1400,2463,1063,75.92857142857143
Ausa,Coriander (Dry),2016,6588,7651,1063,16.135397692774742
Jalgaon,Green Chilli,2015,1911,2974,1063,55.62532705389848
Hingoli,Turmeric,2015,7710,8773,1063,13.787289234760053
Khamgaon,Black Gram,2016,8556,9619,1063,12.424029920523608
Osmanabad,Chikoo,2016,1106,2169,1063,96.11211573236889
Nira-Saswad,Sorgum(Jawar),2016,1650,2713,1063,64.42424242424242
Pune-Manjri,Green Chilli,2016,3197,4260,1063,33.249921801689084
Jalgaon,Flower,2015,2183,3246,1063,48.69445716903344
Nashik,Shepu,2016,1508,2571,1063,70.49071618037135
Chalisgaon,Ladies Finger,2016,1400,2463,1063,75.92857142857143
Malkapur,Gram,2015,3424,4487,1063,31.04556074766355
Akluj,Onion,2016,675,1738,1063,157.4814814814815
Ahmednagar,Ground Nut Pods (Dry),2016,2938,4000,1062,36.14703880190606
Pune-Manjri,Tomato,2015,1146,2208,1062,92.67015706806282
Loha,Turmeric,2015,5651,6713,1062,18.7931339585914
Khed-Chakan,Squash Gourd,2016,2738,3800,1062,38.78743608473338
Pune,Tomato,2016,667,1729,1062,159.22038980509745
Umared,Other Pulses,2016,7750,8812,1062,13.703225806451613
Solapur,Custard Apple,2016,1588,2650,1062,66.8765743073048
Osmanabad,Shevga,2016,1309,2371,1062,81.13063407181055
Beed,Sorgum(Jawar),2015,1591,2653,1062,66.75047140163419
Barshi,Turmeric,2014,4035,5097,1062,26.319702602230482
Khamgaon,Black Gram,2016,6033,7095,1062,17.603182496270513
Nandgaon Khandeshwar,GRAM,2016,6113,7175,1062,17.372812039914937
Osmanabad,Flower,2016,1388,2450,1062,76.51296829971182
Kamthi,Brinjal,2015,638,1700,1062,166.4576802507837
Chalisgaon,Green Gram,2015,6713,7775,1062,15.820050647996425
Koregaon,Onion,2014,538,1600,1062,197.39776951672863
Pune,Bitter Gourd,2016,1400,2462,1062,75.85714285714286
Kolhapur,Flower,2016,348,1410,1062,305.17241379310343
Akluj,Brinjal,2016,1510,2571,1061,70.26490066225166
Pusad,Black Gram,2015,7712,8773,1061,13.757780082987551
Sangali,Sorgum(Jawar),2015,1653,2714,1061,64.18632788868723
Anajngaon Surji,Ground Nut Pods (Dry),2016,4550,5611,1061,23.318681318681318
Barshi,Gram,2015,3393,4454,1061,31.270262304745064
Satara,Ladies Finger,2016,2239,3300,1061,47.387226440375166
Murbad,Capsicum,2016,7850,8910,1060,13.503184713375797
Balapur,Gram,2016,6160,7220,1060,17.207792207792206
Kamthi,Cluster Bean,2016,1220,2280,1060,86.88524590163935
Mangaon(Bhadav),Nachani,2016,1420,2480,1060,74.64788732394366
Pune-Manjri,Green-Peas,2016,3854,4914,1060,27.5038920601972
Sangali,Wheat(Husked),2015,1669,2729,1060,63.51108448172558
Kalyan,Jaggery,2016,3223,4283,1060,32.88861309339125
Indapur-Bhigwan,Black Gram,2016,8700,9760,1060,12.183908045977011
Solapur,Pigeon Pea (Tur),2015,4543,5603,1060,23.332599603786043
Kej,Tamarind,2016,6806,7866,1060,15.574493094328533
Buldhana,Pigeon Pea (Tur),2016,7790,8850,1060,13.607188703465981
Jalna,Sorgum(Jawar),2015,1308,2368,1060,81.03975535168196
Yeola,Gram,2016,3757,4817,1060,28.214000532339632
Kej,Black Gram,2015,8880,9940,1060,11.936936936936936
Mumbai-Fruit Market,Guava,2016,1300,2360,1060,81.53846153846153
Shirpur,Chillies(Red),2015,1664,2724,1060,63.70192307692308
Khed-Chakan,Capsicum,2016,4660,5720,1060,22.746781115879827
Mehkar,Pigeon Pea (Tur),2015,4406,5465,1059,24.0354062641852
Pune,Black Gram,2015,7908,8967,1059,13.391502276176023
Devala,Gram,2015,3351,4410,1059,31.602506714413607
Nashik,Carrot,2016,2186,3245,1059,48.44464775846295
Telhara,Gram,2016,6314,7373,1059,16.772252138105795
Pimpalgaon Basawant,Onion,2015,486,1545,1059,217.90123456790124
Manora,Pigeon Pea (Tur),2015,8614,9673,1059,12.293940097515673
Palus,Ladies Finger,2016,3217,4275,1058,32.88778364936276
Varud-Rajura Bazar,Gram,2016,4000,5058,1058,26.45
Nandura,Pigeon Pea (Tur),2016,5694,6752,1058,18.580962416578856
Nanded,Turmeric,2014,5000,6058,1058,21.16
Dondaicha,Chillies(Red),2015,2243,3301,1058,47.168970129291125
Mumbai,Spilt Gerrn Gram,2014,8000,9058,1058,13.225
Nashik,Bor,2015,575,1633,1058,184.0
Indapur,Sorgum(Jawar),2016,1765,2822,1057,59.88668555240793
Kalamb (Os),Pigeon Pea (Tur),2015,4768,5825,1057,22.168624161073826
Newasa-Ghodegaon,Onion,2015,285,1342,1057,370.87719298245617
Ulhasnagar,Bajri,2016,1986,3043,1057,53.22255790533736
Nagpur,Grapes,2014,1564,2621,1057,67.58312020460357
Solapur,Bor,2015,673,1730,1057,157.05794947994056
Jalgaon,Ladies Finger,2015,1789,2846,1057,59.08328675237563
Jalna,Sorgum(Jawar),2015,1305,2362,1057,80.99616858237547
Nagpur,Grapes,2015,1910,2967,1057,55.340314136125656
Pune-Manjri,Bitter Gourd,2015,2430,3487,1057,43.49794238683128
Dindori-Vani,Onion,2015,3579,4636,1057,29.53338921486449
Pune,Parwar,2016,1933,2990,1057,54.68184169684428
Ambejogai,Green Gram,2015,6716,7773,1057,15.738534842167956
Hinganghat,Gram,2015,3667,4723,1056,28.797382056176712
Pune,Rice(Paddy-Hus),2015,4614,5670,1056,22.886866059817944
Vai,PAVTTA,2016,2544,3600,1056,41.509433962264154
Akluj,Brinjal,2016,1333,2389,1056,79.2198049512378
Rahata,Green Chilli,2015,3222,4278,1056,32.774674115456236
Aurangabad,Onion,2016,337,1393,1056,313.35311572700294
Nashik,Wal Papdi,2016,1123,2179,1056,94.03383793410508
Mumbai,Papai,2015,720,1776,1056,146.66666666666666
Latur,Gram,2015,4072,5128,1056,25.93320235756385
Shrirampur,Cluster Bean,2016,3583,4639,1056,29.47250907061122
Malegaon,Pigeon Pea (Tur),2016,6280,7336,1056,16.81528662420382
Jalgaon,Brinjal,2015,872,1928,1056,121.10091743119266
Samudrapur,Pigeon Pea (Tur),2016,7994,9050,1056,13.20990743057293
Ulhasnagar,Wheat(Husked),2016,2044,3100,1056,51.663405088062625
Khed-Chakan,Walvad,2016,2111,3167,1056,50.023685457129325
Nashik,Cucumber,2016,1480,2535,1055,71.28378378378379
Mehkar,Gram,2015,3834,4889,1055,27.5169535732916
Malkapur,Green Gram,2014,6483,7538,1055,16.273330248341818
Nashik,Kharbuj,2016,1055,2110,1055,100.0
Akola,Green Gram,2015,5620,6675,1055,18.772241992882563
Majalgaon,Sorgum(Jawar),2014,1104,2159,1055,95.56159420289855
Akola,Black Gram,2015,6779,7834,1055,15.562767369818557
Pune,Cucumber,2016,815,1870,1055,129.4478527607362
Pune-Manjri,Chavli (Shenga ),2015,1035,2090,1055,101.93236714975845
Sangali,Jaggery,2016,2325,3380,1055,45.376344086021504
Ausa,Wheat(Husked),2015,1678,2733,1055,62.87246722288439
Umarga,Sesamum,2014,7672,8727,1055,13.751303441084463
Pune,Bajri,2014,2142,3196,1054,49.20634920634921
Pune,Green-Peas,2016,2100,3154,1054,50.19047619047619
Beed,Pigeon Pea (Tur),2015,7690,8744,1054,13.706111833550064
Hingoli,Turmeric,2015,7461,8515,1054,14.126792655140061
Majalgaon,Pigeon Pea (Tur),2014,3625,4678,1053,29.048275862068966
Ratanagari,Green Chilli,2015,3263,4316,1053,32.27091633466136
Aurangabad,Shevga,2016,2976,4029,1053,35.38306451612903
Solapur,Mula Shenga,2016,1035,2088,1053,101.73913043478261
Pune-Manjri,GREEN CHILLI,2016,981,2034,1053,107.33944954128441
Ambejogai,Green Gram,2014,6267,7320,1053,16.802297750119674
Jalgaon,Onion,2015,870,1923,1053,121.03448275862068
Dhule,GROUND NUT PODS (DRY),2016,3360,4413,1053,31.339285714285715
Shrirampur,Pomegranate,2016,3421,4474,1053,30.780473545746858
Sangrampur,Gram,2015,2982,4035,1053,35.311871227364186
Kamthi,Small Gourd,2014,884,1937,1053,119.11764705882354
Vasai,Wheat(Husked),2016,1477,2530,1053,71.29316181448883
Pune,Capsicum,2015,1202,2254,1052,87.52079866888519
Lasalgaon-Vinchur,Soybean,2015,2686,3738,1052,39.166046165301566
Lasalgaon,Soybean,2015,2744,3796,1052,38.33819241982507
Satara,Brinjal,2016,1670,2722,1052,62.9940119760479
Shirpur,Ground Nut Pods (Dry),2016,4547,5599,1052,23.136133714537056
Amarawati,Ground Nut Pods (Dry),2016,4317,5369,1052,24.368774611999072
Latur,Pigeon Pea (Tur),2015,6617,7669,1052,15.898443403354994
Mehkar,Pigeon Pea (Tur),2016,7852,8904,1052,13.397860417727967
Latur-Murud,Pigeon Pea (Tur),2015,8268,9320,1052,12.723754233188195
Mumbai,Guava,2016,566,1618,1052,185.86572438162545
Pune,Pumpkin,2016,604,1656,1052,174.17218543046357
Nashik,Ghevda,2016,2046,3098,1052,51.417399804496576
Lasur Station,Onion,2015,188,1240,1052,559.5744680851063
Manchar,Ghevda,2015,2533,3585,1052,41.53178049743387
Sangli-Phale Bhajipalam,Pineapple,2016,313,1365,1052,336.10223642172525
Kopargaon,Green Gram,2015,7127,8178,1051,14.746737757822366
Shirpur,Sorgum(Jawar),2015,1255,2306,1051,83.74501992031873
Osmanabad,Pigeon Pea (Tur),2014,4400,5451,1051,23.886363636363637
Tumsar,Gram,2016,6800,7851,1051,15.455882352941176
Phaltan,Sorgum(Jawar),2015,1550,2601,1051,67.80645161290323
Kurdwadi,Chillies(Red),2014,2500,3551,1051,42.04
Ambad(Vadi Godri),Sorgum(Jawar),2014,1170,2221,1051,89.82905982905983
Dondaicha,Green Gram,2015,5801,6852,1051,18.11756593690743
Pune-Manjri,Kardai,2016,0,1050,1050,inf
Vadgaon Peth,Green-Peas,2015,1625,2675,1050,64.61538461538461
Jalna,Jaggery,2016,3600,4650,1050,29.166666666666668
Osmanabad,Coriander (Dry),2016,4401,5451,1050,23.85821404226312
Karad,Grapes,2015,3000,4050,1050,35.0
Ratanagari,Green Chilli,2016,1300,2350,1050,80.76923076923077
Pune-Manjri,Raddish,2015,825,1875,1050,127.27272727272727
Pune-Manjri,Onion,2015,0,1050,1050,inf
Kolhapur,Water Melon,2015,150,1200,1050,700.0
Sangali,Chillies(Red),2015,9700,10750,1050,10.824742268041238
Satara,Shevga,2015,2150,3200,1050,48.83720930232558
Kolhapur,Kanda Pat,2016,1138,2188,1050,92.2671353251318
Pune,Tamarind,2014,3950,5000,1050,26.582278481012658
Koregaon,Onion,2015,625,1675,1050,168.0
Kada,Sorgum(Jawar),2016,1688,2738,1050,62.203791469194314
Kalyan,Apple,2015,3950,5000,1050,26.582278481012658
Aurangabad,Ground Nut Pods (Dry),2016,3075,4125,1050,34.146341463414636
Akola,Pigeon Pea (Tur),2016,7335,8385,1050,14.314928425357873
Junnar (Narayangaon),CORIANDER ,2016,251,1301,1050,418.32669322709165
Anajngaon Surji,Pigeon Pea (Tur),2016,7954,9004,1050,13.200905204928338
Pune-Manjri,Bitter Gourd,2015,2160,3210,1050,48.611111111111114
Kalyan,Guava,2015,3083,4133,1050,34.057735971456374
Akluj,Carrot,2016,1450,2500,1050,72.41379310344827
Pune-Manjri,Kanda Pat,2015,1100,2150,1050,95.45454545454545
Kada,Black Gram,2016,5700,6750,1050,18.42105263157895
Indapur,Gram,2015,3220,4270,1050,32.608695652173914
Kolhapur,Orange,2015,4900,5950,1050,21.428571428571427
Pune,Cabbage,2016,1167,2217,1050,89.97429305912597
Chandrapur-Ganjwad,Math (Bhaji),2014,1910,2960,1050,54.973821989528794
Manchar,Beet Root,2016,300,1350,1050,350.0
Kolhapur,Papai,2015,350,1400,1050,300.0
Pune,Pumpkin,2014,780,1830,1050,134.6153846153846
Jalgaon,Ladies Finger,2015,1090,2140,1050,96.3302752293578
Kamthi,Orange,2014,1063,2113,1050,98.77704609595484
Akola,Black Gram,2015,6728,7778,1050,15.606420927467301
Jalgaon,Shevga,2015,2700,3750,1050,38.888888888888886
Nashik,Shepu,2015,250,1300,1050,420.0
Manchar,Bitter Gourd,2016,200,1250,1050,525.0
Vadgaon Peth,PAVTTA,2016,1900,2950,1050,55.26315789473684
Khed-Chakan,Green-Peas,2016,3438,4488,1050,30.541012216404887
Pune-Pimpri,Gr.Nut Kernels,2015,6975,8025,1050,15.053763440860216
Kalyan,Gr.Nut Kernels,2016,8100,9150,1050,12.962962962962964
Pune-Manjri,Coriander  ,2015,500,1550,1050,210.0
Nashik,Methi (Bhaji),2015,700,1750,1050,150.0
Manchar,Walvad,2016,1800,2850,1050,58.333333333333336
Mumbai-Fruit Market,Fig,2016,2550,3600,1050,41.1764705882353
Malkapur,Onion,2015,3750,4800,1050,28.0
Amarawati-Fruit And Vegetables,Lemon,2016,1979,3029,1050,53.05709954522486
Sengaon,Pigeon Pea (Tur),2015,9200,10250,1050,11.41304347826087
Kamthi,Chavli (Shenga ),2016,1283,2333,1050,81.8394388152767
Kolhapur,Flower,2016,447,1497,1050,234.8993288590604
Vadgaon Peth,Bitter Gourd,2016,1689,2739,1050,62.16696269982238
Amarawati-Fruit And Vegetables,Orange,2016,2250,3300,1050,46.666666666666664
Pune,Pumpkin,2016,985,2035,1050,106.5989847715736
Nashik,Kanda Pat,2015,1225,2275,1050,85.71428571428571
Nashik,Kanda Pat,2015,1400,2450,1050,75.0
Solapur,Guava,2015,877,1927,1050,119.72633979475485
Manchar,Green Chilli,2016,1000,2050,1050,105.0
Amarawati-Fruit And Vegetables,Mango,2016,2993,4043,1050,35.08185766789175
Bhivandi,Onion,2015,5200,6250,1050,20.192307692307693
Chalisgaon,Math (Bhaji),2016,900,1950,1050,116.66666666666667
Jalgaon,Ginger (Fresh),2016,1754,2804,1050,59.863169897377425
Manmad,Methi (Bhaji),2016,344,1394,1050,305.2325581395349
Nagpur,PAPAI,2016,1025,2075,1050,102.4390243902439
Mumbai,Guava,2015,950,2000,1050,110.52631578947368
Chandur Bajar,Gram,2015,3163,4213,1050,33.19633259563705
Rahata,Green Chilli,2015,1450,2500,1050,72.41379310344827
Akot,Black Gram,2015,6705,7755,1050,15.659955257270694
Mumbai,Gr.Nut Kernels,2014,5950,7000,1050,17.647058823529413
Manchar,Cucumber,2016,1300,2350,1050,80.76923076923077
Washim,GRAM,2016,8870,9919,1049,11.826381059751974
Pathari,Pigeon Pea (Tur),2016,7001,8050,1049,14.983573775174975
Chalisgaon,Pigeon Pea (Tur),2016,7021,8070,1049,14.940891610881641
Sangali,Jaggery,2016,3004,4053,1049,34.92010652463382
Manchar,Coriander  ,2015,552,1600,1048,189.85507246376812
Murtizapur,Pigeon Pea (Tur),2015,7995,9043,1048,13.108192620387742
Mandhal,Chillies(Red),2015,6609,7657,1048,15.857164472688758
Kamthi,Kanda Pat,2015,1412,2460,1048,74.22096317280453
Yeola,Onion,2015,482,1530,1048,217.42738589211618
Mumbai,Gr.Nut Kernels,2014,5984,7032,1048,17.513368983957218
Kamthi,Flower,2014,1624,2671,1047,64.4704433497537
Nashik,Raddish,2016,1041,2088,1047,100.57636887608069
Aurangabad,Chavli (Shenga ),2015,1854,2900,1046,56.418554476806904
Jalna,Pigeon Pea (Tur),2016,5694,6740,1046,18.370214260625218
Shirpur,Onion,2015,431,1477,1046,242.69141531322506
Mangalwedha,Gram,2014,2114,3160,1046,49.47965941343425
Khed-Chakan,Shevga,2016,2295,3341,1046,45.57734204793028
Karad,Shevga,2015,3318,4364,1046,31.525015069318865
Dhule,Gram,2015,3609,4655,1046,28.983097811027985
Ramtek,Green Chilli,2016,4136,5182,1046,25.290135396518377
Pune,Cabbage,2016,1521,2567,1046,68.77054569362262
Amarawati,Lemon,2016,2018,3064,1046,51.83349851337958
Nagpur,Gram,2016,5898,6944,1046,17.734825364530348
Kolhapur-Malkapur,Coriander  ,2016,587,1633,1046,178.19420783645657
Malegaon,Gram,2016,3655,4701,1046,28.61833105335157
Indapur-Bhigwan,Wheat(Husked),2015,1461,2506,1045,71.52635181382615
Nashik,Raddish,2014,944,1989,1045,110.69915254237289
Vadgaon Peth,Flower,2016,1122,2167,1045,93.13725490196079
Jalgaon,Green Chilli,2016,1670,2715,1045,62.5748502994012
Jalna,Pigeon Pea (Tur),2015,4672,5717,1045,22.367294520547944
Nagpur,Ground Nut Pods (Dry),2016,4433,5478,1045,23.573200992555833
Vaijapur,Gram,2015,4639,5684,1045,22.52640655313645
Kamthi,Potato,2016,1027,2072,1045,101.75267770204479
Chalisgaon,Ground Nut Pods (Dry),2016,3633,4678,1045,28.76410679878888
Akola,Black Gram,2015,9500,10545,1045,11.0
Kalyan,CUSTARD APPLE,2016,3222,4267,1045,32.433271260086904
Aurangabad,Custard Apple,2015,2033,3078,1045,51.401869158878505
Solapur,Chikoo,2016,548,1593,1045,190.6934306569343
Mangalwedha,Tomato,2016,267,1312,1045,391.38576779026215
Shirpur,Sesamum,2015,5658,6703,1045,18.46942382467303
Latur,Pigeon Pea (Tur),2015,6737,7782,1045,15.511355202612439
Ausa,Black Gram,2015,6406,7451,1045,16.312831720262253
Pune,Pumpkin,2015,514,1559,1045,203.30739299610894
Kurdwadi-Modnimb,Bor,2015,670,1715,1045,155.97014925373134
Chandur Rly.,Pigeon Pea (Tur),2016,8123,9168,1045,12.864705158192786
Pusad,Green Gram,2015,8305,9350,1045,12.582781456953642
Dondaicha,GRAM,2016,7511,8555,1044,13.8996138996139
Kurdwadi-Modnimb,Onion,2015,409,1453,1044,255.25672371638143
Osmanabad,Potato,2014,1339,2383,1044,77.96863330843914
Barshi,Green Gram,2015,6777,7821,1044,15.405046480743692
Pune,Bottle Gourd,2016,984,2028,1044,106.09756097560975
Solapur,Cucumber,2016,229,1273,1044,455.89519650655023
Ulhasnagar,Gr.Nut Kernels,2016,8000,9044,1044,13.05
Mumbai,GREEN PEAS (DRY),2016,3108,4152,1044,33.59073359073359
Kurdwadi-Modnimb,Gram,2016,4253,5297,1044,24.547378321185047
Aurangabad,Onion,2015,745,1788,1043,140.0
Nagpur,Pigeon Pea (Tur),2016,7500,8543,1043,13.906666666666666
Manora,Green Gram,2015,6600,7643,1043,15.803030303030303
Malkapur,Gram,2015,3729,4772,1043,27.96996513810673
Murtizapur,Pigeon Pea (Tur),2015,8079,9122,1043,12.910013615546479
Tumsar,Gram,2016,5713,6756,1043,18.256607736740765
Pune,GREEN PEAS (DRY),2016,3007,4050,1043,34.68573328899235
Pimpalgaon (B)-Saykheda,Onion,2015,483,1526,1043,215.94202898550725
Aurangabad,Grapes,2015,2536,3579,1043,41.12776025236593
Mumbai,Split Lentil,2016,6319,7362,1043,16.505776230416206
Sangali,Jaggery,2014,2427,3470,1043,42.974866089822825
Pune,Curry Leaves,2015,1457,2500,1043,71.58544955387784
Nashik,Tomato,2016,833,1876,1043,125.21008403361344
Ratanagari,Brinjal,2016,2511,3553,1042,41.497411389884505
Dudhani,Bajri,2016,1679,2721,1042,62.06075044669446
Barshi,Methi (Bhaji),2016,908,1950,1042,114.75770925110132
Latur,Wheat(Husked),2015,1403,2445,1042,74.26942266571632
Rahata,Tomato,2015,733,1775,1042,142.15552523874487
Mumbai,Papai,2014,525,1567,1042,198.47619047619048
Kamthi,Onion,2016,611,1653,1042,170.54009819967266
Nashik,Cucumber,2016,1736,2778,1042,60.02304147465438
Nandgaon,Gram,2015,3391,4433,1042,30.728398702447656
Ghansawangi,Gram,2016,4025,5067,1042,25.888198757763973
Nashik,Methi (Bhaji),2016,1340,2382,1042,77.76119402985074
Palghar(Bevur),Rice(Paddy-Hus),2015,2293,3335,1042,45.44265154819014
Bhokar,Turmeric,2016,6983,8025,1042,14.921953315194044
Hinganghat,Pigeon Pea (Tur),2016,5775,6816,1041,18.025974025974026
Dondaicha-Sindkheda,Green Gram,2016,3764,4805,1041,27.656748140276303
Beed,Sorgum(Jawar),2014,1629,2670,1041,63.904235727440145
Jalgaon,Coriander (Dry),2014,11067,12108,1041,9.406343182434265
Chikhali,Green Gram,2016,5288,6329,1041,19.68608169440242
Nagpur,Potato,2016,570,1611,1041,182.6315789473684
Shrirampur,Green Chilli,2015,2917,3958,1041,35.6873500171409
Pune-Pimpri,Ladies Finger,2016,3362,4403,1041,30.963712076145153
Nandurbar,Chillies(Red),2015,1115,2156,1041,93.36322869955157
Barshi-Vairag,Sorgum(Jawar),2015,1334,2375,1041,78.0359820089955
Malegaon,Gram,2015,3606,4646,1040,28.840820854132
Kamthi,Chavli (Shenga ),2015,890,1930,1040,116.85393258426966
Kalyan,Black Gram,2016,7800,8840,1040,13.333333333333334
Pune-Pimpri,Tamarind,2015,4800,5840,1040,21.666666666666668
Akluj,Bitter Gourd,2015,2310,3350,1040,45.02164502164502
Khed-Chakan,Green Chilli,2016,4360,5400,1040,23.853211009174313
Jalna,Mosambi,2016,2040,3080,1040,50.98039215686274
Solapur,Flower,2014,320,1360,1040,325.0
Pune,Nolkol,2016,600,1640,1040,173.33333333333334
Chandrapur,Kharbuj,2016,960,2000,1040,108.33333333333333
Vadgaon Peth,Flower,2014,1120,2160,1040,92.85714285714286
Mumbai,Split Black Gram,2015,10000,11040,1040,10.4
Akluj,Chillies(Red),2015,2460,3500,1040,42.27642276422764
Barshi,Ladies Finger,2016,1066,2106,1040,97.5609756097561
Mangrulpeer,Pigeon Pea (Tur),2015,5571,6611,1040,18.66810267456471
Pune,CARROT,2016,640,1680,1040,162.5
Kamthi,Onion,2016,640,1680,1040,162.5
Chandrapur,Papai,2014,973,2013,1040,106.88591983556012
Varud-Rajura Bazar,Soybean,2016,2551,3591,1040,40.768326146609176
Kamthi,Lemon,2015,1560,2600,1040,66.66666666666667
Chandrapur,Chikoo,2014,1930,2970,1040,53.8860103626943
Pune,Dhemse,2016,2090,3130,1040,49.760765550239235
Khed-Chakan,Cluster Bean,2016,3538,4577,1039,29.36687394007914
Shevgaon-Bodhegaon,Gram,2016,5900,6939,1039,17.610169491525422
Kannad,Ginger (Fresh),2016,1061,2100,1039,97.92648444863336
Pandharpur,Capsicum,2015,1029,2068,1039,100.97181729834791
Katol,Ground Nut Pods (Dry),2016,4658,5697,1039,22.30571060541005
Sindi,Pigeon Pea (Tur),2016,6945,7984,1039,14.96040316774658
Kolhapur,Flower,2015,361,1400,1039,287.8116343490305
Osmanabad,Wheat(Husked),2015,1813,2852,1039,57.308328736900165
Mumbai,Ginger (Dry),2016,1515,2554,1039,68.58085808580859
Vadgaon Peth,Bitter Gourd,2016,1433,2472,1039,72.50523377529657
Pune,Bitter Gourd,2015,2023,3062,1039,51.359367276322295
Beed,Green Gram,2014,6009,7048,1039,17.29073057081045
Kalyan,Lemon,2016,4115,5154,1039,25.24908869987849
Pune-Manjri,Flower,2016,1023,2062,1039,101.56402737047898
Jalgaon,Bitter Gourd,2015,1661,2700,1039,62.5526791089705
Ulhasnagar,Gr.Nut Kernels,2016,8000,9038,1038,12.975
Mangalwedha,Sorgum(Jawar),2015,1521,2559,1038,68.24457593688363
Sinner,Ground Nut Pods (Dry),2016,3500,4538,1038,29.65714285714286
Mangalwedha,Bitter Gourd,2015,1750,2788,1038,59.31428571428572
Barshi,Pigeon Pea (Tur),2015,4684,5722,1038,22.16054654141759
Pune-Moshi,Shevga,2016,2375,3413,1038,43.705263157894734
Tuljapur,Green Gram,2015,6903,7941,1038,15.036940460669275
Pune,Chavli (Shenga ),2015,1424,2462,1038,72.8932584269663
Jamkhed,Sorgum(Jawar),2015,1650,2688,1038,62.90909090909091
Daryapur,Soybean,2015,2748,3786,1038,37.77292576419214
Indapur-Bhigwan,Green Gram,2016,4125,5163,1038,25.163636363636364
Solapur,Wheat(Husked),2015,1639,2677,1038,63.33129957291031
Nashik-Devlali,Raddish,2016,1745,2783,1038,59.48424068767908
Solapur,Onion,2016,100,1138,1038,1038.0
Pune,Green Gram,2015,7527,8564,1037,13.777069217483724
Nandgaon,Gram,2015,3127,4164,1037,33.16277582347298
Jalgaon Jamod,Ground Nut Pods (Dry),2015,3891,4928,1037,26.65124646620406
Pune-Manjri,Kardai,2014,245,1282,1037,423.265306122449
Solapur,Carrot,2016,443,1480,1037,234.08577878103839
Lasalgaon-Niphad,Onion,2015,908,1945,1037,114.20704845814979
Junnar-Otur,Carrot,2016,1038,2075,1037,99.90366088631984
Pune-Moshi,Ground Nut Pods (Dry),2016,2776,3813,1037,37.35590778097983
Jalgaon,WAL PAPDI,2016,1413,2450,1037,73.38995046001415
Washim,Pigeon Pea (Tur),2015,8381,9418,1037,12.373225152129818
Babhulgaon,Pigeon Pea (Tur),2015,5050,6087,1037,20.534653465346533
Nagpur,Orange,2014,742,1779,1037,139.75741239892184
Mumbai,Orange,2016,788,1824,1036,131.4720812182741
Pandharpur,Capsicum,2015,521,1557,1036,198.84836852207295
Rahata,Garlic,2016,6714,7750,1036,15.430443848674411
Shrirampur,Gram,2014,2093,3129,1036,49.49832775919732
Phaltan,Sorgum(Jawar),2015,1492,2528,1036,69.43699731903486
Chandrapur-Ganjwad,Bitter Gourd,2016,1964,3000,1036,52.74949083503055
Gevrai,Gram,2016,6513,7549,1036,15.906648241977583
Chandrapur,Papai,2015,509,1545,1036,203.53634577603142
Kalamb (Os),Green Gram,2015,7138,8174,1036,14.513869431213225
Ulhasnagar,Wheat(Husked),2016,1950,2986,1036,53.12820512820513
Barshi-Vairag,Sorgum(Jawar),2014,1184,2220,1036,87.5
Pune-Manjri,Coriander  ,2015,709,1745,1036,146.1212976022567
Vadgaon Peth,Capsicum,2015,1555,2591,1036,66.62379421221866
Khamgaon,Gram,2015,3609,4645,1036,28.706012745912997
Nashik,Kharbuj,2016,955,1991,1036,108.48167539267016
Ahmednagar,Onion,2016,100,1136,1036,1036.0
Kolhapur,Carrot,2016,675,1710,1035,153.33333333333334
Nagpur,Chikoo,2015,1120,2155,1035,92.41071428571429
Ambejogai,Sesamum,2014,9373,10408,1035,11.042355702549877
Mumbai,Green-Peas,2015,4145,5180,1035,24.96984318455971
Jalna,Pigeon Pea (Tur),2016,5407,6442,1035,19.141853153319772
Chandrapur-Ganjwad,Tomato,2016,813,1848,1035,127.30627306273063
Malegaon,Onion,2014,593,1628,1035,174.5362563237774
Chandur Rly.,Pigeon Pea (Tur),2016,7427,8462,1035,13.93564023158745
Loha,Turmeric,2014,5005,6040,1035,20.67932067932068
Rahuri-Vambori,Gram,2016,6568,7603,1035,15.758221680876979
Malkapur,Onion,2015,863,1898,1035,119.93047508690614
Junnar,Onion,2014,1200,2235,1035,86.25
Baramati,Gram,2015,2560,3595,1035,40.4296875
Kopargaon,Gram,2016,6570,7605,1035,15.753424657534246
Manchar,Bitter Gourd,2016,1610,2645,1035,64.28571428571429
Kolhapur,Kanda Pat,2015,1750,2785,1035,59.142857142857146
Mumbai,Small Gourd,2016,1094,2129,1035,94.60694698354662
Kamthi,Beet Root,2016,1633,2667,1034,63.319044703000614
Barshi,Pigeon Pea (Tur),2016,7405,8439,1034,13.963538149898717
Panvel,Ridge Gourd,2016,5733,6767,1034,18.03593232164661
Pune,Wal Papdi,2014,1733,2767,1034,59.66532025389498
Sakri,Gram,2016,4626,5660,1034,22.35192390834414
Pimpalgaon (B)-Saykheda,Onion,2015,387,1421,1034,267.18346253229976
Kamthi,Jack Fruit,2015,633,1667,1034,163.34913112164298
Chandrapur,Papai,2015,833,1867,1034,124.1296518607443
Aurangabad,GUAVA,2016,1167,2200,1033,88.51756640959726
Junnar,Onion,2015,1150,2183,1033,89.82608695652173
Hinganghat,Gram,2015,3214,4247,1033,32.1406347230865
Satara,Shevga,2015,3467,4500,1033,29.795211998846266
Vadgaon Peth,Carrot,2015,1000,2033,1033,103.3
Rahuri,Ground Nut Pods (Dry),2015,2042,3075,1033,50.58765915768854
Kamthi,Cluster Bean,2015,1288,2321,1033,80.20186335403727
Achalpur,Gram,2016,8150,9183,1033,12.674846625766872
Nashik,MELON,2016,950,1983,1033,108.73684210526316
Nagpur,Chikoo,2015,946,1979,1033,109.19661733615222
Khalapur(Shil-Phata),Other Cereals,2016,2567,3600,1033,40.24152707440592
Kalyan,Gram,2015,3300,4333,1033,31.303030303030305
Kopargaon,Onion,2014,368,1401,1033,280.70652173913044
Ausa,Wheat(Husked),2016,2078,3111,1033,49.71126082771896
Kalyan,Gr.Nut Kernels,2015,8667,9700,1033,11.918772354909427
Indapur,Onion,2015,320,1353,1033,322.8125
Mumbai-Fruit Market,Pomegranate,2016,3508,4540,1032,29.418472063854047
Kamthi,Dhemse,2016,1506,2538,1032,68.52589641434263
Pune,Parwar,2015,2031,3063,1032,50.81240768094535
Sinner,GREEN GRAM,2016,3167,4199,1032,32.586043574360595
Mangrulpeer,Gram,2015,3997,5029,1032,25.819364523392544
Lasalgaon,Soybean,2015,2333,3365,1032,44.23489069867124
Ahmedpur,Pigeon Pea (Tur),2015,7933,8965,1032,13.0089499558805
Mumbai,Jaggery,2016,2443,3474,1031,42.2022103970528
Mangalwedha,Gram,2015,2257,3288,1031,45.68010633584404
Sangali,Green Gram,2016,5211,6242,1031,19.785070044137402
Pune,Rice(Paddy-Hus),2015,4290,5321,1031,24.032634032634032
Sangali,Gram,2016,8142,9173,1031,12.662736428395972
Pandharpur,Cabbage,2016,1300,2331,1031,79.3076923076923
Mumbai,Small Gourd,2015,838,1869,1031,123.0310262529833
Majalgaon,Soybean,2015,2713,3744,1031,38.00221157390343
Katol,Pigeon Pea (Tur),2016,7297,8328,1031,14.129094148280116
Shrirampur,ONION,2016,200,1231,1031,515.5
Pune,Curry Leaves,2015,1220,2250,1030,84.42622950819673
Hinganghat,Gram,2015,2922,3952,1030,35.2498288843258
Chandrapur,Banana,2016,758,1788,1030,135.88390501319262
Solapur,Onion,2016,100,1130,1030,1030.0
Aurangabad,Cluster Bean,2016,2637,3667,1030,39.05953735305271
Mumbai,Green Peas (Dry),2016,2935,3965,1030,35.09369676320273
Telhara,Pigeon Pea (Tur),2016,5425,6455,1030,18.986175115207374
Nashik,Ground Nut Pods (Dry),2016,4185,5215,1030,24.611708482676224
Shrirampur,Onion,2016,178,1208,1030,578.6516853932584
Amalner,Coriander (Dry),2014,6760,7790,1030,15.236686390532544
Mangaon(Bhadav),NACHANI,2016,1410,2440,1030,73.04964539007092
Lasur Station,Sorgum(Jawar),2015,1168,2198,1030,88.18493150684931
Ambejogai,Pigeon Pea (Tur),2015,7620,8650,1030,13.517060367454068
Narkhed,Orange,2016,1670,2700,1030,61.67664670658683
Osmanabad,LEMON,2016,1290,2320,1030,79.84496124031008
Patan,Ginger (Fresh),2014,4350,5380,1030,23.67816091954023
Nashik,Carrot,2016,2020,3050,1030,50.99009900990099
Vadgaon Peth,Bitter Gourd,2016,1300,2329,1029,79.15384615384616
Kamthi,Coriander  ,2015,1275,2304,1029,80.70588235294117
Pune,Bottle Gourd,2016,771,1800,1029,133.46303501945525
Ratanagari,Green Chilli,2015,2147,3176,1029,47.92734047508151
Ratanagari,Brinjal,2016,1195,2224,1029,86.10878661087867
Aurangabad,BOR,2016,1957,2986,1029,52.58048032703117
Jalgaon,Coriander (Dry),2015,6892,7921,1029,14.930354033662217
Taloda,Pigeon Pea (Tur),2016,6959,7988,1029,14.78660727115965
Murum,Pigeon Pea (Tur),2016,7624,8653,1029,13.49685204616999
Solapur,Carrot,2016,814,1843,1029,126.41277641277641
Chopda,Black Gram,2014,3928,4957,1029,26.19653767820774
Ahmedpur,Sesamum,2016,4162,5191,1029,24.723690533397406
Manmad,Methi (Bhaji),2016,338,1367,1029,304.4378698224852
Satara,Green-Peas,2015,5000,6029,1029,20.58
Nashik,Ladies Finger,2016,1433,2462,1029,71.80739706908584
Sakri,Green Gram,2016,4000,5028,1028,25.7
Jalgaon,Shevga,2015,1343,2371,1028,76.54504839910648
Katol,Ground Nut Pods (Dry),2015,4715,5743,1028,21.80275715800636
Solapur,Wheat(Husked),2014,1606,2634,1028,64.00996264009963
Kamthi,BITTER GOURD,2016,1944,2972,1028,52.88065843621399
Solapur,Potato,2016,795,1823,1028,129.30817610062894
Pune,Bottle Gourd,2016,748,1776,1028,137.4331550802139
Kamthi,DHEMSE,2016,1727,2755,1028,59.52518818760857
Kalyan,Small Gourd,2016,3904,4932,1028,26.331967213114755
Lasalgaon,Tomato,2016,182,1210,1028,564.8351648351648
Nandura,Gram,2015,3754,4782,1028,27.38412360149174
Satara,Brinjal,2014,1224,2252,1028,83.98692810457516
Mumbai,Jaggery,2015,2850,3877,1027,36.03508771929825
Mumbai,Melon,2016,780,1807,1027,131.66666666666666
Barshi-Vairag,Pigeon Pea (Tur),2016,6336,7363,1027,16.208964646464647
Nagpur,Mosambi,2014,942,1969,1027,109.02335456475583
Latur-Murud,Wheat(Husked),2016,2346,3373,1027,43.7766410912191
Jalgaon,Ladies Finger,2015,1606,2633,1027,63.94769613947696
Baramati,Ground Nut Pods (Dry),2016,4707,5734,1027,21.818568090078607
Umared,Gram,2016,6367,7394,1027,16.130045547353543
Nilanga,Pigeon Pea (Tur),2016,7346,8372,1026,13.966784644704601
Solapur,Carrot,2015,435,1461,1026,235.86206896551724
Pune,Snake Gourd,2015,1037,2063,1026,98.93924783027965
Kej,Pigeon Pea (Tur),2015,5235,6261,1026,19.598853868194844
Nashik,Capsicum,2016,1709,2735,1026,60.03510825043885
Mumbai,Papai,2015,841,1867,1026,121.99762187871582
Mumbai,Orange,2016,736,1762,1026,139.40217391304347
Mumbai,Split Gram,2015,6196,7222,1026,16.55907036797934
Solapur,Chikoo,2015,564,1590,1026,181.91489361702128
Kamthi,Methi (Bhaji),2016,1017,2043,1026,100.88495575221239
Mumbai,Ladies Finger,2015,2938,3964,1026,34.92171545268891
Satana,Green Gram,2015,7837,8863,1026,13.091744289906853
Kada (Ashti),Pigeon Pea (Tur),2016,6350,7375,1025,16.141732283464567
Indapur-Bhigwan,Sorgum(Jawar),2016,1663,2688,1025,61.63559831629585
Achalpur,Pigeon Pea (Tur),2015,4650,5675,1025,22.043010752688172
Rahata,Bitter Gourd,2016,1500,2525,1025,68.33333333333333
Shrigonda,Black Gram,2016,5475,6500,1025,18.72146118721461
Pune,Capsicum,2015,1940,2965,1025,52.83505154639175
Osmanabad,Capsicum,2015,1150,2175,1025,89.1304347826087
Kalyan,Green-Peas,2015,6510,7535,1025,15.745007680491552
Mehkar,Black Gram,2014,4189,5214,1025,24.468846980186203
Nashik,Onion,2015,525,1550,1025,195.23809523809524
Solapur,Wheat(Unhusked),2015,2075,3100,1025,49.397590361445786
Sangli-Phale Bhajipalam,Ginger (Fresh),2016,3125,4150,1025,32.8
Mumbai,Guava,2015,900,1925,1025,113.88888888888889
Vadgaon Peth,Capsicum,2015,975,2000,1025,105.12820512820512
Pune,Elephant Root,2016,2000,3025,1025,51.25
Pathari,Pigeon Pea (Tur),2016,8063,9088,1025,12.71238992930671
Shirpur,Gram,2015,3559,4584,1025,28.800224782242204
Nilanga,Gram,2014,2375,3400,1025,43.1578947368421
Chandur Bajar,Gram,2015,3225,4250,1025,31.782945736434108
Aurangabad,Cluster Bean,2016,3550,4575,1025,28.87323943661972
Shrirampur,Mosambi,2016,3058,4083,1025,33.51863963374755
Aurangabad,Orange,2016,1325,2350,1025,77.35849056603773
Mangaon(Bhadav),Nachani,2016,1450,2475,1025,70.6896551724138
Chandrapur,Papai,2016,1800,2825,1025,56.94444444444444
Osmanabad,Ginger (Fresh),2015,2500,3525,1025,41.0
Daryapur,Gram,2014,1900,2925,1025,53.94736842105263
Bhokar,Black Gram,2015,9234,10258,1024,11.08945202512454
Umared,Gram,2016,4214,5238,1024,24.299952539155196
Nandura,Sesamum,2016,4376,5400,1024,23.40036563071298
Indapur,Wheat(Husked),2015,1487,2511,1024,68.86348352387357
Khed-Chakan,Shevga,2016,4180,5204,1024,24.497607655502392
Indapur,Onion,2015,195,1219,1024,525.1282051282051
Lasalgaon,Onion,2015,663,1687,1024,154.4494720965309
Vadgaon Peth,Bitter Gourd,2016,1682,2706,1024,60.87990487514863
Pune,Rice(Paddy-Hus),2014,5640,6664,1024,18.156028368794328
Sangali,Jaggery,2015,2021,3045,1024,50.66798614547254
Jalgaon,Ladies Finger,2014,1614,2638,1024,63.44485749690211
Sangrampur-Varvatbakal,Black Gram,2016,5733,6756,1023,17.84406070120356
Kolhapur,Capsicum,2015,406,1429,1023,251.9704433497537
Vadgaon Peth,Green-Peas,2015,2208,3231,1023,46.33152173913044
Vasai,Tomato,2016,1013,2036,1023,100.98716683119447
Pune,Ghosali(Bhaji),2014,1227,2250,1023,83.37408312958435
Nashik,Kanda Pat,2016,907,1930,1023,112.78941565600881
Sinner,Gram,2015,2809,3832,1023,36.4186543253827
Nagpur,Green Chilli,2016,4882,5905,1023,20.954526833265056
Mumbai,Pomegranate,2015,5977,7000,1023,17.115609837711226
Hingoli,Pigeon Pea (Tur),2015,8350,9373,1023,12.251497005988025
Pune-Manjri,Onion,2015,91,1114,1023,1124.1758241758241
Aurangabad,Pigeon Pea (Tur),2015,5000,6022,1022,20.44
Khamgaon,Pigeon Pea (Tur),2014,4068,5090,1022,25.12291052114061
Khed-Chakan,Squash Gourd,2016,3674,4696,1022,27.817093086554163
Satara,Ginger (Fresh),2015,2422,3444,1022,42.19653179190752
Kamthi,Capsicum,2015,1552,2574,1022,65.85051546391753
Solapur,Papai,2016,868,1890,1022,117.74193548387096
Kolhapur,BITTER GOURD,2016,713,1735,1022,143.33800841514727
Mumbai,Split Lentil,2016,6161,7183,1022,16.58821619866905
Kamthi,Tomato,2014,1285,2307,1022,79.53307392996109
Khamgaon,Pigeon Pea (Tur),2016,5700,6722,1022,17.92982456140351
Kolhapur,Papai,2016,497,1519,1022,205.6338028169014
Hingoli,Green Gram,2014,5621,6642,1021,18.164027753068847
Mumbai,Papai,2015,871,1892,1021,117.22158438576349
Pune,Ridge Gourd,2014,1458,2479,1021,70.02743484224966
Shrirampur,Green Chilli,2016,4000,5021,1021,25.525
Aurangabad,Lemon,2016,1979,3000,1021,51.59171298635675
Mumbai,Chikoo,2016,1012,2033,1021,100.88932806324111
Indapur-Bhigwan,Gram,2015,3653,4674,1021,27.949630440733642
Latur,Wheat(Husked),2016,1590,2611,1021,64.21383647798743
Chandvad,BRINJAL,2016,531,1552,1021,192.27871939736346
Pune,Onion,2015,724,1745,1021,141.02209944751382
Malkapur,Pigeon Pea (Tur),2016,8051,9071,1020,12.669233635573221
Raver,Gram,2016,5559,6579,1020,18.34862385321101
Lasur Station,Gram,2016,5886,6906,1020,17.329255861365954
Jalgaon,Ginger (Fresh),2016,1005,2025,1020,101.49253731343283
Chandrapur,Chikoo,2016,2200,3220,1020,46.36363636363637
Indapur-Bhigwan,Green Gram,2016,5560,6580,1020,18.345323741007196
Aurangabad,Onion,2015,491,1511,1020,207.73930753564156
Aurangabad,Zendu,2016,1440,2460,1020,70.83333333333333
Pune-Moshi,Green-Peas,2016,3700,4720,1020,27.56756756756757
Satara,Shevga,2016,4480,5500,1020,22.767857142857142
Jalgaon,Wal Papdi,2016,2620,3640,1020,38.93129770992366
Daryapur,Gram,2015,3524,4544,1020,28.944381384790013
Satara,Cluster Bean,2016,4813,5833,1020,21.192603365884064
Khed-Chakan,Ladies Finger,2016,1500,2520,1020,68.0
Pune,Ghosali(Bhaji),2015,1267,2287,1020,80.50513022888714
Pune-Manjri,Kanda Pat,2015,1155,2175,1020,88.31168831168831
Kamthi,Carrot,2016,690,1710,1020,147.82608695652175
Khed-Chakan,Cluster Bean,2016,3500,4520,1020,29.142857142857142
Pune,Green Gram,2015,7460,8480,1020,13.672922252010723
Jalgaon,LADIES FINGER,2016,1490,2510,1020,68.45637583892618
Akot,Black Gram,2016,6645,7665,1020,15.349887133182845
Nashik,Lemon,2015,1110,2130,1020,91.89189189189189
Chandur Bajar,Gram,2015,4183,5202,1019,24.360506813291895
Khed-Chakan,Shevga,2016,4135,5154,1019,24.64328899637243
Karad,Shevga,2015,3405,4424,1019,29.926578560939795
Mumbai,Pomegranate,2015,6962,7981,1019,14.636598678540649
Chandvad,CUCUMBER,2016,661,1680,1019,154.160363086233
Satana,Green Gram,2016,4395,5414,1019,23.185437997724687
Khed-Chakan,Cluster Bean,2016,3231,4250,1019,31.53822346022903
Mumbai,Pineapple,2015,1000,2019,1019,101.9
Rahata,Bottle Gourd,2016,1662,2681,1019,61.31167268351384
Ahmednagar,Ghosali(Bhaji),2016,476,1495,1019,214.07563025210084
Sangali,Jaggery,2016,2391,3410,1019,42.61815140108741
Pune,Cucumber,2015,791,1809,1018,128.69785082174462
Barshi,Sorgum(Jawar),2015,1453,2471,1018,70.06194081211287
Taloda,Pigeon Pea (Tur),2014,4333,5351,1018,23.49411493191784
Jalgaon,Coriander  ,2014,1159,2177,1018,87.83433994823123
Patan,Green Chilli,2016,4553,5571,1018,22.358884252141443
Pune,Chavli (Shenga ),2015,1455,2473,1018,69.96563573883161
Mehkar,Gram,2015,4029,5047,1018,25.26681558699429
Indapur-Bhigwan,Ground Nut Pods (Dry),2015,4760,5778,1018,21.386554621848738
Kamthi,Bottle Gourd,2015,878,1896,1018,115.94533029612757
Kalyan,Guava,2015,2882,3900,1018,35.32269257460097
Nashik,Guava,2016,1430,2448,1018,71.18881118881119
Kamthi,GUAVA,2016,1853,2871,1018,54.93793847814355
Latur,Pigeon Pea (Tur),2016,6068,7086,1018,16.776532630191166
Amarawati,Ground Nut Pods (Dry),2015,4580,5597,1017,22.20524017467249
Chandrapur,Chikoo,2015,2083,3100,1017,48.823811809889584
Kalyan,Green Chilli,2016,4511,5528,1017,22.544890268233207
Nagpur,Pigeon Pea (Tur),2015,7659,8676,1017,13.27849588719154
Pune,Parwar,2016,1650,2667,1017,61.63636363636363
Samudrapur,Cotton,2016,3925,4942,1017,25.910828025477706
Chandrapur,Mosambi,2016,1800,2817,1017,56.5
Kada,Sorgum(Jawar),2015,1528,2545,1017,66.55759162303664
Rahuri,FLOWER,2016,289,1306,1017,351.9031141868512
Tasgaon,Gram,2016,6983,8000,1017,14.563940999570384
Akola,Pigeon Pea (Tur),2016,8326,9343,1017,12.214748979101609
Mehkar,Green Gram,2015,5902,6919,1017,17.231446967129788
Pune,Mula Shenga,2016,1475,2492,1017,68.94915254237289
Lasalgaon,Sunflower,2014,2351,3368,1017,43.25818800510421
Manchar,Bitter Gourd,2016,4800,5817,1017,21.1875
Sakri,GROUND NUT PODS (DRY),2016,3270,4287,1017,31.10091743119266
Solapur,Bor,2015,221,1238,1017,460.18099547511315
Lasalgaon,Gram,2014,2022,3039,1017,50.29673590504451
Solapur,Ghevda,2016,1860,2877,1017,54.67741935483871
Vasai,Tomato,2015,1000,2017,1017,101.7
Kamthi,Ladies Finger,2015,1573,2590,1017,64.65352828989192
Amarawati,Black Gram,2015,6111,7128,1017,16.642120765832107
Pune,Brinjal,2015,656,1672,1016,154.8780487804878
Mumbai,Pineapple,2014,996,2012,1016,102.00803212851406
Jalgaon,Chavli (Shenga ),2016,1484,2500,1016,68.46361185983828
Manchar,Methi (Bhaji),2015,436,1452,1016,233.0275229357798
Aurangabad,Lemon,2015,2472,3488,1016,41.10032362459547
Pune-Manjri,Green Chilli,2015,2179,3195,1016,46.626893070215694
Hinganghat,Pigeon Pea (Tur),2015,4828,5844,1016,21.04391052195526
Chandvad,Onion,2014,565,1581,1016,179.8230088495575
Jalgaon,Brinjal,2015,920,1935,1015,110.32608695652173
Taloda,Gram,2016,5971,6986,1015,16.998827667057444
Kopargaon,Gram,2015,3758,4773,1015,27.00904736562001
Malkapur,Gram,2015,3409,4424,1015,29.7741273100616
Pune,Elephant Root,2015,1485,2500,1015,68.35016835016835
Pune-Manjri,Spinach,2014,785,1800,1015,129.29936305732485
Akluj,Shevga,2014,2308,3323,1015,43.97746967071057
Ausa,Sesamum,2015,8211,9226,1015,12.361466325660698
Latur,Gram,2016,6488,7503,1015,15.6442663378545
Sangrampur-Varvatbakal,Gram,2016,6786,7801,1015,14.957264957264957
Pune,Rice(Paddy-Hus),2015,4447,5462,1015,22.82437598380931
Jalgaon,Bitter Gourd,2016,1171,2186,1015,86.67805294619983
Tumsar,Rice(Paddy-Hus),2016,2014,3029,1015,50.39721946375372
Parner,Onion,2015,500,1515,1015,203.0
Kalamb (Os),SOYBEAN,2016,1784,2799,1015,56.89461883408072
Lonand,Onion,2015,688,1703,1015,147.52906976744185
Manchar,Methi (Bhaji),2015,825,1840,1015,123.03030303030303
Kamthi,Coriander  ,2016,664,1679,1015,152.86144578313252
Jalgaon,Ladies Finger,2016,1990,3005,1015,51.005025125628144
Jalgaon,Methi (Bhaji),2015,1148,2162,1014,88.32752613240419
Kolhapur-Laxmipuri,Wheat(Husked),2015,1786,2800,1014,56.77491601343785
Jalna,Green Gram,2016,4354,5368,1014,23.28892971979789
Kurdwadi-Modnimb,Gram,2015,2464,3478,1014,41.1525974025974
Solapur,Carrot,2014,693,1707,1014,146.32034632034632
Aurangabad,Bitter Gourd,2016,2929,3943,1014,34.619324001365655
Ahmednagar,Cabbage,2015,386,1400,1014,262.6943005181347
Shirpur,Pigeon Pea (Tur),2015,4237,5251,1014,23.932027377861694
Nira-Saswad,Rice(Paddy-Hus),2016,2175,3188,1013,46.57471264367816
Phaltan,Sorgum(Jawar),2015,1587,2600,1013,63.83112791430372
Manchar,Chavli (Shenga ),2016,2992,4005,1013,33.856951871657756
Sangrampur,Green Gram,2015,5450,6463,1013,18.587155963302752
Latur-Murud,Gram,2016,3428,4441,1013,29.55075845974329
Kada,Sorgum(Jawar),2015,1688,2701,1013,60.01184834123223
Chandrapur-Ganjwad,Green-Peas,2016,1420,2433,1013,71.33802816901408
Nashik,Papai,2015,600,1613,1013,168.83333333333334
Pune,Walvad,2016,1274,2287,1013,79.51334379905809
Akluj,Chillies(Red),2015,2120,3133,1013,47.783018867924525
Kamthi,Spinach,2016,1552,2565,1013,65.27061855670104
Malegaon,Onion,2016,325,1338,1013,311.6923076923077
Hinganghat,Gram,2015,3164,4177,1013,32.016434892541085
Kolhapur,Ghevda,2015,1200,2213,1013,84.41666666666667
Kolhapur,Water Melon,2016,150,1163,1013,675.3333333333334
Mumbai,Jaggery,2015,2500,3512,1012,40.48
Sangali,Black Gram,2016,6038,7050,1012,16.760516727393178
Shirpur,Onion,2014,274,1286,1012,369.3430656934307
Sinner,Green Gram,2014,7216,8228,1012,14.024390243902438
Kej,Gram,2016,6381,7393,1012,15.859583137439273
Pune,Green Gram,2015,7788,8800,1012,12.994350282485875
Dhule,Green Gram,2014,6694,7706,1012,15.11801613385121
Pune,Walvad,2014,1940,2952,1012,52.16494845360825
Barshi,Sorgum(Jawar),2016,1677,2689,1012,60.3458556946929
Tumsar,Black Gram,2015,4238,5250,1012,23.87918829636621
Rahata,Bitter Gourd,2015,1388,2400,1012,72.91066282420749
Amarawati,Ground Nut Pods (Dry),2015,4488,5500,1012,22.54901960784314
Kamthi,Pumpkin,2015,653,1665,1012,154.9770290964778
Ahmednagar,Sorgum(Jawar),2015,1707,2718,1011,59.22671353251318
Kannad,Ginger (Fresh),2015,1822,2833,1011,55.48847420417124
Shahada,Gram,2016,3970,4981,1011,25.465994962216623
Pune,Rice(Paddy-Hus),2015,4435,5446,1011,22.795941375422775
Mumbai,Onion,2015,3679,4690,1011,27.480293558032074
Akole,Onion,2016,125,1136,1011,808.8
Kolhapur,Bitter Gourd,2016,435,1446,1011,232.41379310344828
Palus,Capsicum,2016,3500,4510,1010,28.857142857142858
Ahmednagar,Tomato,2015,550,1560,1010,183.63636363636363
Kurdwadi-Modnimb,Sorgum(Jawar),2016,1289,2299,1010,78.35531419705198
Manchar,Cluster Bean,2016,5500,6510,1010,18.363636363636363
Osmanabad,Ghevda,2015,1590,2600,1010,63.522012578616355
Sangali,Jaggery,2016,2633,3643,1010,38.359285985567794
Indapur-Bhigwan,Cowpea,2015,4370,5380,1010,23.112128146453088
Ahmednagar,Tomato,2016,333,1343,1010,303.3033033033033
Sindi (Selu),Pigeon Pea (Tur),2016,5125,6135,1010,19.70731707317073
Pune-Manjri,Flower,2016,1167,2177,1010,86.54670094258783
Sonpeth,Green Gram,2014,6669,7679,1010,15.14469935522567
Kamthi,Onion,2014,1133,2143,1010,89.14386584289497
Nandura,Green Gram,2014,6603,7613,1010,15.296077540511888
Jalgaon,Ladies Finger,2015,1460,2470,1010,69.17808219178082
Devala,Gram,2015,3408,4417,1009,29.606807511737088
Ulhasnagar,Sorgum(Jawar),2016,2991,4000,1009,33.73453694416583
Mumbai,Small Gourd,2016,1229,2238,1009,82.09926769731489
Nashik,Flower,2015,732,1741,1009,137.8415300546448
Kamthi,Chavli (Shenga ),2014,833,1842,1009,121.12845138055222
Nashik,Grapes,2016,1972,2981,1009,51.16632860040568
Dudhani,Pigeon Pea (Tur),2016,8406,9415,1009,12.003330954080418
Indapur,Black Gram,2016,10000,11009,1009,10.09
Latur-Murud,Wheat(Husked),2016,1888,2897,1009,53.442796610169495
Karanja,Gram,2016,5497,6505,1008,18.337274877205747
Vadgaon Peth,Flower,2015,671,1679,1008,150.2235469448584
Barshi,Turmeric,2014,4008,5016,1008,25.149700598802394
Chandvad,Onion,2015,290,1298,1008,347.58620689655174
Kolhapur,Green Chilli,2016,627,1635,1008,160.76555023923444
Dindori-Vani,Onion,2015,2027,3035,1008,49.72866304884065
Aurangabad,Cluster Bean,2015,2954,3962,1008,34.12322274881517
Majalgaon,Pigeon Pea (Tur),2014,3753,4761,1008,26.85851318944844
Mumbai,Mosambi,2015,1011,2019,1008,99.70326409495549
Pune,Green-Peas,2014,2368,3376,1008,42.567567567567565
Mumbai,Cluster Bean,2016,2728,3736,1008,36.950146627565985
Lasalgaon,Gram,2015,2874,3881,1007,35.03827418232429
Kalyan,Mosambi,2016,2480,3487,1007,40.604838709677416
Latur,Black Gram,2016,6554,7561,1007,15.364662801342691
Chandrapur,Chikoo,2015,1564,2571,1007,64.38618925831202
Baramati,Ground Nut Pods (Dry),2016,4080,5087,1007,24.681372549019606
Phaltan,Cluster Bean,2016,4308,5315,1007,23.375116063138346
Lasur Station,Pigeon Pea (Tur),2015,5437,6444,1007,18.52124333272025
Pune-Manjri,Ghosali(Bhaji),2016,2703,3710,1007,37.254901960784316
Kada,Sorgum(Jawar),2016,1600,2607,1007,62.9375
Kamthi,Cucumber,2016,1075,2082,1007,93.67441860465117
Sinner,Gram,2014,1788,2794,1006,56.26398210290828
Pusad,Pigeon Pea (Tur),2015,8055,9061,1006,12.489137181874613
Akluj,Tomato,2015,1235,2241,1006,81.4574898785425
Risod,Gram,2016,8231,9237,1006,12.222087231199126
Malkapur,Green Gram,2016,4119,5125,1006,24.423403738771547
Yeola,Onion,2015,368,1374,1006,273.3695652173913
Akola,Pigeon Pea (Tur),2016,7504,8510,1006,13.406183368869936
Shirpur,Chillies(Red),2015,1831,2837,1006,54.94265428727471
Nashik,Squash Gourd,2016,1271,2277,1006,79.15027537372148
Phaltan,Sorgum(Jawar),2016,1570,2576,1006,64.07643312101911
Vadgaon Peth,Brinjal,2016,1059,2064,1005,94.90084985835693
Kolhapur,Pineapple,2016,530,1535,1005,189.62264150943398
Kalyan,Cluster Bean,2016,3643,4648,1005,27.587153444962944
Barshi,Gram,2016,5556,6561,1005,18.088552915766737
Pune-Moshi,Ground Nut Pods (Dry),2016,2900,3905,1005,34.6551724137931
Nashik,Green-Peas,2016,2430,3435,1005,41.358024691358025
Rahata,Capsicum,2015,1170,2175,1005,85.8974358974359
Aurangabad,Flower,2015,1755,2760,1005,57.26495726495727
Jalgaon,Methi (Bhaji),2014,1477,2482,1005,68.04333107650643
Mumbai,Split Gram,2015,5491,6496,1005,18.3026771079949
Pune,Tomato,2015,770,1775,1005,130.5194805194805
Chandur Bajar,Green Gram,2016,7050,8055,1005,14.25531914893617
Mumbai-Fruit Market,Pomegranate,2016,3591,4595,1004,27.958785853522695
Nandgaon Khandeshwar,Pigeon Pea (Tur),2016,7795,8799,1004,12.880051314945478
Osmanabad,Tomato,2015,664,1668,1004,151.20481927710844
Pune,Pavtta,2015,2220,3224,1004,45.22522522522522
Kalyan,Green-Peas,2016,6884,7888,1004,14.584543869843115
Khed-Chakan,Farshi,2016,1929,2933,1004,52.04769310523587
Jintur,Pigeon Pea (Tur),2015,4987,5990,1003,20.112291959093643
Ahmednagar,Onion,2016,100,1103,1003,1003.0
Kolhapur,Papai,2015,280,1283,1003,358.2142857142857
Chikhali,Green Gram,2016,5686,6689,1003,17.639817094618362
Chalisgaon,Black Gram,2016,5714,6717,1003,17.553377668883446
Shrirampur,Gram,2016,5367,6370,1003,18.68828023104155
Ulhasnagar,Bajri,2016,1971,2974,1003,50.887874175545406
Chalisgaon,Sorgum(Jawar),2015,1219,2222,1003,82.2805578342904
Wardha,Pigeon Pea (Tur),2016,8043,9046,1003,12.47047121720751
Gevrai,Green Gram,2015,6905,7907,1002,14.511223750905142
Amalner,Green Gram,2014,6283,7285,1002,15.947795639025943
Lasalgaon,Gram,2015,3387,4389,1002,29.5837023914969
Solapur,Bor,2015,278,1280,1002,360.431654676259
Barshi,Gram,2016,3674,4676,1002,27.272727272727273
Dhule,Onion,2015,288,1289,1001,347.56944444444446
Bhandara,GRAM,2016,7991,8992,1001,12.526592416468526
Dindori,Onion,2015,662,1663,1001,151.20845921450152
Phaltan,ONION,2016,200,1201,1001,500.5
Majalgaon,Gram,2015,2863,3864,1001,34.96332518337408
Ulhasnagar,Sorgum(Jawar),2016,1963,2964,1001,50.99337748344371
Akkolkot,Pigeon Pea (Tur),2014,4200,5201,1001,23.833333333333332
Nandgaon Khandeshwar,Chino,2016,3148,4149,1001,31.797966963151207
Ahmedpur,Coriander (Dry),2014,7000,8001,1001,14.3
Akkolkot,Gram,2015,4000,5001,1001,25.025
Nilanga,Black Gram,2016,5000,6001,1001,20.02
Ahmednagar,Sorgum(Jawar),2014,1600,2601,1001,62.5625
Mantha,Green Gram,2014,5044,6045,1001,19.84536082474227
Jalgaon,Onion,2014,593,1594,1001,168.8026981450253
Kamthi,Beet Root,2016,1875,2875,1000,53.333333333333336
Patan,Cluster Bean,2016,3500,4500,1000,28.571428571428573
Patan,Pavtta,2014,4250,5250,1000,23.529411764705884
Satara,Green-Peas,2016,3818,4818,1000,26.191723415400734
Kamthi,Chavli (Pala),2016,721,1721,1000,138.69625520110958
Bhivandi,Male Goat,2016,7000,8000,1000,14.285714285714286
Patan,Ghevda,2015,2500,3500,1000,40.0
Shrirampur,Chikoo,2014,1500,2500,1000,66.66666666666667
Pune-Moshi,Ladies Finger,2016,1797,2797,1000,55.648302726766836
Kamthi,Pumpkin,2015,1129,2129,1000,88.57395925597874
Amalner,Soybean,2016,3000,4000,1000,33.333333333333336
Satara,Ground Nut Pods (Dry),2016,3000,4000,1000,33.333333333333336
Kamthi,Raddish,2015,743,1743,1000,134.58950201884252
Patan,Cluster Bean,2015,3000,4000,1000,33.333333333333336
Satara,Ladies Finger,2016,2083,3083,1000,48.00768122899664
Manora,Green Gram,2016,5000,6000,1000,20.0
Patan,Cluster Bean,2015,2000,3000,1000,50.0
Umared,Chillies(Red),2014,3250,4250,1000,30.76923076923077
Sakri,Green Gram,2016,3500,4500,1000,28.571428571428573
Patan,Ghevda,2015,2000,3000,1000,50.0
Mantha,Sesamum,2016,4000,5000,1000,25.0
Umared,Chillies(Red),2014,5500,6500,1000,18.181818181818183
Patan,Cluster Bean,2016,3500,4500,1000,28.571428571428573
Amarawati,Lemon,2016,3441,4441,1000,29.061319383900027
Kolhapur-Malkapur,Capsicum,2016,2000,3000,1000,50.0
Patan,Cluster Bean,2016,3000,4000,1000,33.333333333333336
Amarawati,Ginger (Fresh),2015,2500,3500,1000,40.0
Satara,Ghevda,2016,3000,4000,1000,33.333333333333336
Junnar-Otur,Chavli (Shenga ),2015,500,1500,1000,200.0
Jalgaon Jamod,Green Gram,2014,5000,6000,1000,20.0
Amalner,Coriander (Dry),2014,7000,8000,1000,14.285714285714286
Amarawati,Grapes,2016,3500,4500,1000,28.571428571428573
Koregaon,Potato,2014,1067,2067,1000,93.72071227741331
Parshiwani,Pigeon Pea (Tur),2015,7500,8500,1000,13.333333333333334
Satara,Green-Peas,2016,6286,7286,1000,15.90836780146357
Satara,Green-Peas,2016,7111,8111,1000,14.06271972999578
Ghoti,Cucumber,2016,2000,3000,1000,50.0
Shrirampur,Pomegranate,2014,3476,4476,1000,28.768699654775602
Amarawati,Bullock Heart,2016,2000,3000,1000,50.0
Shrirampur,Pomegranate,2014,3500,4500,1000,28.571428571428573
Satara,Pavtta,2016,3667,4667,1000,27.270248159258248
Patan,Green Peas (Dry),2016,4500,5500,1000,22.22222222222222
Amarawati,Amba Koy,2016,1000,2000,1000,100.0
Patan,Green Peas (Dry),2016,6000,7000,1000,16.666666666666668
Ramtek,Coriander  ,2016,4739,5739,1000,21.101498206372653
Patan,Bitter Gourd,2016,3000,4000,1000,33.333333333333336
Patan,Capsicum,2014,3000,4000,1000,33.333333333333336
Nira,Rice(Paddy-Hus),2015,2200,3200,1000,45.45454545454545
Jalgaon,Methi (Bhaji),2016,3907,4907,1000,25.59508574353724
Kamthi,Kand,2016,886,1886,1000,112.86681715575621
Amarawati,Amba Koy,2016,3250,4250,1000,30.76923076923077
Satara,Pavtta,2016,6800,7800,1000,14.705882352941176
Manora,Black Gram,2015,10000,11000,1000,10.0
Pune,Double Bee,2015,2000,3000,1000,50.0
Kamthi,BEET ROOT,2016,1900,2900,1000,52.63157894736842
Patan,Bitter Gourd,2015,2500,3500,1000,40.0
Kamthi,Karvand,2016,2000,3000,1000,50.0
Ulhasnagar,Gr.Nut Kernels,2016,6636,7636,1000,15.06931886678722
Rahata,Ground Nut Pods (Dry),2014,4000,5000,1000,25.0
Ulhasnagar,Gr.Nut Kernels,2016,6615,7615,1000,15.11715797430083
Ulhasnagar,Gr.Nut Kernels,2016,7000,8000,1000,14.285714285714286
Kamthi,Guava,2016,2000,3000,1000,50.0
Pune,Wal Bhaji,2016,1353,2353,1000,73.90983000739098
Savner,Ground Nut Pods (Dry),2014,3000,4000,1000,33.333333333333336
Ratanagari,Bitter Gourd,2016,4000,5000,1000,25.0
Kamthi,Papai,2016,2000,3000,1000,50.0
Patan,Cluster Bean,2015,3500,4500,1000,28.571428571428573
Kamthi,ELEPHANT ROOT,2016,2500,3500,1000,40.0
Shrirampur,Green Chilli,2014,3214,4214,1000,31.113876789047914
Pune-Moshi,Chavli (Pala),2016,3000,4000,1000,33.333333333333336
Koregaon,Ghevda Seed,2016,3000,4000,1000,33.333333333333336
Kamthi,Papai,2015,1000,2000,1000,100.0
Patan,Bitter Gourd,2015,2500,3500,1000,40.0
Nira-Saswad,Green Gram,2016,5500,6500,1000,18.181818181818183
Satara,Shevga,2016,3042,4042,1000,32.87310979618672
Patan,Squash Gourd,2016,2000,3000,1000,50.0
Kamthi,MOSAMBI,2016,2000,3000,1000,50.0
Kamthi,Papai,2016,1500,2500,1000,66.66666666666667
Mumbai,Grapes,2015,4000,5000,1000,25.0
Kamthi,Parwar,2016,2000,3000,1000,50.0
Pachora,Pigeon Pea (Tur),2015,7000,8000,1000,14.285714285714286
Solapur,Green Gram,2015,7500,8500,1000,13.333333333333334
Karad,Orange,2016,2000,3000,1000,50.0
Vai,Ginger (Fresh),2014,4161,5161,1000,24.03268445085316
Nandgaon Khandeshwar,Soybean,2016,2892,3892,1000,34.57814661134163
Ramtek,Raddish,2016,3000,4000,1000,33.333333333333336
Nandgaon Khandeshwar,Soybean,2016,2644,3644,1000,37.821482602118
Nandgaon Khandeshwar,Soybean,2016,2785,3785,1000,35.90664272890485
Barshi,Coriander  ,2016,1000,2000,1000,100.0
Karad,Pomegranate,2016,3212,4212,1000,31.133250311332503
Ramtek,Shevga,2016,1000,2000,1000,100.0
Osmanabad,SHEVGA,2016,4000,5000,1000,25.0
Rahata,Garlic,2015,3125,4125,1000,32.0
Shirpur,Chillies(Red),2015,4050,5050,1000,24.691358024691358
Aurangabad,Tamarind,2015,3000,4000,1000,33.333333333333336
Nagpur,Ginger (Dry),2015,1900,2900,1000,52.63157894736842
Ramtek,Squash Gourd,2016,3000,4000,1000,33.333333333333336
Vita,Ladies Finger,2014,3000,4000,1000,33.333333333333336
Pandharpur,Green-Peas,2015,2150,3150,1000,46.51162790697674
Aurangabad,Bitter Gourd,2016,3313,4313,1000,30.184123151222458
Aurangabad,Chavli (Shenga ),2016,1500,2500,1000,66.66666666666667
Rahata,Green Chilli,2015,3107,4107,1000,32.1853878339234
Aurangabad,Chikoo,2016,1500,2500,1000,66.66666666666667
Khed-Chakan,WAL PAPDI,2016,1500,2500,1000,66.66666666666667
Khed-Chakan,Shevga,2016,3368,4368,1000,29.69121140142518
Ratanagari,Carrot,2015,4000,5000,1000,25.0
Nandgaon Khandeshwar,Pigeon Pea (Tur),2016,6888,7888,1000,14.518002322880372
Nandgaon Khandeshwar,Pigeon Pea (Tur),2016,7940,8940,1000,12.594458438287154
Nandgaon Khandeshwar,Pigeon Pea (Tur),2016,7050,8050,1000,14.184397163120567
Vai,Ginger (Fresh),2014,5000,6000,1000,20.0
Pandharpur,Cucumber,2016,350,1350,1000,285.7142857142857
Kolhapur,Guava,2015,500,1500,1000,200.0
Osmanabad,Flower,2016,500,1500,1000,200.0
Kolhapur,Ground Nut Pods (Dry),2015,2500,3500,1000,40.0
Aurangabad,Grapes,2014,2750,3750,1000,36.36363636363637
Pune-Manjri,Papai,2015,1000,2000,1000,100.0
Karad,Shevga,2015,4000,5000,1000,25.0
Nandgaon Khandeshwar,Black Gram,2016,7500,8500,1000,13.333333333333334
Karad,Shevga,2015,4071,5071,1000,24.563989191844755
Pune,Wal Bhaji,2015,3000,4000,1000,33.333333333333336
Ramtek,Lemon,2016,3000,4000,1000,33.333333333333336
Aurangabad,Carrot,2015,1500,2500,1000,66.66666666666667
Aurangabad,Garlic,2015,2800,3800,1000,35.714285714285715
Sangali,Pigeon Pea (Tur),2015,4500,5500,1000,22.22222222222222
Ramtek,Lemon,2016,2000,3000,1000,50.0
Nandgaon Khandeshwar,Chino,2016,5020,6020,1000,19.9203187250996
Osmanabad,Green Chilli,2016,1000,2000,1000,100.0
Nandgaon Khandeshwar,Chino,2016,3152,4152,1000,31.725888324873097
Ramtek,Mango,2016,3000,4000,1000,33.333333333333336
Aurangabad,Fig,2015,8000,9000,1000,12.5
Solapur,Ground Nut Pods (Dry),2015,2695,3695,1000,37.105751391465674
Nandgaon Khandeshwar,Gram,2016,5518,6518,1000,18.12250815512867
Ratanagari,Cucumber,2015,1500,2500,1000,66.66666666666667
Nandgaon Khandeshwar,Green Gram,2016,5800,6800,1000,17.24137931034483
Khed-Chakan,Shepu,2016,4000,5000,1000,25.0
Mumbai,Apple,2015,3300,4300,1000,30.303030303030305
Kamthi,Pigen-Pea (Bhaji),2016,1000,2000,1000,100.0
Mumbai,Apple,2015,4000,5000,1000,25.0
Jamkhed,Green Gram,2015,6500,7500,1000,15.384615384615385
Balapur,Green Gram,2015,6000,7000,1000,16.666666666666668
Balapur,Pigeon Pea (Tur),2015,9100,10100,1000,10.989010989010989
Rahata,Cluster Bean,2016,6143,7143,1000,16.278691193228063
Ratanagari,Brinjal,2014,1676,2676,1000,59.665871121718375
Palus,Cabbage,2016,1500,2500,1000,66.66666666666667
Baramati,Pigeon Pea (Tur),2016,7250,8250,1000,13.793103448275861
Balapur,Black Gram,2016,5800,6800,1000,17.24137931034483
Palus,Pavtta,2015,6500,7500,1000,15.384615384615385
Palus,Green-Peas,2015,3000,4000,1000,33.333333333333336
Khamgaon,Male Lamb,2015,3000,4000,1000,33.333333333333336
Ratanagari,Cluster Bean,2014,3167,4167,1000,31.575623618566468
Mumbai,Custard Apple,2014,3500,4500,1000,28.571428571428573
Sangali,Pigeon Pea (Tur),2016,8000,9000,1000,12.5
Mumbai,Custard Apple,2014,3000,4000,1000,33.333333333333336
Ratanagari,Cluster Bean,2014,1750,2750,1000,57.142857142857146
Baramati,Green Gram,2016,4900,5900,1000,20.408163265306122
Ratanagari,Ginger (Fresh),2014,6500,7500,1000,15.384615384615385
Pune,Bhagar/Vari,2016,3000,4000,1000,33.333333333333336
Baramati,Onion,2015,400,1400,1000,250.0
Mumbai,Gr.Nut Kernels,2014,6000,7000,1000,16.666666666666668
Ratanagari,Ghevda,2014,3000,4000,1000,33.333333333333336
Ratanagari,French Bean,2014,3167,4167,1000,31.575623618566468
Ratanagari,Cucumber,2014,1382,2382,1000,72.3589001447178
Rahata,Capsicum,2016,3771,4771,1000,26.518164942985944
Palus,Pavtta,2016,2500,3500,1000,40.0
Ratanagari,Maize(Corn.),2014,6000,7000,1000,16.666666666666668
Barshi,Custard Apple,2014,2500,3500,1000,40.0
Barshi,Coriander  ,2015,1000,2000,1000,100.0
Pachora,Green Gram,2016,4800,5800,1000,20.833333333333332
Jamkhed,Pigeon Pea (Tur),2016,6000,7000,1000,16.666666666666668
Aurangabad,Kharbuj,2016,1000,2000,1000,100.0
Aurangabad,Kharbuj,2016,3000,4000,1000,33.333333333333336
Khed-Chakan,Ghevda,2016,3000,4000,1000,33.333333333333336
Khed-Chakan,Ghevda,2016,1500,2500,1000,66.66666666666667
Khed-Chakan,Farshi,2016,3688,4688,1000,27.114967462039047
Aurangabad,MANGO(RAW),2016,4000,5000,1000,25.0
Sindi,Pigeon Pea (Tur),2016,7875,8875,1000,12.698412698412698
Khed-Chakan,Chavli (Shenga ),2016,2000,3000,1000,50.0
Barshi,Coriander  ,2015,1000,2000,1000,100.0
Khed-Chakan,Capsicum,2016,2338,3338,1000,42.7715996578272
Palus,Squash Gourd,2016,4500,5500,1000,22.22222222222222
Khed-Chakan,Brinjal,2016,2833,3833,1000,35.29827038475115
Mumbai,Spilt Gerrn Gram,2014,8028,9028,1000,12.45640259093174
Pune-Manjri,Mango(Raw),2016,1600,2600,1000,62.5
Rahata,Lemon,2015,5000,6000,1000,20.0
Jamkhed,Sorgum(Jawar),2015,1800,2800,1000,55.55555555555556
Rahata,Green Chilli,2016,4538,5538,1000,22.036139268400177
Mumbai,Spilt Gerrn Gram,2014,8207,9207,1000,12.184720360667722
Nagpur,Coriander (Dry),2015,9000,10000,1000,11.11111111111111
Pandharpur,Ladies Finger,2014,800,1800,1000,125.0
Khed,Green Chilli,2016,833,1833,1000,120.04801920768307
Vai,Cluster Bean,2014,3000,4000,1000,33.333333333333336
Nandgaon Khandeshwar,Pigeon Pea (Tur),2015,6894,7894,1000,14.50536698578474
Karad,Onion,2015,3125,4125,1000,32.0
Karad,Mosambi,2015,4714,5714,1000,21.21340687314383
Kolhapur,Harbara(Pendi),2015,200,1200,1000,500.0
Ratanagari,Maize(Corn.),2015,2000,3000,1000,50.0
Kolhapur-Laxmipuri,Spilt Gerrn Gram,2015,10000,11000,1000,10.0
Mumbai,Jaggery,2015,2457,3457,1000,40.7000407000407
Jalgaon Jamod-Aasalgaon,Black Gram,2015,7000,8000,1000,14.285714285714286
Mauda,Gram,2016,5500,6500,1000,18.181818181818183
Jalgaon Jamod-Aasalgaon,Ground Nut Pods (Dry),2015,4200,5200,1000,23.80952380952381
Kolhapur-Laxmipuri,Lentil,2015,6000,7000,1000,16.666666666666668
Kolhapur-Laxmipuri,Green Peas (Dry),2015,3000,4000,1000,33.333333333333336
Amarawati-Fruit And Vegetables,GRAPES,2016,2300,3300,1000,43.47826086956522
Ramtek,Garlic,2016,9000,10000,1000,11.11111111111111
Ramtek,Garlic,2016,5222,6222,1000,19.149751053236308
Osmanabad,Ground Nut Pods (Dry),2015,3150,4150,1000,31.746031746031747
Amarawati-Fruit And Vegetables,Green Chilli,2016,7000,8000,1000,14.285714285714286
Kolhapur-Laxmipuri,Gr.Nut Kernels,2015,6250,7250,1000,16.0
Osmanabad,Ground Nut Pods (Dry),2015,2500,3500,1000,40.0
Amarawati-Fruit And Vegetables,Jambhul,2016,3875,4875,1000,25.806451612903224
Jalgaon Jamod-Aasalgaon,Sesamum,2015,9500,10500,1000,10.526315789473685
Pune-Manjri,Walvad,2016,4000,5000,1000,25.0
Amarawati-Fruit And Vegetables,Lemon,2016,1933,2933,1000,51.733057423693744
Amarawati-Fruit And Vegetables,Lemon,2016,3460,4460,1000,28.90173410404624
Amarawati-Fruit And Vegetables,Mosambi,2016,2750,3750,1000,36.36363636363637
Amarawati-Fruit And Vegetables,Naspatti ,2016,1914,2914,1000,52.2466039707419
Ramtek,Ginger (Fresh),2016,3625,4625,1000,27.586206896551722
Amarawati-Fruit And Vegetables,Orange,2016,3000,4000,1000,33.333333333333336
Kolhapur,Wal Bhaji,2016,3500,4500,1000,28.571428571428573
Osmanabad,Ghevda,2015,2000,3000,1000,50.0
Ratanagari,Maize(Corn.),2015,5000,6000,1000,20.0
Ratanagari,Maize(Corn.),2015,4000,5000,1000,25.0
Bhivandi,Male Goat,2014,2500,3500,1000,40.0
Bhivandi,Male Goat,2015,2500,3500,1000,40.0
Nagpur,Pigeon Pea (Tur),2015,7000,8000,1000,14.285714285714286
Amarawati,Mango(Raw),2016,3250,4250,1000,30.76923076923077
Ratanagari,Sweet Potato,2015,2000,3000,1000,50.0
Amarawati,Mango(Raw),2016,2000,3000,1000,50.0
Amarawati,Mosambi,2016,3357,4357,1000,29.788501638367592
Amarawati,Naspatti ,2016,2100,3100,1000,47.61904761904762
Bhivandi,Potato,2014,1000,2000,1000,100.0
Amarawati,Orange,2016,3000,4000,1000,33.333333333333336
Jalgaon Jamod,Pigeon Pea (Tur),2016,8000,9000,1000,12.5
Bhivandi,Onion,2014,1500,2500,1000,66.66666666666667
Bhivandi,Male Goat,2014,2250,3250,1000,44.44444444444444
Ratanagari,Maize(Corn.),2015,1500,2500,1000,66.66666666666667
Kamthi,SQUASH GOURD,2016,1000,2000,1000,100.0
Solapur,Mosambi,2016,200,1200,1000,500.0
Solapur,Mula Shenga,2016,3200,4200,1000,31.25
Jalgaon Jamod-Aasalgaon,Black Gram,2014,3800,4800,1000,26.31578947368421
Osmanabad,Cucumber,2015,700,1700,1000,142.85714285714286
Ramtek,GINGER (FRESH),2016,3875,4875,1000,25.806451612903224
Amarawati-Fruit And Vegetables,Capsicum,2016,7000,8000,1000,14.285714285714286
Ratanagari,Maize(Corn.),2015,2500,3500,1000,40.0
Kamthi,Zendu,2016,1500,2500,1000,66.66666666666667
Varud,ORANGE,2016,2500,3500,1000,40.0
Amarawati-Fruit And Vegetables,Chikoo,2016,1567,2567,1000,63.81620931716656
Pune,Parwar,2015,1880,2880,1000,53.191489361702125
Ghansawangi,Pigeon Pea (Tur),2016,8000,9000,1000,12.5
Ramtek,Ginger (Fresh),2016,4000,5000,1000,25.0
Karad,Grapes,2015,2500,3500,1000,40.0
Jalkot,Pigeon Pea (Tur),2016,7000,8000,1000,14.285714285714286
Vadgaon Peth,Snake Gourd,2014,1000,2000,1000,100.0
Vadgaon Peth,Shepu,2014,3000,4000,1000,33.333333333333336
Vasai,Onion,2014,1250,2250,1000,80.0
Ratanagari,French Bean,2015,7000,8000,1000,14.285714285714286
Kolhapur,Strawberi,2015,1000,2000,1000,100.0
Kolhapur,Small Gourd,2015,500,1500,1000,200.0
Ratanagari,French Bean,2015,2000,3000,1000,50.0
Shirpur,Soybean,2015,2000,3000,1000,50.0
Vadgaon Peth,Onion,2014,1500,2500,1000,66.66666666666667
Nandgaon,Wheat(Husked),2016,5600,6600,1000,17.857142857142858
Osmanabad,Cluster Bean,2016,1150,2150,1000,86.95652173913044
Kolhapur,Beet Root,2016,1813,2813,1000,55.15719801434087
Karad,Green-Peas,2015,3000,4000,1000,33.333333333333336
Karad,Green-Peas,2015,2375,3375,1000,42.10526315789474
Nandgaon Khandeshwar,Chino,2015,3002,4002,1000,33.311125916055964
Nandgaon Khandeshwar,Chino,2015,3400,4400,1000,29.41176470588235
Vadgaon Peth,Ghevda,2014,1500,2500,1000,66.66666666666667
Atpadi,Cotton,2015,4500,5500,1000,22.22222222222222
Mumbai,Fennel,2015,14955,15955,1000,6.686726847208291
Atpadi,Ground Nut Pods (Dry),2016,5000,6000,1000,20.0
Karad,Mosambi,2015,4000,5000,1000,25.0
Ramtek,Kand,2016,1000,2000,1000,100.0
Karad,Mosambi,2015,4400,5400,1000,22.727272727272727
Kolhapur,BEET ROOT,2016,500,1500,1000,200.0
Kolhapur,Beet Root,2016,750,1750,1000,133.33333333333334
Rahuri,Capsicum,2015,1333,2333,1000,75.01875468867217
Ghansawangi,Green Gram,2014,5250,6250,1000,19.047619047619047
Ramtek,Ginger (Fresh),2016,3818,4818,1000,26.191723415400734
Ramtek,Ginger (Fresh),2016,4222,5222,1000,23.685457129322597
Ghansawangi,Green Gram,2015,6000,7000,1000,16.666666666666668
Karad,Custard Apple,2014,2750,3750,1000,36.36363636363637
Pune,Double Bee,2016,5000,6000,1000,20.0
Ratanagari,Green-Peas,2015,4000,5000,1000,25.0
Ratanagari,Green-Peas,2015,8000,9000,1000,12.5
Ramtek,Ginger (Fresh),2016,3778,4778,1000,26.469031233456857
Osmanabad,Tomato,2015,500,1500,1000,200.0
Sangali,Chillies(Red),2015,12000,13000,1000,8.333333333333334
Ramtek,Ginger (Fresh),2016,3875,4875,1000,25.806451612903224
Paranda,Sorgum(Jawar),2016,1468,2468,1000,68.11989100817439
Kolhapur,Capsicum,2016,415,1415,1000,240.96385542168676
Sangali,Coriander (Dry),2015,11000,12000,1000,9.090909090909092
Pune-Manjri,Kardai,2015,0,1000,1000,inf
Karad,Pavata,2014,4500,5500,1000,22.22222222222222
Ratanagari,Ginger (Fresh),2015,4375,5375,1000,22.857142857142858
Karad,Pomegranate,2014,2750,3750,1000,36.36363636363637
Anajngaon Surji,Chillies(Red),2015,9667,10667,1000,10.344470880314471
Anajngaon Surji,Chillies(Red),2015,8875,9875,1000,11.267605633802816
Mumbai,Grapes,2015,5000,6000,1000,20.0
Anajngaon Surji,Sesamum,2015,6000,7000,1000,16.666666666666668
Nagpur,Hemp,2015,1000,2000,1000,100.0
Anajngaon Surji,Chillies(Red),2016,7850,8850,1000,12.738853503184714
Kamthi,Kanda Pat,2015,1500,2500,1000,66.66666666666667
Vai,Brinjal,2014,4000,5000,1000,25.0
Alibag,Rice(Paddy-Hus),2016,3500,4500,1000,28.571428571428573
Bhokardan-Pimpalgaon Renu,Green Gram,2015,7000,8000,1000,14.285714285714286
Shrirampur,Pomegranate,2015,2500,3500,1000,40.0
Shrirampur,Pomegranate,2015,2500,3500,1000,40.0
Kalyan,Chandani,2015,6000,7000,1000,16.666666666666668
Kalyan,Chikoo,2015,2500,3500,1000,40.0
Shrirampur,Pomegranate,2015,3500,4500,1000,28.571428571428573
Shrirampur,Pomegranate,2015,2643,3643,1000,37.835792659856224
Shrirampur,Pomegranate,2015,3500,4500,1000,28.571428571428573
Kalyan,Cluster Bean,2015,1500,2500,1000,66.66666666666667
Akhadabalapur,Gram,2016,7500,8500,1000,13.333333333333334
Chandrapur-Ganjwad,Bitter Gourd,2016,2050,3050,1000,48.78048780487805
Chandrapur-Ganjwad,Pigen-Pea (Bhaji),2015,2000,3000,1000,50.0
Akhadabalapur,Turmeric,2016,9000,10000,1000,11.11111111111111
Kalyan,Green Chilli,2015,3000,4000,1000,33.333333333333336
Akhadabalapur,Turmeric,2016,8500,9500,1000,11.764705882352942
Shrirampur,Orange,2015,1000,2000,1000,100.0
Pune-Pimpri,Pavtta,2016,2000,3000,1000,50.0
Chandrapur-Ganjwad,Green-Peas,2015,2000,3000,1000,50.0
Kalyan,Green Gram,2015,7500,8500,1000,13.333333333333334
Pune-Pimpri,Pumpkin,2016,1000,2000,1000,100.0
Shrirampur,Mosambi,2015,2500,3500,1000,40.0
Kalyan,Guava,2015,2000,3000,1000,50.0
Kalyan,Guava,2015,3333,4333,1000,30.003000300030003
Pune-Manjri,Bottle Gourd,2016,1000,2000,1000,100.0
Kalyan,Gulchadi,2015,6000,7000,1000,16.666666666666668
Shrirampur,Mosambi,2015,2500,3500,1000,40.0
Kalyan,Bor,2015,2500,3500,1000,40.0
Chandrapur-Ganjwad,Coriander  ,2016,750,1750,1000,133.33333333333334
Nashik,Custard Apple,2014,800,1800,1000,125.0
Chandrapur-Ganjwad,Coriander  ,2016,1500,2500,1000,66.66666666666667
Pune-Pimpri,Ladies Finger,2014,2380,3380,1000,42.016806722689076
Pune-Pimpri,Capsicum,2016,4250,5250,1000,23.529411764705884
Yawal,Sesamum,2016,6000,7000,1000,16.666666666666668
Vadgaon Peth,Ghevda,2016,3000,4000,1000,33.333333333333336
Shrirampur,Bitter Gourd,2016,1500,2500,1000,66.66666666666667
Vadgaon Peth,Green-Peas,2015,2000,3000,1000,50.0
Sangli-Phale Bhajipalam,Ginger (Fresh),2015,3000,4000,1000,33.333333333333336
Chandrapur-Ganjwad,Wal Bhaji,2016,1500,2500,1000,66.66666666666667
Chandrapur-Ganjwad,Squash Gourd,2016,1333,2333,1000,75.01875468867217
Yawal,Green Gram,2016,4000,5000,1000,25.0
Chandrapur-Ganjwad,Spinach,2016,1000,2000,1000,100.0
Jalgaon,Custard Apple,2015,800,1800,1000,125.0
Chandrapur-Ganjwad,Math (Bhaji),2016,2000,3000,1000,50.0
Chandrapur-Ganjwad,Math (Bhaji),2016,2000,3000,1000,50.0
Vadgaon Peth,Green-Peas,2016,1500,2500,1000,66.66666666666667
Chandrapur-Ganjwad,Mango(Raw),2016,1000,2000,1000,100.0
Chandrapur-Ganjwad,MATH (BHAJI),2016,1750,2750,1000,57.142857142857146
Rahuri-Songaon,Capsicum,2016,2500,3500,1000,40.0
Chandrapur-Ganjwad,GINGER (FRESH),2016,2605,3605,1000,38.38771593090211
Yawal,Cotton,2016,4028,5028,1000,24.826216484607745
Chandrapur-Ganjwad,Dhemse,2016,1000,2000,1000,100.0
Chandrapur-Ganjwad,Custard Apple,2016,1000,2000,1000,100.0
Kalyan,Banana,2015,7000,8000,1000,14.285714285714286
Kada,SOYBEAN,2016,1717,2717,1000,58.241118229470004
Pune-Pimpri,Green-Peas,2016,5500,6500,1000,18.181818181818183
Kalyan,Jaggery,2015,3000,4000,1000,33.333333333333336
Kalyan,Kagda,2015,5000,6000,1000,20.0
Mahagaon,Pigeon Pea (Tur),2016,7000,8000,1000,14.285714285714286
Kalyan,Black Gram,2016,8000,9000,1000,12.5
Chandrapur,Onion,2016,500,1500,1000,200.0
Chandrapur,Mosambi,2016,3000,4000,1000,33.333333333333336
Mumbai,Spilt Gerrn Gram,2015,9000,10000,1000,11.11111111111111
Akluj,Carrot,2015,1000,2000,1000,100.0
Pune-Manjri,Goosefoot,2015,0,1000,1000,inf
Nashik-Devlali,Mint,2016,900,1900,1000,111.11111111111111
Chandrapur,Flower,2016,1500,2500,1000,66.66666666666667
Akluj,Chillies(Red),2015,1500,2500,1000,66.66666666666667
Akluj,Cluster Bean,2015,1500,2500,1000,66.66666666666667
Akluj,Garlic,2015,2923,3923,1000,34.21142661648991
Chandrapur,Chavli (Shenga ),2016,1000,2000,1000,100.0
Shrirampur,Ladies Finger,2015,2500,3500,1000,40.0
Shrirampur,Ladies Finger,2015,2500,3500,1000,40.0
Chandrapur,Cabbage,2016,1000,2000,1000,100.0
Kalyan,Chillies(Red),2016,4000,5000,1000,25.0
Kalyan,Chillies(Red),2016,6000,7000,1000,16.666666666666668
Indapur,Cowpea,2015,4006,5006,1000,24.962556165751373
Pune-Pimpri,Walvad,2016,1000,2000,1000,100.0
Akluj,Ladies Finger,2015,1868,2868,1000,53.53319057815846
Pune-Pimpri,Walvad,2016,3000,4000,1000,33.333333333333336
Chandrapur,Mosambi,2015,2250,3250,1000,44.44444444444444
Akluj,Shevga,2015,2175,3175,1000,45.97701149425287
Mumbai,Pomegranate,2015,7000,8000,1000,14.285714285714286
Mumbai,Pomegranate,2015,5521,6521,1000,18.112660749864155
Akluj,Tamarind,2015,2000,3000,1000,50.0
Mumbai,Spilt Gerrn Gram,2015,8823,9823,1000,11.33401337413578
Chandrapur,Papai,2016,500,1500,1000,200.0
Kalyan,Ladies Finger,2015,1500,2500,1000,66.66666666666667
Mumbai,Spilt Gerrn Gram,2015,8508,9508,1000,11.753643629525152
Chandrapur-Ganjwad,Capsicum,2015,1600,2600,1000,62.5
Shrirampur,Mosambi,2015,2389,3389,1000,41.85851820845542
Kalyan,Orange,2015,4000,5000,1000,25.0
Shrirampur,Mango(Raw),2015,2500,3500,1000,40.0
Pune-Pimpri,Squash Gourd,2016,4000,5000,1000,25.0
Pune-Pimpri,Squash Gourd,2016,4592,5592,1000,21.777003484320556
Kalyan,Small Gourd,2015,3000,4000,1000,33.333333333333336
Latur-Murud,Pigeon Pea (Tur),2016,7525,8525,1000,13.289036544850498
Pune-Pimpri,Tamarind,2016,3500,4500,1000,28.571428571428573
Akluj,Green-Peas,2014,2000,3000,1000,50.0
Akluj,Ground Nut Pods (Dry),2014,2000,3000,1000,50.0
Mumbai,Spilt Pigeon Pea,2015,7017,8017,1000,14.251104460595696
Kalyan,Zendu,2015,5000,6000,1000,20.0
Kalyan,Zendu,2015,3000,4000,1000,33.333333333333336
Ramtek,Zendu,2015,4500,5500,1000,22.22222222222222
Ramtek,Zendu,2015,2000,3000,1000,50.0
Kalyan,Aster,2016,7000,8000,1000,14.285714285714286
Chandrapur,Water Melon,2016,1000,2000,1000,100.0
Chandrapur,Tomato,2016,1500,2500,1000,66.66666666666667
Shrirampur,Lemon,2015,1500,2500,1000,66.66666666666667
Chandrapur,Squash Gourd,2016,1500,2500,1000,66.66666666666667
Shrirampur,Lemon,2015,2848,3848,1000,35.1123595505618
Indapur,Pigeon Pea (Tur),2015,7633,8633,1000,13.101008777675881
Kalyan,Bijli,2016,4286,5286,1000,23.33177788147457
Mumbai,Spilt Gerrn Gram,2015,8973,9973,1000,11.144544745347153
Mahagaon,Gram,2016,5000,6000,1000,20.0
Kada (Ashti),Green Gram,2014,5800,6800,1000,17.24137931034483
Kalyan,Gr.Nut Kernels,2016,8667,9667,1000,11.538017768547364
Mumbai-Fruit Market,Pitch,2016,5250,6250,1000,19.047619047619047
Pune,Double Bee,2014,4000,5000,1000,25.0
Shrirampur,Papai,2016,1000,2000,1000,100.0
Shrirampur,Mosambi,2016,2500,3500,1000,40.0
Ramtek,Bitter Gourd,2015,3000,4000,1000,33.333333333333336
Ramtek,Bitter Gourd,2015,2000,3000,1000,50.0
Deulgaon Raja,Pigeon Pea (Tur),2015,4500,5500,1000,22.22222222222222
Nashik,Onion,2015,200,1200,1000,500.0
Shrirampur,Mosambi,2016,2500,3500,1000,40.0
Shrirampur,Mosambi,2016,2500,3500,1000,40.0
Mumbai-Fruit Market,Jambhul,2016,7000,8000,1000,14.285714285714286
Manchar,Cluster Bean,2016,4500,5500,1000,22.22222222222222
Manchar,Farshi,2016,1250,2250,1000,80.0
Mumbai-Fruit Market,Jambhul,2016,7000,8000,1000,14.285714285714286
Pune-Pimpri,Ladies Finger,2015,1722,2722,1000,58.07200929152149
Shrirampur,Mango,2016,3786,4786,1000,26.413100898045432
Ramtek,Lemon,2015,1000,2000,1000,100.0
Vadgaon Peth,Bottle Gourd,2016,500,1500,1000,200.0
Shrirampur,Lemon,2016,1500,2500,1000,66.66666666666667
Shrirampur,Lemon,2016,1500,2500,1000,66.66666666666667
Manchar,Ghevda,2016,4000,5000,1000,25.0
Shrirampur,Ground Nut Pods (Dry),2016,3500,4500,1000,28.571428571428573
Shrirampur,Green-Peas,2016,4167,5167,1000,23.99808015358771
Shrirampur,Green Chilli,2016,3500,4500,1000,28.571428571428573
Nashik,Tomato,2015,500,1500,1000,200.0
Murbad,Bottle Gourd,2016,4000,5000,1000,25.0
Solapur,Cabbage,2016,769,1769,1000,130.03901170351105
Vai,Ridge Gourd,2016,4000,5000,1000,25.0
Shrirampur,Grapes,2016,2500,3500,1000,40.0
Shrirampur,Pomegranate,2016,2591,3591,1000,38.595137012736394
Ramtek,Garlic,2015,5000,6000,1000,20.0
Nashik,Dhemse,2015,2500,3500,1000,40.0
Ramtek,Ginger (Fresh),2015,4000,5000,1000,25.0
Ramtek,Ginger (Fresh),2015,4000,5000,1000,25.0
Ramtek,Ginger (Fresh),2015,4111,5111,1000,24.324981756263682
Ramtek,Dhemse,2015,2000,3000,1000,50.0
Vai,Curry Leaves,2016,2000,3000,1000,50.0
Ramtek,Dhemse,2015,2000,3000,1000,50.0
Ramtek,Custard Apple,2015,2000,3000,1000,50.0
Manchar,Green Chilli,2014,3000,4000,1000,33.333333333333336
Shrirampur,Shevga,2016,1500,2500,1000,66.66666666666667
Vai,Green-Peas,2016,5000,6000,1000,20.0
Vai,Ladies Finger,2016,3400,4400,1000,29.41176470588235
Nashik,Green-Peas,2015,4500,5500,1000,22.22222222222222
Manchar,Capsicum,2016,5000,6000,1000,20.0
Ramtek,Chillies(Red),2015,3000,4000,1000,33.333333333333336
Indapur-Bhigwan,Sesamum,2016,6051,7051,1000,16.526194017517767
Vai,Pavata,2016,6333,7333,1000,15.790304752881731
Shrirampur,Pomegranate,2016,2500,3500,1000,40.0
Shrirampur,Pomegranate,2016,3500,4500,1000,28.571428571428573
Vai,Pavtta,2016,7000,8000,1000,14.285714285714286
Vai,Pavtta,2016,4000,5000,1000,25.0
Shrirampur,Pomegranate,2016,3563,4563,1000,28.066236317709794
Shrirampur,Pomegranate,2016,2423,3423,1000,41.271151465125875
Ramtek,Capsicum,2015,2000,3000,1000,50.0
Pune,Wal Bhaji,2014,2124,3124,1000,47.080979284369114
Shrirampur,Grapes,2016,2500,3500,1000,40.0
Mahur,Black Gram,2015,5500,6500,1000,18.181818181818183
Ahmednagar,Brinjal,2016,450,1450,1000,222.22222222222223
Chikhali,Sesamum,2016,5100,6100,1000,19.607843137254903
Ahmednagar,GINGER (FRESH),2016,1000,2000,1000,100.0
Ahmednagar,Ghevda,2016,7667,8667,1000,13.04291117777488
Vadgaon Peth,Cluster Bean,2016,2250,3250,1000,44.44444444444444
Ahmednagar,Ginger (Fresh),2016,1192,2192,1000,83.89261744966443
Nashik,Green Chilli,2016,2994,3994,1000,33.4001336005344
Nashik,Green Chilli,2016,944,1944,1000,105.9322033898305
Ratanagari,Ladies Finger,2016,3395,4395,1000,29.455081001472752
Pune-Pimpri,Bitter Gourd,2016,3000,4000,1000,33.333333333333336
Ratanagari,Ladies Finger,2016,3611,4611,1000,27.693159789531986
Pune-Pimpri,Bitter Gourd,2016,3700,4700,1000,27.027027027027028
Nashik,Guava,2016,1500,2500,1000,66.66666666666667
Pune-Pimpri,Bitter Gourd,2016,3000,4000,1000,33.333333333333336
Ahmednagar,Mango(Raw),2016,1000,2000,1000,100.0
Ahmednagar,Mango(Raw),2016,1000,2000,1000,100.0
Jalgaon,Bor,2015,1500,2500,1000,66.66666666666667
Sangli-Phale Bhajipalam,Bor,2016,3500,4500,1000,28.571428571428573
Jalgaon,Chikoo,2015,1500,2500,1000,66.66666666666667
Shrirampur,Cluster Bean,2016,4750,5750,1000,21.05263157894737
Shrirampur,Chikoo,2016,1500,2500,1000,66.66666666666667
Dharmabad,Green Gram,2015,7000,8000,1000,14.285714285714286
Ratanagari,Green-Peas,2016,8800,9800,1000,11.363636363636363
Pune-Pimpri,Ridge Gourd,2014,3000,4000,1000,33.333333333333336
Ratanagari,Green-Peas,2016,9000,10000,1000,11.11111111111111
Mahur,Green Gram,2015,6000,7000,1000,16.666666666666668
Ahmednagar,Carrot,2016,2000,3000,1000,50.0
Murbad,Ghevda,2016,6388,7388,1000,15.654351909830932
Ahmednagar,Bitter Gourd,2015,1875,2875,1000,53.333333333333336
Ratanagari,Maize(Corn.),2016,5000,6000,1000,20.0
Jalgaon,Ginger (Fresh),2014,2642,3642,1000,37.85011355034065
Indapur-Bhigwan,Sorgum(Jawar),2015,1400,2400,1000,71.42857142857143
Ahmednagar,Bottle Gourd,2015,380,1380,1000,263.1578947368421
Pune-Pimpri,Shevga,2015,5000,6000,1000,20.0
Ahmednagar,Brinjal,2015,1033,2033,1000,96.8054211035818
Ahmednagar,Capsicum,2015,1000,2000,1000,100.0
Ahmednagar,Cucumber,2015,618,1618,1000,161.81229773462783
Ahmednagar,Ghevda,2015,1000,2000,1000,100.0
Ahmednagar,Ginger (Fresh),2015,2000,3000,1000,50.0
Ahmednagar,Horse Gram,2015,5000,6000,1000,20.0
Ahmednagar,Ladies Finger,2015,1300,2300,1000,76.92307692307692
Ramtek,Pigeon Pea (Tur),2015,2000,3000,1000,50.0
Vaijapur,Pigeon Pea (Tur),2015,8102,9102,1000,12.342631449024932
Pombhurni,Pigeon Pea (Tur),2016,8500,9500,1000,11.764705882352942
Shrirampur,Garlic,2016,3833,4833,1000,26.089225150013046
Shrirampur,Garlic,2016,5000,6000,1000,20.0
Shrirampur,Garlic,2016,3833,4833,1000,26.089225150013046
Ahmednagar,Pigeon Pea (Tur),2015,6000,7000,1000,16.666666666666668
Malegaon,Ground Nut Pods (Dry),2015,4001,5001,1000,24.993751562109473
Sangli-Phale Bhajipalam,Ginger (Fresh),2016,3000,4000,1000,33.333333333333336
Malegaon,Cowpea,2015,3000,4000,1000,33.333333333333336
Pune-Pimpri,Walvad,2015,2000,3000,1000,50.0
Murbad,Capsicum,2016,3000,4000,1000,33.333333333333336
Vadgaon Peth,Capsicum,2016,933,1933,1000,107.18113612004288
Ratanagari,Maize(Corn.),2016,4000,5000,1000,25.0
Chandrapur,Chikoo,2015,1500,2500,1000,66.66666666666667
Shrirampur,Shevga,2015,1500,2500,1000,66.66666666666667
Kamthi,Brinjal,2014,947,1947,1000,105.59662090813094
Vadgaon Peth,Carrot,2015,1000,2000,1000,100.0
Kalyan,Papai,2016,2000,3000,1000,50.0
Kalyan,Indian Bean,2016,4000,5000,1000,25.0
Shrirampur,Ginger (Fresh),2015,2500,3500,1000,40.0
Kamthi,Capsicum,2015,1720,2720,1000,58.13953488372093
Vadgaon Peth,Ghevda,2015,2000,3000,1000,50.0
Navapur,Coriander  ,2016,2875,3875,1000,34.78260869565217
Kalyan,Guava,2016,3000,4000,1000,33.333333333333336
Kamthi,Onion,2014,1500,2500,1000,66.66666666666667
Kalyan,Green-Peas,2016,7204,8204,1000,13.8811771238201
Chalisgaon,Pigeon Pea (Tur),2015,4500,5500,1000,22.22222222222222
Satara,Ground Nut Pods (Dry),2015,3500,4500,1000,28.571428571428573
Chalisgaon,Matki,2015,6500,7500,1000,15.384615384615385
Kamthi,Mosambi,2014,1500,2500,1000,66.66666666666667
Kamthi,Mosambi,2014,1040,2040,1000,96.15384615384616
Jalgaon,Chavli (Shenga ),2016,2475,3475,1000,40.4040404040404
Kalyan,Green Peas (Dry),2016,3000,4000,1000,33.333333333333336
Kalyan,Green Peas (Dry),2016,7000,8000,1000,14.285714285714286
Kalyan,Green Peas (Dry),2016,3200,4200,1000,31.25
Satara,Ground Nut Pods (Dry),2014,3000,4000,1000,33.333333333333336
Kalyan,Green Peas (Dry),2016,2500,3500,1000,40.0
Rahuri,Cucumber,2016,200,1200,1000,500.0
Kalyan,Mosambi,2016,6000,7000,1000,16.666666666666668
Murud,Rice(Paddy-Hus),2016,2667,3667,1000,37.49531308586427
Kalyan,Indian Bean,2016,4000,5000,1000,25.0
Kamthi,Onion,2014,1214,2214,1000,82.37232289950576
Ratanagari,FRENCH BEAN,2016,2000,3000,1000,50.0
Ratanagari,French Bean,2016,2000,3000,1000,50.0
Chalisgaon,Gram,2016,5000,6000,1000,20.0
Jalgaon,Shevga,2015,3000,4000,1000,33.333333333333336
Chalisgaon,Castor Seed,2016,2500,3500,1000,40.0
Pune,Chavli (Pala),2015,1000,2000,1000,100.0
Ratanagari,GREEN-PEAS,2016,6000,7000,1000,16.666666666666668
Ratanagari,GREEN CHILLI,2016,1500,2500,1000,66.66666666666667
Mangaon(Bhadav),Nagali,2015,1300,2300,1000,76.92307692307692
Dhule,Brinjal,2016,2000,3000,1000,50.0
Murud,RICE(PADDY-HUS),2016,2543,3543,1000,39.32363350373574
Shrirampur,Garlic,2015,4000,5000,1000,25.0
Dhule,Cluster Bean,2016,3000,4000,1000,33.333333333333336
Hingna,Pigeon Pea (Tur),2016,7350,8350,1000,13.605442176870747
Vaijapur,Pigeon Pea (Tur),2016,5000,6000,1000,20.0
Dhule,Coriander  ,2016,2000,3000,1000,50.0
Junnar-Otur,Garlic,2016,4000,5000,1000,25.0
Pathardi,BLACK GRAM,2016,5833,6833,1000,17.143836790673753
Chalisgaon,Black Gram,2016,9000,10000,1000,11.11111111111111
Shrirampur,Custard Apple,2015,1500,2500,1000,66.66666666666667
Shrirampur,Custard Apple,2015,2500,3500,1000,40.0
Shrirampur,Custard Apple,2015,1500,2500,1000,66.66666666666667
Lasur Station,Thymol/Lovage,2016,14150,15150,1000,7.067137809187279
Buldhana,Green Gram,2015,6500,7500,1000,15.384615384615385
Buldhana,Green Gram,2016,5000,6000,1000,20.0
Murud,Rice(Paddy-Hus),2016,2630,3630,1000,38.02281368821293
Kalyan,Gram,2016,4833,5833,1000,20.69108214359611
Alibag,Rice(Paddy-Hus),2015,3000,4000,1000,33.333333333333336
Kalyan,Zendu,2016,2000,3000,1000,50.0
Shrirampur,Garlic,2015,3500,4500,1000,28.571428571428573
Nandura,Sesamum,2015,7000,8000,1000,14.285714285714286
Alibag,Betelnuts,2016,1500,2500,1000,66.66666666666667
Alibag,Betelnuts,2016,1500,2500,1000,66.66666666666667
Alibag,Coconut,2016,2500,3500,1000,40.0
Ratanagari,Capsicum,2016,3042,4042,1000,32.87310979618672
Alibag,Rice(Paddy-Hus),2016,3500,4500,1000,28.571428571428573
Pathari,Pigeon Pea (Tur),2015,8000,9000,1000,12.5
Kamthi,Jack Fruit(Raw),2015,1500,2500,1000,66.66666666666667
Shrirampur,Garlic,2015,2500,3500,1000,40.0
Kalyan,Gram,2016,4500,5500,1000,22.22222222222222
Pune,Mango(Raw),2016,2250,3250,1000,44.44444444444444
Satara,Carrot,2015,1000,2000,1000,100.0
Ramtek,Capsicum,2016,5000,6000,1000,20.0
Alibag,Rice(Paddy-Hus),2016,3504,4504,1000,28.538812785388128
Alibag,Rice(Paddy-Hus),2016,3500,4500,1000,28.571428571428573
Vadgaon Peth,Cluster Bean,2015,1500,2500,1000,66.66666666666667
Alibag,Rice(Paddy-Hus),2016,3500,4500,1000,28.571428571428573
Alibag,Rice(Paddy-Hus),2016,3500,4500,1000,28.571428571428573
Alibag,Rice(Paddy-Hus),2016,3500,4500,1000,28.571428571428573
Kamthi,Chavli (Pala),2014,1132,2132,1000,88.33922261484099
Navapur,Pigen-Pea (Bhaji),2016,4000,5000,1000,25.0
Shrirampur,Garlic,2015,3500,4500,1000,28.571428571428573
Satara,Shevga,2014,4800,5800,1000,20.833333333333332
Solapur,Guava,2016,1500,2500,1000,66.66666666666667
Murud,Rice(Paddy-Hus),2016,2587,3587,1000,38.654812524159254
Akole,Gram,2015,3400,4400,1000,29.41176470588235
Shrirampur,Green Chilli,2015,3417,4417,1000,29.2654375182909
Pune-Moshi,Snake Gourd,2016,2333,3333,1000,42.86326618088298
Satara,Pavtta,2015,5273,6273,1000,18.96453631708705
Kalyan,Green Gram,2016,5833,6833,1000,17.143836790673753
Kalyan,Green Gram,2016,7000,8000,1000,14.285714285714286
Akole,Bhagar/Vari,2014,2000,3000,1000,50.0
Kalyan,Squash Gourd,2016,5000,6000,1000,20.0
Lasalgaon,Green Gram,2015,5826,6826,1000,17.164435290078956
Kalyan,Squash Gourd,2016,5000,6000,1000,20.0
Ramtek,Capsicum,2016,3000,4000,1000,33.333333333333336
Kalyan,Squash Gourd,2016,5000,6000,1000,20.0
Kamthi,Dhemse,2015,1250,2250,1000,80.0
Jalgaon,Grapes,2016,2500,3500,1000,40.0
Pune-Moshi,Small Gourd,2016,1250,2250,1000,80.0
Akluj,Bor,2016,1000,2000,1000,100.0
Kalyan,Grapes,2016,4250,5250,1000,23.529411764705884
Ulhasnagar,Sorgum(Jawar),2016,1842,2841,999,54.23452768729641
Kalamb (Os),Gram,2015,3414,4413,999,29.261862917398947
Kille Dharur,Coriander (Dry),2016,5001,6000,999,19.976004799040194
Phaltan,Sorgum(Jawar),2015,1570,2569,999,63.63057324840764
Barshi,Sorgum(Jawar),2016,1719,2718,999,58.1151832460733
Palghar(Bevur),Rice(Paddy-Hus),2015,2318,3316,998,43.05435720448663
Solapur,Tomato,2015,150,1148,998,665.3333333333334
Latur,Black Gram,2015,6704,7702,998,14.886634844868736
Jalna,GREEN GRAM,2016,4232,5230,998,23.582230623818525
Nandgaon Khandeshwar,Soybean,2016,2746,3744,998,36.343772760378734
Risod,Pigeon Pea (Tur),2015,9019,10017,998,11.065528329083048
Solapur,Tomato,2014,141,1139,998,707.8014184397163
Chandur Rly.,Pigeon Pea (Tur),2015,10945,11942,997,9.10918227501142
Varora,Pigeon Pea (Tur),2016,6935,7932,997,14.37635183850036
Pune-Manjri,Onion,2015,312,1309,997,319.55128205128204
Katol,Ground Nut Pods (Dry),2016,4700,5697,997,21.21276595744681
Junnar-Otur,Cucumber,2016,423,1420,997,235.69739952718678
Mumbai,Pomegranate,2015,5515,6512,997,18.077969174977333
Akot,Green Gram,2016,4176,5173,997,23.874521072796934
Kalamb (Os),Wheat(Husked),2016,2684,3680,996,37.108792846497764
Mumbai,Jaggery,2016,2533,3529,996,39.320963284642716
Mumbai,Orange,2016,506,1502,996,196.83794466403162
Barshi,Sorgum(Jawar),2015,1657,2653,996,60.10863005431503
Nandgaon Khandeshwar,Soybean,2016,2672,3668,996,37.275449101796404
Dudhani,Pigeon Pea (Tur),2015,4692,5688,996,21.22762148337596
Rahata,Cucumber,2016,2067,3063,996,48.18577648766328
Sangrampur-Varvatbakal,Gram,2015,2836,3832,996,35.119887165021154
Hinganghat,Soybean,2015,3015,4011,996,33.03482587064676
Bhivandi,Rice(Paddy-Hus),2014,1413,2408,995,70.41755130927105
Mumbai,Jaggery,2016,2924,3919,995,34.02872777017784
Aurangabad,Tomato,2015,1224,2219,995,81.29084967320262
Mangalwedha,Tomato,2016,224,1219,995,444.19642857142856
Pune,Bitter Gourd,2015,1916,2911,995,51.931106471816285
Jamkhed,Sorgum(Jawar),2015,1603,2598,995,62.071116656269496
Akola,Black Gram,2015,7786,8781,995,12.779347546879013
Vasai,Wheat(Husked),2016,1510,2505,995,65.89403973509934
Karmala,Sorgum(Jawar),2016,1622,2617,995,61.34401972872996
Pune,BLACK GRAM,2016,7600,8595,995,13.092105263157896
Nandgaon Khandeshwar,Pigeon Pea (Tur),2016,8022,9017,995,12.403390675641985
Indapur,Sorgum(Jawar),2015,1558,2553,995,63.86392811296534
Pune-Manjri,Walvad,2015,2463,3458,995,40.39788875355258
Dondaicha,Chillies(Red),2016,2322,3317,995,42.85099052540913
Sakri,Ground Nut Pods (Dry),2014,2868,3863,995,34.693165969316595
Pune,Rice(Paddy-Hus),2015,4388,5383,995,22.675478577939835
Akluj,Brinjal,2016,1424,2418,994,69.80337078651685
Shahada,Green Gram,2015,7195,8189,994,13.815149409312022
Nashik,Squash Gourd,2014,826,1820,994,120.33898305084746
Daryapur,Green Gram,2016,3471,4465,994,28.637280322673583
Amarawati,Pigeon Pea (Tur),2015,10797,11791,994,9.206260998425488
Nampur,Gram,2016,7066,8060,994,14.067364845740164
Indapur,Gram,2015,2815,3809,994,35.31083481349911
Nashik,Bottle Gourd,2016,1210,2204,994,82.14876033057851
Umarga,Sesamum,2014,8685,9679,994,11.445020149683362
Jalgaon,Lemon,2014,2150,3144,994,46.23255813953488
Mumbai,Melon,2016,866,1860,994,114.78060046189377
Pune-Manjri,Spinach,2014,1031,2025,994,96.41125121241514
Osmanabad,Bor,2016,553,1547,994,179.74683544303798
Sindi,Pigeon Pea (Tur),2015,5604,6597,993,17.719486081370448
Bhivandi,Onion,2014,1526,2519,993,65.07208387942333
Nandgaon Khandeshwar,Chino,2016,3056,4049,993,32.4934554973822
Kamthi,Cabbage,2016,1145,2138,993,86.72489082969432
Amarawati,Dhemse,2016,1700,2693,993,58.411764705882355
Nagpur,Onion,2014,881,1874,993,112.71282633371169
Phaltan,Green-Peas,2016,3938,4931,993,25.21584560690706
Malegaon,Ground Nut Pods (Dry),2016,4062,5055,993,24.446085672082717
Mumbai,Pomegranate,2015,6838,7831,993,14.521789997075167
Lasalgaon,Rice(Paddy-Hus),2015,1707,2700,993,58.17223198594024
Phaltan,Sorgum(Jawar),2016,1570,2563,993,63.2484076433121
Mangalwedha,Tomato,2014,244,1237,993,406.9672131147541
Karanja,Gram,2016,5915,6908,993,16.787827557058325
Solapur,Chikoo,2015,623,1615,992,159.22953451043338
Sangamner,Onion,2016,304,1296,992,326.3157894736842
Morshi,Pigeon Pea (Tur),2015,9508,10500,992,10.43331931005469
Osmanabad,Bottle Gourd,2016,1158,2150,992,85.66493955094991
Nagpur,Chikoo,2015,996,1988,992,99.59839357429719
Shrirampur,Gram,2014,2127,3119,992,46.638457921955805
Shirpur,Onion,2015,297,1289,992,334.006734006734
Sindi (Selu),Cotton,2016,3739,4731,992,26.531158063653383
Mumbai,Jaggery,2015,2517,3509,992,39.41199841080652
Pune,Snake Gourd,2016,900,1892,992,110.22222222222223
Pathardi,Gram,2016,3683,4675,992,26.934564213956016
Kalamb (Os),Pigeon Pea (Tur),2015,4943,5935,992,20.06878413918673
Barshi-Vairag,Sorgum(Jawar),2015,1188,2180,992,83.5016835016835
Dondaicha,Chillies(Red),2014,1958,2950,992,50.66394279877426
Rahata,Brinjal,2015,1146,2138,992,86.56195462478185
Daryapur,Pigeon Pea (Tur),2015,6188,7180,992,16.031027795733678
Mumbai,Brinjal,2015,576,1568,992,172.22222222222223
Majalgaon,Pigeon Pea (Tur),2016,5286,6277,991,18.74763526295876
Nandgaon Khandeshwar,Chino,2016,4663,5654,991,21.252412609907786
Pune,Capsicum,2016,1342,2333,991,73.84500745156483
Buldhana,Pigeon Pea (Tur),2016,7542,8533,991,13.139750729249537
Kurdwadi-Modnimb,Sorgum(Jawar),2016,1445,2436,991,68.58131487889273
Kurdwadi-Modnimb,Gram,2016,3053,4044,991,32.45987553226335
Jamkhed,Sorgum(Jawar),2015,1806,2797,991,54.87264673311185
Pune-Pimpri,Brinjal,2015,1948,2939,991,50.87268993839836
Pune,Pumpkin,2016,1000,1991,991,99.1
Nashik,Ladies Finger,2016,1408,2399,991,70.38352272727273
Pimpalgaon Basawant,ONION,2016,240,1231,991,412.9166666666667
Pathardi,Onion,2016,204,1195,991,485.7843137254902
Kada,Sorgum(Jawar),2016,1639,2629,990,60.40268456375839
Ahmednagar,Bottle Gourd,2016,348,1338,990,284.48275862068965
Junnar-Otur,FARSHI,2016,918,1908,990,107.84313725490196
Sailu,Green Gram,2015,7694,8684,990,12.86716922277099
Pune,Chavli (Shenga ),2014,925,1915,990,107.02702702702703
Pune-Moshi,LADIES FINGER,2016,2023,3013,990,48.93722194760257
Aurangabad,Chikoo,2016,1290,2280,990,76.74418604651163
Akot,Pigeon Pea (Tur),2016,7266,8256,990,13.625103220478943
Palghar(Bevur),Rice(Paddy-Hus),2015,2257,3247,990,43.86353566681436
Karanja,Ground Nut Pods (Dry),2016,5007,5997,990,19.772318753744756
Kalamb (Os),Sesamum,2016,4639,5628,989,21.319249838327227
Kolhapur,Kanda Pat,2015,2590,3579,989,38.18532818532819
Solapur,Wheat(Husked),2015,1736,2725,989,56.97004608294931
Chandrapur,Banana,2015,700,1689,989,141.28571428571428
Aurangabad,Lemon,2015,2528,3517,989,39.12183544303797
Pune-Manjri,Spinach,2016,1211,2200,989,81.66804293971924
Shegaon,Pigeon Pea (Tur),2016,8025,9014,989,12.32398753894081
Vadgaon Peth,Cucumber,2016,1122,2111,989,88.14616755793226
Akluj,Bitter Gourd,2015,2139,3128,989,46.236559139784944
Nilanga,Pigeon Pea (Tur),2014,3990,4978,988,24.761904761904763
Nashik,Tomato,2014,682,1670,988,144.86803519061584
Bhivandi,Onion,2014,1500,2488,988,65.86666666666666
Taloda,Gram,2015,2894,3882,988,34.139599170698
Nira-Saswad,Gram,2016,6075,7063,988,16.263374485596707
Nandgaon Khandeshwar,Pigeon Pea (Tur),2016,7743,8731,988,12.75991217874209
Nashik,Cucumber,2016,1368,2356,988,72.22222222222223
Devala,Onion,2014,597,1585,988,165.49413735343384
Kolhapur,Bor,2015,1075,2063,988,91.90697674418605
Pune,Wal Papdi,2015,1771,2759,988,55.78769057029927
Kurdwadi,Sorgum(Jawar),2016,1342,2330,988,73.62146050670641
Khed-Chakan,Green Chilli,2016,2658,3646,988,37.17080511662905
Mohol,Sorgum(Jawar),2015,1565,2553,988,63.13099041533546
Sangali,Jaggery,2015,2156,3144,988,45.82560296846011
Pune,Tomato,2015,656,1644,988,150.609756097561
Pune-Manjri,Kanda Pat,2015,900,1888,988,109.77777777777777
Pune,Green Peas (Dry),2016,3565,4553,988,27.713884992987378
Shirpur,Onion,2016,242,1230,988,408.26446280991735
Nashik,Ginger (Fresh),2016,2748,3735,987,35.917030567685586
Pune,Wal Bhaji,2015,1295,2282,987,76.21621621621621
Khed-Chakan,Green-Peas,2016,4000,4987,987,24.675
Nandura,Green Gram,2015,6851,7838,987,14.406655962633192
Kurdwadi,Sorgum(Jawar),2015,932,1919,987,105.90128755364807
Ulhasnagar,Bajri,2016,1967,2954,987,50.1779359430605
Pune,Green Peas (Dry),2016,3423,4410,987,28.834355828220858
Umared,Pigeon Pea (Tur),2015,5957,6944,987,16.56874265569918
Kalamb (Os),Wheat(Husked),2015,2191,3178,987,45.04792332268371
Nashik,Bor,2014,838,1825,987,117.78042959427208
Barshi-Vairag,Black Gram,2014,4205,5192,987,23.472057074910822
Nashik,Green Chilli,2014,1563,2550,987,63.14779270633397
Pune,Green Gram,2015,7238,8225,987,13.636363636363637
Kej,Coriander (Dry),2016,5455,6441,986,18.075160403299726
Pune-Manjri,Kardai,2015,43,1029,986,2293.0232558139537
Nashik,Wal Papdi,2015,1497,2483,986,65.86506346025384
Mangaon(Bhadav),Nagali,2016,1400,2386,986,70.42857142857143
Hinganghat,Pigeon Pea (Tur),2016,7939,8925,986,12.419700214132762
Akola,Pigeon Pea (Tur),2015,6387,7373,986,15.437607640519806
Ahmednagar,Black Gram,2015,8100,9086,986,12.17283950617284
Mangaon(Bhadav),Nagali,2016,1343,2329,986,73.41772151898734
Pune-Manjri,Goosefoot,2015,0,986,986,inf
Chandvad,Tomato,2016,600,1586,986,164.33333333333334
Kamthi,Brinjal,2015,848,1834,986,116.27358490566037
Shirpur,Green Gram,2015,6769,7755,986,14.566405672920668
Chandur Bajar,Gram,2016,5725,6711,986,17.222707423580786
Nilanga,Gram,2016,6675,7661,986,14.771535580524345
Pune-Pimpri,Green-Peas,2016,4143,5129,986,23.799179338643494
Malegaon,Pigeon Pea (Tur),2015,6263,7248,985,15.727287242535526
Nagpur,Potato,2016,770,1755,985,127.92207792207792
Vadgaon Peth,Bitter Gourd,2016,1510,2495,985,65.23178807947019
Akluj,Shevga,2015,1992,2977,985,49.44779116465863
Akluj,BOR,2016,1415,2400,985,69.6113074204947
Mehkar,Gram,2015,4046,5031,985,24.34503213049926
Pandharpur,Cucumber,2015,600,1585,985,164.16666666666666
Lasalgaon-Vinchur,Gram,2016,5238,6223,985,18.804887361588392
Kada (Ashti),Sorgum(Jawar),2015,1565,2550,985,62.93929712460064
Nashik,Flower,2014,792,1777,985,124.36868686868686
Ahmedpur,PIGEON PEA (TUR),2016,4336,5321,985,22.71678966789668
Vadgaon Peth,Bitter Gourd,2014,1634,2619,985,60.28151774785802
Ahmedpur,Gram,2016,5204,6189,985,18.927747886241352
Pune-Manjri,Chavli (Shenga ),2016,1369,2354,985,71.95032870708546
Pune,Ghosali(Bhaji),2016,2350,3335,985,41.91489361702128
Washim,Pigeon Pea (Tur),2016,8193,9178,985,12.022458196020994
Mangaon(Bhadav),Nagali,2016,1469,2454,985,67.05241660993873
Kalyan,SMALL GOURD,2016,1908,2892,984,51.57232704402516
Mumbai,Brinjal,2016,564,1548,984,174.46808510638297
Kalyan,Custard Apple,2016,4583,5567,984,21.470652411084444
Pune-Manjri,Cabbage,2016,433,1417,984,227.25173210161662
Ahmednagar,Carrot,2016,1133,2117,984,86.84907325684024
Babhulgaon,Pigeon Pea (Tur),2015,6320,7304,984,15.569620253164556
Nagpur,Coriander  ,2016,2833,3817,984,34.73349805859513
Pandharpur,Brinjal,2015,466,1450,984,211.1587982832618
Mangalwedha,Ladies Finger,2016,340,1324,984,289.4117647058824
Khed (Shel Pimpalgaon),Cluster Bean,2016,1466,2450,984,67.12141882673943
Junnar (Narayangaon),Tomato,2015,1677,2661,984,58.67620751341681
Morshi,GRAM,2016,7833,8817,984,12.562236690923019
Pune,Bottle Gourd,2014,588,1572,984,167.3469387755102
Kalvan,Wheat(Husked),2015,1471,2455,984,66.89326988443236
Khed-Chakan,SHEVGA,2016,3456,4440,984,28.47222222222222
Chikhali,Black Gram,2015,4759,5742,983,20.655599915948727
Aurangabad,Onion,2015,630,1613,983,156.03174603174602
Kolhapur-Laxmipuri,Wheat(Husked),2015,1867,2850,983,52.651312265666846
Akluj,Ground Nut Pods (Dry),2015,3375,4358,983,29.125925925925927
Dound,Cowpea,2015,5410,6393,983,18.170055452865064
Palghar(Bevur),Rice(Paddy-Hus),2015,2288,3271,983,42.96328671328671
Katol,Pigeon Pea (Tur),2016,6654,7637,983,14.77306883077848
Pune-Manjri,Onion,2015,317,1300,983,310.09463722397476
Pimpalgaon Basawant,Onion,2015,636,1619,983,154.55974842767296
Satara,Cucumber,2016,1917,2900,983,51.27803860198227
Junnar-Otur,Flower,2016,788,1770,982,124.61928934010152
Pune,Bottle Gourd,2015,773,1755,982,127.03751617076325
Pune,Curry Leaves,2015,1459,2441,982,67.30637422892391
Kurdwadi-Modnimb,Sorgum(Jawar),2015,1266,2248,982,77.56714060031595
Mumbai-Fruit Market,Papai,2016,636,1618,982,154.40251572327045
Sangali,GRAM,2016,7606,8588,982,12.910859847488824
Akluj,Bitter Gourd,2014,2818,3800,982,34.84740951029099
Sangrampur,Gram,2015,2000,2982,982,49.1
Pune-Manjri,SQUASH GOURD,2016,1954,2936,982,50.255885363357216
Umared,Pigeon Pea (Tur),2016,6688,7670,982,14.683014354066986
Chikhali,Green Gram,2016,4318,5300,982,22.742010189902732
Vai,Ginger (Fresh),2014,5000,5981,981,19.62
Satara,Green Chilli,2016,5077,6058,981,19.32243450856805
Raver,Green Gram,2016,5456,6437,981,17.980205278592376
Murud,Rice(Paddy-Hus),2016,2538,3519,981,38.652482269503544
Nashik,Papai,2016,944,1925,981,103.91949152542372
Junnar-Otur,Onion,2014,1663,2644,981,58.98977751052315
Khed-Chakan,Tomato,2016,4192,5173,981,23.40171755725191
Shrirampur,Grapes,2016,2500,3481,981,39.24
Khed-Chakan,CLUSTER BEAN,2016,2900,3880,980,33.793103448275865
Aurangabad,Wal Bhaji,2016,3020,4000,980,32.450331125827816
Jalgaon,Onion,2015,656,1636,980,149.390243902439
Palus,Ladies Finger,2016,2140,3120,980,45.794392523364486
Pune,Onion,2015,690,1670,980,142.02898550724638
Kolhapur,Carrot,2016,624,1604,980,157.05128205128204
Vadgaon Peth,Flower,2015,850,1830,980,115.29411764705883
Pune-Manjri,HARBARA(BHAJI),2016,3700,4680,980,26.486486486486488
Khed-Chakan,Squash Gourd,2016,2380,3360,980,41.1764705882353
Pune-Manjri,Chavli (Shenga ),2015,983,1963,980,99.69481180061038
Shrirampur,Mango,2015,3083,4063,980,31.78722024002595
Kolhapur,Flower,2015,294,1274,980,333.3333333333333
Pune-Manjri,Spinach,2016,658,1638,980,148.93617021276594
Aurangabad,Shevga,2014,3870,4850,980,25.322997416020673
Kolhapur,Papai,2015,303,1283,980,323.4323432343234
Karad,Jaggery,2016,3000,3980,980,32.666666666666664
Pimpalgaon Basawant,Onion,2015,469,1449,980,208.955223880597
Solapur,Bor,2015,681,1661,980,143.90602055800295
Indapur,Wheat(Husked),2015,1492,2471,979,65.61662198391421
Pandharpur,Onion,2016,141,1120,979,694.3262411347517
Malegaon,Pigeon Pea (Tur),2015,4693,5672,979,20.860856594928617
Kalamb (Os),Gram,2016,5390,6369,979,18.163265306122447
Chikhali,Gram,2016,4550,5529,979,21.516483516483518
Pune,Carrot,2015,863,1842,979,113.441483198146
Akluj,Chillies(Red),2014,2507,3486,979,39.05065815715995
Junnar (Narayangaon),Tomato,2015,2125,3104,979,46.07058823529412
Pathari,Wheat(Husked),2016,1154,2133,979,84.83535528596187
Pune-Manjri,Kanda Pat,2016,861,1839,978,113.58885017421603
Mumbai,Jaggery,2015,2482,3460,978,39.40370668815471
Karanja,Pigeon Pea (Tur),2016,8328,9306,978,11.743515850144092
Rahata,Cucumber,2015,500,1478,978,195.6
Barshi,Tomato,2016,1467,2445,978,66.66666666666667
Shrirampur,Lemon,2016,2761,3739,978,35.421948569358925
Kolhapur,Guava,2015,689,1667,978,141.94484760522496
Shrirampur,Grapes,2015,2761,3739,978,35.421948569358925
Shrirampur,Ladies Finger,2015,2565,3543,978,38.12865497076023
Ratanagari,Ladies Finger,2016,2136,3114,978,45.78651685393258
Shrirampur,Grapes,2015,3045,4023,978,32.118226600985224
Chandrapur,Banana,2014,698,1676,978,140.11461318051576
Amarawati,Orange,2016,1846,2823,977,52.92524377031419
Satara,Green-Peas,2016,7000,7977,977,13.957142857142857
Sangrampur,Green Gram,2015,5253,6230,977,18.598895869027224
Chandrapur,Banana,2016,1118,2095,977,87.3881932021467
Murbad,Bitter Gourd,2016,3841,4818,977,25.436084353033063
Ratanagari,Brinjal,2015,1841,2818,977,53.068984247691475
Kille Dharur,Green Gram,2014,5851,6828,977,16.69800034182191
Ramtek,Coriander  ,2016,3071,4048,977,31.81374145229567
Latur-Murud,Gram,2015,3071,4048,977,31.81374145229567
Khamgaon,Ground Nut Pods (Dry),2015,4388,5365,977,22.265268915223338
Shrirampur,Cluster Bean,2016,3571,4548,977,27.359283113973678
Solapur,Green Chilli,2016,2214,3191,977,44.128274616079494
Nandgaon,Onion,2014,778,1755,977,125.57840616966581
Varud-Rajura Bazar,Gram,2015,2639,3616,977,37.02159909056461
Anajngaon Surji,Pigeon Pea (Tur),2015,6243,7220,977,15.649527470767259
Kamthi,Green Chilli,2016,1043,2020,977,93.67209971236817
Jalna,Sorgum(Jawar),2015,1234,2210,976,79.09238249594813
Pune-Moshi,GARLIC,2016,8143,9119,976,11.98575463588358
Satara,Green-Peas,2015,4881,5857,976,19.995902479000204
Osmanabad,Onion,2015,887,1863,976,110.03382187147689
Vai,Green Chilli,2016,5767,6743,976,16.92387723252991
Kamthi,Lemon,2016,943,1919,976,103.49946977730647
Karad,Mosambi,2016,5857,6833,976,16.663821068806556
Phaltan,Sorgum(Jawar),2015,1550,2526,976,62.96774193548387
Indapur-Bhigwan,Sorgum(Jawar),2015,1300,2276,976,75.07692307692308
Shirpur,Pigeon Pea (Tur),2016,6380,7356,976,15.297805642633229
Aurangabad,Ground Nut Pods (Dry),2015,2262,3238,976,43.14765694076039
Vai,Green Chilli,2016,5154,6129,975,18.917345750873107
Indapur-Bhigwan,Pigeon Pea (Tur),2016,6188,7163,975,15.756302521008404
Ramtek,Green Chilli,2016,2345,3320,975,41.57782515991471
Akkolkot,Gram,2014,2201,3176,975,44.29804634257156
Akluj,Bitter Gourd,2015,2125,3100,975,45.88235294117647
Shrirampur,Lemon,2015,1500,2475,975,65.0
Kalyan,Green Peas (Dry),2015,2975,3950,975,32.773109243697476
Vadgaon Peth,RIDGE GOURD,2016,1200,2175,975,81.25
Bhivandi,Rice(Paddy-Hus),2016,2287,3262,975,42.63226934849148
Malegaon,Onion,2014,389,1364,975,250.6426735218509
Pune-Manjri,Hemp,2015,0,975,975,inf
Murbad,Tomato,2016,5375,6350,975,18.13953488372093
Karjat (A- Nagar),Sorgum(Jawar),2016,1800,2775,975,54.166666666666664
Satara,Cluster Bean,2016,5050,6025,975,19.306930693069308
Shrirampur,Pomegranate,2015,3000,3975,975,32.5
Barshi,Gram,2015,3458,4433,975,28.195488721804512
Shrirampur,Tomato,2015,2025,3000,975,48.148148148148145
Kada,Pigeon Pea (Tur),2016,7315,8290,975,13.328776486671224
Shrigonda,Gram,2016,5300,6275,975,18.39622641509434
Sangali,Wheat(Husked),2016,1829,2804,975,53.30781848004374
Pune-Manjri,Spinach,2015,600,1575,975,162.5
Jalgaon Jamod,Pigeon Pea (Tur),2016,7950,8925,975,12.264150943396226
Chandrapur-Ganjwad,CHAVLI (SHENGA ),2016,950,1925,975,102.63157894736842
Mumbai,Onion,2014,1450,2425,975,67.24137931034483
Pune-Manjri,Harbara(Pendi),2015,225,1200,975,433.3333333333333
Indapur-Bhigwan,Wheat(Husked),2015,1375,2350,975,70.9090909090909
Sangali,Sorgum(Jawar),2015,1585,2560,975,61.51419558359621
Akot,Sesamum,2016,5075,6050,975,19.211822660098523
Jalgaon,Orange,2016,1025,2000,975,95.1219512195122
Khed-Chakan,Shevga,2015,4606,5581,975,21.16804168475901
Chandrapur-Ganjwad,Capsicum,2016,2025,3000,975,48.148148148148145
Akhadabalapur,Green Gram,2015,6100,7074,974,15.967213114754099
Aurangabad,Lemon,2016,2026,3000,974,48.07502467917078
Malegaon,Gram,2014,2110,3084,974,46.161137440758296
Khamgaon,Soybean,2016,2077,3051,974,46.89455946076071
Dondaicha,Gram,2015,3091,4065,974,31.510837916531866
Khed-Chakan,Walvad,2016,2789,3763,974,34.92291143779132
Shrirampur,Pomegranate,2015,2447,3421,974,39.803841438496114
Shrirampur,Lemon,2015,1763,2737,974,55.246738513896766
Pune,Walvad,2016,1391,2365,974,70.0215672178289
Shirpur,Gram,2015,3309,4283,974,29.434874584466606
Shahada,Pigeon Pea (Tur),2016,5992,6966,974,16.255006675567422
Malkapur,Gram,2016,5666,6640,974,17.190257677373808
Pune-Pimpri,Brinjal,2016,3037,4011,974,32.071122818570956
Kurdwadi,Sorgum(Jawar),2015,1112,2086,974,87.58992805755396
Barshi,Turmeric,2015,6439,7413,974,15.126572449138065
Latur,Pigeon Pea (Tur),2014,4209,5183,974,23.14088857210739
Barshi-Vairag,Sorgum(Jawar),2015,1159,2132,973,83.95168248490077
Kille Dharur,Pigeon Pea (Tur),2015,4778,5751,973,20.364169108413563
Kamthi,Mint,2016,1058,2031,973,91.96597353497164
Kolhapur,Bottle Gourd,2016,515,1488,973,188.93203883495147
Shrirampur,Lemon,2016,1583,2556,973,61.465571699305116
Jalgaon,Ginger (Fresh),2016,1595,2568,973,61.00313479623824
Indapur,Wheat(Husked),2015,1531,2504,973,63.5532331809275
Palus,Tomato,2016,990,1963,973,98.28282828282828
Shahada,Gram,2015,2489,3462,973,39.09200482121334
Buldhana,Gram,2016,8409,9382,973,11.57093590200975
Mehkar,Black Gram,2016,8051,9024,973,12.085455222953671
Pune-Manjri,Walvad,2015,2395,3368,973,40.626304801670145
Dhule,Green Gram,2015,6108,7080,972,15.913555992141454
Akola,Pigeon Pea (Tur),2016,7972,8944,972,12.192674360260913
Sangali,Wheat(Unhusked),2015,2964,3936,972,32.79352226720648
Vadgaon Peth,Tomato,2015,955,1927,972,101.78010471204189
Umarga,Green Gram,2016,4077,5049,972,23.841059602649008
Shrirampur,Cluster Bean,2016,3528,4500,972,27.551020408163264
Mangalwedha,Wheat(Husked),2015,1406,2378,972,69.13229018492176
Ratanagari,LADIES FINGER,2016,1917,2889,972,50.70422535211268
Pune,Rice(Paddy-Hus),2016,4794,5766,972,20.275344180225282
Solapur,Guava,2014,1114,2086,972,87.25314183123878
Osmanabad,Tomato,2015,700,1672,972,138.85714285714286
Kamthi,Brinjal,2016,533,1504,971,182.1763602251407
Sakri,Ground Nut Pods (Dry),2016,3918,4889,971,24.78305257784584
Ratanagari,Flower,2016,2529,3500,971,38.3946223803875
Hingoli,Turmeric,2014,4970,5941,971,19.537223340040242
Osmanabad,Sorgum(Jawar),2014,1442,2413,971,67.3370319001387
Pune,Walvad,2015,2235,3206,971,43.44519015659955
Jalna,Green Gram,2015,7005,7976,971,13.861527480371164
Anajngaon Surji,Pigeon Pea (Tur),2015,4800,5771,971,20.229166666666668
Sangali,Sorgum(Jawar),2016,1702,2673,971,57.050528789659225
Ausa,Wheat(Husked),2015,1834,2805,971,52.9443838604144
Shrirampur,Pomegranate,2016,2441,3412,971,39.77877918885702
Kamthi,Cabbage,2015,725,1696,971,133.93103448275863
Pune-Moshi,Bottle Gourd,2016,920,1890,970,105.43478260869566
Shrirampur,Grapes,2015,2618,3588,970,37.05118411000764
Dudhani,Pigeon Pea (Tur),2016,8086,9056,970,11.996042542666338
Mangrulpeer,Pigeon Pea (Tur),2015,10567,11537,970,9.179521150752342
Ausa,Gram,2016,3574,4544,970,27.140458869613877
Amarawati,Lemon,2016,2000,2969,969,48.45
Kurdwadi-Modnimb,SORGUM(JAWAR),2016,1661,2630,969,58.33835039133052
Nagpur,Orange,2015,448,1417,969,216.29464285714286
Chandrapur,Papai,2014,954,1923,969,101.57232704402516
Kalamb (Os),Gram,2015,2601,3570,969,37.254901960784316
Aurangabad,Cluster Bean,2016,2574,3543,969,37.645687645687644
Kurdwadi,Gram,2016,6469,7438,969,14.979131241304684
Pune-Manjri,Methi (Bhaji),2014,485,1454,969,199.79381443298968
Jalgaon,Chavli (Shenga ),2015,2268,3236,968,42.68077601410935
Mumbai,SPLIT GRAM,2016,11656,12624,968,8.304735758407688
Akola,Gram,2016,5660,6628,968,17.102473498233216
Pune,Chavli (Shenga ),2016,1714,2682,968,56.47607934655776
Ausa,Wheat(Husked),2016,1834,2802,968,52.780806979280264
Indapur-Bhigwan,Sorgum(Jawar),2015,1565,2533,968,61.853035143769965
Akluj,Bitter Gourd,2016,1532,2500,968,63.18537859007833
Kolhapur,Maize(Corn.),2015,446,1414,968,217.0403587443946
Latur,Wheat(Husked),2016,1650,2618,968,58.666666666666664
Kalyan,Cluster Bean,2016,4160,5128,968,23.26923076923077
Pandharpur,Tomato,2015,265,1233,968,365.2830188679245
Kalyan,Ridge Gourd,2016,4204,5172,968,23.025689819219792
Kille Dharur,Cotton,2016,4118,5086,968,23.506556580864498
Pusad,Gram,2016,5828,6796,968,16.609471516815375
Khed-Chakan,Bitter Gourd,2016,2514,3482,968,38.50437549721559
Kalyan,Cluster Bean,2015,2913,3881,968,33.23034672159286
Ausa,Gram,2015,3914,4882,968,24.731732243229434
Balapur,Gram,2016,4533,5500,967,21.332450915508492
Rahata,Onion,2016,200,1167,967,483.5
Nandgaon Khandeshwar,Chino,2016,4091,5058,967,23.637252505499877
Kamthi,Tomato,2015,1460,2427,967,66.23287671232876
Mumbai-Fruit Market,Melon,2016,833,1800,967,116.08643457382954
Sailu,Cotton,2016,3598,4565,967,26.87604224569205
Satara,Pavtta,2016,7733,8700,967,12.504849346954611
Phaltan,Sorgum(Jawar),2014,1600,2567,967,60.4375
Chandrapur,Papai,2015,1083,2050,967,89.28901200369344
Pandharpur,Tomato,2014,158,1125,967,612.0253164556962
Sillod-Bharadi,Gram,2016,6900,7867,967,14.014492753623188
Indapur-Bhigwan,Sorgum(Jawar),2015,1500,2467,967,64.46666666666667
Shrirampur,Ground Nut Pods (Dry),2016,3633,4600,967,26.617120836774017
Nagpur,Grapes,2015,2752,3719,967,35.138081395348834
Phaltan,Sorgum(Jawar),2016,1600,2567,967,60.4375
Nagpur,Mango,2016,2033,3000,967,47.56517461878997
Umared,Other Pulses,2015,4428,5395,967,21.838301716350497
Sangali,Sorgum(Jawar),2015,1651,2618,967,58.57056329497274
Mantha,Black Gram,2016,5400,6367,967,17.90740740740741
Manchar,Small Gourd,2016,1522,2489,967,63.534822601839686
Vadgaon Peth,Cucumber,2014,750,1717,967,128.93333333333334
Nashik,Bor,2016,933,1900,967,103.64415862808146
Solapur,Green Peas (Dry),2016,3083,4050,967,31.3655530327603
Barshi,Wheat(Husked),2016,1713,2680,967,56.45067133683596
Ratanagari,Bottle Gourd,2016,2200,3167,967,43.95454545454545
Pune-Manjri,Ground Nut Pods (Dry),2016,3333,4300,967,29.01290129012901
Vadgaon Peth,Capsicum,2014,1200,2167,967,80.58333333333333
Nashik,Kanda Pat,2015,1043,2009,966,92.61744966442953
Junnar-Otur,CHAVLI (SHENGA ),2016,967,1933,966,99.8965873836608
Chikhali,Pigeon Pea (Tur),2014,4050,5016,966,23.85185185185185
Indapur,Chillies(Red),2015,6567,7533,966,14.709913202375514
Chalisgaon,Black Gram,2014,3117,4083,966,30.991337824831568
Kolhapur,Melon,2015,1778,2744,966,54.330708661417326
Pune-Manjri,Tomato,2015,942,1908,966,102.54777070063695
Karanja,Black Gram,2014,3476,4442,966,27.790563866513235
Shrirampur,Pomegranate,2015,2567,3533,966,37.63147643163226
Mumbai-Fruit Market,Pitch,2016,4592,5558,966,21.036585365853657
Akole,Onion,2016,120,1086,966,805.0
Kolhapur,Potato,2016,543,1509,966,177.90055248618785
Hingoli-Kanegaon Naka,TURMERIC,2016,7067,8033,966,13.6691665487477
Yeola,Onion,2015,404,1370,966,239.1089108910891
Bhokardan,Green Gram,2015,5867,6833,966,16.464973581046532
Manchar,Pavtta,2016,2067,3033,966,46.73439767779391
Nashik,Raddish,2016,1728,2693,965,55.844907407407405
Kalamb (Os),Black Gram,2016,6053,7018,965,15.942507847348422
Rahuri-Vambori,Gram,2016,4980,5945,965,19.377510040160644
Indapur-Bhigwan,Gram,2015,3888,4853,965,24.819958847736626
Khamgaon,Pigeon Pea (Tur),2014,4091,5056,965,23.5883647030066
Nashik-Devlali,Coriander  ,2016,741,1706,965,130.2294197031039
Satana,Gram,2016,3375,4340,965,28.59259259259259
Nashik,Lemon,2016,946,1911,965,102.00845665961945
Pune,Arvi,2015,1785,2750,965,54.061624649859944
Solapur,Gram,2016,7378,8343,965,13.079425318514502
Kamthi,Chavli (Pala),2016,882,1847,965,109.41043083900227
Akola,Green Gram,2016,5971,6936,965,16.161446993803384
Nira-Saswad,Sorgum(Jawar),2016,1580,2545,965,61.075949367088604
Karad,Chikoo,2015,2088,3053,965,46.21647509578544
Manmad,Green Gram,2016,4679,5644,965,20.624064971147682
Latur-Murud,GRAM,2016,4532,5497,965,21.293027360988525
Pune,Cucumber,2015,626,1591,965,154.15335463258785
Nira-Saswad,Sorgum(Jawar),2016,1600,2564,964,60.25
Barshi-Vairag,Black Gram,2014,4147,5111,964,23.245719797443936
Dhule,Onion,2016,331,1295,964,291.238670694864
Pune-Moshi,Ghosali(Bhaji),2016,2775,3739,964,34.73873873873874
Karad,Carrot,2015,927,1891,964,103.99137001078749
Mangalwedha,Wheat(Husked),2015,1468,2432,964,65.66757493188011
Umarga,Green Gram,2015,6738,7702,964,14.306915998812704
Kalyan,Custard Apple,2015,3091,4055,964,31.187318020058232
Shrirampur,Custard Apple,2015,2500,3464,964,38.56
Patan,Green Chilli,2016,3494,4458,964,27.590154550658273
Sangali,Sorgum(Jawar),2016,1708,2672,964,56.440281030444964
Pune-Pimpri,Brinjal,2016,2703,3667,964,35.66407695153533
Rahata,Capsicum,2015,2045,3009,964,47.13936430317848
Pune,Tamarind,2015,4036,5000,964,23.885034687809714
Mangrulpeer,Green Gram,2016,4121,5085,964,23.39238049017229
Varud-Rajura Bazar,Pigeon Pea (Tur),2015,4950,5914,964,19.474747474747474
Shrirampur,Lemon,2015,1500,2464,964,64.26666666666667
Varud-Rajura Bazar,Pigeon Pea (Tur),2016,7161,8125,964,13.461807010194107
Solapur,Guava,2016,1057,2020,963,91.10690633869442
Jalna,Banana,2014,477,1440,963,201.88679245283018
Amarawati-Fruit And Vegetables,Lemon,2016,2000,2963,963,48.15
Palus,Bitter Gourd,2016,1300,2263,963,74.07692307692308
Sangali,Jaggery,2015,2306,3269,963,41.76062445793582
Khed-Chakan,Green Chilli,2016,3158,4121,963,30.493983533882204
Shrirampur,Gram,2016,4470,5433,963,21.543624161073826
Solapur,Matki,2016,6050,7013,963,15.917355371900827
Pune-Manjri,Rajgira,2016,0,963,963,inf
Kamthi,Dhemse,2015,1756,2719,963,54.840546697038725
Chandrapur-Ganjwad,Coriander  ,2015,1350,2313,963,71.33333333333333
Dhule,Pigeon Pea (Tur),2015,5352,6315,963,17.993273542600896
Chandrapur,Chikoo,2016,1500,2463,963,64.2
Satara,Ginger (Fresh),2016,1000,1963,963,96.3
Mumbai,Jaggery,2014,4021,4984,963,23.94926635165382
Pune-Manjri,Bitter Gourd,2014,1626,2589,963,59.22509225092251
Nashik,Coriander  ,2016,570,1533,963,168.94736842105263
Sinner,ONION,2016,90,1052,962,1068.888888888889
Shrirampur,Custard Apple,2015,1519,2481,962,63.33113890717577
Bhivandi,Other Vegetables,2014,1113,2075,962,86.43306379155436
Kolhapur-Laxmipuri,Wheat(Husked),2016,2192,3154,962,43.886861313868614
Pune,Black Gram,2015,8613,9575,962,11.169162893300824
Nira-Saswad,Rice(Paddy-Hus),2016,2413,3375,962,39.86738499792789
Mumbai,Split Gram,2015,5500,6462,962,17.490909090909092
Pune,Walvad,2015,1846,2808,962,52.11267605633803
Latur-Murud,Gram,2016,5106,6068,962,18.840579710144926
Balapur,Black Gram,2015,4688,5650,962,20.52047781569966
Nandura,Gram,2015,3593,4555,962,26.774283328694683
Kalyan,Orange,2016,5313,6275,962,18.10653115000941
Pune,Onion,2015,690,1652,962,139.42028985507247
Kolhapur,GREEN CHILLI,2016,598,1560,962,160.8695652173913
Shrirampur,Grapes,2016,2500,3462,962,38.48
Pandharpur,BRINJAL,2016,388,1350,962,247.93814432989691
Pune-Manjri,Pavtta,2015,2305,3267,962,41.7353579175705
Ambad(Vadi Godri),Gram,2016,4756,5718,962,20.22708158116064
Mangrulpeer,Green Gram,2015,5492,6454,962,17.516387472687544
Sangali,Sorgum(Jawar),2016,1706,2667,961,56.33059788980071
Satara,Flower,2015,1326,2287,961,72.47360482654601
Satara,Brinjal,2014,2481,3442,961,38.73438129786376
Ramtek,Dhemse,2015,2231,3192,961,43.07485432541461
Shrirampur,Green Chilli,2016,3077,4038,961,31.231719207019825
Nashik,GROUND NUT PODS (DRY),2016,3253,4214,961,29.54196126652321
Pune-Manjri,Guava,2016,3935,4896,961,24.421855146124525
Devala,Gram,2016,4320,5281,961,22.24537037037037
Jalgaon,Coriander (Dry),2015,9971,10932,961,9.637950055159964
Rahuri,GREEN CHILLI,2016,708,1669,961,135.73446327683615
Pune,Wal Bhaji,2014,1929,2890,961,49.81855883877657
Dondaicha,Ground Nut Pods (Dry),2015,2685,3646,961,35.791433891992554
Chandrapur-Ganjwad,Coriander  ,2014,1108,2069,961,86.73285198555956
Sangali,Sorgum(Jawar),2015,1659,2620,961,57.92646172393008
Pune-Manjri,Coriander  ,2015,525,1485,960,182.85714285714286
Ahmednagar,Brinjal,2015,900,1860,960,106.66666666666667
Jalgaon,Chavli (Shenga ),2015,1580,2540,960,60.75949367088607
Ulhasnagar,Sorgum(Jawar),2016,1880,2840,960,51.06382978723404
Solapur,Onion,2016,100,1060,960,960.0
Vasai,Tomato,2015,1026,1986,960,93.5672514619883
Paithan,Pigeon Pea (Tur),2016,7587,8547,960,12.653222617635429
Khed-Chakan,Green-Peas,2016,6760,7720,960,14.201183431952662
Rahuri,Tomato,2016,180,1140,960,533.3333333333334
Satara,Shevga,2015,3760,4720,960,25.53191489361702
Bhivandi,Potato,2014,1060,2020,960,90.56603773584905
Dudhani,Pigeon Pea (Tur),2016,8213,9173,960,11.688786070863266
Chandrapur,Kharbuj,2015,1040,2000,960,92.3076923076923
Hingoli,Turmeric,2014,5570,6530,960,17.235188509874327
Kamthi,Tomato,2014,880,1840,960,109.0909090909091
Devala,Onion,2014,805,1764,959,119.1304347826087
Shrirampur,Mosambi,2015,2083,3042,959,46.039366298607774
Khamgaon,Green Gram,2014,6577,7536,959,14.581116010339061
Akluj,Garlic,2015,2159,3118,959,44.4187123668365
Daryapur,Gram,2015,3956,4915,959,24.24165824064712
Junnar-Otur,Brinjal,2016,855,1814,959,112.16374269005848
Gevrai,Sesamum,2015,6141,7100,959,15.616349128806384
Phaltan,Bajri,2016,1275,2234,959,75.2156862745098
Indapur,Wheat(Husked),2015,1436,2395,959,66.78272980501393
Kolhapur-Laxmipuri,Cowpea,2015,4029,4988,959,23.802432365351205
Barshi,Gram,2014,2210,3169,959,43.39366515837104
Shrirampur,Shevga,2015,1625,2583,958,58.95384615384615
Khed-Chakan,Ladies Finger,2016,3327,4285,958,28.794709948902916
Varud-Rajura Bazar,Gram,2014,2025,2983,958,47.30864197530864
Karad,Mango,2015,1875,2833,958,51.093333333333334
Pandharpur,Coriander  ,2014,625,1583,958,153.28
Nashik,Guava,2016,1419,2377,958,67.5123326286117
Umared,Pigeon Pea (Tur),2015,5271,6229,958,18.174919370138493
Nagpur,Math (Bhaji),2016,3318,4276,958,28.872814948764315
Kada,Tamarind,2015,4236,5194,958,22.615675165250234
Shrirampur,Lemon,2016,3167,4125,958,30.249447426586674
Rahuri,Papai,2015,245,1203,958,391.0204081632653
Shrirampur,Ginger (Fresh),2015,2500,3458,958,38.32
Akluj,Ground Nut Pods (Dry),2015,3717,4675,958,25.77347323110035
Pune,Pumpkin,2015,471,1429,958,203.39702760084927
Sindi (Selu),Soybean,2016,3000,3958,958,31.933333333333334
Kannad,Ginger (Fresh),2016,825,1783,958,116.12121212121212
Solapur,Sorgum(Jawar),2014,1771,2729,958,54.09373235460192
Amarawati,Sesamum,2016,5458,6416,958,17.552216929278124
Pune,Green Gram,2015,7664,8621,957,12.486951983298539
Khed-Chakan,SQUASH GOURD,2016,1500,2457,957,63.8
Kolhapur,Jaggery,2016,3150,4107,957,30.38095238095238
Akluj,Ground Nut Pods (Dry),2016,3419,4376,957,27.990640538169057
Pune-Pimpri,Green Gram,2016,7214,8171,957,13.265871915719435
Kolhapur,Flower,2016,248,1205,957,385.88709677419354
Akola,Green Gram,2015,7951,8908,957,12.036221858885675
Ausa,Gram,2015,3504,4461,957,27.311643835616437
Mangaon(Bhadav),Nachani,2016,1457,2414,957,65.68291008922444
Yeola,Onion,2015,348,1305,957,275.0
Solapur,Chikoo,2015,524,1481,957,182.63358778625954
Manmad,Onion,2015,446,1403,957,214.57399103139014
Babhulgaon,Pigeon Pea (Tur),2016,7280,8237,957,13.145604395604396
Akluj,Chillies(Red),2015,1714,2671,957,55.8343057176196
Pandharpur,Math (Bhaji),2015,356,1313,957,268.82022471910113
Jalgaon,Ginger (Fresh),2016,1643,2600,957,58.24710894704808
Malegaon,Onion,2014,598,1554,956,159.86622073578596
Barshi,Onion,2015,289,1245,956,330.79584775086505
Akluj,Carrot,2015,2082,3038,956,45.91738712776177
Rahuri-Vambori,Pigeon Pea (Tur),2016,6389,7345,956,14.963218030990765
Vasai,Tomato,2015,969,1925,956,98.65841073271415
Kada (Ashti),Green Gram,2015,6700,7656,956,14.26865671641791
Osmanabad,Capsicum,2015,2144,3100,956,44.58955223880597
Vasai,Wheat(Husked),2016,1478,2434,956,64.68200270635995
Osmanabad,GREEN CHILLI,2016,763,1719,956,125.29488859764089
Hinganghat,Cotton,2016,4105,5061,956,23.288672350791717
Mumbai,Tomato,2014,876,1832,956,109.1324200913242
Mehkar,Green Gram,2015,6606,7561,955,14.456554647290343
Nira-Saswad,SORGUM(JAWAR),2016,1736,2691,955,55.01152073732719
Ahmednagar,Cabbage,2015,518,1473,955,184.36293436293437
Kopargaon,Onion,2015,395,1350,955,241.77215189873417
Osmanabad,Brinjal,2016,589,1544,955,162.13921901528013
Nashik,SHEPU,2016,1335,2290,955,71.53558052434457
Barshi,Mango,2016,1875,2830,955,50.93333333333333
Karad,Green-Peas,2016,3306,4261,955,28.886872353297036
Nandgaon,Onion,2015,530,1485,955,180.18867924528303
Murbad,Ghevda,2016,4167,5122,955,22.918166546676265
Vani,Cotton,2016,3785,4740,955,25.23117569352708
Amarawati,Ground Nut Pods (Dry),2015,4328,5283,955,22.06561922365989
Kolhapur,Ghevda,2015,1489,2444,955,64.1370047011417
Akluj,Bor,2015,1045,2000,955,91.38755980861244
Rahata,Capsicum,2015,1318,2273,955,72.45827010622155
Newasa-Ghodegaon,Onion,2016,192,1146,954,496.875
Pandharpur,GREEN CHILLI,2016,538,1492,954,177.32342007434943
Sangali,Wheat(Unhusked),2015,3600,4554,954,26.5
Rahata,Green Chilli,2015,2091,3045,954,45.62410329985653
Mumbai-Fruit Market,Orange,2016,1008,1962,954,94.64285714285714
Pune,Flower,2016,992,1946,954,96.16935483870968
Ramtek,Wal Bhaji,2015,2455,3409,954,38.85947046843177
Shegaon,Black Gram,2016,5989,6943,954,15.929203539823009
Karad,Green-Peas,2015,2591,3545,954,36.81976071015052
Kamthi,Flower,2015,673,1627,954,141.75334323922735
Kamthi,Potato,2015,673,1627,954,141.75334323922735
Kolhapur,Bottle Gourd,2016,421,1375,954,226.60332541567695
Kolhapur,Bottle Gourd,2016,450,1404,954,212.0
Osmanabad,Kharbuj,2015,673,1627,954,141.75334323922735
Mumbai,Green-Peas,2016,3238,4192,954,29.46263125386041
Jalna,Mosambi,2016,1857,2811,954,51.37318255250404
Raver,Pigeon Pea (Tur),2016,6213,7167,954,15.354901014002897
Ulhasnagar,WHEAT(HUSKED),2016,2000,2953,953,47.65
Akluj,Chillies(Red),2014,1688,2641,953,56.45734597156398
Ahmednagar,Bitter Gourd,2016,421,1374,953,226.36579572446556
Chandrapur-Ganjwad,Bitter Gourd,2016,962,1915,953,99.06444906444906
Lasalgaon,Soybean,2016,2321,3274,953,41.05988797931926
Akluj,Brinjal,2016,1129,2082,953,84.41098317094774
Pune-Manjri,Bottle Gourd,2015,870,1822,952,109.42528735632185
Mumbai,Jaggery,2015,2485,3437,952,38.309859154929576
Ulhasnagar,Sorgum(Jawar),2016,2032,2984,952,46.8503937007874
Kalamb (Os),Wheat(Husked),2015,2234,3186,952,42.61414503133393
Sangali,JAGGERY,2016,3188,4140,952,29.86198243412798
Mumbai,Split Lentil,2015,7367,8319,952,12.922492194923306
Daryapur,Green Gram,2014,6933,7885,952,13.731429395644021
Mangrulpeer,Gram,2016,5688,6640,952,16.736990154711673
Mohol,SORGUM(JAWAR),2016,1650,2602,952,57.696969696969695
Sillod-Bharadi,Pigeon Pea (Tur),2016,6825,7777,952,13.948717948717949
Junnar-Otur,Bottle Gourd,2016,523,1475,952,182.02676864244742
Udgir,Gram,2015,2463,3415,952,38.65205034510759
Nashik-Devlali,Coriander  ,2016,1769,2721,952,53.815715093273035
Kolhapur,Jaggery,2015,2563,3515,952,37.1439719079204
Solapur,Matki,2014,5679,6631,952,16.763514703292834
Barshi,Gram,2014,2142,3094,952,44.44444444444444
Chikhali,Pigeon Pea (Tur),2014,4150,5101,951,22.91566265060241
Lasur Station,Onion,2015,410,1361,951,231.9512195121951
Nashik,Ground Nut Pods (Dry),2016,2869,3820,951,33.147438131753226
Nashik,Bottle Gourd,2016,725,1676,951,131.17241379310346
Manchar,Onion,2015,1028,1979,951,92.50972762645914
Solapur,Wheat(Husked),2014,1662,2613,951,57.2202166064982
Shahada,GRAM,2016,7350,8301,951,12.938775510204081
Kille Dharur,Wheat(Husked),2015,1450,2401,951,65.58620689655173
Ghoti,Tomato,2016,1749,2700,951,54.37392795883362
Pathardi,Gram,2016,4933,5884,951,19.278329616866003
Tuljapur,Black Gram,2016,5860,6811,951,16.22866894197952
Nashik,Orange,2016,1015,1965,950,93.5960591133005
Pune-Manjri,Hemp,2015,0,950,950,inf
Amarawati,Ginger (Fresh),2015,3050,4000,950,31.147540983606557
Khed-Chakan,Shevga,2016,2906,3856,950,32.69098417068135
Karad,Mosambi,2015,3900,4850,950,24.358974358974358
Jamkhed,Green Gram,2014,5544,6494,950,17.135642135642136
Ashti-Karanja,Gram,2016,3200,4150,950,29.6875
Pathardi,Gram,2016,6800,7750,950,13.970588235294118
Pune-Manjri,Hemp,2015,50,1000,950,1900.0
Taloda,Green Gram,2016,5450,6400,950,17.431192660550458
Palus,Tomato,2016,2100,3050,950,45.23809523809524
Kalyan,Indian Bean,2015,4650,5600,950,20.43010752688172
Lasur Station,Ginger (Dry),2015,2850,3800,950,33.333333333333336
Sillod-Bharadi,Gram,2016,5375,6325,950,17.674418604651162
Pune-Manjri,Bottle Gourd,2016,800,1750,950,118.75
Kopargaon,Green Gram,2016,5971,6921,950,15.910232791827164
Karad,Pavtta,2014,4125,5075,950,23.03030303030303
Ahmednagar,Ground Nut Pods (Dry),2016,3000,3950,950,31.666666666666668
Manchar,Walvad,2016,700,1650,950,135.71428571428572
Sindi (Selu),Cotton,2016,3993,4943,950,23.791635361883294
Kamthi,Orange,2016,550,1500,950,172.72727272727272
Patan,Green Chilli,2015,2600,3550,950,36.53846153846154
Palus,Cabbage,2016,883,1833,950,107.58776896942243
Manchar,Carrot,2015,1800,2750,950,52.77777777777778
Balapur,Gram,2015,3380,4330,950,28.106508875739646
Ratanagari,Green Chilli,2014,2575,3525,950,36.89320388349515
Junnar-Otur,Brinjal,2016,517,1467,950,183.752417794971
Ramtek,Custard Apple,2015,2350,3300,950,40.42553191489362
Aurangabad,Kharbuj,2015,1550,2500,950,61.29032258064516
Akluj,Banana,2016,360,1310,950,263.8888888888889
Ratanagari,Cucumber,2015,1167,2117,950,81.40531276778063
Ahmednagar,Bitter Gourd,2015,875,1825,950,108.57142857142857
Kille Dharur,Green Gram,2014,5290,6240,950,17.958412098298677
Ratanagari,Flower,2014,2425,3375,950,39.175257731958766
Kamthi,Methi (Bhaji),2015,1104,2054,950,86.05072463768116
Amalner,Coriander (Dry),2016,7800,8750,950,12.179487179487179
Barshi,SQUASH GOURD,2016,2067,3017,950,45.9603289791969
Nashik-Devlali,Methi (Bhaji),2016,500,1450,950,190.0
Pune,Cucumber,2015,700,1650,950,135.71428571428572
Nira,Rice(Paddy-Hus),2015,2050,3000,950,46.34146341463415
Akola,Batbati,2016,3050,4000,950,31.147540983606557
Pune-Manjri,Kardai,2015,360,1310,950,263.8888888888889
Buldhana,Black Gram,2015,7625,8575,950,12.459016393442623
Sindi (Selu),Ground Nut Pods (Dry),2016,4900,5850,950,19.387755102040817
Ghoti,Brinjal,2016,850,1800,950,111.76470588235294
Pune,Parwar,2015,2583,3533,950,36.77893921796361
Chalisgaon,Black Gram,2015,4150,5100,950,22.89156626506024
Ghoti,Capsicum,2015,950,1900,950,100.0
Pune-Manjri,Bottle Gourd,2014,1121,2071,950,84.7457627118644
Vaijapur,Onion,2016,150,1100,950,633.3333333333334
Kada,Sorgum(Jawar),2016,1606,2556,950,59.153175591531756
Sindkhed Raja,Gram,2016,4850,5800,950,19.587628865979383
Kolhapur-Laxmipuri,Split Black Gram,2015,8100,9050,950,11.728395061728396
Baramati,Ground Nut Pods (Dry),2015,2750,3700,950,34.54545454545455
Palus,Capsicum,2016,2400,3350,950,39.583333333333336
Pune,MULA SHENGA,2016,1363,2313,950,69.69919295671313
Akole,Gram,2015,3300,4250,950,28.78787878787879
Nagpur,Orange,2015,700,1650,950,135.71428571428572
Pune-Moshi,Squash Gourd,2016,1989,2939,950,47.76269482151835
Ratanagari,Capsicum,2015,2450,3400,950,38.775510204081634
Kada (Ashti),Pigeon Pea (Tur),2016,7420,8370,950,12.803234501347708
Sindi,Cotton,2016,4000,4950,950,23.75
Katol,Ground Nut Pods (Dry),2015,3396,4346,950,27.974087161366313
Chikhali,Green Gram,2014,7400,8350,950,12.837837837837839
Buldhana,Pigeon Pea (Tur),2015,7750,8700,950,12.258064516129032
Solapur,Ghevda,2016,1499,2448,949,63.30887258172115
Kolhapur,Tomato,2016,279,1228,949,340.14336917562724
Satara,Ladies Finger,2016,2507,3456,949,37.8540087754288
Satana,Gram,2015,3739,4688,949,25.38111794597486
Latur,Wheat(Husked),2016,1638,2587,949,57.93650793650794
Nashik-Devlali,Coriander  ,2016,1644,2593,949,57.72506082725061
Kille Dharur,Gram,2015,3648,4597,949,26.01425438596491
Achalpur,Soybean,2015,2375,3324,949,39.95789473684211
Malegaon,Green Gram,2014,6914,7863,949,13.725773792305468
Jintur,Pigeon Pea (Tur),2016,7933,8882,949,11.962687507878483
Mandhal,Chillies(Red),2015,3982,4931,949,23.832245102963334
Baramati,Sorgum(Jawar),2016,1638,2587,949,57.93650793650794
Ahmednagar,Ladies Finger,2016,389,1337,948,243.7017994858612
Lasur Station,Sorgum(Jawar),2015,1149,2097,948,82.50652741514361
Dhule,Green Gram,2015,6547,7495,948,14.479914464640293
Mumbai,SPLIT BLACK GRAM,2016,9228,10176,948,10.273081924577372
Manmad,Onion,2014,697,1645,948,136.01147776183643
Kolhapur,Chikoo,2015,1009,1957,948,93.95441030723488
Solapur,Green Gram,2014,6778,7726,948,13.986426674535261
Manora,Pigeon Pea (Tur),2015,8246,9194,948,11.496483143342227
Murud,Rice(Paddy-Hus),2016,2461,3409,948,38.52092645266152
Pune-Manjri,Bitter Gourd,2015,2281,3229,948,41.56071898290224
Umared,Other Pulses,2015,5358,6306,948,17.69316909294513
Pune-Manjri,Onion,2015,719,1667,948,131.84979137691238
Pune,Green Gram,2014,6444,7391,947,14.695841092489138
Indapur-Bhigwan,Gram,2015,3483,4430,947,27.189204708584555
Pune,Ghosali(Bhaji),2015,1024,1971,947,92.48046875
Pune,Green Gram,2015,7638,8585,947,12.398533647551716
Kolhapur,Wal Bhaji,2015,2594,3541,947,36.507324595219735
Pune-Manjri,Cucumber,2014,2135,3082,947,44.3559718969555
Aurangabad,Orange,2016,795,1742,947,119.11949685534591
Shegaon,Thymol/Lovage,2014,6942,7889,947,13.641601843849035
Aurangabad,Mango(Raw),2015,2824,3771,947,33.53399433427762
Jalgaon,Chavli (Shenga ),2015,1940,2887,947,48.81443298969072
Malkapur,Pigeon Pea (Tur),2016,5958,6905,947,15.894595501846258
Solapur,Tomato,2014,117,1063,946,808.5470085470085
Jalna,Sorgum(Jawar),2016,1552,2498,946,60.95360824742268
Satara,Flower,2016,1792,2738,946,52.79017857142857
Hingoli,Green Gram,2015,7152,8098,946,13.227069351230424
Mumbai-Fruit Market,Orange,2016,836,1782,946,113.15789473684211
Bhokar,Black Gram,2016,6413,7359,946,14.751286449399657
Akluj,Brinjal,2016,1267,2213,946,74.66456195737963
Pune-Manjri,Tomato,2015,1009,1955,946,93.75619425173439
Shirpur,Pigeon Pea (Tur),2015,4722,5668,946,20.033883947479882
Akluj,Carrot,2014,1062,2008,946,89.07721280602637
Mumbai,Brinjal,2016,554,1500,946,170.75812274368232
Morshi,Pigeon Pea (Tur),2015,7500,8445,945,12.6
Lasalgaon-Vinchur,Gram,2015,4001,4946,945,23.61909522619345
Solapur,Bor,2016,411,1356,945,229.92700729927006
Kolhapur,Orange,2015,578,1523,945,163.4948096885813
Jalgaon,Flower,2015,1850,2795,945,51.08108108108108
Hingoli,Turmeric,2015,6808,7753,945,13.880728554641598
Barshi,Sorgum(Jawar),2016,1632,2577,945,57.904411764705884
Devala,Gram,2014,2732,3677,945,34.5900439238653
Lonand,Onion,2015,713,1658,945,132.53856942496495
Satara,Shevga,2014,5444,6389,945,17.358559882439383
Paranda,Pigeon Pea (Tur),2016,6620,7565,945,14.274924471299094
Paranda,Sorgum(Jawar),2016,1524,2469,945,62.00787401574803
Amarawati,Lemon,2016,2373,3318,945,39.823008849557525
Kamthi,Pumpkin,2016,612,1556,944,154.2483660130719
Bhivandi,Potato,2014,1056,2000,944,89.39393939393939
Satara,Pavtta,2015,4056,5000,944,23.274161735700197
Mangrulpeer,Pigeon Pea (Tur),2015,6486,7430,944,14.554424915201974
Kalvan,Ground Nut Pods (Dry),2015,3978,4922,944,23.730517848164908
Shrirampur,Mosambi,2015,2500,3444,944,37.76
Lonand,Onion,2015,631,1575,944,149.60380348652933
Rahata,Garlic,2015,5278,6222,944,17.88556271314892
Barshi,BITTER GOURD,2016,1500,2444,944,62.93333333333333
Solapur,Capsicum,2015,427,1371,944,221.07728337236534
Pune,Pumpkin,2015,725,1669,944,130.20689655172413
Vai,Green Chilli,2016,4540,5484,944,20.792951541850222
Kalamb (Os),Pigeon Pea (Tur),2015,5642,6586,944,16.73165544133286
Ramtek,Ginger (Fresh),2015,2889,3833,944,32.67566632052613
Chandrapur,Custard Apple,2016,971,1914,943,97.11637487126673
Kamthi,Parwar,2015,1771,2714,943,53.246753246753244
Kamthi,Lemon,2016,1100,2043,943,85.72727272727273
Varora,Pigeon Pea (Tur),2015,6410,7353,943,14.711388455538222
Manchar,Shevga,2016,2571,3514,943,36.678335278101905
Parola,Green Gram,2016,3765,4708,943,25.046480743691898
Khed-Chakan,Shevga,2016,2938,3881,943,32.096664397549354
Pune-Manjri,Spinach,2016,600,1543,943,157.16666666666666
Vasai,Onion,2015,914,1857,943,103.17286652078775
Nagpur,Ginger (Fresh),2016,1896,2839,943,49.73628691983122
Kopargaon,Gram,2016,4492,5435,943,20.99287622439893
Kamthi,Capsicum,2016,1548,2491,943,60.917312661498705
Latur,Gram,2015,3881,4823,942,24.272094820922444
Kej,Pigeon Pea (Tur),2015,7301,8243,942,12.902342144911655
Manchar,Farshi,2016,2200,3142,942,42.81818181818182
Mumbai,Jaggery,2016,2610,3552,942,36.0919540229885
Akluj,Ground Nut Pods (Dry),2016,2933,3875,942,32.11728605523355
Pathardi,ONION,2016,211,1153,942,446.4454976303318
Pune-Manjri,Tomato,2014,1316,2258,942,71.580547112462
Chikhali,Pigeon Pea (Tur),2015,6301,7243,942,14.950007935248374
Chandvad,Onion,2015,553,1495,942,170.34358047016275
Pathari,Wheat(Husked),2016,1196,2138,942,78.76254180602007
Pune-Manjri,Goosefoot,2015,0,942,942,inf
Jalgaon Jamod-Aasalgaon,Pigeon Pea (Tur),2016,7729,8671,942,12.187863889248286
Khed-Chakan,Farshi,2016,3077,4019,942,30.614234644133898
Bhokar,Turmeric,2016,6821,7763,942,13.810291746078288
Ghoti,Tomato,2016,1439,2381,942,65.46212647671994
Pulgaon,Pigeon Pea (Tur),2015,6293,7235,942,14.969013189257906
Pune,Black Gram,2015,7075,8017,942,13.314487632508834
Manwat,Green Gram,2015,7382,8324,942,12.760769439176375
Satara,Cluster Bean,2016,4077,5019,942,23.10522442972774
Kalyan,CLUSTER BEAN,2016,2425,3367,942,38.845360824742265
Beed,Pigeon Pea (Tur),2016,7188,8130,942,13.10517529215359
Kolhapur-Laxmipuri,Cowpea,2016,6010,6952,942,15.6738768718802
Shahapur,Shevga,2015,6412,7353,941,14.6756082345602
Sangali,Wheat(Husked),2016,1851,2792,941,50.837385197190706
Pimpalgaon Basawant,Tomato,2016,352,1293,941,267.32954545454544
Malegaon,Gram,2015,4075,5016,941,23.0920245398773
Nandurbar,Gram,2015,3902,4843,941,24.115838031778576
Varud-Rajura Bazar,Gram,2015,3614,4555,941,26.037631433314885
Pune-Manjri,Rajgira,2014,164,1105,941,573.780487804878
Umared,Pigeon Pea (Tur),2016,6750,7691,941,13.940740740740742
Baramati,Pigeon Pea (Tur),2016,6611,7552,941,14.23385266979277
Amarawati,Green Gram,2015,6876,7817,941,13.685282140779522
Rahata,Tomato,2016,709,1650,941,132.72214386459802
Dondaicha-Sindkheda,Matki,2015,6342,7282,940,14.821822768842637
Deglur,Green Gram,2016,4000,4940,940,23.5
Vasai,Tomato,2015,1018,1958,940,92.33791748526522
Barshi,Jambhul,2015,60,1000,940,1566.6666666666667
Kamthi,Carrot,2016,1847,2787,940,50.89334055224689
Baramati,Sorgum(Jawar),2015,1667,2607,940,56.38872225554889
Pune-Manjri,Coriander  ,2016,608,1548,940,154.60526315789474
Osmanabad,Shevga,2016,620,1560,940,151.61290322580646
Murud,Rice(Paddy-Hus),2016,2500,3440,940,37.6
Mumbai,Melon,2016,922,1862,940,101.9522776572668
Jamkhed,Pigeon Pea (Tur),2016,6530,7470,940,14.39509954058193
Pune,Shevga,2016,770,1710,940,122.07792207792208
Kolhapur-Malkapur,Cabbage,2016,770,1710,940,122.07792207792208
Nandurbar,Sunflower,2014,3076,4016,940,30.5591677503251
Kalyan,Green Gram,2016,6160,7100,940,15.25974025974026
Pune-Manjri,Kanda Pat,2016,488,1428,940,192.62295081967213
Chandrapur,CUSTARD APPLE,2016,700,1640,940,134.28571428571428
Ahmednagar,Green Chilli,2016,550,1490,940,170.9090909090909
Rahata,Onion,2016,100,1040,940,940.0
Telhara,Pigeon Pea (Tur),2016,5605,6545,940,16.770740410347905
Pune-Moshi,Garlic,2016,6772,7712,940,13.8806851742469
Pune,Ghosali(Bhaji),2015,1460,2400,940,64.38356164383562
Pune-Pimpri,Onion,2015,1400,2340,940,67.14285714285714
Kalmeshwar,Pigeon Pea (Tur),2016,7536,8476,940,12.473460721868365
Vasai,Wheat(Husked),2015,1512,2452,940,62.16931216931217
Solapur,Potato,2015,366,1306,940,256.8306010928962
Lasur Station,Onion,2016,169,1109,940,556.2130177514792
Mumbai-Fruit Market,Chikoo,2016,830,1770,940,113.25301204819277
Manchar,Brinjal,2016,500,1440,940,188.0
Akluj,Chikoo,2014,1680,2620,940,55.95238095238095
Karad,Pomegranate,2016,3860,4800,940,24.352331606217618
Akole,Tomato,2015,684,1624,940,137.42690058479533
Aurangabad,Chikoo,2015,1440,2380,940,65.27777777777777
Kolhapur-Malkapur,Tomato,2016,310,1250,940,303.2258064516129
Aarni,Ground Nut Pods (Dry),2016,4573,5512,939,20.533566586485897
Nashik,Shepu,2016,963,1902,939,97.50778816199377
Nashik,Guava,2016,1120,2059,939,83.83928571428571
Savner,GRAM,2016,7548,8487,939,12.440381558028617
Ahmednagar,Green Gram,2016,4475,5414,939,20.98324022346369
Kalyan,Green Chilli,2015,2161,3100,939,43.452105506709856
Sindi,Pigeon Pea (Tur),2015,5013,5952,939,18.731298623578695
Pune-Manjri,Bitter Gourd,2016,2003,2942,939,46.87968047928108
Pune,Green-Peas,2016,1704,2643,939,55.105633802816904
Beed,Pigeon Pea (Tur),2016,7248,8187,939,12.955298013245033
Chandrapur,Kharbuj,2016,752,1691,939,124.86702127659575
Risod,Black Gram,2016,6396,7335,939,14.681050656660412
Mangalwedha,Ridge Gourd,2016,2324,3263,939,40.40447504302926
Pulgaon,Pigeon Pea (Tur),2016,7215,8153,938,13.000693000693001
Aurangabad,Fig,2016,2758,3696,938,34.01015228426396
Pune,Rice(Paddy-Hus),2015,4411,5349,938,21.2650192700068
Koregaon,Onion,2015,600,1538,938,156.33333333333334
Ratanagari,CUCUMBER,2016,1000,1938,938,93.8
Vadgaon Peth,Bitter Gourd,2016,762,1700,938,123.0971128608924
Yeotmal,Ground Nut Pods (Dry),2016,4812,5750,938,19.492934330839567
Solapur,Wheat(Husked),2015,1738,2676,938,53.970080552359036
Nagpur,Onion,2014,804,1742,938,116.66666666666667
Umared,Gram,2015,3725,4663,938,25.181208053691275
Mumbai,Orange,2015,900,1838,938,104.22222222222223
Shirpur,Onion,2015,199,1137,938,471.356783919598
Ramtek,Green Chilli,2016,3157,4095,938,29.711751662971174
Malkapur,Pigeon Pea (Tur),2016,7569,8507,938,12.39265424758885
Pune-Manjri,Ladies Finger,2016,2508,3446,938,37.400318979266345
Patan,Pavtta,2015,2500,3438,938,37.52
Ambejogai,Pigeon Pea (Tur),2014,3450,4388,938,27.18840579710145
Kolhapur,Guava,2016,654,1592,938,143.4250764525994
Kamthi,Parwar,2016,2062,3000,938,45.489815712900096
Ahmednagar,BLACK GRAM,2016,5884,6822,938,15.941536369816452
Kolhapur,Wal Bhaji,2015,989,1926,937,94.74216380182003
Parola,BLACK GRAM,2016,4666,5603,937,20.08144020574368
Shrirampur,Mango,2016,3563,4500,937,26.29806342969408
Manchar,Methi (Bhaji),2015,509,1446,937,184.08644400785855
Chandrapur-Ganjwad,Ginger (Fresh),2016,2895,3832,937,32.36614853195164
Sinner,Onion,2016,107,1044,937,875.7009345794393
Partur,Gram,2016,6615,7552,937,14.164777021919878
Solapur,Carrot,2015,393,1330,937,238.42239185750637
Jintur-Bori,Pigeon Pea (Tur),2015,4796,5733,937,19.537114261884906
Kalvan,GRAM,2016,6638,7575,937,14.11569749924676
Umared,Other Pulses,2016,6667,7604,937,14.054297285135743
Junnar,POTATO,2016,600,1537,937,156.16666666666666
Ratanagari,Cluster Bean,2015,1813,2750,937,51.68229453943739
Sinner,Potato,2016,313,1250,937,299.36102236421726
Manchar,Ghevda,2015,2563,3500,937,36.55872024970738
Osmanabad,Tomato,2016,742,1679,937,126.28032345013477
Pune,Sweet Potato,2015,888,1825,937,105.51801801801801
Savner,Gram,2016,7647,8583,936,12.24009415457042
Pune,Carrot,2014,740,1676,936,126.48648648648648
Pune,Capsicum,2015,935,1871,936,100.10695187165776
Armori-Desaiganj,Chillies(Red),2014,11700,12636,936,8.0
Chalisgaon,Tomato,2016,1232,2168,936,75.97402597402598
Kolhapur,Bottle Gourd,2015,487,1423,936,192.1971252566735
Vadgaon Peth,Green Chilli,2015,1682,2618,936,55.648038049940546
Satara,Ladies Finger,2015,3060,3996,936,30.58823529411765
Mumbai,Papai,2016,629,1564,935,148.64864864864865
Baramati,Sorgum(Jawar),2016,1600,2535,935,58.4375
Sailu,Pigeon Pea (Tur),2015,4740,5675,935,19.72573839662447
Mumbai,Onion,2015,3192,4127,935,29.291979949874687
Malegaon,Horse Gram,2016,2615,3550,935,35.75525812619503
Jalkot,Pigeon Pea (Tur),2016,8422,9357,935,11.101876038945619
Babhulgaon,Pigeon Pea (Tur),2016,8061,8996,935,11.599057188934376
Pune-Manjri,Bottle Gourd,2014,900,1835,935,103.88888888888889
Satara,Cluster Bean,2015,2096,3031,935,44.6087786259542
Indapur-Bhigwan,Sorgum(Jawar),2016,1603,2538,935,58.32813474734872
Khed-Chakan,Capsicum,2016,2848,3783,935,32.83005617977528
Shrirampur,Lemon,2016,3239,4174,935,28.866934238962642
Pune,Parwar,2016,2083,3017,934,44.83917426788286
Jalgaon,Potato,2016,730,1664,934,127.94520547945206
Sinner,Onion,2016,111,1045,934,841.4414414414415
Kalvan,Green Gram,2016,4533,5467,934,20.604456210015442
Rahata,Garlic,2015,3833,4767,934,24.367336290112185
Barshi,Turmeric,2016,7683,8617,934,12.156709618638553
Mumbai,Papai,2016,514,1448,934,181.71206225680933
Telhara,Black Gram,2015,7833,8767,934,11.923911655815141
Pune-Manjri,Onion,2016,533,1467,934,175.23452157598499
Akhadabalapur,Pigeon Pea (Tur),2015,6233,7167,934,14.984758543237607
Kamthi,Papai,2014,933,1867,934,100.10718113612005
Indapur-Bhigwan,Black Gram,2015,7033,7967,934,13.280250248826958
Varud-Rajura Bazar,Pigeon Pea (Tur),2015,6250,7184,934,14.944
Nashik,RADDISH,2016,983,1917,934,95.01525940996949
Osmanabad,Carrot,2016,1567,2500,933,59.5405232929164
Kamthi,Mango,2015,567,1500,933,164.55026455026456
Sangamner,Tomato,2015,355,1288,933,262.8169014084507
Chandrapur-Ganjwad,Capsicum,2014,1607,2540,933,58.05849408836341
Osmanabad,Cucumber,2016,767,1700,933,121.64276401564537
Solapur,Chikoo,2014,475,1408,933,196.42105263157896
Ulhasnagar,Sorgum(Jawar),2016,1987,2920,933,46.955208857574235
Kamthi,Chavli (Pala),2014,1104,2037,933,84.51086956521739
Kalvan,Onion,2016,390,1323,933,239.23076923076923
Ratanagari,Maize(Corn.),2015,3250,4183,933,28.70769230769231
Vadgaon Peth,Cluster Bean,2015,1567,2500,933,59.5405232929164
Indapur,Onion,2016,150,1083,933,622.0
Ratanagari,Brinjal,2014,1267,2200,933,73.63851617995265
Satara,Green-Peas,2016,3063,3996,933,30.460333006856022
Kolhapur,Spinach,2016,875,1808,933,106.62857142857143
Khed-Chakan,Cluster Bean,2016,4210,5143,933,22.161520190023754
Shahapur,Shevga,2016,6667,7600,933,13.994300284985751
Kej,Sesamum,2016,5334,6267,933,17.49156355455568
Malkapur,Gram,2015,3118,4051,933,29.923027581783195
Vadgaon Peth,Ghevda,2016,900,1833,933,103.66666666666667
Junnar-Otur,Flower,2016,686,1619,933,136.0058309037901
Jalgaon,Shevga,2015,1967,2900,933,47.432638535841384
Latur,WHEAT(HUSKED),2016,1699,2631,932,54.85579752795762
Phaltan,Sorgum(Jawar),2014,1577,2509,932,59.099556119213695
Shrigonda,Gram,2016,5181,6113,932,17.988805249951746
Pathari,Wheat(Husked),2016,1254,2186,932,74.32216905901116
Nagpur,Orange,2016,552,1484,932,168.84057971014494
Raver,Pigeon Pea (Tur),2015,4668,5600,932,19.96572407883462
Pune,Cucumber,2016,732,1664,932,127.3224043715847
Vadgaon Peth,Cabbage,2016,1063,1995,932,87.6763875823142
Satara,SHEVGA,2016,4318,5250,932,21.58406669754516
Bhokar,Sesamum,2015,7589,8521,932,12.28093292923969
Shrirampur,Capsicum,2016,2184,3116,932,42.67399267399267
Pune,Rice(Paddy-Hus),2016,4680,5612,932,19.914529914529915
Chikhali,Pigeon Pea (Tur),2016,5311,6243,932,17.548484277913765
Mumbai,Melon,2016,910,1842,932,102.41758241758242
Nagpur,Grapes,2015,2600,3531,931,35.80769230769231
Shrirampur,Onion,2016,188,1119,931,495.21276595744683
Shirpur,Gram,2015,4085,5016,931,22.790697674418606
Ahmednagar,Sorgum(Jawar),2014,1782,2713,931,52.24466891133558
Nagpur,Ginger (Fresh),2015,2750,3681,931,33.85454545454545
Pune,Capsicum,2015,1064,1995,931,87.5
Mangalwedha,Sorgum(Jawar),2014,1644,2575,931,56.6301703163017
Kamthi,Raddish,2014,731,1662,931,127.35978112175103
Indapur,Ground Nut Pods (Dry),2016,4630,5561,931,20.107991360691145
Mumbai,Small Gourd,2015,1154,2085,931,80.67590987868284
Pusad,Gram,2016,3728,4659,931,24.973175965665234
Taloda,Pigeon Pea (Tur),2015,7679,8610,931,12.123974475843209
Shahada,Green Gram,2016,3554,4485,931,26.195835678109173
Jalgaon,Lemon,2015,2300,3231,931,40.47826086956522
Kalyan,Shevga,2015,3617,4547,930,25.71191595244678
Sangali,SORGUM(JAWAR),2016,1943,2873,930,47.864127637673704
Mumbai,Jaggery,2015,2694,3624,930,34.521158129175944
Parner,Onion,2015,500,1430,930,186.0
Pune-Manjri,Rajgira,2015,120,1050,930,775.0
Pune,Arvi,2015,1396,2326,930,66.6189111747851
Baramati,SORGUM(JAWAR),2016,1675,2605,930,55.52238805970149
Majalgaon,Wheat(Husked),2016,1508,2438,930,61.6710875331565
Jalgaon,Bor,2014,1348,2278,930,68.99109792284867
Indapur,Gram,2016,4964,5894,930,18.734891216760676
Sangali,Sorgum(Jawar),2015,1729,2659,930,53.78831694621168
Ambad(Vadi Godri),Green Gram,2015,6510,7440,930,14.285714285714286
Devala,Green Gram,2015,7083,8013,930,13.130029648454045
Ulhasnagar,Wheat(Husked),2016,1970,2900,930,47.20812182741117
Sangli-Phale Bhajipalam,Onion,2016,215,1145,930,432.5581395348837
Pune-Manjri,Walvad,2015,1377,2307,930,67.53812636165577
Sangrampur-Varvatbakal,Gram,2015,3233,4163,930,28.765852149706156
Satana,Onion,2016,430,1360,930,216.27906976744185
Nagpur,Gram,2015,3543,4473,930,26.248941574936495
Ashti-Karanja,Gram,2016,4263,5193,930,21.815622800844476
Lasalgaon-Vinchur,Gram,2015,3638,4568,930,25.563496426608026
Kamthi,Ladies Finger,2016,790,1719,929,117.59493670886076
Sengaon,Green Gram,2015,6631,7560,929,14.009953249886895
Akot,Green Gram,2015,7037,7966,929,13.201648429728577
Pune,Snake Gourd,2016,1057,1986,929,87.89025543992432
Kej,Green Gram,2014,5728,6657,929,16.218575418994412
Sangali,WHEAT(HUSKED),2016,1940,2869,929,47.88659793814433
Patan,Green Chilli,2015,2571,3500,929,36.133800077790745
Amarawati,Onion,2015,2171,3100,929,42.79134039613081
Kolhapur,Maize(Corn.),2015,456,1385,929,203.7280701754386
Mumbai,Spilt Gerrn Gram,2015,8967,9896,929,10.360209657633545
Pimpalgaon Basawant,Onion,2015,515,1444,929,180.38834951456312
Pune,Walvad,2015,1057,1986,929,87.89025543992432
Shrirampur,Shevga,2016,2571,3500,929,36.133800077790745
Karad,Green Chilli,2016,5519,6448,929,16.832759557890924
Jalgaon,Green Gram,2014,6357,7286,929,14.613811546326884
Shrirampur,Gram,2016,3490,4419,929,26.6189111747851
Aurangabad,Cluster Bean,2015,3300,4229,929,28.151515151515152
Majalgaon,Gram,2015,2627,3556,929,35.36353254663114
Nandgaon,Onion,2014,690,1618,928,134.4927536231884
Amarawati,Ginger (Fresh),2015,2536,3464,928,36.59305993690852
Amarawati,Sesamum,2015,6725,7653,928,13.799256505576208
Vadgaon Peth,BITTER GOURD,2016,1128,2056,928,82.26950354609929
Osmanabad,Guava,2015,1386,2314,928,66.95526695526695
Pune-Pimpri,Tamarind,2016,4286,5214,928,21.6518898740084
Chandrapur-Ganjwad,Flower,2016,1143,2071,928,81.18985126859143
Jalgaon,Methi (Bhaji),2016,3239,4167,928,28.650818153751157
Pune-Manjri,PAPAI,2016,2045,2973,928,45.37897310513448
Manchar,Green Chilli,2015,3900,4828,928,23.794871794871796
Khed-Chakan,Walvad,2016,2643,3571,928,35.111615588346574
Jalgaon,Orange,2014,761,1689,928,121.94480946123522
Sinner,Onion,2016,88,1016,928,1054.5454545454545
Chalisgaon,Ground Nut Pods (Dry),2015,4307,5235,928,21.54631994427676
Jalgaon,Green Gram,2016,4556,5483,927,20.346795434591748
Indapur,Onion,2015,1261,2188,927,73.51308485329103
Kalamb (Os),Pigeon Pea (Tur),2015,5721,6648,927,16.20346093340325
Chandrapur,Kharbuj,2016,664,1591,927,139.60843373493975
Pune,Rice(Paddy-Hus),2015,4404,5331,927,21.049046321525886
Kamthi,Kand,2016,555,1482,927,167.02702702702703
Pune-Manjri,Green-Peas,2014,3000,3927,927,30.9
Hinganghat,Cotton,2016,4245,5172,927,21.83745583038869
Barshi,Pigeon Pea (Tur),2016,7111,8038,927,13.03614118970609
Satara,Flower,2015,1177,2104,927,78.75955819881054
Dound,Green Gram,2015,7700,8627,927,12.03896103896104
Pune-Moshi,Shevga,2016,3590,4517,927,25.821727019498606
Nagpur,Ginger (Fresh),2015,3900,4827,927,23.76923076923077
Mangaon(Bhadav),Nachani,2016,1518,2445,927,61.06719367588933
Pune,Tamarind,2015,3618,4545,927,25.621890547263682
Solapur,Potato,2014,1772,2698,926,52.25733634311512
Nandurbar,Chillies(Red),2014,1784,2710,926,51.90582959641256
Kurdwadi-Modnimb,Gram,2015,2599,3525,926,35.62908811081185
Kolhapur,MAIZE(CORN.),2016,518,1444,926,178.76447876447875
Mumbai,Melon,2016,932,1858,926,99.35622317596567
Sangali,Wheat(Husked),2016,1826,2752,926,50.71193866374589
Mangalwedha,Wheat(Husked),2015,1275,2201,926,72.62745098039215
Chikhali,Gram,2015,3668,4594,926,25.2453653217012
Chikhali,Gram,2014,2150,3076,926,43.06976744186046
Barshi,Sorgum(Jawar),2015,1602,2528,926,57.80274656679151
Manmad,Gram,2015,3976,4902,926,23.2897384305835
Baramati,Onion,2016,193,1119,926,479.79274611398966
Jalna,Mosambi,2015,1337,2263,926,69.25953627524308
Alibag,Rice(Paddy-Hus),2016,3339,4265,926,27.732854147948487
Kalyan,Mosambi,2016,1325,2250,925,69.81132075471699
Palus,Tomato,2016,800,1725,925,115.625
Malkapur,Black Gram,2014,4308,5233,925,21.471680594243267
Kalyan,Green-Peas,2015,4450,5375,925,20.786516853932586
Ramtek,Coriander  ,2016,2275,3200,925,40.65934065934066
Osmanabad,Pigeon Pea (Tur),2016,7500,8425,925,12.333333333333334
Akluj,Shevga,2015,1250,2175,925,74.0
Ulhasnagar,Bajri,2016,1950,2875,925,47.43589743589744
Indapur-Bhigwan,Cowpea,2016,6197,7122,925,14.92657737614975
Mumbai,Spilt Gerrn Gram,2016,8254,9179,925,11.206687666585898
Nampur,Ground Nut Pods (Dry),2016,3806,4731,925,24.303730951129793
Akole,Tomato,2015,200,1125,925,462.5
Shrirampur,Lemon,2016,1500,2425,925,61.666666666666664
Taloda,Green Gram,2016,5875,6800,925,15.74468085106383
Umared,Gram,2016,4533,5458,925,20.405912199426428
Lasalgaon,Soybean,2016,2846,3771,925,32.501756851721716
Chandrapur-Ganjwad,Capsicum,2014,1538,2463,925,60.14304291287386
Kalyan,Chikoo,2015,2005,2930,925,46.13466334164588
Parshiwani,Other Vegetables,2016,950,1875,925,97.36842105263158
Ulhasnagar,Sorgum(Jawar),2016,2442,3367,925,37.878787878787875
Shrirampur,Pomegranate,2015,3550,4475,925,26.056338028169016
Karad,Garlic,2016,7650,8575,925,12.091503267973856
Jalgaon,Ladies Finger,2015,1550,2475,925,59.67741935483871
Pune,Bottle Gourd,2015,500,1425,925,185.0
Kolhapur,Wal Bhaji,2016,988,1913,925,93.62348178137651
Ahmednagar,Jaggery,2015,2175,3100,925,42.52873563218391
Kalamb (Os),Gram,2016,6550,7475,925,14.122137404580153
Palus,Ladies Finger,2016,1400,2325,925,66.07142857142857
Shrirampur,Lemon,2016,1900,2825,925,48.68421052631579
Lonar,Green Gram,2014,6492,7417,925,14.248305606900802
Mandhal,Chillies(Red),2016,4378,5303,925,21.12836911831887
Malegaon (Washim),BLACK GRAM,2016,6250,7175,925,14.8
Jamkhed,Onion,2016,142,1067,925,651.4084507042254
Nandurbar,Gram,2015,2872,3797,925,32.2075208913649
Baramati,Wheat(Unhusked),2016,2283,3207,924,40.473061760841
Khamgaon,Gram,2015,4012,4936,924,23.030907278165504
Pune,Bitter Gourd,2016,1324,2248,924,69.78851963746223
Kada,WHEAT(HUSKED),2016,1711,2635,924,54.003506721215665
Chandrapur-Ganjwad,Onion,2016,632,1556,924,146.20253164556962
Pune,Brinjal,2015,562,1486,924,164.41281138790035
Satara,Green-Peas,2015,3812,4736,924,24.239244491080797
Kopargaon,ONION,2016,161,1085,924,573.9130434782609
Bhivandi,Rice(Paddy-Hus),2016,2176,3100,924,42.463235294117645
Nashik,Cabbage,2016,541,1465,924,170.79482439926062
Akola,Gram,2015,3873,4797,924,23.857474825716498
Chandrapur-Ganjwad,Tomato,2016,888,1812,924,104.05405405405405
Hinganghat,Pigeon Pea (Tur),2016,5510,6433,923,16.7513611615245
Patan,Green Chilli,2015,2731,3654,923,33.79714390333211
Nampur,Pomegranate,2016,47,970,923,1963.8297872340424
Chandrapur,Papai,2016,533,1456,923,173.17073170731706
Mangalwedha,Gram,2015,4072,4995,923,22.666994106090375
Pimpalgaon Basawant,Onion,2014,838,1761,923,110.14319809069212
Nandurbar,CHILLIES(RED),2016,1517,2440,923,60.84377059986816
Osmanabad,Flower,2015,1360,2283,923,67.86764705882354
Pune-Manjri,Tomato,2014,1124,2047,923,82.11743772241992
Mumbai,Papai,2015,900,1823,923,102.55555555555556
Amarawati,Black Gram,2015,6192,7115,923,14.906330749354005
Pune,Pumpkin,2015,818,1741,923,112.8361858190709
Lasalgaon,Gram,2015,4024,4947,923,22.93737574552684
Deglur,Pigeon Pea (Tur),2015,8033,8956,923,11.490103323789368
Indapur,Sorgum(Jawar),2016,1871,2794,923,49.331908070550504
Akola,Wheat(Husked),2016,1773,2696,923,52.05865764241399
Junnar-Otur,Green Chilli,2016,608,1531,923,151.80921052631578
Mumbai,Pomegranate,2014,4862,5785,923,18.983957219251337
Pune,Curry Leaves,2015,1077,2000,923,85.70102135561746
Aurangabad,Onion,2015,395,1318,923,233.67088607594937
Jalgaon,Green Chilli,2015,1183,2106,923,78.02197802197803
Sangali,Wheat(Husked),2016,1858,2781,923,49.67707212055974
Dhule,ONION,2016,201,1124,923,459.2039800995025
Ahmednagar,Onion,2016,90,1013,923,1025.5555555555557
Chandrapur-Ganjwad,Math (Bhaji),2014,1792,2715,923,51.50669642857143
Kolhapur-Malkapur,Tomato,2016,178,1100,922,517.9775280898876
Khed-Chakan,Bitter Gourd,2016,3778,4700,922,24.40444679724722
Akluj,Shevga,2016,1111,2033,922,82.98829882988299
Nashik,Shepu,2014,443,1365,922,208.12641083521444
Chandur Rly.,Black Gram,2016,5938,6860,922,15.527113506231053
Nagpur,Orange,2014,754,1675,921,122.14854111405836
Ratanagari,Ladies Finger,2015,2763,3684,921,33.333333333333336
Daryapur,Gram,2015,3714,4635,921,24.79806138933764
Sangrampur,Black Gram,2015,4779,5700,921,19.271814187068426
Akola,Green Gram,2016,4198,5119,921,21.939018580276322
Indapur,Wheat(Husked),2016,1561,2482,921,59.00064061499039
Yeotmal,Pigeon Pea (Tur),2015,6363,7284,921,14.474304573314475
Kamthi,Brinjal,2014,918,1839,921,100.32679738562092
Satana,Green Gram,2015,6026,6947,921,15.28377032857617
Pune,Bitter Gourd,2015,1617,2538,921,56.957328385899814
Ratanagari,Brinjal,2014,2868,3789,921,32.11297071129707
Jalgaon,Brinjal,2015,1026,1947,921,89.76608187134502
Nira,Sorgum(Jawar),2015,1638,2559,921,56.227106227106226
Kada,Wheat(Husked),2016,1500,2421,921,61.4
Kamthi,Flower,2016,879,1800,921,104.77815699658703
Mangalwedha,Bitter Gourd,2016,4050,4971,921,22.74074074074074
Indapur,Ground Nut Pods (Dry),2016,4000,4921,921,23.025
Pune-Manjri,Coriander  ,2015,520,1440,920,176.92307692307693
Kamthi,Parwar,2015,1247,2167,920,73.77706495589415
Bhokar,Turmeric,2014,4034,4954,920,22.806147744174517
Sangali,Wheat(Husked),2016,1936,2856,920,47.52066115702479
Pune-Pimpri,Ladies Finger,2015,2660,3580,920,34.58646616541353
Osmanabad,CARROT,2016,1120,2040,920,82.14285714285714
Purna,Green Gram,2014,5256,6176,920,17.503805175038053
Ausa,Coriander (Dry),2014,7157,8077,920,12.854547994969959
Kolhapur,Cucumber,2015,351,1271,920,262.1082621082621
Vadgaon Peth,Bitter Gourd,2015,1520,2440,920,60.526315789473685
Basmat,Pigeon Pea (Tur),2016,8300,9220,920,11.08433734939759
Khed-Chakan,LADIES FINGER,2016,2140,3060,920,42.99065420560748
Dhule,Green Gram,2016,5194,6114,920,17.71274547554871
Vadgaon Peth,Ridge Gourd,2015,1980,2900,920,46.464646464646464
Rahuri,Cabbage,2015,240,1160,920,383.3333333333333
Pune,Wal Bhaji,2014,1950,2870,920,47.17948717948718
Ramtek,Spinach,2015,2630,3550,920,34.98098859315589
Nilanga,Green Gram,2016,4000,4920,920,23.0
Anajngaon Surji,Pigeon Pea (Tur),2015,8100,9020,920,11.358024691358025
Kalamb (Yawatmal),Pigeon Pea (Tur),2016,7160,8080,920,12.849162011173185
Lasur Station,Sorgum(Jawar),2016,1436,2356,920,64.06685236768803
Pune,Chavli (Shenga ),2015,1430,2350,920,64.33566433566433
Rahuri,Melon,2016,283,1203,920,325.0883392226148
Akola,Green Gram,2016,5437,6357,920,16.921096192753357
Akluj,Onion,2015,880,1800,920,104.54545454545455
Ahmednagar,Onion,2016,100,1020,920,920.0
Dhule,Pigeon Pea (Tur),2015,6445,7365,920,14.274631497284718
Mumbai,Water Melon,2016,733,1653,920,125.51159618008185
Kolhapur,Flower,2015,275,1194,919,334.1818181818182
Pune-Manjri,Raddish,2014,1181,2100,919,77.81541066892464
Amarawati,SESAMUM,2016,6319,7238,919,14.543440417787625
Baramati,ONION,2016,200,1119,919,459.5
Mumbai,Potato,2014,1458,2377,919,63.03155006858711
Lonand,Sorgum(Jawar),2016,1600,2519,919,57.4375
Baramati,Sorgum(Jawar),2015,1613,2532,919,56.97458152510849
Kolhapur,Pineapple,2015,844,1763,919,108.88625592417061
Amarawati-Fruit And Vegetables,Lemon,2016,2405,3324,919,38.21205821205821
Kurdwadi,Pigeon Pea (Tur),2015,7746,8664,918,11.851278079008521
Osmanabad,Lemon,2014,896,1814,918,102.45535714285714
Daryapur,Gram,2016,3535,4453,918,25.968882602545968
Nashik,Brinjal,2016,1241,2159,918,73.97260273972603
Pulgaon,Pigeon Pea (Tur),2015,5100,6018,918,18.0
Barshi,Sorgum(Jawar),2015,1670,2588,918,54.97005988023952
Shevgaon,Sorgum(Jawar),2014,1604,2522,918,57.231920199501246
Akluj,Chikoo,2015,1718,2636,918,53.43422584400466
Anajngaon Surji,Black Gram,2016,5988,6906,918,15.330661322645291
Pune,Curry Leaves,2014,1047,1965,918,87.67908309455588
Dondaicha,Ground Nut Pods (Dry),2015,3498,4416,918,26.243567753001717
Vasai,Onion,2015,1488,2406,918,61.693548387096776
Ratanagari,Capsicum,2014,2083,3000,917,44.023043686989915
Nashik,Cucumber,2015,1141,2058,917,80.3680981595092
Chandrapur,Papai,2016,533,1450,917,172.04502814258913
Phaltan,Green Gram,2016,4850,5767,917,18.90721649484536
Shrirampur,Garlic,2015,3500,4417,917,26.2
Shrirampur,Mango,2015,3500,4417,917,26.2
Mangalwedha,Bitter Gourd,2016,746,1663,917,122.92225201072387
Ausa,Green Gram,2014,6606,7523,917,13.881320012110203
Chandrapur,Papai,2015,1083,2000,917,84.67220683287165
Vai,Cluster Bean,2016,3500,4417,917,26.2
Vai,Pavtta,2016,3833,4750,917,23.923819462561962
Shrirampur,Ground Nut Pods (Dry),2015,3500,4417,917,26.2
Nagpur,Gram,2016,6912,7829,917,13.266782407407407
Mangaon(Bhadav),Nachani,2015,1450,2367,917,63.241379310344826
Manchar,Coriander  ,2015,169,1086,917,542.603550295858
Khed-Chakan,Bitter Gourd,2016,3896,4813,917,23.536960985626283
Ulhasnagar,Gr.Nut Kernels,2016,7000,7917,917,13.1
Pune-Manjri,Pavtta,2016,1983,2900,917,46.243066061522946
Pune-Pimpri,Bitter Gourd,2016,4683,5600,917,19.581464872944693
Sangali,Jaggery,2015,2441,3358,917,37.566571077427284
Malkapur,Green Gram,2014,6544,7461,917,14.01283618581907
Barshi-Vairag,Black Gram,2014,3530,4447,917,25.977337110481585
Vasai,Potato,2016,1283,2200,917,71.47310989867498
Ratanagari,Ladies Finger,2015,3571,4488,917,25.679081489778774
Jalgaon,Black Gram,2015,8213,9130,917,11.165225861439183
Chandvad,ONION,2016,324,1241,917,283.0246913580247
Barshi,Gram,2016,4437,5354,917,20.667117421681315
Rahuri-Vambori,Pigeon Pea (Tur),2015,8026,8942,916,11.412908048841265
Nandurbar,Cluster Bean,2014,4391,5307,916,20.860851742199955
Pune-Manjri,Pavtta,2015,2363,3279,916,38.76428269149386
Pune-Manjri,BRINJAL,2016,1043,1959,916,87.823585810163
Shrirampur,Ginger (Fresh),2016,2528,3444,916,36.234177215189874
Ratanagari,Capsicum,2016,2806,3722,916,32.64433357091946
Nandurbar,Chillies(Red),2016,6300,7216,916,14.53968253968254
Khed-Chakan,Green-Peas,2016,8167,9083,916,11.215868740051427
Pune-Manjri,Kardai,2015,67,983,916,1367.1641791044776
Amarawati,Sesamum,2016,5417,6333,916,16.909728632084178
Mumbai,Papai,2015,821,1737,916,111.57125456760049
Sillod,Gram,2016,4973,5889,916,18.419465111602655
Indapur,Ground Nut Pods (Dry),2015,4617,5533,916,19.83972276369937
Kalyan,Banana,2016,4017,4933,916,22.803086880756783
Sangali,Lentil,2016,6492,7408,916,14.109673444239064
Barshi,Turmeric,2015,5373,6289,916,17.04820398287735
Akkolkot,Wheat(Husked),2016,1250,2166,916,73.28
Jalgaon Jamod,Ground Nut Pods (Dry),2016,4414,5329,915,20.729497054825554
Pune,Cucumber,2015,711,1626,915,128.69198312236287
Amalner,Soybean,2015,2614,3529,915,35.00382555470543
Devani,Pigeon Pea (Tur),2015,8001,8916,915,11.436070491188602
Ratanagari,Flower,2015,2085,3000,915,43.884892086330936
Pune,Pumpkin,2016,1005,1920,915,91.04477611940298
Jalgaon,Flower,2015,1005,1920,915,91.04477611940298
Amarawati,Lemon,2016,2121,3036,915,43.14002828854314
Rahuri-Vambori,Onion,2016,177,1092,915,516.9491525423729
Palghar(Bevur),Rice(Paddy-Hus),2015,2256,3171,915,40.558510638297875
Mumbai,Split Gram,2016,6923,7838,915,13.216813520150223
Barshi,Green Gram,2016,4300,5215,915,21.27906976744186
Vadgaon Peth,Cucumber,2016,1155,2070,915,79.22077922077922
Kalyan,Shevga,2015,3577,4492,915,25.58009505171932
Umarga,Black Gram,2014,4641,5556,915,19.715578539107952
Alibag,RICE(PADDY-HUS),2016,3324,4239,915,27.52707581227437
Sangali,Sorgum(Jawar),2015,1682,2597,915,54.39952437574316
Pathari,Green Gram,2015,7011,7926,915,13.05091998288404
Aurangabad,Flower,2015,2400,3315,915,38.125
Sakri,Ground Nut Pods (Dry),2016,3551,4466,915,25.76738946775556
Pune,Chavli (Shenga ),2016,1459,2373,914,62.64564770390678
Rahata,Ladies Finger,2016,1550,2464,914,58.96774193548387
Kamthi,Flower,2014,1136,2050,914,80.45774647887323
Daryapur,Gram,2016,3798,4712,914,24.065297525013165
Solapur,Potato,2016,430,1344,914,212.5581395348837
Jalgaon,Ginger (Fresh),2015,2550,3464,914,35.84313725490196
Kamthi,Orange,2016,429,1343,914,213.05361305361305
Mohol,Sorgum(Jawar),2015,1650,2564,914,55.39393939393939
Nampur,ONION,2016,275,1189,914,332.3636363636364
Lonar,Black Gram,2016,6256,7170,914,14.60997442455243
Solapur,Carrot,2016,492,1406,914,185.77235772357724
Pune,Elephant Root,2014,1300,2214,914,70.3076923076923
Jalna,Gram,2016,5399,6313,914,16.929060937210593
Sangrampur-Varvatbakal,Gram,2016,3444,4358,914,26.53890824622532
Jamkhed,Sorgum(Jawar),2015,1622,2536,914,56.3501849568434
Khamgaon,Green Gram,2016,3627,4541,914,25.19988971601875
Kolhapur,Bottle Gourd,2015,357,1271,914,256.02240896358546
Shrirampur,Lemon,2015,3413,4326,913,26.750659244066803
Shrirampur,Custard Apple,2014,2565,3478,913,35.59454191033139
Shahada,Green Gram,2016,5367,6280,913,17.011365753679897
Achalpur,Pigeon Pea (Tur),2015,6480,7393,913,14.089506172839506
Dudhani,Sorgum(Jawar),2015,1197,2110,913,76.27401837928154
Jalgaon,Coriander  ,2016,827,1740,913,110.39903264812575
Pune-Manjri,Goosefoot,2014,500,1413,913,182.6
Osmanabad,Brinjal,2015,650,1563,913,140.46153846153845
Jalgaon,Orange,2015,900,1813,913,101.44444444444444
Shrirampur,Bitter Gourd,2015,1609,2522,913,56.7433188315724
Kalamb (Os),Wheat(Husked),2015,1564,2477,913,58.37595907928389
Ambejogai,Gram,2016,6638,7551,913,13.754142814100632
Pune,Curry Leaves,2015,1400,2313,913,65.21428571428571
Kamthi,Ladies Finger,2016,1210,2123,913,75.45454545454545
Hinganghat,Pigeon Pea (Tur),2015,6427,7340,913,14.205694725377315
Kalyan,Capsicum,2016,5226,6139,913,17.470340604668962
Kolhapur,Beet Root,2015,856,1769,913,106.6588785046729
Nilanga,Pigeon Pea (Tur),2016,6100,7012,912,14.950819672131148
Jalgaon,Brinjal,2014,1663,2575,912,54.840649428743234
Pathari,Pigeon Pea (Tur),2015,5567,6479,912,16.38225255972696
Nira-Saswad,Sorgum(Jawar),2015,1600,2512,912,57.0
Pandharpur,Brinjal,2015,479,1391,912,190.39665970772444
Kej,Black Gram,2016,5847,6759,912,15.59774243201642
Koregaon,Ghevda Seed,2014,2788,3700,912,32.7116212338594
Pune,Ginger (Fresh),2016,976,1888,912,93.44262295081967
Nagpur,Orange,2015,665,1577,912,137.14285714285714
Nagpur,Chikoo,2015,900,1812,912,101.33333333333333
Gevrai,Pigeon Pea (Tur),2015,5563,6475,912,16.394031997123854
Pimpalgaon (B)-Saykheda,Onion,2015,445,1357,912,204.9438202247191
Ratanagari,Cucumber,2015,988,1900,912,92.3076923076923
Nandurbar,Ground Nut Pods (Dry),2016,4481,5393,912,20.35259986610132
Pune-Manjri,Bottle Gourd,2015,639,1550,911,142.56651017214398
Sinner,Matki,2016,6050,6961,911,15.057851239669422
Indapur-Bhigwan,Sorgum(Jawar),2015,1415,2326,911,64.38162544169612
Kamthi,Carrot,2016,1356,2267,911,67.18289085545723
Kamthi,Chavli (Pala),2016,1103,2014,911,82.59292837715321
Nashik,Grapes,2016,1920,2831,911,47.447916666666664
Nagpur,Mosambi,2014,904,1815,911,100.77433628318585
Nashik,Orange,2015,600,1511,911,151.83333333333334
Murum,Green Gram,2015,7228,8139,911,12.603763143331488
Nashik,Ghosali(Bhaji),2016,1741,2652,911,52.32624928202183
Jalgaon Jamod-Aasalgaon,Pigeon Pea (Tur),2016,5500,6411,911,16.563636363636363
Kolhapur,Potato,2016,1174,2085,911,77.59795570698466
Parbhani,Green Gram,2014,5526,6437,911,16.485703944987332
Satara,Ladies Finger,2015,1712,2623,911,53.21261682242991
Indapur-Bhigwan,Pigeon Pea (Tur),2015,3400,4311,911,26.794117647058822
Solapur,Ridge Gourd,2016,350,1261,911,260.2857142857143
Pune-Manjri,SPINACH,2016,672,1583,911,135.5654761904762
Shahapur,Chavli (Shenga ),2016,2633,3544,911,34.599316369160654
Amarawati,Sesamum,2016,6964,7875,911,13.081562320505457
Karanja,Black Gram,2016,6306,7217,911,14.446558832857596
Ulhasnagar,Gram,2016,4367,5278,911,20.861002976871994
Satara,Onion,2016,911,1822,911,100.0
Junnar-Otur,CUCUMBER,2016,879,1789,910,103.52673492605233
Nandgaon,Onion,2014,698,1608,910,130.37249283667623
Baramati,Pigeon Pea (Tur),2016,6430,7340,910,14.152410575427682
Khed (Shel Pimpalgaon),Cluster Bean,2014,2441,3351,910,37.279803359278986
Yeotmal,Pigeon Pea (Tur),2015,5778,6688,910,15.749394254067152
Solapur,Matki,2014,5615,6525,910,16.20658949243099
Satara,Tomato,2015,2053,2963,910,44.32537749634681
Sangali,Jaggery,2016,3060,3970,910,29.73856209150327
Majalgaon,Sorgum(Jawar),2015,1217,2127,910,74.77403451109285
Loha,Sesamum,2015,5711,6621,910,15.934162143232358
Lasalgaon,Black Gram,2015,6939,7849,910,13.11428159677187
Chandrapur-Ganjwad,Coriander  ,2016,990,1900,910,91.91919191919192
Sinner,Pigeon Pea (Tur),2016,6535,7445,910,13.925019127773528
Kolhapur-Laxmipuri,Spilt Gerrn Gram,2016,7173,8083,910,12.686463125609926
Kamthi,Brinjal,2016,1224,2134,910,74.34640522875817
Ambejogai,Gram,2014,1854,2764,910,49.083063646170444
Varud-Rajura Bazar,Pigeon Pea (Tur),2014,3840,4750,910,23.697916666666668
Jalna,Pigeon Pea (Tur),2016,7750,8660,910,11.741935483870968
Sangali,Jaggery,2015,2280,3190,910,39.91228070175438
Satara,Flower,2014,1591,2500,909,57.133878064110625
Mumbai,Split Gram,2016,7682,8591,909,11.832856027076282
Nagpur,Onion,2014,911,1820,909,99.78046103183316
Ahmednagar,Potato,2015,1318,2227,909,68.96813353566009
Umarga,Green Gram,2015,7108,8017,909,12.78840742824986
Pune,Pumpkin,2014,552,1461,909,164.67391304347825
Sangali,Wheat(Husked),2016,1900,2809,909,47.8421052631579
Kurdwadi-Modnimb,Gram,2015,3330,4239,909,27.2972972972973
Rahata,Capsicum,2014,2818,3727,909,32.256919801277505
Ulhasnagar,Bajri,2016,1733,2642,909,52.452394691286784
Sangamner,Gram,2016,4655,5564,909,19.52738990332975
Mumbai,Split Lentil,2016,5339,6248,909,17.02566023599925
Ulhasnagar,Bajri,2016,1636,2545,909,55.562347188264056
Shrirampur,Pomegranate,2015,3409,4318,909,26.664711058961572
Pune-Pimpri,Ladies Finger,2015,2548,3457,909,35.67503924646782
Mumbai,Jaggery,2015,2800,3709,909,32.464285714285715
Jalgaon,Onion,2015,428,1336,908,212.14953271028037
Sangli-Phale Bhajipalam,Onion,2016,280,1188,908,324.2857142857143
Nagpur,Wal Bhaji,2016,3700,4608,908,24.54054054054054
Khamgaon,Sesamum,2015,5338,6246,908,17.010116148370177
Mangrulpeer,Gram,2015,3577,4485,908,25.384400335476656
Pune,Flower,2015,670,1578,908,135.52238805970148
Nandura,Pigeon Pea (Tur),2016,7520,8428,908,12.074468085106384
Solapur,Bor,2014,262,1170,908,346.5648854961832
Amarawati,Sesamum,2016,5577,6485,908,16.281154742693204
Pathari,Gram,2016,8359,9267,908,10.86254336643139
Pune-Manjri,Shepu,2015,624,1532,908,145.51282051282053
Rahuri-Vambori,Green Gram,2015,6902,7810,908,13.155607070414373
Umared,Green Gram,2015,4927,5834,907,18.40876801298965
Murbad,Capsicum,2016,4400,5307,907,20.613636363636363
Gevrai,Wheat(Husked),2016,1668,2575,907,54.37649880095923
Murud,Rice(Paddy-Hus),2016,2593,3500,907,34.978789047435406
Ghoti,Ladies Finger,2015,2986,3893,907,30.375083724045545
Naigaon,Green Gram,2016,4161,5068,907,21.797644796923816
Mumbai,Jaggery,2014,2863,3770,907,31.680055885434857
Kurdwadi,Onion,2014,260,1167,907,348.84615384615387
Pandharpur,Cabbage,2015,579,1486,907,156.64939550949913
Kolhapur,Flower,2015,266,1173,907,340.97744360902254
Mehkar,Gram,2015,3870,4777,907,23.43669250645995
Pusad,Gram,2016,4483,5390,907,20.231987508364934
Kamthi,Tomato,2016,883,1790,907,102.71800679501699
Osmanabad,Onion,2015,944,1850,906,95.97457627118644
Shahada,Pigeon Pea (Tur),2016,6581,7487,906,13.766904725725574
Pathardi,Onion,2016,188,1094,906,481.9148936170213
Dhule,Pigeon Pea (Tur),2015,4252,5158,906,21.307619943555974
Ramtek,Dhemse,2016,2506,3412,906,36.15323224261772
Shrirampur,Lemon,2016,1563,2469,906,57.965451055662186
Khamgaon,Green Gram,2014,7029,7935,906,12.889457959880495
Pune,Lentil,2015,6888,7794,906,13.153310104529616
Vadgaon Peth,Brinjal,2016,1065,1971,906,85.07042253521126
Barshi,Bitter Gourd,2016,1389,2295,906,65.2267818574514
Hingoli,Green Gram,2015,6256,7162,906,14.482097186700766
Solapur,Carrot,2015,337,1243,906,268.8427299703264
Pathari,SOYBEAN,2016,1765,2671,906,51.331444759206796
Patan,Ginger (Fresh),2015,3000,3906,906,30.2
Gadhinglaj,Jaggery,2014,2234,3139,905,40.510295434198746
Ratanagari,Brinjal,2015,1432,2337,905,63.19832402234637
Lasalgaon-Vinchur,Gram,2015,2894,3799,905,31.271596406357983
Akola,Green Gram,2015,6526,7431,905,13.867606497088568
Pune-Manjri,Bottle Gourd,2015,705,1610,905,128.36879432624113
Pune,Bottle Gourd,2015,677,1582,905,133.67799113737075
Pune,Pavtta,2015,1683,2588,905,53.77302436125966
Nagpur,Gram,2015,3864,4769,905,23.421325051759833
Vadgaon Peth,Tomato,2015,619,1524,905,146.20355411954765
Nashik,Bottle Gourd,2016,810,1715,905,111.72839506172839
Pune,Capsicum,2014,1137,2042,905,79.59542656112576
Savner,Pigeon Pea (Tur),2015,7000,7904,904,12.914285714285715
Nagpur,Onion,2015,869,1773,904,104.02761795166859
Khed,Green Chilli,2016,827,1731,904,109.31076178960097
Sangali,Sorgum(Jawar),2016,1725,2629,904,52.405797101449274
Manchar,Ladies Finger,2016,1150,2054,904,78.6086956521739
Barshi,Green Gram,2015,7337,8241,904,12.321112171187133
Satara,Ladies Finger,2016,2472,3376,904,36.56957928802589
Udgir,Pigeon Pea (Tur),2015,5856,6760,904,15.437158469945356
Hingoli,Turmeric,2016,7927,8831,904,11.404062066355493
Palghar(Bevur),RICE(PADDY-HUS),2016,2569,3473,904,35.188789412222654
Jalgaon,Ginger (Fresh),2016,1055,1959,904,85.68720379146919
Pusad,Spilt Pigeon Pea,2015,10827,11731,904,8.349496628798374
Barshi,Onion,2016,60,964,904,1506.6666666666667
Mumbai,Green Chilli,2014,3192,4096,904,28.32080200501253
Karad,Jaggery,2016,3250,4154,904,27.815384615384616
Paithan,Pigeon Pea (Tur),2015,5364,6268,904,16.8530947054437
Aurangabad,Orange,2014,1073,1977,904,84.24976700838769
Washim,Pigeon Pea (Tur),2016,8173,9076,903,11.048574574819527
Parli-Vaijnath,Pigeon Pea (Tur),2015,4978,5881,903,18.139815186822016
Hingoli,Black Gram,2016,6127,7030,903,14.738044720091398
Pimpalgaon (B)-Saykheda,Onion,2015,309,1212,903,292.2330097087379
Mehkar,Pigeon Pea (Tur),2014,3875,4778,903,23.303225806451614
Malkapur,Soybean,2015,3016,3919,903,29.94031830238727
Shirpur,Green Gram,2016,3871,4774,903,23.32730560578662
Mangalwedha,Gram,2014,2032,2935,903,44.438976377952756
Kamthi,Chavli (Shenga ),2016,1536,2439,903,58.7890625
Sakri,Ground Nut Pods (Dry),2015,3798,4701,903,23.77567140600316
Mumbai,Orange,2014,978,1881,903,92.33128834355828
Gevrai,Pigeon Pea (Tur),2015,7910,8813,903,11.415929203539823
Kamthi,Cabbage,2015,690,1593,903,130.8695652173913
Vadgaon Peth,Tomato,2016,744,1646,902,121.23655913978494
Latur,Green Gram,2016,4088,4990,902,22.06457925636008
Murum,Black Gram,2016,9594,10496,902,9.401709401709402
Nashik,Potato,2016,528,1430,902,170.83333333333334
Akkolkot,Wheat(Unhusked),2016,2700,3602,902,33.407407407407405
Nira-Saswad,Rice(Paddy-Hus),2016,2780,3682,902,32.44604316546763
Sangali,Wheat(Husked),2016,1885,2787,902,47.851458885941646
Ausa,Gram,2016,6279,7181,902,14.365344800127408
Pandharpur,Cabbage,2016,631,1533,902,142.94770206022187
Barshi,Black Gram,2016,6256,7158,902,14.418158567774936
Parli-Vaijnath,Pigeon Pea (Tur),2015,4797,5698,901,18.782572441109025
Palghar(Bevur),Rice(Paddy-Hus),2014,2001,2902,901,45.02748625687156
Kej,Rala,2016,1500,2401,901,60.06666666666667
Sonpeth,Pigeon Pea (Tur),2015,5175,6076,901,17.41062801932367
Mehkar,Gram,2016,4895,5796,901,18.406537282941777
Nandura,Gram,2015,3655,4556,901,24.651162790697676
Mantha,Gram,2016,4450,5351,901,20.247191011235955
Sailu,Green Gram,2015,6916,7817,901,13.027761711972238
Yeola,Pigeon Pea (Tur),2016,6600,7501,901,13.651515151515152
Lasalgaon,Green Gram,2016,5900,6801,901,15.271186440677965
Nashik,Ladies Finger,2016,2085,2986,901,43.21342925659472
Nandurbar,Ground Nut Pods (Dry),2015,4664,5565,901,19.318181818181817
Pathari,Pigeon Pea (Tur),2015,8900,9801,901,10.123595505617978
Kalamb (Os),Pigeon Pea (Tur),2015,4885,5786,901,18.444216990788128
Ulhasnagar,Bajri,2016,1883,2783,900,47.79607010090282
Pavani,Pigeon Pea (Tur),2016,6300,7200,900,14.285714285714286
Tuljapur,Turmeric,2015,6067,6967,900,14.834349761002143
Newasa-Ghodegaon,Onion,2016,125,1025,900,720.0
Lonand,Wheat(Husked),2016,1475,2375,900,61.016949152542374
Pune-Pimpri,Cluster Bean,2015,2042,2942,900,44.07443682664055
Nashik,Kharbuj,2016,600,1500,900,150.0
Jalgaon,AMLA,2016,1100,2000,900,81.81818181818181
Ratanagari,Flower,2016,2650,3550,900,33.9622641509434
Pune-Manjri,Raddish,2016,900,1800,900,100.0
Mumbai,Papai,2015,509,1409,900,176.81728880157172
Jalgaon,Ladies Finger,2015,1075,1975,900,83.72093023255815
Ratanagari,Ground Nut Pods (Dry),2014,3300,4200,900,27.272727272727273
Aurangabad,Orange,2014,600,1500,900,150.0
Chandrapur,Grapes,2016,2500,3400,900,36.0
Satara,Ladies Finger,2016,3460,4360,900,26.01156069364162
Solapur,Bor,2015,500,1400,900,180.0
Ratanagari,Ginger (Fresh),2016,3100,4000,900,29.032258064516128
Dondaicha,Chillies(Red),2015,3758,4658,900,23.94890899414582
Nashik,Papai,2015,900,1800,900,100.0
Amarawati,Black Gram,2015,6335,7235,900,14.20678768745067
Pune-Manjri,Harbara(Pendi),2015,760,1660,900,118.42105263157895
Kolhapur,Beet Root,2015,1100,2000,900,81.81818181818181
Kamthi,Jack Fruit(Raw),2015,700,1600,900,128.57142857142858
Pune,Wal Papdi,2014,1904,2804,900,47.26890756302521
Vadgaon Peth,Green Chilli,2015,1235,2135,900,72.8744939271255
Mangaon(Bhadav),Nagali,2016,1300,2200,900,69.23076923076923
Nashik,Melon,2015,725,1625,900,124.13793103448276
Pune-Manjri,Goosefoot,2015,0,900,900,inf
Indapur,Cowpea,2015,4700,5600,900,19.148936170212767
Osmanabad,Water Melon,2016,600,1500,900,150.0
Solapur,Onion,2016,104,1004,900,865.3846153846154
Jalgaon,Mango(Raw),2015,936,1836,900,96.15384615384616
Murum,Pigeon Pea (Tur),2016,8234,9134,900,10.930289045421423
Indapur-Bhigwan,Pavtta,2015,2475,3375,900,36.36363636363637
Mumbai,Chavli (Shenga ),2016,5300,6200,900,16.9811320754717
Dound,Lemon,2016,1250,2150,900,72.0
Varora,Pigeon Pea (Tur),2015,6136,7036,900,14.667535853976531
Amalner,Soybean,2016,2500,3400,900,36.0
Jalgaon Jamod,Pigeon Pea (Tur),2016,5600,6500,900,16.071428571428573
Jalgaon Jamod,Pigeon Pea (Tur),2016,7075,7975,900,12.720848056537102
Pune-Pimpri,Green Chilli,2016,3900,4800,900,23.076923076923077
Indapur-Bhigwan,Chillies(Red),2016,5500,6400,900,16.363636363636363
Dudhani,Black Gram,2015,6100,7000,900,14.754098360655737
Pune-Manjri,Bitter Gourd,2016,5100,6000,900,17.647058823529413
Palus,Cucumber,2016,2100,3000,900,42.857142857142854
Lasalgaon,Black Gram,2015,7501,8401,900,11.998400213304892
Osmanabad,Cucumber,2015,705,1605,900,127.65957446808511
Chopda,Gram,2015,3650,4550,900,24.65753424657534
Shrirampur,Onion,2016,100,1000,900,900.0
Kannad,Ginger (Fresh),2016,1600,2500,900,56.25
Aurangabad,Flower,2016,1419,2319,900,63.424947145877375
Ratanagari,Ginger (Fresh),2016,3100,4000,900,29.032258064516128
Pune,Bottle Gourd,2015,518,1418,900,173.74517374517376
Pune,Wal Bhaji,2015,2806,3706,900,32.07412687099073
Pune-Manjri,Ambat Chuka,2015,900,1800,900,100.0
Nashik,Potato,2015,200,1100,900,450.0
Barshi,Small Gourd,2016,1600,2500,900,56.25
Kada,Tamarind,2016,5700,6600,900,15.789473684210526
Basmat (Kurunda),Turmeric,2016,7200,8100,900,12.5
Nashik,Wal Papdi,2015,875,1775,900,102.85714285714286
Pune-Pimpri,Small Gourd,2016,500,1400,900,180.0
Sailu,GRAM,2016,6750,7650,900,13.333333333333334
Ahmednagar,Tomato,2016,227,1127,900,396.4757709251101
Daryapur,Sorgum(Jawar),2015,1145,2045,900,78.60262008733625
Jintur-Bori,Green Gram,2014,4980,5880,900,18.072289156626507
Kada,Pigeon Pea (Tur),2016,5900,6800,900,15.254237288135593
Vadgaon Peth,Cucumber,2016,1200,2100,900,75.0
Koregaon,Coriander (Dry),2015,9600,10500,900,9.375
Pune,Snake Gourd,2014,953,1853,900,94.43861490031479
Pathari,Sorgum(Jawar),2014,1500,2400,900,60.0
Parshiwani,Other Vegetables,2016,1600,2500,900,56.25
Kalyan,Green Gram,2016,6800,7700,900,13.235294117647058
Patan,Bitter Gourd,2015,2700,3600,900,33.333333333333336
Kolhapur,Melon,2016,1800,2700,900,50.0
Koregaon,Onion,2015,700,1600,900,128.57142857142858
Kalyan,Green Gram,2016,7450,8350,900,12.080536912751677
Pune,Chavli (Pala),2014,1350,2250,900,66.66666666666667
Pune-Manjri,Shepu,2014,577,1477,900,155.97920277296362
Varud,Mosambi,2014,1200,2100,900,75.0
Varud,Orange,2014,700,1600,900,128.57142857142858
Shahapur,Shevga,2015,3500,4400,900,25.714285714285715
Nashik,Ginger (Fresh),2014,1900,2800,900,47.36842105263158
Ghoti,Squash Gourd,2016,1000,1900,900,90.0
Osmanabad,Garlic,2014,2300,3200,900,39.130434782608695
Solapur,Coriander  ,2015,300,1200,900,300.0
Sangali,HORSE GRAM,2016,3300,4200,900,27.272727272727273
Jalgaon Jamod-Aasalgaon,Pigeon Pea (Tur),2016,7100,8000,900,12.67605633802817
Nagpur,Potato,2016,706,1606,900,127.47875354107649
Ramtek,Ginger (Fresh),2016,3350,4250,900,26.865671641791046
Kalyan,Gram,2015,4438,5338,900,20.279405137449302
Nagpur,Potato,2016,732,1632,900,122.95081967213115
Ahmednagar,Onion,2016,100,1000,900,900.0
Kopargaon,Pigeon Pea (Tur),2015,6213,7113,900,14.485755673587638
Ramtek,Garlic,2015,5511,6411,900,16.33097441480675
Pune-Manjri,Cucumber,2015,1243,2143,900,72.40547063555913
Pune-Manjri,Cucumber,2015,757,1657,900,118.89035667107001
Kamthi,Kanda Pat,2016,1238,2138,900,72.69789983844912
Pune-Manjri,Shepu,2016,600,1500,900,150.0
Shrirampur,Grapes,2016,2500,3400,900,36.0
Pathardi,Pigeon Pea (Tur),2016,7000,7900,900,12.857142857142858
Aurangabad,Ground Nut Pods (Dry),2015,3040,3940,900,29.605263157894736
Chandrapur,Kharbuj,2015,1100,2000,900,81.81818181818181
Chandrapur-Ganjwad,CAPSICUM,2016,1000,1900,900,90.0
Shrigonda,Lemon,2016,2356,3256,900,38.20033955857385
Jalgaon Jamod-Aasalgaon,Black Gram,2015,4967,5867,900,18.11958928930944
Ulhasnagar,Wheat(Husked),2015,2130,3030,900,42.25352112676056
Newasa,Pigeon Pea (Tur),2015,6183,7083,900,14.55604075691412
Junnar,Onion,2015,750,1650,900,120.0
Chandrapur,Apple,2015,4000,4900,900,22.5
Dound,Cowpea,2015,6000,6900,900,15.0
Vadgaon Peth,Capsicum,2015,1085,1985,900,82.94930875576037
Shrirampur,Cluster Bean,2016,3129,4029,900,28.763183125599234
Manmad,Onion,2014,733,1633,900,122.78308321964529
Junnar-Otur,Cucumber,2016,1500,2400,900,60.0
Indapur,Wheat(Husked),2016,1651,2551,900,54.51241671714113
Pune-Manjri,Chavli (Pala),2015,429,1329,900,209.7902097902098
Pune,Snake Gourd,2014,929,1829,900,96.8783638320775
Ahmednagar,Cabbage,2016,383,1283,900,234.98694516971278
Khed,Cucumber,2016,803,1703,900,112.07970112079701
Pune-Manjri,Methi (Bhaji),2015,494,1394,900,182.18623481781376
Akluj,Potato,2014,1779,2679,900,50.5902192242833
Palus,Shevga,2016,2000,2900,900,45.0
Ratanagari,French Bean,2015,2900,3800,900,31.03448275862069
Karad,Chikoo,2015,1285,2185,900,70.03891050583658
Jalgaon,Papai,2016,1100,2000,900,81.81818181818181
Pune,Gram,2014,3841,4741,900,23.431398073418382
Chalisgaon,BLACK GRAM,2016,4500,5400,900,20.0
Ratanagari,Cluster Bean,2016,2200,3100,900,40.90909090909091
Phaltan,Gram,2015,3100,4000,900,29.032258064516128
Chalisgaon,Black Gram,2014,3992,4892,900,22.54509018036072
Kej,Sesamum,2015,7150,8050,900,12.587412587412587
Osmanabad,Kharbuj,2015,1150,2050,900,78.26086956521739
Akluj,Carrot,2016,1225,2125,900,73.46938775510205
Pune-Manjri,Goosefoot,2015,375,1275,900,240.0
Jalgaon,BRINJAL,2016,490,1390,900,183.6734693877551
Pune-Manjri,Harbara(Pendi),2014,873,1773,900,103.09278350515464
Rahuri-Vambori,Onion,2016,154,1054,900,584.4155844155844
Vadgaon Peth,Bottle Gourd,2014,1100,2000,900,81.81818181818181
Ratanagari,Ladies Finger,2016,2033,2933,900,44.26955238563699
Balapur,Green Gram,2016,5875,6775,900,15.319148936170214
Akhadabalapur,Turmeric,2015,6500,7400,900,13.846153846153847
Kada (Ashti),SORGUM(JAWAR),2016,1825,2725,900,49.31506849315068
Chalisgaon,Black Gram,2016,5600,6500,900,16.071428571428573
Osmanabad,Kharbuj,2015,600,1500,900,150.0
Purna,Turmeric,2015,6620,7520,900,13.595166163141993
Ratanagari,Cluster Bean,2016,2050,2950,900,43.90243902439025
Amarawati,Green Gram,2015,6700,7600,900,13.432835820895523
Murbad,Ghevda,2016,5917,6817,900,15.210410681088389
Indapur,Wheat(Husked),2016,1558,2457,899,57.70218228498074
Jalna,Mosambi,2015,1078,1977,899,83.3951762523191
Indapur-Bhigwan,Wheat(Husked),2016,1583,2482,899,56.79090334807328
Lasalgaon,Pigeon Pea (Tur),2016,7234,8133,899,12.42742604368261
Dondaicha,Ground Nut Pods (Dry),2016,4361,5260,899,20.614537950011464
Kurdwadi,Sorgum(Jawar),2016,1529,2428,899,58.79659908436887
Manmad,Green Gram,2016,5851,6750,899,15.364894889762434
Sakri,Ground Nut Pods (Dry),2016,2593,3492,899,34.670266101041264
Indapur,Sorgum(Jawar),2015,1407,2306,899,63.894811656005686
Ahmednagar,Pigeon Pea (Tur),2015,4813,5711,898,18.657801786827342
Jalna,Green Gram,2015,6750,7648,898,13.303703703703704
Devala,Onion,2014,771,1669,898,116.47211413748379
Barshi-Vairag,Sorgum(Jawar),2014,1163,2061,898,77.21410146173689
Hinganghat,Pigeon Pea (Tur),2016,5629,6527,898,15.953100017765145
Nashik,WAL PAPDI,2016,835,1733,898,107.54491017964072
Ahmedpur,Green Gram,2014,5963,6861,898,15.05953379171558
Amarawati,Sesamum,2016,5638,6536,898,15.927633912735013
Akot,Ground Nut Pods (Dry),2016,4802,5700,898,18.70054144106622
Majalgaon,Sorgum(Jawar),2015,1092,1990,898,82.23443223443223
Deglur,Green Gram,2014,5513,6411,898,16.28877199346998
Malegaon,Onion,2015,597,1495,898,150.41876046901172
Pimpalgaon (B)-Saykheda,Onion,2016,391,1288,897,229.41176470588235
Barshi-Vairag,Sorgum(Jawar),2016,1562,2459,897,57.42637644046095
Pune-Manjri,Green Chilli,2016,926,1823,897,96.8682505399568
Vadgaon Peth,Tomato,2014,746,1643,897,120.24128686327077
Kamthi,Chavli (Shenga ),2016,681,1578,897,131.71806167400882
Mangrulpeer,Gram,2015,3214,4111,897,27.90914747977598
Kamthi,Raddish,2014,844,1741,897,106.27962085308057
Kurdwadi-Modnimb,Onion,2016,67,964,897,1338.8059701492537
Katol,Pigeon Pea (Tur),2015,6290,7187,897,14.260731319554848
Osmanabad,Ground Nut Pods (Dry),2014,3053,3950,897,29.38093678349165
Sangali,Sorgum(Jawar),2015,1667,2563,896,53.74925014997
Jintur,Turmeric,2015,6213,7109,896,14.421374537260583
Chalisgaon,Flower,2016,1486,2382,896,60.296096904441455
Khed-Chakan,Cluster Bean,2016,2184,3080,896,41.02564102564103
Pune,GHOSALI(BHAJI),2016,1172,2068,896,76.45051194539249
Nandurbar,Chillies(Red),2014,1754,2650,896,51.08323831242873
Pune,BITTER GOURD,2016,1316,2212,896,68.08510638297872
Kamthi,Chavli (Pala),2015,730,1626,896,122.73972602739725
Dondaicha,Ground Nut Pods (Dry),2014,3189,4085,896,28.096582000627155
Pune,Chavli (Shenga ),2015,1132,2028,896,79.15194346289752
Shirpur,Green Gram,2015,6336,7232,896,14.141414141414142
Kamthi,Guava,2015,936,1832,896,95.72649572649573
Karanja,Pigeon Pea (Tur),2015,4753,5649,896,18.851251840942563
Satara,Bitter Gourd,2016,5375,6271,896,16.669767441860465
Nandgaon,Onion,2016,493,1388,895,181.54158215010142
Umarga,Pigeon Pea (Tur),2015,8451,9346,895,10.590462667139983
Sangli-Phale Bhajipalam,Potato,2016,738,1633,895,121.27371273712737
Bhokar,Turmeric,2015,6636,7531,895,13.487040385774563
Jalgaon,Ginger (Fresh),2016,1535,2430,895,58.306188925081436
Dhule,Pigeon Pea (Tur),2015,7147,8042,895,12.522736812648663
Umarga,Maize,2014,1050,1945,895,85.23809523809524
Khed-Chakan,Chavli (Shenga ),2016,1290,2185,895,69.37984496124031
Pune,Elephant Root,2016,1947,2842,895,45.96815613764766
Aurangabad,Green Chilli,2014,1513,2408,895,59.15399867812293
Ramtek,Wal Bhaji,2015,1965,2860,895,45.5470737913486
Barshi,Coriander (Dry),2016,5540,6435,895,16.15523465703971
Akluj,Brinjal,2015,1128,2022,894,79.25531914893617
Rajura,Cotton,2016,3912,4806,894,22.85276073619632
Kolhapur,Onion,2016,300,1194,894,298.0
Sangamner,Onion,2016,300,1194,894,298.0
Manmad,Onion,2015,356,1250,894,251.12359550561797
Solapur,Capsicum,2015,614,1508,894,145.6026058631922
Kille Dharur,Wheat(Husked),2015,2751,3645,894,32.49727371864776
Barshi,Pigeon Pea (Tur),2015,6614,7508,894,13.516782582400968
Akkolkot,Black Gram,2016,6496,7390,894,13.76231527093596
Shahada,Gram,2015,3465,4359,894,25.8008658008658
Jalna,Sorgum(Jawar),2016,1312,2206,894,68.14024390243902
Akluj,Chikoo,2015,1853,2747,894,48.246087425796006
Kolhapur,Ginger (Fresh),2016,2438,3331,893,36.62838392124692
Sangali,Gram,2016,6627,7520,893,13.47517730496454
Nashik-Devlali,Spinach,2016,493,1386,893,181.13590263691682
Vasai,Onion,2015,1200,2093,893,74.41666666666667
Akola,Gram,2015,3508,4401,893,25.456100342075256
Ahmednagar,GRAM,2016,7057,7950,893,12.654102309763356
Pathari,Pigeon Pea (Tur),2015,4943,5836,893,18.065951851102568
Jalna,Pigeon Pea (Tur),2015,4623,5516,893,19.316461172398874
Nira-Saswad,Rice(Paddy-Hus),2016,2750,3643,893,32.472727272727276
Kolhapur,Sweet Potato,2015,455,1348,893,196.26373626373626
Sindi (Selu),Pigeon Pea (Tur),2016,7739,8632,893,11.53895852177284
Kurdwadi-Modnimb,Sorgum(Jawar),2015,1061,1953,892,84.07163053722903
Solapur,Green Chilli,2016,451,1343,892,197.78270509977827
Latur-Murud,Gram,2016,3348,4240,892,26.642771804062125
Vadgaon Peth,Ridge Gourd,2015,1608,2500,892,55.472636815920396
Manora,Pigeon Pea (Tur),2015,5213,6105,892,17.111068482639556
Shrirampur,Gram,2015,3496,4388,892,25.51487414187643
Shahada,Gram,2015,4000,4892,892,22.3
Nagpur,Green Chilli,2016,3948,4840,892,22.59371833839919
Rahuri-Vambori,Onion,2016,100,992,892,892.0
Nandurbar,Gram,2016,4335,5227,892,20.57670126874279
Hinganghat,Soybean,2015,2856,3748,892,31.23249299719888
Rahata,Green Chilli,2016,4262,5154,892,20.929141248240263
Pune,Carrot,2016,768,1660,892,116.14583333333333
Shegaon,Black Gram,2015,8231,9123,892,10.837079334224274
Nashik,Coriander  ,2015,275,1167,892,324.3636363636364
Nagpur,Grapes,2015,2043,2935,892,43.66128242780225
Beed,Green Gram,2014,5619,6510,891,15.856914041644421
Purna,Pigeon Pea (Tur),2015,7500,8391,891,11.88
Solapur,Carrot,2016,537,1428,891,165.9217877094972
Jalgaon,Brinjal,2014,1277,2168,891,69.77290524667188
Jalgaon,Chavli (Shenga ),2015,1764,2655,891,50.51020408163265
Nanded,Pigeon Pea (Tur),2015,7565,8456,891,11.77792465300727
Kolhapur,Maize(Corn.),2016,392,1283,891,227.29591836734693
Mumbai,Jaggery,2015,2873,3764,891,31.012878524190743
Mumbai,Spilt Gerrn Gram,2015,9514,10405,891,9.365146100483498
Indapur-Bhigwan,Ground Nut Pods (Dry),2016,4550,5441,891,19.582417582417584
Mumbai-Fruit Market,Water Melon,2016,864,1755,891,103.125
Pune-Pimpri,Brinjal,2015,1718,2609,891,51.86263096623981
Nagpur,Gram,2015,3617,4508,891,24.63367431573127
Dondaicha,Wheat(Husked),2016,1452,2343,891,61.36363636363637
Mumbai,Split Gram,2016,9338,10229,891,9.541657742557293
Lonand,Onion,2014,722,1613,891,123.40720221606648
Kalvan,Ground Nut Pods (Dry),2015,3554,4445,891,25.070343275182893
Vadgaon Peth,Flower,2015,1064,1954,890,83.64661654135338
Ramtek,Ginger (Fresh),2016,2003,2893,890,44.433349975037444
Aarni,Pigeon Pea (Tur),2014,4020,4910,890,22.139303482587064
Patur,Gram,2015,4010,4900,890,22.194513715710723
Kille Dharur,Cotton,2016,4069,4959,890,21.872695994101743
Ambejogai,Gram,2016,6638,7528,890,13.40765290750226
Kolhapur-Malkapur,Flower,2016,250,1140,890,356.0
Kalamb (Os),Green Gram,2015,6733,7623,890,13.218476162186247
Chopda,Black Gram,2014,3835,4725,890,23.20730117340287
Lasalgaon-Niphad,Onion,2015,612,1502,890,145.4248366013072
Shahada,Gram,2015,3040,3930,890,29.276315789473685
Murtizapur,Pigeon Pea (Tur),2015,4528,5418,890,19.65547703180212
Kada,SORGUM(JAWAR),2016,1930,2820,890,46.1139896373057
Nashik,Kanda Pat,2016,909,1799,890,97.9097909790979
Karad,Chikoo,2015,1180,2070,890,75.42372881355932
Rahuri-Vambori,Sunflower,2016,2000,2890,890,44.5
Kamthi,Flower,2016,607,1497,890,146.62273476112026
Mohol,Gram,2016,7594,8484,890,11.719778772715301
Sangali,Chillies(Red),2014,8660,9550,890,10.277136258660509
Pune-Moshi,Green-Peas,2016,3733,4623,890,23.841414412001072
Jalgaon,GINGER (FRESH),2016,905,1795,890,98.34254143646409
Ramtek,Garlic,2016,2781,3671,890,32.002876663070836
Gangapur,Gram,2016,7516,8406,890,11.84140500266099
Vadgaon Peth,Bitter Gourd,2015,1310,2200,890,67.93893129770993
Kurdwadi-Modnimb,Black Gram,2015,7800,8689,889,11.397435897435898
Junnar-Otur,WALVAD,2016,769,1658,889,115.60468140442133
Murbad,Ghosali(Bhaji),2016,4444,5333,889,20.004500450045004
Shahapur,Shevga,2015,4111,5000,889,21.624908781318414
Mangaon(Bhadav),Nachani,2016,1378,2267,889,64.51378809869377
Satara,Ginger (Fresh),2016,1678,2567,889,52.97973778307509
Murud,Rice(Paddy-Hus),2016,2374,3263,889,37.44734625105308
Solapur,Ghevda,2015,1969,2858,889,45.149822244794315
Sangali,Wheat(Husked),2016,1903,2792,889,46.71571203363111
Ratanagari,Ladies Finger,2014,2333,3222,889,38.10544363480497
Pune,Mula Shenga,2016,1333,2222,889,66.69167291822956
Shrirampur,Shevga,2016,3111,4000,889,28.57602057216329
Ahmednagar,Green Gram,2016,4649,5538,889,19.12239191223919
Shrirampur,Cluster Bean,2016,3500,4389,889,25.4
Solapur,Pigeon Pea (Tur),2016,7327,8216,889,12.133205950593695
Pune-Manjri,Chavli (Pala),2014,575,1463,888,154.43478260869566
Murbad,Ladies Finger,2016,4541,5429,888,19.555164060779564
Osmanabad,Ground Nut Pods (Dry),2015,2006,2894,888,44.267198404785645
Pune,Bitter Gourd,2015,1856,2744,888,47.8448275862069
Mumbai,Cucumber,2014,600,1488,888,148.0
Majalgaon,Wheat(Husked),2016,1479,2367,888,60.04056795131846
Kamthi,Kanda Pat,2016,648,1536,888,137.03703703703704
Navapur,Tomato,2015,1675,2563,888,53.014925373134325
Paithan,Bajri,2016,1440,2328,888,61.666666666666664
Pune,Capsicum,2014,1268,2156,888,70.03154574132492
Jalgaon,Lemon,2015,1327,2215,888,66.9178598342125
Kolhapur,Onion,2016,304,1192,888,292.10526315789474
Khed-Chakan,Bitter Gourd,2016,3820,4708,888,23.24607329842932
Amarawati,Sesamum,2016,7125,8013,888,12.463157894736842
Solapur,Bor,2015,469,1356,887,189.12579957356076
Ausa,Ground Nut Pods (Dry),2014,2901,3788,887,30.575663564288178
Achalpur,Pigeon Pea (Tur),2015,4513,5400,887,19.654331929980057
Amarawati,Chikoo,2016,1573,2460,887,56.38906547997457
Pune,Curry Leaves,2015,1113,2000,887,79.69451931716083
Solapur,Potato,2016,703,1590,887,126.17354196301565
Lasalgaon,Ground Nut Pods (Dry),2015,4563,5450,887,19.438965592811748
Barshi,Tamarind,2015,3649,4536,887,24.308029597149904
Solapur,Tomato,2015,126,1013,887,703.968253968254
Karad,Green-Peas,2015,3386,4273,887,26.196101594802126
Shrirampur,Pomegranate,2016,2636,3523,887,33.649468892261
Karanja,Ground Nut Pods (Dry),2016,4751,5638,887,18.66975373605557
Chandur Bajar,Pigeon Pea (Tur),2015,4914,5801,887,18.05046805046805
Aurangabad,Tomato,2016,1307,2193,886,67.78882938026014
Indapur,Wheat(Husked),2015,1419,2305,886,62.43833685694151
Vasai,Potato,2015,943,1829,886,93.95546129374337
Nilanga,Green Gram,2015,7040,7926,886,12.585227272727273
Ratanagari,Ginger (Fresh),2016,3014,3900,886,29.396151293961513
Dondaicha-Sindkheda,Pigeon Pea (Tur),2016,6293,7179,886,14.079135547433657
Jalgaon,Shevga,2015,2957,3843,886,29.962800135272236
Chandrapur,Chikoo,2016,1757,2643,886,50.42686397268071
Aurangabad,Capsicum,2015,1543,2429,886,57.42060920285159
Udgir,Green Gram,2014,5834,6720,886,15.186835790195406
Pune-Manjri,Tomato,2016,1227,2113,886,72.20863895680522
Dondaicha,Ground Nut Pods (Dry),2016,4299,5185,886,20.609444056757386
Sangamner,Tomato,2015,381,1267,886,232.54593175853017
Ahmedpur,SESAMUM,2016,4043,4929,886,21.914419985159537
Pune-Manjri,BITTER GOURD,2016,1762,2648,886,50.28376844494892
Pune-Manjri,Spinach,2016,675,1560,885,131.11111111111111
Pune-Pimpri,Squash Gourd,2016,5828,6713,885,15.185312285518188
Amarawati,Green Gram,2015,7123,8008,885,12.42454022181665
Akkolkot,Black Gram,2014,4437,5322,885,19.945909398242055
Chandrapur-Ganjwad,Math (Bhaji),2014,1211,2096,885,73.08009909165979
Jalgaon Jamod-Aasalgaon,Pigeon Pea (Tur),2016,5936,6821,885,14.909029649595688
Ratanagari,Green Chilli,2015,2577,3462,885,34.342258440046564
Vadgaon Peth,Ladies Finger,2014,992,1877,885,89.21370967741936
Paithan,Onion,2016,161,1046,885,549.6894409937888
Gadhinglaj,Jaggery,2014,2203,3088,885,40.172492056286885
Ramtek,Dhemse,2016,2329,3214,885,37.99914126234435
Nagpur,Mosambi,2014,1177,2062,885,75.1911639762107
Kamthi,Raddish,2014,805,1690,885,109.93788819875776
Mehkar,Pigeon Pea (Tur),2016,5627,6512,885,15.727741247556425
Kada,Wheat(Husked),2016,1575,2460,885,56.19047619047619
Pune-Manjri,Spinach,2014,533,1417,884,165.85365853658536
Patan,Ginger (Fresh),2014,3513,4397,884,25.16367776828921
Ambad(Vadi Godri),Sorgum(Jawar),2016,1369,2253,884,64.572680788897
Kamthi,Raddish,2016,520,1404,884,170.0
Jalgaon,Amla,2014,883,1767,884,100.11325028312571
Pune-Moshi,Cluster Bean,2016,3533,4417,884,25.021228417775262
Pune-Moshi,Bitter Gourd,2016,3033,3917,884,29.14606000659413
Lonand,Onion,2014,775,1659,884,114.06451612903226
Sangali,Wheat(Unhusked),2015,2677,3561,884,33.02203959656332
Kolhapur,GUAVA,2016,783,1667,884,112.89910600255428
Mumbai,Papai,2016,502,1386,884,176.09561752988049
Buldhana,Black Gram,2016,6083,6967,884,14.532303139898076
Nashik,Bor,2016,983,1867,884,89.92878942014242
Mangrulpeer,PIGEON PEA (TUR),2016,4951,5835,884,17.854978792163198
Pune-Moshi,Ghevda,2016,2633,3517,884,33.573870110140525
Aurangabad,Cluster Bean,2015,2321,3205,884,38.087031451960364
Solapur,Carrot,2015,622,1506,884,142.12218649517686
Ahmednagar,GREEN CHILLI,2016,483,1367,884,183.02277432712216
Ahmednagar,CUCUMBER,2016,583,1467,884,151.6295025728988
Vai,Green Chilli,2016,4308,5192,884,20.51996285979573
Karmala,Ground Nut Pods (Dry),2016,5016,5900,884,17.62360446570973
Ratanagari,Cucumber,2014,1700,2583,883,51.94117647058823
Nagpur,Onion,2015,965,1848,883,91.50259067357513
Kalamb (Os),Green Gram,2015,6936,7819,883,12.730680507497116
Jalna,Sorgum(Jawar),2015,1179,2062,883,74.89397794741306
Akluj,Chillies(Red),2016,1117,2000,883,79.05102954341987
Vadgaon Peth,Brinjal,2015,1042,1925,883,84.74088291746641
Kurdwadi-Modnimb,Bor,2015,941,1824,883,93.83634431455899
Karad,Banana,2014,1767,2650,883,49.971703452178836
Aurangabad,Wal Bhaji,2016,2350,3233,883,37.57446808510638
Yeotmal,Pigeon Pea (Tur),2015,4598,5481,883,19.20400173988691
Kurdwadi,Tamarind,2015,1984,2867,883,44.506048387096776
Shrirampur,Gram,2016,5046,5929,883,17.49900911613159
Pune,Green Chilli,2016,600,1483,883,147.16666666666666
Pune-Pimpri,Bitter Gourd,2015,3000,3883,883,29.433333333333334
Pune,Parwar,2015,1878,2761,883,47.01810436634718
Kalyan,Green Chilli,2016,3525,4407,882,25.02127659574468
Khamgaon,Pigeon Pea (Tur),2014,3871,4753,882,22.78481012658228
Barshi,Gram,2015,3422,4304,882,25.77440093512566
Ratanagari,Green Chilli,2015,3265,4147,882,27.013782542113322
Ratanagari,Green Chilli,2015,3294,4176,882,26.775956284153004
Rahata,Onion,2016,133,1015,882,663.1578947368421
Shrirampur,Cluster Bean,2015,1971,2853,882,44.74885844748859
Karad,Shevga,2015,3091,3973,882,28.534454868974443
Shrirampur,Ginger (Fresh),2014,4357,5238,881,20.220335092953867
Jalkot,Pigeon Pea (Tur),2016,8163,9044,881,10.792600759524685
Satana,Gram,2015,3682,4563,881,23.927213470939705
Kalamb (Os),Pigeon Pea (Tur),2014,3203,4084,881,27.50546362784889
Satana,ONION,2016,250,1131,881,352.4
Kamthi,POTATO,2016,975,1856,881,90.35897435897436
Palghar(Bevur),Rice(Paddy-Hus),2016,2502,3383,881,35.21183053557154
Sangali,Wheat(Husked),2016,1874,2755,881,47.011739594450376
Barshi,Turmeric,2015,5453,6334,881,16.15624426920961
Malegaon,Gram,2016,6144,7025,881,14.339192708333334
Ratanagari,Tomato,2015,1252,2133,881,70.36741214057508
Shrirampur,Brinjal,2016,1476,2357,881,59.68834688346883
Solapur,Wheat(Husked),2015,1757,2638,881,50.14228799089357
Pune-Manjri,Shepu,2014,1125,2006,881,78.31111111111112
Shrirampur,Ginger (Fresh),2016,2020,2900,880,43.56435643564357
Pune-Manjri,Chavli (Shenga ),2015,1210,2090,880,72.72727272727273
Kurdwadi-Modnimb,BOR,2016,1460,2340,880,60.273972602739725
Palus,Tomato,2016,553,1433,880,159.13200723327304
Satara,Capsicum,2016,3200,4080,880,27.5
Jalgaon,Chavli (Shenga ),2014,3590,4470,880,24.512534818941504
Manchar,Ghevda,2016,1820,2700,880,48.35164835164835
Risod,Black Gram,2015,9029,9909,880,9.746372798759552
Kamthi,Elephant Root,2016,1200,2080,880,73.33333333333333
Malegaon,Gram,2015,4105,4985,880,21.43727161997564
Nira-Saswad,Gram,2016,3830,4710,880,22.97650130548303
Samudrapur,Pigeon Pea (Tur),2016,6985,7865,880,12.598425196850394
Chandrapur-Ganjwad,Chavli (Shenga ),2016,1000,1880,880,88.0
Ambad(Vadi Godri),Sorgum(Jawar),2016,1316,2196,880,66.8693009118541
Ausa,Black Gram,2014,5126,6006,880,17.167381974248926
Kamthi,Papai,2016,720,1600,880,122.22222222222223
Jalgaon Jamod-Aasalgaon,Green Gram,2015,6940,7820,880,12.680115273775217
Paranda,Sorgum(Jawar),2015,1880,2760,880,46.808510638297875
Mangalwedha,Bitter Gourd,2015,2208,3088,880,39.85507246376812
Koregaon,Ghevda Seed,2015,3120,4000,880,28.205128205128204
Mauda,Green Gram,2016,4621,5501,880,19.043497078554424
Kalyan,Small Gourd,2016,3204,4083,879,27.43445692883895
Barshi,Sorgum(Jawar),2016,1602,2481,879,54.8689138576779
Barshi,Coriander  ,2016,471,1350,879,186.62420382165604
Pune,Wal Papdi,2016,1304,2183,879,67.4079754601227
Akot,Sesamum,2015,5867,6746,879,14.982103289585819
Akot,Black Gram,2015,7394,8273,879,11.888017311333513
Kej,Pigeon Pea (Tur),2016,7061,7940,879,12.448661662654015
Akluj,Brinjal,2015,1205,2084,879,72.9460580912863
Baramati,Ground Nut Pods (Dry),2016,4422,5301,879,19.87788331071913
Shirpur,Ground Nut Pods (Dry),2016,3817,4696,879,23.02855645795127
Kille Dharur,Bajri,2014,1389,2268,879,63.2829373650108
Vaijapur,Gram,2016,5995,6874,879,14.662218515429524
Chandrapur,Chikoo,2015,1429,2307,878,61.44156752974108
Lonar,Green Gram,2016,4572,5450,878,19.20384951881015
Barshi-Vairag,Sorgum(Jawar),2016,1699,2577,878,51.6774573278399
Pune-Moshi,Cucumber,2016,1079,1957,878,81.37164040778498
Murtizapur,Pigeon Pea (Tur),2015,9473,10351,878,9.26844716562863
Osmanabad,Carrot,2014,783,1661,878,112.13282247765007
Jintur,Green Gram,2015,7621,8499,878,11.520797795564887
Nashik,Shepu,2014,395,1273,878,222.27848101265823
Satana,Onion,2014,995,1873,878,88.24120603015075
Nashik,Flower,2016,993,1871,878,88.41893252769385
Aurangabad,Capsicum,2015,1995,2873,878,44.010025062656645
Vasai,Tomato,2015,889,1767,878,98.76265466816648
Kolhapur,Cucumber,2015,348,1226,878,252.29885057471265
Khed,Cucumber,2016,829,1707,878,105.91073582629674
Jalgaon Jamod-Aasalgaon,Green Gram,2016,4000,4878,878,21.95
Nashik,Onion,2016,187,1065,878,469.5187165775401
Barshi,Pigeon Pea (Tur),2015,4703,5581,878,18.66893472251754
Kamthi,Potato,2015,577,1454,877,151.99306759098786
Kille Dharur,Pigeon Pea (Tur),2015,4779,5656,877,18.351119481062984
Kolhapur,Onion,2016,300,1177,877,292.3333333333333
Patan,Ginger (Fresh),2015,2647,3524,877,33.1318473743861
Chopda,Soybean,2015,2443,3320,877,35.89848546868604
Pandharpur,Onion,2016,158,1035,877,555.0632911392405
Mumbai,Split Gram,2015,5719,6596,877,15.33484874978143
Nagpur,Gram,2016,5874,6751,877,14.930200885257065
Murtizapur,Pigeon Pea (Tur),2015,6260,7137,877,14.00958466453674
Kalyan,Green Chilli,2015,2667,3544,877,32.88338957630296
Pune-Manjri,Walvad,2016,2410,3287,877,36.39004149377593
Mumbai,Spilt Gerrn Gram,2016,8081,8958,877,10.852617250340304
Khed-Chakan,Green Chilli,2016,2919,3796,877,30.044535799931484
Pune-Manjri,Coriander  ,2014,473,1350,877,185.4122621564482
Karad,Cluster Bean,2015,2692,3569,877,32.57800891530461
Akluj,Brinjal,2016,1162,2038,876,75.38726333907057
Dhule,Onion,2015,628,1504,876,139.4904458598726
Indapur-Bhigwan,Ground Nut Pods (Dry),2015,3350,4226,876,26.149253731343283
Lasalgaon,Black Gram,2016,8400,9276,876,10.428571428571429
Kopargaon,Green Gram,2014,5880,6756,876,14.89795918367347
Sangali,Sorgum(Jawar),2016,1686,2562,876,51.95729537366548
Jalgaon,Bitter Gourd,2015,1100,1976,876,79.63636363636364
Phaltan,Wheat(Husked),2015,1400,2276,876,62.57142857142857
Baramati,Ground Nut Pods (Dry),2016,4625,5501,876,18.94054054054054
Kamthi,Chavli (Pala),2015,819,1695,876,106.95970695970696
Ghatanji,Cotton,2016,4136,5012,876,21.179883945841393
Kalvan,Green Gram,2015,7100,7976,876,12.338028169014084
Jamkhed,Gram,2016,5875,6750,875,14.893617021276595
Vadgaon Peth,Bitter Gourd,2015,1083,1958,875,80.79409048938135
Kalyan,Chikoo,2015,2250,3125,875,38.888888888888886
Junnar-Otur,CAPSICUM,2016,900,1775,875,97.22222222222223
Beed,GRAM,2016,8013,8888,875,10.919755397479097
Khed-Chakan,Ghosali(Bhaji),2016,3000,3875,875,29.166666666666668
Kolhapur-Laxmipuri,Spilt Pigeon Pea,2016,11800,12675,875,7.415254237288136
Karad,Pomegranate,2015,1625,2500,875,53.84615384615385
Ratanagari,Ginger (Fresh),2016,3250,4125,875,26.923076923076923
Indapur-Bhigwan,Pigeon Pea (Tur),2016,5700,6575,875,15.350877192982455
Mumbai,Green Peas (Dry),2015,2710,3585,875,32.28782287822878
Shrirampur,Garlic,2015,3500,4375,875,25.0
Chandrapur,Chikoo,2016,1475,2350,875,59.32203389830509
Pune-Manjri,Spinach,2014,850,1725,875,102.94117647058823
Kolhapur,Melon,2016,1625,2500,875,53.84615384615385
Aurangabad,Squash Gourd,2016,1400,2275,875,62.5
Kolhapur,Chavli (Shenga ),2015,1500,2375,875,58.333333333333336
Shrirampur,Garlic,2016,4250,5125,875,20.58823529411765
Shrirampur,Orange,2015,1625,2500,875,53.84615384615385
Pune-Manjri,Chavli (Pala),2014,450,1325,875,194.44444444444446
Pune-Manjri,Kardai,2015,100,975,875,875.0
Mumbai,Ginger (Dry),2016,2000,2875,875,43.75
Pune-Manjri,Rajgira,2015,100,975,875,875.0
Mumbai,Ginger (Dry),2015,4075,4950,875,21.47239263803681
Ratanagari,Ginger (Fresh),2015,3750,4625,875,23.333333333333332
Amarawati,Ginger (Fresh),2015,2625,3500,875,33.333333333333336
Shrirampur,Garlic,2014,2500,3375,875,35.0
Ratanagari,Ginger (Fresh),2015,4250,5125,875,20.58823529411765
Rahata,Green Chilli,2016,3708,4583,875,23.59762675296656
Basmat,Turmeric,2016,7325,8200,875,11.945392491467576
Kalyan,Guava,2015,2858,3733,875,30.615815255423374
Gondiya,Tamarind,2016,4842,5717,875,18.071045022717886
Vadgaon Peth,Flower,2015,809,1684,875,108.15822002472189
Ramtek,Bitter Gourd,2016,1875,2750,875,46.666666666666664
Shrirampur,Mosambi,2015,2500,3375,875,35.0
Ratanagari,Capsicum,2015,1750,2625,875,50.0
Nashik,GINGER (FRESH),2016,2095,2970,875,41.766109785202865
Ratanagari,Green-Peas,2016,6000,6875,875,14.583333333333334
Ahmednagar,Onion,2016,110,985,875,795.4545454545455
Ratanagari,Cluster Bean,2016,3125,4000,875,28.0
Nashik,Melon,2016,615,1490,875,142.27642276422765
Chalisgaon,Brinjal,2016,1100,1975,875,79.54545454545455
Manchar,Ladies Finger,2016,2250,3125,875,38.888888888888886
Phaltan,Bajri,2016,1275,2150,875,68.62745098039215
Rahata,Ladies Finger,2015,1333,2208,875,65.64141035258815
Chandrapur,Bor,2015,1125,2000,875,77.77777777777777
Kada,Gram,2015,3763,4638,875,23.25272389051289
Satara,Bitter Gourd,2014,2875,3750,875,30.434782608695652
Sillod-Bharadi,Pigeon Pea (Tur),2016,6500,7375,875,13.461538461538462
Solapur,GREEN CHILLI,2016,471,1346,875,185.77494692144373
Indapur-Bhigwan,Sesamum,2016,5625,6500,875,15.555555555555555
Ratanagari,Cluster Bean,2015,2875,3750,875,30.434782608695652
Indapur-Bhigwan,Black Gram,2016,5350,6225,875,16.35514018691589
Ratanagari,Maize(Corn.),2015,4125,5000,875,21.21212121212121
Ratanagari,Tomato,2016,1230,2105,875,71.13821138211382
Ratanagari,Cucumber,2015,1188,2063,875,73.65319865319866
Latur,Pigeon Pea (Tur),2015,6774,7649,875,12.917035724830233
Pathardi,Onion,2016,200,1075,875,437.5
Jamkhed,Green Gram,2015,5375,6250,875,16.27906976744186
Dhule,Onion,2015,306,1181,875,285.9477124183006
Rahuri,CUCUMBER,2016,225,1100,875,388.8888888888889
Umared,Coriander (Dry),2015,7522,8396,874,11.619250199415049
Yawal,Banana,2016,556,1430,874,157.19424460431654
Babhulgaon,Pigeon Pea (Tur),2015,6663,7537,874,13.117214467957377
Nagpur,Potato,2016,587,1461,874,148.89267461669505
Mumbai,Brinjal,2015,500,1374,874,174.8
Aurangabad,Orange,2016,904,1778,874,96.68141592920354
Gevrai,Pigeon Pea (Tur),2015,8070,8944,874,10.830235439900868
Pune-Pimpri,Green Chilli,2015,2284,3158,874,38.2661996497373
Solapur,Onion,2016,92,966,874,950.0
Solapur,Wheat(Husked),2015,1835,2709,874,47.62942779291553
Pune,Tomato,2015,617,1491,874,141.65316045380874
Ambad(Vadi Godri),WHEAT(HUSKED),2016,1670,2544,874,52.33532934131737
Akluj,Carrot,2016,1273,2147,874,68.65671641791045
Nashik,Squash Gourd,2016,1549,2423,874,56.42349903163331
Dondaicha,Green Gram,2016,4236,5109,873,20.609065155807365
Amarawati-Fruit And Vegetables,Chikoo,2016,1553,2426,873,56.2137797810689
Akluj,Brinjal,2014,1469,2342,873,59.42818243703199
Umared,Pigeon Pea (Tur),2015,4820,5693,873,18.112033195020746
Akola,Pigeon Pea (Tur),2015,6493,7366,873,13.445248729400893
Barshi,Ladies Finger,2016,1232,2105,873,70.8603896103896
Kurdwadi-Modnimb,Sorgum(Jawar),2015,1250,2123,873,69.84
Kamthi,Tomato,2015,699,1572,873,124.89270386266094
Gevrai,Wheat(Husked),2016,1626,2499,873,53.690036900369
Lasalgaon-Vinchur,Soybean,2015,2458,3331,873,35.5166802278275
Karanja,Pigeon Pea (Tur),2016,8296,9168,872,10.511089681774349
Yeotmal,Pigeon Pea (Tur),2015,8117,8989,872,10.742885302451645
Nashik,Shepu,2016,1001,1873,872,87.11288711288711
Dudhani,Pigeon Pea (Tur),2016,8888,9760,872,9.810981098109812
Khed-Chakan,Brinjal,2016,1360,2232,872,64.11764705882354
Barshi,Pigeon Pea (Tur),2016,5818,6690,872,14.987968374011688
Amarawati,Sesamum,2016,5500,6372,872,15.854545454545455
Manmad,Onion,2015,619,1491,872,140.8723747980614
Lonand,ONION,2016,357,1229,872,244.2577030812325
Sinner,Gram,2015,2566,3438,872,33.98285268901013
Beed,Pigeon Pea (Tur),2016,8072,8944,872,10.802775024777008
Aurangabad,Bitter Gourd,2016,2042,2913,871,42.65426052889324
Pune-Manjri,Bottle Gourd,2016,852,1723,871,102.2300469483568
Osmanabad,Onion,2016,688,1559,871,126.59883720930233
Pune,Snake Gourd,2016,1000,1871,871,87.1
Akole,Onion,2016,78,949,871,1116.6666666666667
Akola,Black Gram,2016,6339,7210,871,13.740337592680234
Jalgaon,Ladies Finger,2015,1121,1992,871,77.69848349687778
Kamthi,Ladies Finger,2015,803,1674,871,108.46824408468244
Rahuri-Vambori,Gram,2016,5826,6697,871,14.95022313765877
Yeotmal,Pigeon Pea (Tur),2016,7460,8331,871,11.675603217158177
Kada,Green Gram,2014,6029,6900,871,14.446840272018576
Katol,Pigeon Pea (Tur),2015,5479,6350,871,15.897061507574374
Karad,Potato,2015,1000,1871,871,87.1
Lasur Station,Sorgum(Jawar),2015,1273,2144,871,68.42105263157895
Malkapur,Gram,2015,3688,4558,870,23.59002169197397
Karad,Cluster Bean,2015,2900,3770,870,30.0
Murbad,Cabbage,2016,4120,4990,870,21.116504854368934
Akole,Onion,2016,108,978,870,805.5555555555555
Kopargaon,Gram,2016,3470,4340,870,25.072046109510087
Chandrapur-Ganjwad,Capsicum,2014,1770,2640,870,49.152542372881356
Satara,Cluster Bean,2016,3630,4500,870,23.96694214876033
Amarawati-Fruit And Vegetables,Mosambi,2016,1800,2670,870,48.333333333333336
Ahmednagar,Cabbage,2016,510,1380,870,170.58823529411765
Akluj,Sorgum(Jawar),2014,1530,2400,870,56.86274509803921
Shirpur,Gram,2016,3607,4477,870,24.119767119489882
Jalna,Gram,2015,3683,4553,870,23.62204724409449
Pune-Manjri,Spinach,2015,645,1515,870,134.88372093023256
Kille Dharur,Pigeon Pea (Tur),2016,5205,6075,870,16.714697406340058
Kalyan,Gram,2016,7050,7920,870,12.340425531914894
Kolhapur-Laxmipuri,Green Gram,2015,8110,8980,870,10.727496917385944
Pune-Manjri,Walvad,2015,1865,2735,870,46.64879356568365
Nagpur,Chikoo,2015,905,1775,870,96.13259668508287
Karad,Onion,2015,980,1850,870,88.77551020408163
Pune,Potato,2014,2100,2970,870,41.42857142857143
Daryapur,Soybean,2015,2763,3633,870,31.487513572204126
Manora,Pigeon Pea (Tur),2015,6437,7306,869,13.500077675935994
Vadgaon Peth,Tomato,2015,681,1550,869,127.6064610866373
Solapur,Carrot,2016,706,1575,869,123.08781869688386
Indapur,Sorgum(Jawar),2015,1606,2475,869,54.10958904109589
Naigaon,Pigeon Pea (Tur),2016,7471,8340,869,11.63164235042163
Indapur,Onion,2015,185,1054,869,469.72972972972974
Khed-Chakan,Chavli (Shenga ),2016,2842,3711,869,30.577058409570725
Akola,Green Gram,2015,5711,6580,869,15.21624934337244
Sangrampur,Green Gram,2016,4900,5769,869,17.73469387755102
Indapur-Bhigwan,Wheat(Husked),2015,1370,2239,869,63.43065693430657
Latur,Gram,2014,2342,3211,869,37.105038428693426
Barshi,GREEN GRAM,2016,4044,4913,869,21.48862512363996
Gangapur,Onion,2015,400,1269,869,217.25
Pune-Manjri,Squash Gourd,2016,1524,2393,869,57.020997375328086
Ratanagari,Green Chilli,2014,2658,3526,868,32.6561324303988
Paranda,Sorgum(Jawar),2016,1709,2577,868,50.7899356348742
Yeola,Gram,2015,3834,4702,868,22.639540949400104
Phaltan,Sorgum(Jawar),2016,1570,2438,868,55.28662420382165
Pune,Pumpkin,2015,579,1447,868,149.91364421416236
Yeola,Green Gram,2014,6832,7700,868,12.704918032786885
Barshi-Vairag,Sorgum(Jawar),2016,1692,2560,868,51.30023640661938
Chandrapur-Ganjwad,Tomato,2015,1309,2177,868,66.31016042780749
Mumbai,Pomegranate,2014,3688,4556,868,23.535791757049893
Amarawati,Green Gram,2014,7088,7956,868,12.246049661399548
Daryapur,Black Gram,2016,7000,7868,868,12.4
Osmanabad,Pigeon Pea (Tur),2016,5766,6634,868,15.053763440860216
Shrirampur,Custard Apple,2015,1553,2421,868,55.89182227945911
Kurdwadi,Gram,2015,3313,4181,868,26.199818895261092
Daryapur,Pigeon Pea (Tur),2016,6164,7032,868,14.08176508760545
Chalisgaon,Gram,2016,5200,6067,867,16.673076923076923
Ramtek,Pavtta,2016,2300,3167,867,37.69565217391305
Malegaon,Matki,2014,5471,6338,867,15.847194297203437
Nashik,Raddish,2016,1143,2010,867,75.85301837270342
Aurangabad,Ginger (Fresh),2016,1144,2011,867,75.7867132867133
Vadgaon Peth,Cucumber,2016,1189,2056,867,72.91841883936081
Ramtek,Bitter Gourd,2016,2800,3667,867,30.964285714285715
Buldhana,Pigeon Pea (Tur),2016,5333,6200,867,16.257266079129945
Pune-Pimpri,Chavli (Shenga ),2015,1333,2200,867,65.04126031507877
Pathardi,Pigeon Pea (Tur),2016,6033,6900,867,14.370959721531577
Shrirampur,Tomato,2015,1733,2600,867,50.028851702250435
Mumbai,French Bean,2015,2133,3000,867,40.646976090014064
Kolhapur,Flower,2016,249,1116,867,348.1927710843373
Phaltan,Sorgum(Jawar),2014,1565,2432,867,55.39936102236422
Pandharpur,Tomato,2014,179,1046,867,484.35754189944134
Kamthi,Bottle Gourd,2014,900,1767,867,96.33333333333333
Pune,Green Gram,2015,7650,8517,867,11.333333333333334
Vadgaon Peth,Green Chilli,2015,1461,2328,867,59.3429158110883
Amarawati,Green Gram,2015,5822,6689,867,14.891789762968052
Sindi (Selu),Pigeon Pea (Tur),2016,7690,8557,867,11.274382314694408
Indapur,Onion,2015,2508,3375,867,34.569377990430624
Barshi,Wheat(Husked),2015,1433,2300,867,60.50244242847174
Ghatanji,Pigeon Pea (Tur),2016,7775,8642,867,11.15112540192926
Karad,Pavata,2015,1833,2700,867,47.299509001636665
Koregaon,Potato,2016,383,1250,867,226.37075718015666
Ausa,Pigeon Pea (Tur),2016,5801,6667,866,14.928460610239615
Ahmednagar,Tamarind,2016,7370,8236,866,11.75033921302578
Vadgaon Peth,Pavtta,2015,2217,3083,866,39.0617952187641
Sangali,Chillies(Red),2014,8178,9044,866,10.589386157984837
Lonand,Sorgum(Jawar),2015,1555,2421,866,55.69131832797428
Nashik,Potato,2016,436,1302,866,198.62385321100916
Nira,Sorgum(Jawar),2015,1600,2466,866,54.125
Pune-Manjri,Spinach,2016,767,1633,866,112.90743155149934
Vadgaon Peth,Green Chilli,2015,1078,1944,866,80.33395176252318
Pune,Beet Root,2016,967,1833,866,89.55532574974147
Nashik-Devlali,Raddish,2016,709,1575,866,122.14386459802539
Vadgaon Peth,Brinjal,2015,913,1778,865,94.74260679079956
Newasa-Ghodegaon,Onion,2016,123,988,865,703.2520325203252
Dudhani,Green Gram,2014,5429,6294,865,15.932952661631976
Lasur Station,Gram,2015,3475,4340,865,24.892086330935253
Indapur,Wheat(Husked),2015,1483,2348,865,58.32771409305462
Hingoli,Black Gram,2014,3658,4523,865,23.646801530891196
Pune-Manjri,Bottle Gourd,2016,1021,1886,865,84.72086190009794
Khed,Flower,2016,851,1716,865,101.64512338425382
Pune,Curry Leaves,2014,1209,2074,865,71.54673283705542
Shahada,Pigeon Pea (Tur),2016,6866,7731,865,12.598310515584037
Aurangabad,Shevga,2016,1713,2578,865,50.49620548744892
Dhule,Green Gram,2016,4282,5147,865,20.20084072863148
Nandura,Gram,2016,6598,7463,865,13.110033343437406
Sangrampur,Soybean,2015,2523,3388,865,34.28458184700753
Vai,Tomato,2016,2970,3835,865,29.124579124579125
Phaltan,BAJRI,2016,1340,2205,865,64.55223880597015
Satara,Bitter Gourd,2016,4635,5500,865,18.66235167206041
Nashik,Green-Peas,2015,2285,3150,865,37.85557986870897
Satara,Cluster Bean,2015,4385,5250,865,19.726339794754846
Lasalgaon,Gram,2015,3367,4231,864,25.66082566082566
Khed,GREEN CHILLI,2016,815,1679,864,106.0122699386503
Nandgaon Khandeshwar,Soybean,2015,2885,3749,864,29.94800693240901
Solapur,POTATO,2016,633,1497,864,136.49289099526067
Osmanabad,Potato,2015,910,1774,864,94.94505494505495
Shrirampur,Tomato,2015,1477,2341,864,58.49695328368314
Ahmednagar,Cucumber,2016,336,1200,864,257.14285714285717
Latur-Murud,Soybean,2016,2103,2967,864,41.08416547788873
Jintur,Pigeon Pea (Tur),2015,5743,6607,864,15.044401880550234
Nashik,Shepu,2014,493,1357,864,175.25354969574036
Malkapur,Pigeon Pea (Tur),2016,5808,6672,864,14.87603305785124
Ahmednagar,Potato,2016,700,1564,864,123.42857142857143
Vadgaon Peth,Brinjal,2015,736,1600,864,117.3913043478261
Yeotmal,Pigeon Pea (Tur),2015,9826,10690,864,8.792998168125381
Khed-Chakan,Tomato,2016,2667,3530,863,32.35845519310086
Chandur Bajar,Pigeon Pea (Tur),2016,5950,6813,863,14.504201680672269
Nira-Saswad,Gram,2016,4125,4988,863,20.921212121212122
Pune-Manjri,Goosefoot,2015,0,863,863,inf
Sengaon,Turmeric,2016,7454,8317,863,11.577676415347465
Satara,Green Chilli,2014,2205,3068,863,39.13832199546485
Solapur,Gram,2016,6398,7261,863,13.488590184432635
Akluj,Ladies Finger,2015,2075,2938,863,41.59036144578313
Malkapur,Green Gram,2016,4253,5116,863,20.291558899600282
Pune-Manjri,Spinach,2015,525,1388,863,164.38095238095238
Pune,Carrot,2016,682,1545,863,126.53958944281526
Akluj,Ground Nut Pods (Dry),2014,2675,3538,863,32.26168224299065
Junnar (Alephata),Onion,2014,1379,2242,863,62.58158085569253
Aurangabad,Brinjal,2016,1300,2163,863,66.38461538461539
Vasai,Wheat(Husked),2015,1486,2349,863,58.075370121130554
Dondaicha,Gram,2014,2055,2918,863,41.99513381995134
Amarawati-Fruit And Vegetables,Chikoo,2016,2026,2889,863,42.59624876604146
Majalgaon,Wheat(Husked),2015,1328,2190,862,64.90963855421687
Kalyan,Green-Peas,2015,4638,5500,862,18.58559724018974
Barshi,Pigeon Pea (Tur),2016,7847,8709,862,10.985089843252199
Nilanga,Gram,2015,3629,4491,862,23.7531000275558
Kamthi,Pumpkin,2015,688,1550,862,125.29069767441861
Mumbai,Cluster Bean,2016,2538,3400,862,33.96375098502758
Kamthi,Coriander  ,2016,819,1681,862,105.25030525030525
Barshi-Vairag,Pigeon Pea (Tur),2016,7505,8367,862,11.485676215856095
Barshi,Pigeon Pea (Tur),2016,7193,8054,861,11.969970804949256
Shrirampur,Custard Apple,2014,2500,3361,861,34.44
Akot,Black Gram,2015,7577,8438,861,11.363336412828296
Chakur,Gram,2016,6560,7421,861,13.125
Ratanagari,Flower,2016,2583,3444,861,33.333333333333336
Ahmedpur,Gram,2016,4913,5774,861,17.524933848972115
Mangrulpeer,Green Gram,2014,7066,7927,861,12.185111803000282
Pune-Pimpri,Bitter Gourd,2015,2874,3735,861,29.958246346555324
Satara,Tomato,2016,3531,4392,861,24.384027187765504
Patan,Green Chilli,2016,4750,5611,861,18.126315789473683
Beed,Sorgum(Jawar),2014,1652,2513,861,52.11864406779661
Akluj,Shevga,2014,2385,3246,861,36.100628930817614
Mumbai,Small Gourd,2015,754,1615,861,114.19098143236074
Jamkhed,Onion,2016,100,961,861,861.0
Murum,Green Gram,2015,6700,7560,860,12.835820895522389
Patan,Pavtta,2015,2700,3560,860,31.85185185185185
Malkapur,Pigeon Pea (Tur),2016,7653,8513,860,11.237423232719195
Pune-Pimpri,Ghosali(Bhaji),2016,3400,4260,860,25.294117647058822
Sonpeth,Pigeon Pea (Tur),2016,8100,8960,860,10.617283950617283
Mumbai,Papai,2016,486,1346,860,176.95473251028807
Kamthi,Amla,2016,1160,2020,860,74.13793103448276
Mangalwedha,Tomato,2015,184,1044,860,467.39130434782606
Osmanabad,Chikoo,2016,960,1820,860,89.58333333333333
Nilanga,Green Gram,2016,3743,4603,860,22.976222281592307
Pune-Pimpri,Onion,2015,3733,4593,860,23.03777122957407
Mangrulpeer,Gram,2016,6878,7738,860,12.503634777551614
Nashik,Bor,2015,760,1620,860,113.15789473684211
Sangali,Wheat(Unhusked),2015,3079,3939,860,27.931146476128614
Kolhapur-Laxmipuri,Split Gram,2015,5983,6843,860,14.374059836202575
Shirpur,Ground Nut Pods (Dry),2015,5172,6032,860,16.62799690641918
Shrirampur,Green Chilli,2016,3400,4260,860,25.294117647058822
Sindi (Selu),Pigeon Pea (Tur),2016,7802,8662,860,11.022814662906947
Paranda,Sorgum(Jawar),2016,1720,2580,860,50.0
Nashik,Kanda Pat,2015,700,1560,860,122.85714285714286
Balapur,Gram,2015,3180,4040,860,27.044025157232703
Purna,Turmeric,2015,7060,7920,860,12.181303116147308
Mumbai,Spilt Gerrn Gram,2016,8608,9468,860,9.990706319702602
Sangali,Sorgum(Jawar),2015,1623,2483,860,52.988293284041895
Bhivandi,Potato,2014,1170,2030,860,73.5042735042735
Chikhali,Black Gram,2014,4841,5701,860,17.764924602354885
Kada,Pigeon Pea (Tur),2016,7020,7880,860,12.250712250712251
Shirpur,Soybean,2016,2551,3411,860,33.712269698157584
Kolhapur,Guava,2016,220,1080,860,390.90909090909093
Umarga,Pigeon Pea (Tur),2015,5058,5918,860,17.002767892447608
Kamthi,Small Gourd,2016,612,1472,860,140.52287581699346
Malegaon,Pigeon Pea (Tur),2015,4443,5303,860,19.356290794508215
Pune-Pimpri,Brinjal,2015,2200,3059,859,39.04545454545455
Kolhapur,Ginger (Fresh),2016,1583,2442,859,54.26405559065066
Solapur,Wheat(Husked),2014,1715,2574,859,50.08746355685131
Ratanagari,Green Chilli,2015,1388,2247,859,61.887608069164266
Sangali,Wheat(Unhusked),2015,3465,4324,859,24.79076479076479
Mumbai,French Bean,2016,3106,3965,859,27.656149388280745
Kolhapur,Wal Bhaji,2015,1326,2185,859,64.78129713423832
Mumbai,Cluster Bean,2016,3165,4024,859,27.140600315955766
Lasur Station,Sorgum(Jawar),2016,1490,2349,859,57.651006711409394
Bhivandi,Rice(Paddy-Hus),2014,1406,2265,859,61.095305832147936
Murtizapur,Black Gram,2016,6160,7019,859,13.944805194805195
Lasalgaon,Onion,2015,442,1301,859,194.34389140271495
Chalisgaon,Cabbage,2016,902,1761,859,95.23281596452328
Koregaon,Ghevda Seed,2014,3333,4192,859,25.77257725772577
Devala,Gram,2016,3634,4493,859,23.6378646119978
Mangalwedha,Tomato,2014,215,1073,858,399.06976744186045
Murum,Green Gram,2014,6686,7544,858,12.832784923721208
Mangaon(Bhadav),Nagali,2016,1400,2258,858,61.285714285714285
Pandharpur,Onion,2016,99,957,858,866.6666666666666
Katol,Soybean,2016,2971,3829,858,28.879165264220802
Pune,Flower,2014,768,1626,858,111.71875
Kolhapur-Laxmipuri,Gr.Nut Kernels,2016,7575,8433,858,11.326732673267326
Kolhapur,Guava,2015,716,1574,858,119.83240223463687
Akluj,Carrot,2015,2116,2974,858,40.54820415879017
Shegaon,Pigeon Pea (Tur),2015,4974,5832,858,17.249698431845598
Pune-Manjri,Cucumber,2014,879,1737,858,97.61092150170649
Sailu,Cotton,2016,3699,4557,858,23.195458231954582
Satara,Capsicum,2016,2188,3046,858,39.213893967093234
Nampur,Gram,2016,4275,5133,858,20.07017543859649
Satara,Brinjal,2016,1473,2331,858,58.24847250509165
Solapur,Potato,2016,1068,1926,858,80.33707865168539
Pune,Black Gram,2014,5671,6529,858,15.129606771292542
Pimpalgaon (B)-Saykheda,Onion,2015,480,1338,858,178.75
Pune-Moshi,Ginger (Fresh),2016,3071,3929,858,27.938782155649626
Patan,Bitter Gourd,2014,2357,3214,857,36.35977938056852
Nashik,Green Chilli,2016,2481,3338,857,34.54252317613865
Dondaicha,Chillies(Red),2016,4000,4857,857,21.425
Shrirampur,Shevga,2015,1786,2643,857,47.984322508398655
Kalmeshwar,Pigeon Pea (Tur),2016,7367,8224,857,11.632957784715623
Shrirampur,Garlic,2015,2500,3357,857,34.28
Kamthi,Papai,2015,714,1571,857,120.0280112044818
Pune-Pimpri,Tomato,2016,1805,2662,857,47.4792243767313
Akluj,Onion,2014,656,1513,857,130.640243902439
Indapur-Bhigwan,Sorgum(Jawar),2016,1606,2463,857,53.36239103362391
Pune,Cucumber,2015,708,1565,857,121.045197740113
Murbad,Cabbage,2016,4357,5214,857,19.6694973605692
Jamkhed,Onion,2016,100,957,857,857.0
Karad,Onion,2015,1114,1971,857,76.92998204667863
Satara,Ladies Finger,2016,3013,3870,857,28.443411881845336
Indapur,Gram,2015,3100,3957,857,27.64516129032258
Pune-Manjri,Coriander  ,2015,386,1243,857,222.02072538860102
Karad,Green-Peas,2016,3730,4587,857,22.975871313672922
Hinganghat,Pigeon Pea (Tur),2016,7578,8435,857,11.309052520453946
Lasalgaon,Soybean,2015,2893,3750,857,29.62322848254407
Barshi,CUSTARD APPLE,2016,1143,2000,857,74.97812773403325
Pune-Manjri,Rajgira,2016,0,857,857,inf
Ambad(Vadi Godri),Sorgum(Jawar),2015,1168,2025,857,73.37328767123287
Pune-Manjri,Chavli (Pala),2015,600,1457,857,142.83333333333334
Jalgaon,Coriander (Dry),2015,7078,7935,857,12.107940096072337
Ratanagari,Maize(Corn.),2015,4500,5357,857,19.044444444444444
Nashik,Carrot,2016,1003,1859,856,85.34396809571287
Phaltan,Sorgum(Jawar),2016,1570,2426,856,54.52229299363057
Kalamb (Os),Black Gram,2015,8126,8982,856,10.534088112232341
Sangali,Jaggery,2016,3585,4441,856,23.87726638772664
Satara,Green-Peas,2016,2580,3436,856,33.17829457364341
Kurdwadi-Modnimb,Sorgum(Jawar),2016,1565,2421,856,54.6964856230032
Lonar,Green Gram,2014,7325,8181,856,11.686006825938566
Pune-Moshi,CLUSTER BEAN,2016,2627,3483,856,32.58469737342977
Manmad,Gram,2016,6773,7629,856,12.638417244943156
Karanja,Ground Nut Pods (Dry),2016,5173,6029,856,16.547457954765125
Pandharpur,Coriander  ,2015,434,1290,856,197.23502304147465
Dudhani,Sorgum(Jawar),2015,1326,2182,856,64.5550527903469
Solapur,Chikoo,2015,624,1480,856,137.17948717948718
Anajngaon Surji,Green Gram,2016,4175,5031,856,20.50299401197605
Hingoli-Kanegaon Naka,Black Gram,2016,6121,6977,856,13.984643032184284
Nira-Saswad,Ghevda Seed,2016,1500,2356,856,57.06666666666667
Malkapur,Gram,2015,3258,4114,856,26.27378759975445
Akola,Gram,2016,5813,6669,856,14.725615000860142
Malegaon,Pigeon Pea (Tur),2015,8347,9203,856,10.25518150233617
Chandur Bajar,Pigeon Pea (Tur),2016,8450,9305,855,10.118343195266272
Paranda,Onion,2016,80,935,855,1068.75
Nashik,Guava,2016,1037,1892,855,82.44937319189971
Chandur Bajar,Pigeon Pea (Tur),2016,5000,5855,855,17.1
Lasalgaon-Vinchur,Gram,2015,3415,4270,855,25.036603221083457
Lohara,Black Gram,2016,6382,7237,855,13.39705421497963
Anajngaon Surji,Black Gram,2015,7078,7933,855,12.079683526419892
Osmanabad,Ladies Finger,2015,867,1722,855,98.6159169550173
Pune-Manjri,Cabbage,2015,208,1063,855,411.0576923076923
Lasalgaon,Bajri,2016,1385,2240,855,61.73285198555957
Ghatanji,Gram,2016,4150,5005,855,20.602409638554217
Satara,Brinjal,2016,1636,2491,855,52.261613691931544
Mumbai,Chikoo,2016,990,1845,855,86.36363636363636
Aurangabad,Onion,2015,448,1303,855,190.84821428571428
Sangali,Sorgum(Jawar),2015,1638,2493,855,52.1978021978022
Ahmedpur,Sesamum,2014,8831,9685,854,9.670478994451365
Shevgaon,Gram,2016,6565,7419,854,13.008377760853008
Kalmeshwar,Pigeon Pea (Tur),2016,6802,7656,854,12.55513084386945
Shirpur,Green Gram,2016,5282,6136,854,16.168118137069293
Baramati,Wheat(Unhusked),2016,2274,3128,854,37.554969217238344
Kurdwadi,Gram,2015,3835,4689,854,22.26857887874837
Osmanabad,Bor,2015,713,1567,854,119.77559607293128
Nashik-Devlali,Coriander  ,2016,1752,2606,854,48.74429223744292
Kamthi,Ladies Finger,2014,804,1658,854,106.21890547263682
Shegaon,Green Gram,2015,7974,8828,854,10.70980687233509
Chandrapur,SOYBEAN,2016,1920,2774,854,44.479166666666664
Nagpur,Gram,2015,2936,3790,854,29.087193460490465
Ahmedpur,Green Gram,2014,6681,7535,854,12.782517587187547
Shrirampur,Gram,2015,3508,4362,854,24.34435575826682
Nagpur,Coriander  ,2015,2938,3792,854,29.067392784206945
Jalgaon,Lemon,2016,1879,2732,853,45.39648749334753
Kolhapur-Laxmipuri,Split Black Gram,2015,16295,17148,853,5.234734581159865
Nagpur,Pigeon Pea (Tur),2014,4100,4953,853,20.804878048780488
Akluj,Shevga,2015,1676,2529,853,50.894988066825775
Satara,Ladies Finger,2015,1717,2570,853,49.67967384973792
Sonpeth,Gram,2014,1500,2353,853,56.86666666666667
Akluj,Chikoo,2014,2041,2894,853,41.793238608525236
Katol,Cotton,2016,4084,4937,853,20.886385896180215
Jalna,Mosambi,2015,829,1682,853,102.8950542822678
Akluj,Ladies Finger,2016,1158,2011,853,73.6614853195164
Kamthi,CARROT,2016,1500,2353,853,56.86666666666667
Khamgaon,Green Gram,2015,6148,7001,853,13.874430709173716
Shirpur,Sesamum,2015,4712,5565,853,18.10271646859083
Nashik,Guava,2014,903,1756,853,94.46290143964562
Ghoti,Tomato,2016,1359,2212,853,62.76674025018396
Rahuri-Vambori,Green Gram,2015,6660,7513,853,12.807807807807809
Ratanagari,Capsicum,2014,2500,3353,853,34.12
Nira-Saswad,Rice(Paddy-Hus),2016,2775,3628,853,30.73873873873874
Dhule,Sesamum,2015,6600,7452,852,12.909090909090908
Pathari,Soybean,2016,2858,3710,852,29.8110566829951
Vasai,Wheat(Husked),2016,1496,2348,852,56.95187165775401
Shirpur,Black Gram,2015,9526,10378,852,8.94394289313458
Nagpur,Orange,2015,708,1560,852,120.33898305084746
Ambejogai,Gram,2015,2882,3734,852,29.562803608605137
Indapur,Black Gram,2016,5590,6442,852,15.241502683363148
Akola,Pigeon Pea (Tur),2015,5238,6090,852,16.265750286368842
Junnar,Onion,2016,778,1629,851,109.38303341902314
Kada,Sorgum(Jawar),2016,1607,2458,851,52.95581829495955
Varud-Rajura Bazar,Gram,2015,4007,4858,851,21.237833790865984
Khamgaon,Lemon,2016,107,958,851,795.3271028037383
Sangamner,Onion,2016,425,1276,851,200.23529411764707
Solapur,Potato,2016,943,1794,851,90.2439024390244
Umrane,ONION,2016,454,1305,851,187.44493392070484
Hingoli,PIGEON PEA (TUR),2016,5215,6066,851,16.3183125599233
Bhokar,Green Gram,2015,5684,6535,851,14.971850809289233
Indapur,Gram,2015,3300,4151,851,25.78787878787879
Manchar,Math (Bhaji),2015,313,1164,851,271.8849840255591
Lasalgaon,Ground Nut Pods (Dry),2015,3854,4705,851,22.080954852101712
Indapur-Bhigwan,Sorgum(Jawar),2016,1563,2414,851,54.446577095329495
Baramati,Jaggery,2014,2200,3051,851,38.68181818181818
Latur,Sunflower,2014,2300,3150,850,36.95652173913044
Solapur,Green Peas (Dry),2014,3919,4769,850,21.68920643021179
Mangalwedha,GREEN GRAM,2016,3300,4150,850,25.757575757575758
Kalyan,Green Chilli,2014,2650,3500,850,32.075471698113205
Aurangabad,Carrot,2016,1250,2100,850,68.0
Shrirampur,Ground Nut Pods (Dry),2016,3600,4450,850,23.61111111111111
Vasai,Potato,2015,825,1675,850,103.03030303030303
Osmanabad,Ladies Finger,2015,1000,1850,850,85.0
Pune-Manjri,Brinjal,2016,1250,2100,850,68.0
Ahmednagar,Soybean,2015,2700,3550,850,31.48148148148148
Palus,Brinjal,2016,1275,2125,850,66.66666666666667
Kada,Sorgum(Jawar),2016,1600,2450,850,53.125
Karad,Onion,2015,1393,2243,850,61.01938262742283
Aurangabad,Green Chilli,2015,2694,3544,850,31.551596139569412
Chandrapur,Jambhul,2016,1500,2350,850,56.666666666666664
Manchar,Chavli (Shenga ),2016,1675,2525,850,50.74626865671642
Shirpur,Gram,2015,3719,4569,850,22.85560634579188
Sangrampur,Ground Nut Pods (Dry),2016,5000,5850,850,17.0
Kalyan,Green Peas (Dry),2016,3100,3950,850,27.419354838709676
Nandgaon Khandeshwar,Gram,2016,7822,8672,850,10.866785988238302
Jalna,Mosambi,2015,1700,2550,850,50.0
Shahapur,Ridge Gourd,2015,4400,5250,850,19.318181818181817
Osmanabad,Pigeon Pea (Tur),2015,4650,5500,850,18.27956989247312
Rahata,Capsicum,2015,2000,2850,850,42.5
Khamgaon,Sesamum,2016,4338,5188,850,19.59428307976026
Aheri,Rice(Paddy-Hus),2015,1775,2625,850,47.88732394366197
Akole,Wheat(Husked),2016,1550,2400,850,54.83870967741935
Indapur-Bhigwan,Green Gram,2016,6500,7350,850,13.076923076923077
Umarga,Wheat(Husked),2016,1350,2200,850,62.96296296296296
Jalgaon,Ladies Finger,2014,911,1761,850,93.30406147091108
Nashik,Papai,2015,700,1550,850,121.42857142857143
Malkapur,Onion,2014,1075,1925,850,79.06976744186046
Vaijapur,ONION,2016,150,1000,850,566.6666666666666
Sangamner,Gram,2016,6520,7370,850,13.036809815950921
Kalamb (Os),Wheat(Husked),2015,1747,2597,850,48.65483686319405
Kolhapur,Ground Nut Pods (Dry),2016,2760,3610,850,30.797101449275363
Solapur,Apple,2016,750,1600,850,113.33333333333333
Chalisgaon,Brinjal,2016,900,1750,850,94.44444444444444
Indapur-Bhigwan,Sorgum(Jawar),2014,1800,2650,850,47.22222222222222
Sindi,Cotton,2016,4100,4950,850,20.73170731707317
Osmanabad,Capsicum,2015,1650,2500,850,51.515151515151516
Shrirampur,Mosambi,2015,1875,2725,850,45.333333333333336
Loha,Green Gram,2015,5661,6511,850,15.015015015015015
Pune-Manjri,Rajgira,2015,640,1490,850,132.8125
Junnar-Otur,Green Chilli,2016,525,1375,850,161.9047619047619
Paranda,Sorgum(Jawar),2015,1250,2100,850,68.0
Pune,Elephant Root,2015,1350,2200,850,62.96296296296296
Osmanabad,Kharbuj,2015,1125,1975,850,75.55555555555556
Rahuri,ONION,2016,331,1181,850,256.797583081571
Manchar,Cucumber,2015,1700,2550,850,50.0
Mumbai,Split Gram,2015,5927,6777,850,14.341150666441708
Indapur-Bhigwan,Wheat(Husked),2014,1450,2300,850,58.62068965517241
Jalgaon,Mosambi,2015,1350,2200,850,62.96296296296296
Manchar,Carrot,2016,792,1642,850,107.32323232323232
Mumbai,Brinjal,2015,427,1277,850,199.0632318501171
Pune,Tamarind,2015,4250,5100,850,20.0
Kalyan,Green Gram,2015,7900,8750,850,10.759493670886076
Chandur Bajar,Soybean,2016,3180,4030,850,26.729559748427672
Pune-Manjri,Chavli (Pala),2015,525,1375,850,161.9047619047619
Savner,Pigeon Pea (Tur),2016,5676,6526,850,14.975334742776603
Buldhana,Pigeon Pea (Tur),2016,7300,8150,850,11.643835616438356
Ahmednagar,Jaggery,2016,2600,3450,850,32.69230769230769
Pimpalgaon Basawant,Tomato,2015,357,1206,849,237.81512605042016
Lonand,Sorgum(Jawar),2014,1558,2407,849,54.49293966623877
Kolhapur,Maize(Corn.),2016,478,1327,849,177.61506276150627
Barshi,Gram,2015,3739,4588,849,22.7066060443969
Pandharkawada,Pigeon Pea (Tur),2015,7267,8116,849,11.68295032337966
Barshi,Turmeric,2014,3800,4649,849,22.342105263157894
Lasalgaon-Niphad,Gram,2016,5051,5900,849,16.80855276182934
Dindori-Vani,Onion,2014,942,1791,849,90.12738853503184
Akluj,Bitter Gourd,2016,1268,2116,848,66.8769716088328
Latur,Gram,2015,4047,4895,848,20.953792933036816
Satara,Cluster Bean,2015,1500,2348,848,56.53333333333333
Aurangabad,Lemon,2015,1687,2535,848,50.26674570243035
Kolhapur-Laxmipuri,Split Gram,2016,10076,10924,848,8.416038110361255
Umarga,Wheat(Unhusked),2016,1815,2663,848,46.72176308539945
Kamthi,Spinach,2015,683,1531,848,124.15812591508053
Mumbai,Shevga,2016,2768,3616,848,30.63583815028902
Mumbai,Carrot,2014,2784,3632,848,30.45977011494253
Nandura,Pigeon Pea (Tur),2015,5090,5938,848,16.660117878192533
Nandgaon,Horse Gram,2014,1500,2347,847,56.46666666666667
Pune,Snake Gourd,2015,988,1835,847,85.72874493927125
Solapur,Sorgum(Jawar),2016,1751,2598,847,48.37235865219874
Jalgaon,LEMON,2016,1010,1857,847,83.86138613861387
Mumbai,Green Chilli,2015,3065,3912,847,27.63458401305057
Pune-Manjri,Bitter Gourd,2015,1311,2158,847,64.60717009916094
Vani,Pigeon Pea (Tur),2016,8005,8852,847,10.580886945658962
Bhokar,Black Gram,2016,6270,7117,847,13.508771929824562
Pathari,Bajri,2016,675,1522,847,125.48148148148148
Pusad,Wheat(Husked),2016,1646,2493,847,51.45808019441069
Rahata,Garlic,2016,7468,8315,847,11.341724692019282
Yeola,Onion,2015,603,1450,847,140.46434494195688
Lasalgaon,Onion,2015,559,1406,847,151.52057245080502
Devala,Green Gram,2015,8006,8853,847,10.579565326005495
Nashik,Bitter Gourd,2016,1534,2380,846,55.14993481095176
Shrirampur,Green Chilli,2016,2500,3346,846,33.84
Latur,PIGEON PEA (TUR),2016,5098,5944,846,16.594743036484896
Osmanabad,Cucumber,2015,696,1542,846,121.55172413793103
Lasalgaon,Ground Nut Pods (Dry),2016,4248,5094,846,19.915254237288135
Shrirampur,Chikoo,2016,1500,2346,846,56.4
Akole,Onion,2016,128,974,846,660.9375
Jamkhed,Coriander (Dry),2014,9500,10346,846,8.905263157894737
Solapur,Pigeon Pea (Tur),2015,4910,5755,845,17.209775967413442
Nandurbar,Chillies(Red),2015,1872,2717,845,45.138888888888886
Shahada,Wheat(Husked),2016,1609,2454,845,52.51709136109385
Kille Dharur,Bajri,2014,1439,2284,845,58.72133425990271
Nashik,Flower,2016,889,1734,845,95.05061867266592
Malkapur,Green Gram,2016,5490,6335,845,15.391621129326047
Kolhapur-Laxmipuri,Split Black Gram,2016,16310,17155,845,5.180870631514408
Nashik,Wal Papdi,2015,1350,2195,845,62.592592592592595
Aurangabad,Flower,2016,2038,2883,845,41.46221786064769
Pune,Pumpkin,2014,900,1745,845,93.88888888888889
Pune-Manjri,Raddish,2015,900,1745,845,93.88888888888889
Solapur,Sorgum(Jawar),2014,1681,2526,845,50.267697798929206
Pune-Manjri,Bottle Gourd,2015,715,1560,845,118.18181818181819
Kille Dharur,Pigeon Pea (Tur),2015,7467,8312,845,11.316459086647917
Osmanabad,Onion,2014,676,1521,845,125.0
Tasgaon,Tamarind,2015,4784,5629,845,17.66304347826087
Ratanagari,Cucumber,2015,1406,2250,844,60.02844950213371
Sengaon,Turmeric,2015,6975,7819,844,12.100358422939069
Jintur-Bori,Pigeon Pea (Tur),2016,6848,7692,844,12.324766355140186
Amarawati-Fruit And Vegetables,Orange,2016,1694,2538,844,49.82290436835891
Rahata,Ladies Finger,2015,1500,2344,844,56.266666666666666
Pune-Pimpri,Bitter Gourd,2016,5156,6000,844,16.369278510473237
Jalgaon,Mango(Raw),2016,1726,2570,844,48.8991888760139
Ratanagari,Capsicum,2016,2875,3719,844,29.356521739130436
Ratanagari,Bitter Gourd,2014,2875,3719,844,29.356521739130436
Sinner,Pigeon Pea (Tur),2016,6085,6929,844,13.870172555464256
Majalgaon,Pigeon Pea (Tur),2015,5756,6600,844,14.662960389159139
Shrirampur,Onion,2016,100,944,844,844.0
Pimpalgaon Basawant,Onion,2014,976,1820,844,86.47540983606558
Pune,Rice(Paddy-Hus),2015,4357,5201,844,19.371126922194172
Kolhapur,Bottle Gourd,2015,317,1161,844,266.2460567823344
Akluj,Bitter Gourd,2015,2628,3472,844,32.115677321156774
Vaijapur,Onion,2016,252,1096,844,334.92063492063494
Amarawati,Green Gram,2015,6150,6994,844,13.723577235772357
Yeotmal,Pigeon Pea (Tur),2016,7446,8290,844,11.33494493687886
Nampur,Gram,2016,3728,4572,844,22.63948497854077
Kille Dharur,Gram,2016,4595,5438,843,18.346028291621327
Jalgaon,Orange,2015,743,1586,843,113.45895020188425
Jalgaon,Onion,2015,802,1645,843,105.11221945137157
Pune-Pimpri,Green Chilli,2015,2550,3393,843,33.05882352941177
Osmanabad,Cucumber,2016,740,1583,843,113.91891891891892
Dhule,Green Gram,2014,6332,7175,843,13.313329121920404
Bhokar,Pigeon Pea (Tur),2015,6037,6880,843,13.96388934901441
Kalyan,Mango,2016,3218,4061,843,26.196395276569298
Amarawati,Chikoo,2016,1495,2338,843,56.38795986622073
Jalgaon,POTATO,2016,626,1469,843,134.66453674121405
Buldhana,Gram,2016,6500,7343,843,12.96923076923077
Akola,Gram,2015,4150,4993,843,20.313253012048193
Jalgaon,Orange,2015,893,1736,843,94.40089585666293
Mangrulpeer,Soybean,2015,2953,3796,843,28.54724009481883
Varud-Rajura Bazar,Gram,2014,2067,2910,843,40.78374455732946
Parner,Onion,2016,354,1197,843,238.135593220339
Shrirampur,Bitter Gourd,2015,1786,2629,843,47.200447928331464
Majalgaon,Black Gram,2016,6100,6943,843,13.819672131147541
Nashik,Methi (Bhaji),2016,1091,1934,843,77.2685609532539
Ratanagari,Capsicum,2015,1943,2786,843,43.386515697375195
Mangrulpeer,Soybean,2015,2978,3821,843,28.307588985896576
Pune,Elephant Root,2014,1543,2386,843,54.633830200907326
Vasai,Wheat(Husked),2015,1542,2385,843,54.6692607003891
Jalgaon,Coriander (Dry),2016,7794,8636,842,10.803181934821657
Baramati,Gram,2015,3400,4242,842,24.764705882352942
Solapur,Green Chilli,2015,707,1549,842,119.09476661951909
Mumbai,Brinjal,2015,1000,1842,842,84.2
Pune-Manjri,Flower,2014,853,1695,842,98.71043376318875
Pusad,Pigeon Pea (Tur),2015,6283,7125,842,13.401241445169505
Pune,GINGER (FRESH),2016,868,1710,842,97.00460829493088
Manora,Pigeon Pea (Tur),2015,4983,5825,842,16.897451334537426
Solapur,Pigeon Pea (Tur),2016,8123,8965,842,10.365628462390742
Kolhapur,CAPSICUM,2016,468,1310,842,179.9145299145299
Lasalgaon-Vinchur,Soybean,2016,2615,3457,842,32.19885277246654
Pandharpur,Onion,2016,87,929,842,967.816091954023
Akluj,Banana,2016,433,1275,842,194.45727482678984
Kalyan,Lemon,2016,2325,3167,842,36.215053763440864
Indapur,Sorgum(Jawar),2016,1783,2625,842,47.22378014582165
Karad,Ginger (Fresh),2015,2558,3400,842,32.91634089132135
Osmanabad,Cucumber,2015,889,1731,842,94.71316085489313
Pachora,Gram,2015,3750,4592,842,22.453333333333333
Manmad,Gram,2014,2000,2842,842,42.1
Junnar-Otur,Chavli (Shenga ),2016,533,1375,842,157.9737335834897
Khed-Chakan,Squash Gourd,2016,2750,3592,842,30.618181818181817
Vadgaon Peth,Cabbage,2016,979,1821,842,86.00612870275792
Pune,GRAM,2016,10300,11141,841,8.16504854368932
Dondaicha,Gram,2015,2390,3231,841,35.18828451882845
Amarawati,Chikoo,2016,2041,2882,841,41.20529152376286
Shrirampur,Bitter Gourd,2014,2614,3455,841,32.17291507268554
Jalgaon,Onion,2015,540,1381,841,155.74074074074073
Lasalgaon,Onion,2015,741,1582,841,113.49527665317139
Malegaon,Pigeon Pea (Tur),2015,8040,8881,841,10.460199004975124
Manchar,Capsicum,2016,2617,3458,841,32.136033626289645
Ramtek,Green Chilli,2016,3133,3974,841,26.843281200127674
Shirpur,GREEN GRAM,2016,3914,4755,841,21.486969851814003
Lasalgaon,Gram,2015,3541,4382,841,23.750353007624966
Ausa,Pigeon Pea (Tur),2016,7404,8245,841,11.358725013506213
Shirpur,Onion,2015,267,1108,841,314.9812734082397
Kalyan,Lemon,2016,3320,4160,840,25.301204819277107
Pune,Mula Shenga,2016,1450,2290,840,57.93103448275862
Mumbai,Onion,2015,1032,1872,840,81.3953488372093
Indapur,WHEAT(HUSKED),2016,1711,2551,840,49.09409701928697
Gangapur,Pigeon Pea (Tur),2016,4687,5527,840,17.921911670578194
Shrirampur,Ground Nut Pods (Dry),2015,3100,3940,840,27.096774193548388
Lonar,BLACK GRAM,2016,6370,7210,840,13.186813186813186
Kada,Sorgum(Jawar),2016,1688,2528,840,49.76303317535545
Pune-Moshi,Brinjal,2016,2757,3597,840,30.46789989118607
Ambad(Vadi Godri),Sorgum(Jawar),2016,1405,2245,840,59.786476868327405
Sillod,Pigeon Pea (Tur),2015,6670,7510,840,12.593703148425787
Kalyan,Green Gram,2015,8200,9040,840,10.24390243902439
Pune,Black Gram,2015,11540,12380,840,7.279029462738301
Kolhapur,Bitter Gourd,2016,2900,3740,840,28.96551724137931
Dudhani,Gram,2016,5383,6223,840,15.604681404421326
Patan,Ginger (Fresh),2015,2470,3310,840,34.008097165991906
Kada,Sorgum(Jawar),2015,1529,2369,840,54.937867887508176
Ashti-Karanja,Pigeon Pea (Tur),2016,6911,7751,840,12.154536246563449
Mohol,Gram,2015,2100,2940,840,40.0
Akluj,Brinjal,2015,1107,1947,840,75.88075880758808
Kurdwadi,Green Gram,2016,4290,5130,840,19.58041958041958
Barshi,Brinjal,2016,1317,2157,840,63.78132118451025
Ulhasnagar,Sorgum(Jawar),2015,2193,3033,840,38.303693570451436
Jalgaon,Methi (Bhaji),2015,1215,2055,840,69.1358024691358
Murbad,Bottle Gourd,2016,2780,3620,840,30.215827338129497
Lasalgaon,Soybean,2015,2562,3402,840,32.78688524590164
Sindi (Selu),Gram,2016,4625,5464,839,18.14054054054054
Satana,Gram,2014,1876,2715,839,44.7228144989339
Jamkhed,Pigeon Pea (Tur),2015,7985,8824,839,10.507201001878522
Jamkhed,Onion,2016,100,939,839,839.0
Aurangabad,Bitter Gourd,2015,2078,2917,839,40.37536092396535
Jalna,Mosambi,2014,857,1696,839,97.89964994165695
Nandurbar,Green Gram,2014,6335,7174,839,13.24388318863457
Barshi,Gram,2015,3560,4399,839,23.56741573033708
Sangali,Lentil,2016,6369,7208,839,13.173182603234416
Mangrulpeer,Wheat(Husked),2016,1313,2152,839,63.8994668697639
Shahada,Gram,2015,2949,3788,839,28.450322143099356
Jintur-Bori,Pigeon Pea (Tur),2015,5610,6448,838,14.937611408199643
Solapur,Tomato,2015,126,964,838,665.0793650793651
Solapur,Wheat(Husked),2015,1844,2682,838,45.44468546637744
Dhamangaon-Rly,Black Gram,2016,5613,6451,838,14.929627650097986
Kalamb (Os),Wheat(Husked),2015,2149,2987,838,38.994881340158216
Pune-Pimpri,Ghosali(Bhaji),2014,2485,3323,838,33.72233400402415
Phaltan,Bajri,2016,1275,2113,838,65.72549019607843
Pune,Gram,2015,3100,3938,838,27.032258064516128
Dindori,Onion,2014,1100,1938,838,76.18181818181819
Parner,Onion,2016,358,1196,838,234.0782122905028
Shrirampur,Green Chilli,2016,2567,3405,838,32.64511102454227
Ahmednagar,Onion,2016,100,938,838,838.0
Kille Dharur,Bajri,2015,1410,2248,838,59.43262411347518
Chandrapur-Ganjwad,Tomato,2015,808,1646,838,103.7128712871287
Khamgaon,Black Gram,2014,4083,4921,838,20.524124418319865
Lasalgaon,Gram,2014,2046,2884,838,40.95796676441838
Yeola,Gram,2016,5488,6326,838,15.269679300291545
Junnar-Otur,Bottle Gourd,2016,975,1813,838,85.94871794871794
Aurangabad,Flower,2016,2862,3700,838,29.28022361984626
Mumbai,Small Gourd,2015,781,1619,838,107.29833546734955
Satara,Ladies Finger,2015,1769,2607,838,47.37139626907857
Jalgaon Jamod-Aasalgaon,Pigeon Pea (Tur),2015,5188,6025,837,16.13338473400154
Pune,Sweet Potato,2016,1013,1850,837,82.62586377097729
Osmanabad,Lemon,2015,813,1650,837,102.9520295202952
Mantha,Sorgum(Jawar),2014,1180,2017,837,70.9322033898305
Manchar,Onion,2015,1163,2000,837,71.96904557179708
Pune-Manjri,Tomato,2014,774,1611,837,108.13953488372093
Pune,Ghosali(Bhaji),2015,1345,2182,837,62.23048327137546
Mumbai,Papai,2014,819,1656,837,102.1978021978022
Mumbai,Green Chilli,2014,1904,2741,837,43.96008403361345
Pune-Manjri,Bitter Gourd,2016,2110,2947,837,39.66824644549763
Mangalwedha,Sorgum(Jawar),2016,1608,2445,837,52.05223880597015
Aurangabad,Green Chilli,2015,1468,2305,837,57.01634877384196
Kalamb (Os),Pigeon Pea (Tur),2015,5534,6371,837,15.124683773039393
Dudhani,Pigeon Pea (Tur),2015,5263,6100,837,15.90347710431313
Jalgaon,Tomato,2014,1694,2531,837,49.40968122786305
Lasalgaon,Tomato,2016,198,1035,837,422.72727272727275
Shirpur,Gram,2016,6199,7036,837,13.502177770608162
Pune-Manjri,Shepu,2016,876,1713,837,95.54794520547945
Khed-Chakan,Brinjal,2016,1446,2283,837,57.88381742738589
Akluj,Ladies Finger,2014,1700,2536,836,49.1764705882353
Pulgaon,Pigeon Pea (Tur),2016,7966,8802,836,10.494602058749686
Narkhed,Ground Nut Pods (Dry),2016,3964,4800,836,21.089808274470233
Akluj,Onion,2015,753,1589,836,111.02257636122178
Pune,Green Chilli,2016,720,1556,836,116.11111111111111
Aurangabad,Chikoo,2015,1073,1909,836,77.91239515377447
Alibag,Betelnuts,2016,1428,2264,836,58.54341736694678
Jalgaon,Green Chilli,2014,1550,2386,836,53.935483870967744
Akluj,Bor,2015,971,1807,836,86.09680741503604
Jamkhed,Onion,2016,100,936,836,836.0
Mumbai,Papai,2016,600,1436,836,139.33333333333334
Ghoti,Tomato,2016,1127,1963,836,74.17923691215617
Kopargaon,Gram,2015,3561,4397,836,23.47655153046897
Khed-Chakan,Bitter Gourd,2016,1815,2650,835,46.00550964187328
Satana,Gram,2015,3275,4110,835,25.49618320610687
Vadgaon Peth,Flower,2016,812,1647,835,102.83251231527093
Parner,ONION,2016,275,1110,835,303.6363636363636
Yeola,Onion,2016,437,1272,835,191.07551487414187
Kolhapur,Guava,2015,250,1085,835,334.0
Pune-Pimpri,Ladies Finger,2015,1895,2730,835,44.06332453825858
Bhokar,Sesamum,2016,5833,6668,835,14.315103720212583
Vadgaon Peth,Flower,2014,1053,1888,835,79.29724596391263
Pune,Snake Gourd,2015,890,1725,835,93.82022471910112
Pune-Manjri,Bottle Gourd,2015,829,1664,835,100.72376357056694
Kalyan,Orange,2016,4183,5017,834,19.93784365288071
Ratanagari,Capsicum,2015,1972,2806,834,42.2920892494929
Kalyan,Lemon,2015,3333,4167,834,25.022502250225024
Shrirampur,Bitter Gourd,2016,2722,3556,834,30.639235855988243
Pune-Pimpri,Garlic,2016,5333,6167,834,15.638477404837802
Barshi,Coriander  ,2015,833,1667,834,100.12004801920769
Jalgaon Jamod,Pigeon Pea (Tur),2016,7583,8417,834,10.998285638929184
Kamthi,Small Gourd,2016,1208,2042,834,69.03973509933775
Amarawati,Mosambi,2016,1633,2467,834,51.071647274954074
Chandrapur-Ganjwad,Brinjal,2016,976,1810,834,85.45081967213115
Pune-Moshi,Capsicum,2016,1833,2667,834,45.49918166939444
Kopargaon,Gram,2015,3310,4144,834,25.196374622356494
Shrirampur,Mosambi,2015,2333,3167,834,35.747963994856406
Nira-Saswad,Ghevda Seed,2015,2533,3367,834,32.9253849190683
Sangali,Chillies(Red),2015,10183,11017,834,8.190120789551212
Patan,Pavtta,2015,2833,3667,834,29.438757500882456
Kurdwadi-Modnimb,Wheat(Husked),2015,1708,2542,834,48.82903981264637
Kalyan,GUAVA,2016,2833,3667,834,29.438757500882456
Chandrapur,Chikoo,2014,2072,2906,834,40.25096525096525
Kalyan,Jaggery,2016,2833,3667,834,29.438757500882456
Ratanagari,GINGER (FRESH),2016,2133,2967,834,39.09985935302391
Lasur Station,Green Gram,2015,7407,8241,834,11.259619279060349
Pune-Manjri,Double Bee,2015,3833,4667,834,21.758413775110878
Lasur Station,Sorgum(Jawar),2015,1157,1991,834,72.08297320656871
Kalyan,Ridge Gourd,2016,3871,4705,834,21.544820459829502
Sangli-Phale Bhajipalam,Papai,2015,241,1075,834,346.05809128630705
Nashik,Mango(Raw),2016,1347,2181,834,61.915367483296215
Kalamb (Os),Sesamum,2014,9535,10369,834,8.74672260094389
Aurangabad,Ground Nut Pods (Dry),2015,2222,3056,834,37.53375337533753
Kalamb (Os),Coriander (Dry),2015,8733,9567,834,9.5499828237719
Ahmednagar,Carrot,2015,1333,2167,834,62.56564141035259
Ratanagari,Cluster Bean,2015,2333,3167,834,35.747963994856406
Ratanagari,Maize(Corn.),2016,3333,4167,834,25.022502250225024
Ahmednagar,Tomato,2015,1122,1956,834,74.33155080213903
Aurangabad,Green Chilli,2015,1296,2130,834,64.35185185185185
Kolhapur,Bitter Gourd,2015,479,1313,834,174.11273486430062
Ahmednagar,Ginger (Fresh),2016,1833,2667,834,45.49918166939444
Kille Dharur,Gram,2016,5900,6734,834,14.135593220338983
Chandvad,Onion,2016,498,1332,834,167.46987951807228
Khed-Chakan,Ladies Finger,2016,1609,2443,834,51.83343691733996
Purna,Pigeon Pea (Tur),2016,7706,8539,833,10.809758629639242
Mangalwedha,Gram,2016,6725,7558,833,12.386617100371748
Kille Dharur,Pigeon Pea (Tur),2015,7767,8600,833,10.724861593923007
Vadgaon Peth,Ghevda,2015,1500,2333,833,55.53333333333333
Kalyan,Grapes,2016,1967,2800,833,42.34875444839858
Karad,Custard Apple,2016,5167,6000,833,16.12154054577124
Pune-Moshi,Mango(Raw),2016,1000,1833,833,83.3
Ramtek,Ground Nut Pods (Dry),2015,2417,3250,833,34.464211832850644
Murbad,Tomato,2016,2950,3783,833,28.23728813559322
Ratanagari,CLUSTER BEAN,2016,2500,3333,833,33.32
Latur-Murud,Gram,2016,5742,6575,833,14.507140369209335
Karad,Ghevda,2014,2500,3333,833,33.32
Kamthi,Coriander  ,2016,1030,1863,833,80.87378640776699
Manchar,Shevga,2016,3540,4373,833,23.531073446327685
Ratanagari,Snake Gourd,2016,2167,3000,833,38.440239963082604
Rahata,Ginger (Fresh),2014,3667,4500,833,22.71611671666212
Karad,Green-Peas,2015,5000,5833,833,16.66
Kolhapur-Laxmipuri,SPLIT BLACK GRAM,2016,11367,12200,833,7.328230843670274
Lonand,Sorgum(Jawar),2015,1600,2433,833,52.0625
Vadgaon Peth,Tomato,2014,667,1500,833,124.88755622188906
Ratanagari,Bitter Gourd,2015,2667,3500,833,31.233595800524935
Pune-Pimpri,Ghevda,2016,2900,3733,833,28.724137931034484
Ratanagari,Pavtta,2014,2500,3333,833,33.32
Umarkhed-Danki,Gram,2014,2267,3100,833,36.74459638288487
Jalgaon Jamod-Aasalgaon,Green Gram,2014,6778,7611,833,12.289760991442904
Kalyan,Green-Peas,2016,6167,7000,833,13.507377979568671
Dondaicha,Gram,2015,3413,4246,833,24.406680339876942
Shrirampur,Shevga,2015,2500,3333,833,33.32
Vai,Ridge Gourd,2016,4167,5000,833,19.990400767938564
Indapur-Bhigwan,Green Gram,2015,5800,6633,833,14.362068965517242
Nashik,Kanda Pat,2015,567,1400,833,146.91358024691357
Amarawati,Guava,2015,1867,2700,833,44.61703267273701
Baramati,Sorgum(Jawar),2016,1580,2413,833,52.721518987341774
Baramati,Ground Nut Pods (Dry),2016,3217,4050,833,25.89368977308051
Nandgaon,Ground Nut Pods (Dry),2014,4285,5118,833,19.43990665110852
Shahapur,Shevga,2014,6250,7083,833,13.328
Akluj,Onion,2015,1247,2080,833,66.80032076984763
Shrirampur,Green Chilli,2015,2875,3708,833,28.973913043478262
Shrirampur,Garlic,2015,3500,4333,833,23.8
Bhivandi,Wheat(Husked),2016,1867,2700,833,44.61703267273701
Shrirampur,Garlic,2016,4500,5333,833,18.511111111111113
Vai,Pavtta,2015,4000,4833,833,20.825
Chandrapur,Awala,2015,1100,1933,833,75.72727272727273
Shrirampur,Mango,2016,3500,4333,833,23.8
Patan,Ginger (Fresh),2015,3042,3875,833,27.383300460223538
Patan,Pavtta,2015,3250,4083,833,25.630769230769232
Indapur-Bhigwan,Chillies(Red),2014,3667,4500,833,22.71611671666212
Partur,Pigeon Pea (Tur),2015,5736,6569,833,14.52231520223152
Shrirampur,Shevga,2014,2500,3333,833,33.32
Shrirampur,Mosambi,2016,2667,3500,833,31.233595800524935
Shrirampur,Mosambi,2016,2500,3333,833,33.32
Shegaon,Black Gram,2015,7687,8520,833,10.83647716924678
Satara,Green-Peas,2014,4667,5500,833,17.848725091064924
Patan,Cluster Bean,2016,3500,4333,833,23.8
Dondaicha,Green Gram,2016,3910,4743,833,21.304347826086957
Buldhana,Pigeon Pea (Tur),2015,8167,9000,833,10.199583690461614
Amarawati-Fruit And Vegetables,Naspatti ,2016,1917,2750,833,43.45331246739698
Tasgaon,Tamarind,2016,6335,7167,832,13.13338595106551
Pune,Brinjal,2015,516,1348,832,161.24031007751938
Kolhapur,Water Melon,2015,368,1200,832,226.08695652173913
Lasalgaon-Vinchur,Green Gram,2015,7326,8158,832,11.356811356811356
Mangalwedha,Gram,2016,4975,5807,832,16.723618090452263
Nandura,Sesamum,2014,8756,9588,832,9.502055733211511
Paithan,Onion,2016,191,1023,832,435.6020942408377
Tumsar,Other Pulses,2016,3303,4135,832,25.18922191946715
Chalisgaon,Pigeon Pea (Tur),2015,5273,6105,832,15.778494215816423
Mandhal,Chillies(Red),2015,6557,7389,832,12.688729601952112
Vadgaon Peth,FLOWER,2016,681,1513,832,122.17327459618208
Nashik,Capsicum,2016,1427,2259,832,58.3041345480028
Hinganghat,Soybean,2016,3188,4020,832,26.097867001254706
Barshi,Green Chilli,2016,2178,3009,831,38.15426997245179
Pune-Manjri,Flower,2015,891,1722,831,93.26599326599326
Dindori-Vani,Onion,2015,768,1599,831,108.203125
Shirpur,Ground Nut Pods (Dry),2015,4086,4917,831,20.337738619676944
Mumbai,French Bean,2016,2338,3169,831,35.543199315654405
Jalna,Gram,2016,7217,8048,831,11.514479700706664
Amarawati,Black Gram,2016,6558,7389,831,12.671546203110704
Pune-Manjri,Mint,2016,969,1800,831,85.75851393188854
Nashik,Cabbage,2016,1070,1901,831,77.66355140186916
Kurdwadi-Modnimb,Sorgum(Jawar),2015,1089,1920,831,76.30853994490359
Kalamb (Os),NIGER-SEED,2016,2100,2931,831,39.57142857142857
Mangalwedha,Sorgum(Jawar),2016,1609,2440,831,51.64698570540708
Deglur,Pigeon Pea (Tur),2016,8246,9077,831,10.077613388309484
Mumbai-Fruit Market,Melon,2016,1277,2108,831,65.07439310884887
Chandrapur,Mosambi,2015,1823,2654,831,45.5842018650576
Junnar (Alephata),ONION,2016,590,1420,830,140.67796610169492
Malkapur,Pigeon Pea (Tur),2014,4303,5133,830,19.28886823146642
Shrirampur,Onion,2016,118,948,830,703.3898305084746
Sangali,Lentil,2016,5510,6340,830,15.063520871143377
Pusad,Pigeon Pea (Tur),2016,7504,8334,830,11.060767590618337
Pune-Moshi,Ladies Finger,2016,2143,2973,830,38.730751283247784
Kalamb (Os),Wheat(Husked),2016,2142,2972,830,38.74883286647992
Khed,Shepu,2016,75,905,830,1106.6666666666667
Shahapur,Shevga,2015,6462,7292,830,12.84432064376354
Phaltan,Wheat(Husked),2015,1506,2336,830,55.112881806108895
Vadgaon Peth,Flower,2015,840,1670,830,98.80952380952381
Umared,Cotton,2016,4000,4830,830,20.75
Rahata,Bitter Gourd,2016,3985,4815,830,20.82810539523212
Jalna-Badnapur,Pigeon Pea (Tur),2016,5290,6120,830,15.689981096408317
Sangli-Phale Bhajipalam,PAPAI,2016,243,1073,830,341.56378600823047
Malegaon,Onion,2014,715,1545,830,116.08391608391608
Sangli-Phale Bhajipalam,Bor,2016,370,1200,830,224.32432432432432
Mehkar,Gram,2016,5917,6747,830,14.02737873922596
Indapur-Bhigwan,Ground Nut Pods (Dry),2016,4901,5730,829,16.914915323403388
Khed-Chakan,Cluster Bean,2016,2379,3208,829,34.846574190836485
Mumbai,Spilt Gerrn Gram,2016,8575,9404,829,9.667638483965014
Sinner,Onion,2016,73,902,829,1135.6164383561643
Kolhapur-Laxmipuri,Green Gram,2015,9190,10019,829,9.020674646354733
Katol,Ground Nut Pods (Dry),2016,3777,4606,829,21.948636483981996
Chandrapur,BANANA,2016,625,1454,829,132.64
Kalyan,Onion,2015,2919,3748,829,28.400137033230557
Taloda,Pigeon Pea (Tur),2015,4450,5279,829,18.629213483146067
Sinner,Gram,2016,5935,6764,829,13.96798652064027
Ahmednagar,Green Gram,2015,8007,8836,829,10.353440739353067
Pusad,Black Gram,2016,6513,7342,829,12.728389375095961
Ratanagari,Ginger (Fresh),2015,3671,4500,829,22.582402615091254
Akola,Green Gram,2016,4273,5102,829,19.400889304937984
Gangakhed,COTTON,2016,4160,4989,829,19.927884615384617
Yeola,Green Gram,2016,4897,5726,829,16.928731876659178
Pune-Pimpri,Gr.Nut Kernels,2016,7564,8393,829,10.959809624537282
Jafrabad,Green Gram,2015,6557,7386,829,12.642976971175843
Udgir,Pigeon Pea (Tur),2016,8751,9580,829,9.473203062507142
Pathari,Soybean,2015,2736,3564,828,30.263157894736842
Latur,Gram,2015,4164,4992,828,19.88472622478386
Palus,BRINJAL,2016,1111,1939,828,74.52745274527453
Barshi,Gram,2015,3703,4531,828,22.36024844720497
Pune-Pimpri,Ladies Finger,2015,1886,2714,828,43.90243902439025
Hinganghat,Pigeon Pea (Tur),2015,5400,6228,828,15.333333333333334
Jalgaon,Methi (Bhaji),2015,1544,2372,828,53.626943005181346
Karad,Ladies Finger,2014,2643,3471,828,31.328036322360955
Indapur,Wheat(Husked),2016,1623,2451,828,51.01663585951941
Osmanabad,Pigeon Pea (Tur),2015,4660,5488,828,17.76824034334764
Newasa-Ghodegaon,Onion,2016,200,1028,828,414.0
Pandharpur,Onion,2016,95,923,828,871.578947368421
Koregaon,Green Gram,2015,6986,7814,828,11.852275980532493
Dondaicha,Gram,2015,2700,3528,828,30.666666666666668
Pune,Tamarind,2016,4839,5667,828,17.110973341599504
Pune,Cucumber,2015,662,1490,828,125.07552870090635
Kolhapur-Laxmipuri,Split Gram,2016,6864,7692,828,12.062937062937063
Junnar-Otur,Cucumber,2016,413,1240,827,200.24213075060533
Ausa,SOYBEAN,2016,1962,2789,827,42.15086646279307
Nashik,Mango(Raw),2016,1493,2320,827,55.39182853315472
Lasur Station,Onion,2016,188,1015,827,439.8936170212766
Phaltan,Sorgum(Jawar),2015,1553,2380,827,53.25177076625885
Parli-Vaijnath,SOYBEAN,2016,2177,3004,827,37.988056959118055
Pune,Sweet Potato,2014,691,1518,827,119.68162083936325
Mehkar,Black Gram,2016,6416,7243,827,12.889650872817954
Osmanabad,Onion,2015,1955,2782,827,42.30179028132992
Shirpur,Ground Nut Pods (Dry),2015,3357,4184,827,24.63509085493
Nilanga,Gram,2016,5668,6495,827,14.590684544812985
Nashik,ONION,2016,199,1026,827,415.5778894472362
Satara,Brinjal,2016,3519,4346,827,23.500994600738846
Umared,Other Pulses,2015,5543,6370,827,14.919718563954538
Karad,Green Chilli,2016,3796,4622,826,21.759747102212856
Shrirampur,Mango,2015,2978,3804,826,27.7367360644728
Shegaon,Pigeon Pea (Tur),2016,8130,8956,826,10.15990159901599
Pulgaon,Cotton,2016,4105,4931,826,20.121802679658952
Satara,Ladies Finger,2014,2435,3261,826,33.921971252566735
Babhulgaon,Pigeon Pea (Tur),2016,7990,8816,826,10.337922403003756
Shrirampur,Green Chilli,2015,3304,4130,826,25.0
Khed-Chakan,Bitter Gourd,2016,3462,4288,826,23.85904101675332
Aurangabad,Chikoo,2016,1095,1921,826,75.4337899543379
Achalpur,Pigeon Pea (Tur),2016,8006,8832,826,10.317262053459904
Nashik,Flower,2015,750,1576,826,110.13333333333334
Pandharpur,Math (Bhaji),2014,385,1210,825,214.28571428571428
Pune-Manjri,Ghevda,2016,2014,2839,825,40.96325719960278
Buldhana,Pigeon Pea (Tur),2015,6025,6850,825,13.692946058091286
Sinner,Ground Nut Pods (Dry),2015,3700,4525,825,22.2972972972973
Kada,Onion,2016,150,975,825,550.0
Jintur,Ghee,2015,6100,6925,825,13.524590163934427
Dound,Pigeon Pea (Tur),2016,6125,6950,825,13.46938775510204
Amarawati,Green Gram,2014,6000,6825,825,13.75
Pusad,Gram,2015,2400,3225,825,34.375
Osmanabad,Guava,2015,1500,2325,825,55.0
Indapur,Onion,2016,111,936,825,743.2432432432432
Osmanabad,Bor,2015,350,1175,825,235.71428571428572
Satara,Cluster Bean,2015,3355,4180,825,24.59016393442623
Bhivandi,Wheat(Husked),2016,1990,2815,825,41.45728643216081
Kamthi,Lemon,2016,1425,2250,825,57.89473684210526
Nira-Saswad,RICE(PADDY-HUS),2016,2700,3525,825,30.555555555555557
Ahmednagar,Lemon,2015,1450,2275,825,56.89655172413793
Kamthi,Spinach,2015,1210,2035,825,68.18181818181819
Nilanga,Pigeon Pea (Tur),2015,6351,7176,825,12.990080302314595
Satana,Gram,2015,3364,4189,825,24.524375743162903
Aarni,Ground Nut Pods (Dry),2016,4551,5376,825,18.127883981542517
Nandgaon Khandeshwar,Chino,2015,3250,4075,825,25.384615384615383
Osmanabad,GINGER (FRESH),2016,1400,2225,825,58.92857142857143
Rahata,Capsicum,2014,1842,2667,825,44.78827361563518
Chandur Bajar,Gram,2015,3617,4442,825,22.808957699751176
Babhulgaon,Gram,2015,3500,4325,825,23.571428571428573
Satara,Ginger (Fresh),2015,3263,4088,825,25.283481458780262
Palus,Flower,2016,950,1775,825,86.84210526315789
Chandrapur-Ganjwad,Math (Bhaji),2016,850,1675,825,97.05882352941177
Chalisgaon,Green Gram,2014,5875,6700,825,14.042553191489361
Pune,Bottle Gourd,2015,642,1467,825,128.50467289719626
Washim,Black Gram,2016,8140,8965,825,10.135135135135135
Akluj,Brinjal,2015,1019,1844,825,80.96172718351325
Akluj,Chikoo,2014,1825,2650,825,45.205479452054796
Mumbai,Potato,2014,1754,2579,825,47.03534777651083
Kalyan,Chikoo,2015,2083,2908,825,39.60633701392223
Pune-Manjri,Kanda Pat,2015,900,1725,825,91.66666666666667
Pune,Black Gram,2015,8150,8975,825,10.122699386503067
Mumbai-Onion And Potato Mkt,Garlic,2016,5263,6088,825,15.675470264107924
Aurangabad,Cluster Bean,2016,2767,3592,825,29.815684857246115
Kalyan,Rice(Paddy-Hus),2015,2700,3525,825,30.555555555555557
Shrirampur,Shevga,2015,1475,2300,825,55.932203389830505
Rahata,Onion,2016,100,925,825,825.0
Karanja,Gram,2015,3953,4778,825,20.870225145459145
Osmanabad,Onion,2016,250,1075,825,330.0
Kada (Ashti),Sorgum(Jawar),2016,1625,2450,825,50.76923076923077
Satana,Green Gram,2015,7350,8174,824,11.210884353741497
Pune,Bottle Gourd,2014,504,1328,824,163.4920634920635
Katol,Orange,2016,1300,2124,824,63.38461538461539
Kalyan,Green-Peas,2015,6605,7429,824,12.475397426192279
Pusad,Ground Nut Pods (Dry),2016,5325,6149,824,15.474178403755868
Pune,Arvi,2015,2082,2906,824,39.577329490874156
Solapur,Wheat(Husked),2015,1835,2659,824,44.904632152588555
Shrirampur,Shevga,2015,1529,2353,824,53.8914323086985
Jalgaon,Ladies Finger,2016,1295,2119,824,63.62934362934363
Ratanagari,Ladies Finger,2014,3941,4765,824,20.908398883532097
Babhulgaon,Soybean,2015,2979,3803,824,27.66028868747902
Dindori-Vani,Onion,2015,3707,4531,824,22.228216886970596
Dhule,Gram,2015,3021,3845,824,27.275736511089043
Lasalgaon,Tomato,2016,225,1049,824,366.22222222222223
Nandgaon Khandeshwar,Ground Nut Pods (Dry),2016,3704,4527,823,22.219222462203025
Murum,BLACK GRAM,2016,6727,7550,823,12.234279768098707
Indapur,Green Gram,2016,5896,6719,823,13.958616010854817
Nandgaon Khandeshwar,Pigeon Pea (Tur),2015,6450,7273,823,12.75968992248062
Sangrampur-Varvatbakal,Gram,2016,5594,6417,823,14.712191633893458
Nashik,Melon,2016,496,1319,823,165.92741935483872
Pune-Manjri,Ambat Chuka,2015,64,887,823,1285.9375
Ratanagari,Flower,2016,1617,2440,823,50.89672232529375
Jalgaon,Lemon,2014,1577,2400,823,52.18769816106531
Sindi,Pigeon Pea (Tur),2016,7700,8523,823,10.688311688311689
Akole,Onion,2016,150,973,823,548.6666666666666
Rahata,Ladies Finger,2016,2077,2900,823,39.62445835339432
Shrirampur,Capsicum,2016,2265,3088,823,36.3355408388521
Solapur,Potato,2016,867,1690,823,94.92502883506344
Pune-Manjri,Walvad,2016,2364,3186,822,34.77157360406091
Aurangabad,Mango(Raw),2016,2200,3022,822,37.36363636363637
Aurangabad,Wal Bhaji,2015,2211,3033,822,37.17774762550882
Barshi,Cucumber,2016,768,1590,822,107.03125
Akot,Pigeon Pea (Tur),2016,7479,8301,822,10.990774167669475
Ulhasnagar,Onion,2016,872,1694,822,94.26605504587155
Pune,Lentil,2015,7056,7878,822,11.649659863945578
Pune,ELEPHANT ROOT,2016,1817,2639,822,45.23940561364887
Shirpur,Gram,2016,3877,4699,822,21.201960278565902
Satara,Tomato,2016,1714,2536,822,47.95799299883314
Pune-Pimpri,Bitter Gourd,2015,2507,3329,822,32.78819305943359
Kamthi,Brinjal,2014,693,1515,822,118.61471861471861
Kalyan,Orange,2016,2278,3100,822,36.08428446005268
Ahmednagar,Brinjal,2015,811,1633,822,101.35635018495684
Chandur Bajar,Gram,2015,3750,4572,822,21.92
Satara,Brinjal,2014,1305,2127,822,62.98850574712644
Rahata,Green Chilli,2015,1964,2786,822,41.85336048879837
Dondaicha,Black Gram,2016,5942,6763,821,13.816896667788624
Pune,Green Gram,2015,7096,7917,821,11.569898534385569
Lasalgaon,Gram,2014,2235,3056,821,36.733780760626395
Kolhapur,Tomato,2016,237,1058,821,346.41350210970467
Ambad(Vadi Godri),Wheat(Husked),2016,1634,2455,821,50.24479804161567
Pune-Manjri,Green Chilli,2015,1657,2478,821,49.54737477368739
Hinganghat,Gram,2015,2632,3453,821,31.193009118541035
Loha,Pigeon Pea (Tur),2015,11500,12321,821,7.139130434782609
Patur,Pigeon Pea (Tur),2015,4650,5471,821,17.655913978494624
Chopda,Green Gram,2016,4336,5157,821,18.93450184501845
Purna,Pigeon Pea (Tur),2016,7683,8503,820,10.672914226213718
Pune-Manjri,Flower,2015,784,1604,820,104.59183673469387
Malkapur,Pigeon Pea (Tur),2016,7671,8491,820,10.689610220310259
Jalgaon,Mango(Raw),2015,2100,2920,820,39.04761904761905
Shrirampur,Capsicum,2016,2100,2920,820,39.04761904761905
Phaltan,Sorgum(Jawar),2015,1580,2400,820,51.89873417721519
Kolhapur-Laxmipuri,Wheat(Husked),2016,2241,3061,820,36.59080767514502
Pathardi,Pigeon Pea (Tur),2015,7900,8720,820,10.379746835443038
Pune,Onion,2015,584,1404,820,140.41095890410958
Vadgaon Peth,Cluster Bean,2014,2420,3240,820,33.88429752066116
Nanded,Pigeon Pea (Tur),2016,7977,8797,820,10.279553716936192
Jalgaon,PAPAI,2016,1140,1960,820,71.9298245614035
Jalgaon,Bor,2015,1136,1956,820,72.1830985915493
Aurangabad,Shevga,2016,3013,3833,820,27.215399933620976
Pune,Tamarind,2015,4170,4990,820,19.664268585131893
Karad,Ghevda,2015,1550,2370,820,52.903225806451616
Vasai,Tomato,2015,920,1740,820,89.1304347826087
Mumbai,Pomegranate,2014,5688,6508,820,14.416315049226442
Osmanabad,Lemon,2015,874,1694,820,93.82151029748283
Nira-Saswad,Bajri,2016,1520,2340,820,53.94736842105263
Sillod-Bharadi,Pigeon Pea (Tur),2016,6650,7470,820,12.330827067669173
Nashik,Cucumber,2014,691,1511,820,118.6685962373372
Indapur-Bhigwan,BAJRI,2016,1371,2191,820,59.81035740335521
Rahuri-Vambori,Onion,2016,115,935,820,713.0434782608696
Kolhapur,Water Melon,2015,130,950,820,630.7692307692307
Murtizapur,Gram,2016,8629,9449,820,9.502839262950516
Devala,Onion,2015,578,1397,819,141.6955017301038
Lonar,Black Gram,2015,6292,7111,819,13.016528925619834
Rahuri,Onion,2016,100,919,819,819.0
Chamorshi,Paddy-Unhusked,2016,2098,2917,819,39.0371782650143
Akluj,Ground Nut Pods (Dry),2015,3156,3975,819,25.950570342205324
Rahata,Ladies Finger,2016,2136,2955,819,38.342696629213485
Jalgaon,Brinjal,2015,681,1500,819,120.26431718061674
Shahada,Sorgum(Jawar),2016,1348,2167,819,60.7566765578635
Kolhapur,POTATO,2016,583,1402,819,140.4802744425386
Lasalgaon-Vinchur,Soybean,2016,2858,3677,819,28.656403079076277
Pune,Curry Leaves,2015,1238,2057,819,66.1550888529887
Jalna,Mosambi,2014,840,1659,819,97.5
Kalamb (Os),Gram,2014,2013,2832,819,40.68554396423249
Kamthi,Brinjal,2015,871,1690,819,94.02985074626865
Pune,Tomato,2015,486,1305,819,168.5185185185185
Amarawati,Ginger (Fresh),2016,1900,2719,819,43.10526315789474
Kurdwadi,Sorgum(Jawar),2016,1573,2392,819,52.06611570247934
Nashik,Melon,2016,448,1266,818,182.58928571428572
Lonand,Wheat(Husked),2016,1538,2356,818,53.185955786736024
Pune,Wal Bhaji,2014,1838,2656,818,44.50489662676823
Pimpalgaon Basawant,TOMATO,2016,185,1003,818,442.1621621621622
Dindori-Vani,Onion,2015,569,1387,818,143.7609841827768
Jalgaon,Bitter Gourd,2016,1578,2396,818,51.837769328263626
Jalgaon,Flower,2016,1343,2161,818,60.908413998510795
Chopda,Pigeon Pea (Tur),2016,7461,8279,818,10.963677791180807
Latur,Green Gram,2016,4501,5319,818,18.17373916907354
Latur,Gram,2016,7207,8025,818,11.350076314694048
Aurangabad,Brinjal,2016,2039,2857,818,40.11770475723394
Akot,Soybean,2015,2733,3551,818,29.930479326747164
Jalna,Mosambi,2015,647,1465,818,126.42967542503864
Dudhani,Black Gram,2015,8496,9314,818,9.628060263653484
Telhara,Pigeon Pea (Tur),2015,7670,8488,818,10.664928292046936
Parola,Green Gram,2016,4171,4989,818,19.611603931910814
Junnar-Otur,Potato,2016,625,1443,818,130.88
Kolhapur,Maize(Corn.),2016,361,1179,818,226.59279778393352
Kalyan,Green Chilli,2015,1813,2631,818,45.11858797573083
Barshi,Pigeon Pea (Tur),2016,7539,8357,818,10.850245390635363
Rahata,Ladies Finger,2015,2075,2892,817,39.373493975903614
Karad,Green-Peas,2016,6708,7525,817,12.179487179487179
Kamthi,Pumpkin,2015,833,1650,817,98.07923169267707
Chopda,Green Gram,2014,6632,7449,817,12.319059107358264
Dhamangaon-Rly,Pigeon Pea (Tur),2016,8286,9103,817,9.860004827419743
Sangamner,Onion,2016,300,1117,817,272.3333333333333
Jalgaon,ORANGE,2016,808,1625,817,101.11386138613861
Jalgaon,Brinjal,2016,1000,1817,817,81.7
Akluj,Tomato,2016,1280,2097,817,63.828125
Balapur,Gram,2015,3283,4100,817,24.88577520560463
Baramati,Sorgum(Jawar),2016,1583,2400,817,51.610865445356914
Aurangabad,Lemon,2015,1105,1921,816,73.84615384615384
Akot,Pigeon Pea (Tur),2016,6037,6853,816,13.516647341394732
Mumbai,Split Gram,2015,5208,6024,816,15.668202764976959
Sinner,Pigeon Pea (Tur),2016,5810,6626,816,14.044750430292599
Pune-Pimpri,Ladies Finger,2015,1737,2553,816,46.97754749568221
Satara,Green Chilli,2014,2420,3236,816,33.71900826446281
Shrirampur,Shevga,2016,1658,2474,816,49.21592279855247
Satara,Shevga,2016,3289,4105,816,24.80997263605959
Amarawati-Fruit And Vegetables,Mosambi,2016,1646,2462,816,49.57472660996355
Shrirampur,Chikoo,2016,1500,2316,816,54.4
Kamthi,CLUSTER BEAN,2016,1042,1858,816,78.31094049904031
Mumbai,Carrot,2014,2512,3328,816,32.48407643312102
Ahmednagar,Sorgum(Jawar),2016,1650,2466,816,49.45454545454545
Lasur Station,Gram,2015,3544,4360,816,23.024830699774267
Loha,Turmeric,2015,5734,6550,816,14.23090338332752
Indapur,Sorgum(Jawar),2015,1617,2433,816,50.46382189239332
Washim,Black Gram,2015,9193,10008,815,8.865441096486457
Nashik,Cabbage,2015,648,1463,815,125.77160493827161
Pune-Manjri,Pavtta,2015,1880,2695,815,43.351063829787236
Pune,Lentil,2014,6077,6892,815,13.411222642751358
Chalisgaon,Pigeon Pea (Tur),2016,6655,7470,815,12.246431254695718
Pune,Carrot,2015,600,1415,815,135.83333333333334
Varora,Gram,2016,4433,5248,815,18.384840965486127
Kamthi,Chavli (Pala),2016,758,1573,815,107.5197889182058
Murtizapur,Pigeon Pea (Tur),2015,5740,6555,815,14.198606271777004
Solapur,Potato,2016,620,1435,815,131.4516129032258
Yeotmal,Pigeon Pea (Tur),2015,5012,5827,815,16.2609736632083
Junnar-Otur,Flower,2016,707,1522,815,115.27581329561528
Solapur,Potato,2015,480,1295,815,169.79166666666666
Mangrulpeer,Gram,2016,3453,4268,815,23.60266434984072
Aurangabad,Capsicum,2016,2222,3037,815,36.678667866786675
Mehkar,Pigeon Pea (Tur),2014,4071,4885,814,19.99508720216163
Yeotmal,Pigeon Pea (Tur),2016,7965,8779,814,10.21971123666039
Solapur,CAPSICUM,2016,358,1172,814,227.37430167597765
Karad,Pavata,2014,1829,2643,814,44.50519409513395
Khed,Flower,2016,668,1482,814,121.8562874251497
Vaijapur,Gram,2016,7011,7825,814,11.610326629582085
Vaijapur,Gram,2016,7717,8531,814,10.548140469094207
Kurdwadi-Modnimb,Sorgum(Jawar),2016,1505,2319,814,54.08637873754153
Dhule,Pigeon Pea (Tur),2015,4854,5668,814,16.76967449526164
Kamthi,Tomato,2014,829,1643,814,98.19059107358262
Devala,Onion,2014,809,1622,813,100.49443757725587
Nanded,Turmeric,2014,5410,6223,813,15.027726432532347
Jalgaon,Chavli (Shenga ),2015,2506,3319,813,32.44213886671987
Shrirampur,Chikoo,2016,1604,2417,813,50.6857855361596
Lasalgaon-Vinchur,Soybean,2015,2689,3502,813,30.23428783934548
Kamthi,Ladies Finger,2016,828,1641,813,98.18840579710145
Ratanagari,Cluster Bean,2016,2875,3688,813,28.278260869565216
Ratanagari,Ground Nut Pods (Dry),2015,3375,4188,813,24.08888888888889
Nagpur,Chikoo,2014,1458,2271,813,55.76131687242798
Rahata,Capsicum,2014,1375,2188,813,59.127272727272725
Karanja,Pigeon Pea (Tur),2016,6179,6992,813,13.1574688460916
Osmanabad,Carrot,2015,675,1488,813,120.44444444444444
Buldhana,Pigeon Pea (Tur),2016,5350,6163,813,15.19626168224299
Chandrapur-Ganjwad,Green-Peas,2016,987,1800,813,82.37082066869301
Pune-Pimpri,Ridge Gourd,2015,3625,4438,813,22.427586206896553
Shahada,Soybean,2014,2564,3377,813,31.70826833073323
Karad,Green Chilli,2016,5130,5943,813,15.847953216374268
Mumbai,Split Lentil,2015,7379,8192,813,11.017753083073588
Shrirampur,Pomegranate,2015,3458,4271,813,23.5106998264893
Shirpur,Ground Nut Pods (Dry),2016,3341,4154,813,24.334031727027835
Ausa,Wheat(Husked),2014,1462,2275,813,55.60875512995896
Karanja,Green Gram,2015,6242,7055,813,13.024671579621916
Mehkar,Black Gram,2015,4426,5239,813,18.368730230456393
Kurdwadi,Pigeon Pea (Tur),2016,7575,8388,813,10.732673267326733
Indapur-Bhigwan,Ground Nut Pods (Dry),2014,2550,3363,813,31.88235294117647
Ramtek,Ginger (Fresh),2015,3000,3813,813,27.1
Nashik,Bottle Gourd,2015,798,1611,813,101.8796992481203
Khamgaon,Gram,2016,6022,6835,813,13.500498173364331
Satana,Green Gram,2014,6502,7314,812,12.488465087665334
Vai,Pavata,2015,4438,5250,812,18.29652996845426
Aurangabad,Chikoo,2014,1413,2225,812,57.46638358103326
Nagpur,Pigeon Pea (Tur),2015,5186,5998,812,15.657539529502507
Latur,Pigeon Pea (Tur),2015,5649,6461,812,14.374225526641883
Pandharpur,Onion,2016,117,929,812,694.017094017094
Manmad,Onion,2015,517,1329,812,157.05996131528047
Samudrapur,Pigeon Pea (Tur),2015,5126,5938,812,15.840811548966055
Chalisgaon,Ground Nut Pods (Dry),2016,4013,4825,812,20.234238724146525
Jalna,Sorgum(Jawar),2016,1512,2324,812,53.7037037037037
Sengaon,Green Gram,2015,7444,8256,812,10.90811391724879
Lasalgaon-Vinchur,Gram,2016,4865,5677,812,16.690647482014388
Akluj,Onion,2014,747,1559,812,108.70147255689425
Hingoli,Wheat(Husked),2015,1448,2260,812,56.07734806629834
Ambad(Vadi Godri),Pigeon Pea (Tur),2016,8071,8883,812,10.060711188204683
Dondaicha,Chillies(Red),2015,1840,2652,812,44.130434782608695
Pune,Squash Gourd,2016,731,1542,811,110.94391244870042
Kolhapur,Cabbage,2016,415,1226,811,195.42168674698794
Aurangabad,Lemon,2016,2404,3215,811,33.73544093178037
Jalgaon,Lemon,2015,1472,2283,811,55.09510869565217
Majalgaon,Soybean,2015,2833,3644,811,28.62689728203318
Pune-Manjri,Spinach,2016,461,1272,811,175.92190889370931
Pandharpur,Cucumber,2015,243,1054,811,333.7448559670782
Hingoli,Turmeric,2016,7021,7832,811,11.551061102407065
Loha,Wheat(Husked),2015,1100,1911,811,73.72727272727273
Mangalwedha,Sorgum(Jawar),2014,1519,2330,811,53.39038841342989
Newasa-Ghodegaon,Onion,2016,100,911,811,811.0
Solapur,Brinjal,2015,234,1045,811,346.5811965811966
Patan,Pavtta,2014,3433,4244,811,23.623652781823477
Amarawati-Fruit And Vegetables,Mosambi,2016,1578,2389,811,51.39416983523447
Aarni,Pigeon Pea (Tur),2015,8780,9590,810,9.225512528473804
Mumbai,Onion,2016,658,1468,810,123.10030395136778
Newasa-Ghodegaon,Onion,2016,179,989,810,452.5139664804469
Jalna,Mosambi,2015,1138,1948,810,71.1775043936731
Kalmeshwar,Gram,2016,7460,8270,810,10.857908847184987
Pune-Pimpri,Bitter Gourd,2016,3155,3965,810,25.673534072900157
Mumbai,Onion,2014,1171,1981,810,69.17164816396243
Daryapur,Green Gram,2015,6451,7261,810,12.55619283831964
Jalgaon,Flower,2016,1014,1824,810,79.88165680473372
Pune,Cabbage,2016,445,1255,810,182.02247191011236
Indapur-Bhigwan,Wheat(Husked),2015,1494,2304,810,54.21686746987952
Chikhali,Black Gram,2015,4934,5744,810,16.41670044588569
Deglur,Pigeon Pea (Tur),2016,7275,8085,810,11.1340206185567
Kolhapur,Water Melon,2015,90,900,810,900.0
Nashik,Carrot,2015,440,1250,810,184.0909090909091
Gevrai,Wheat(Husked),2016,1621,2431,810,49.9691548426897
Pune,Flower,2015,486,1295,809,166.46090534979425
Shirpur,Ground Nut Pods (Dry),2015,4121,4930,809,19.631157486047076
Lonar,Green Gram,2015,6345,7154,809,12.750197005516155
Sinner,Green Gram,2014,5667,6476,809,14.275630845244397
Ahmednagar,Cucumber,2015,500,1309,809,161.8
Satana,Gram,2015,3440,4249,809,23.517441860465116
Lasalgaon,Onion,2014,809,1618,809,100.0
Rahuri,Onion,2016,327,1136,809,247.4006116207951
Akola,Green Gram,2016,6254,7063,809,12.935721138471378
Kamthi,Guava,2015,750,1559,809,107.86666666666666
Amarawati,Mango,2016,2698,3507,809,29.985174203113417
Sangali,Lentil,2016,6218,7027,809,13.010614345448698
Sangrampur,Soybean,2015,2933,3742,809,27.582679849982952
Digras,Pigeon Pea (Tur),2016,8385,9194,809,9.648181276088254
Sangli-Phale Bhajipalam,Water Melon,2016,100,909,809,809.0
Pune-Pimpri,Bottle Gourd,2015,1264,2073,809,64.00316455696202
Katol,Pigeon Pea (Tur),2016,7360,8169,809,10.991847826086957
Malegaon,Onion,2015,507,1316,809,159.56607495069034
Dhadgaon,Maize,2016,1408,2217,809,57.45738636363637
Sinner,Soybean,2016,3244,4053,809,24.938347718865597
Yeotmal,Pigeon Pea (Tur),2016,7902,8711,809,10.237914452037458
Pune,Cucumber,2015,579,1388,809,139.72366148531952
Tumsar,Rice(Paddy-Hus),2014,3121,3930,809,25.921179109259853
Shahada,Green Gram,2016,4356,5165,809,18.57208448117539
Shrirampur,Onion,2016,240,1048,808,336.6666666666667
Aurangabad,Ladies Finger,2016,1304,2112,808,61.96319018404908
Amarawati,Soybean,2016,2835,3643,808,28.500881834215168
Satara,Cluster Bean,2015,2292,3100,808,35.25305410122164
Kamthi,Cluster Bean,2016,870,1678,808,92.8735632183908
Nashik,Green-Peas,2014,2306,3114,808,35.039028620988724
Sangli-Phale Bhajipalam,Onion,2016,163,971,808,495.70552147239266
Mumbai,Small Gourd,2015,840,1648,808,96.19047619047619
Mantha,Green Gram,2015,7121,7929,808,11.346720966156438
Patan,Bitter Gourd,2016,3567,4375,808,22.652088589851417
Jalgaon,Brinjal,2016,870,1678,808,92.8735632183908
Pune,SNAKE GOURD,2016,438,1246,808,184.47488584474885
Ratanagari,Cabbage,2016,2118,2926,808,38.14919735599622
Pune,Flower,2016,680,1488,808,118.82352941176471
Pune-Manjri,Pavtta,2016,1550,2357,807,52.064516129032256
Solapur,Pigeon Pea (Tur),2015,5119,5926,807,15.76479781207267
Shrirampur,Mosambi,2016,2462,3269,807,32.77822908204712
Telhara,Black Gram,2016,6002,6809,807,13.44551816061313
Gevrai,Pigeon Pea (Tur),2016,7694,8501,807,10.488692487652717
Loha,Turmeric,2016,6856,7663,807,11.77071178529755
Karad,Apple,2014,4731,5538,807,17.057704502219405
Kamthi,Chavli (Shenga ),2015,637,1444,807,126.68759811616954
Yeotmal,Pigeon Pea (Tur),2015,6447,7254,807,12.517449976733364
Nandura,Green Gram,2015,6216,7023,807,12.982625482625483
Ahmedpur,Sesamum,2015,6093,6900,807,13.244707040866569
Solapur,Capsicum,2016,541,1348,807,149.16820702402958
Hinganghat,Gram,2016,5932,6738,806,13.58732299393122
Gadhinglaj,Jaggery,2015,2080,2886,806,38.75
Nagpur,Papai,2016,538,1344,806,149.81412639405204
Nagpur,Onion,2015,856,1662,806,94.1588785046729
Sangrampur-Varvatbakal,Soybean,2016,2492,3298,806,32.34349919743178
Kolhapur,Bor,2015,1122,1928,806,71.83600713012478
Jalna,Soybean,2015,2910,3716,806,27.697594501718214
Lasalgaon,Green Gram,2016,5229,6035,806,15.414037100784089
Ambad(Vadi Godri),Wheat(Husked),2015,1490,2296,806,54.09395973154363
Pune,Curry Leaves,2014,1194,2000,806,67.50418760469012
Sangrampur-Varvatbakal,Gram,2016,5695,6501,806,14.15276558384548
Pune-Manjri,Coriander  ,2015,300,1106,806,268.6666666666667
Nandura,Gram,2015,3533,4339,806,22.813472969148034
Kej,Pigeon Pea (Tur),2015,7300,8106,806,11.04109589041096
Mumbai,Jaggery,2015,2891,3696,805,27.84503631961259
Chandvad,Zendu,2016,300,1105,805,268.3333333333333
Pusad,Green Gram,2015,5400,6205,805,14.907407407407407
Satana,Onion,2016,248,1053,805,324.5967741935484
Risod,TURMERIC,2016,6500,7305,805,12.384615384615385
Jalgaon,Flower,2016,1386,2191,805,58.08080808080808
Solapur,Potato,2015,511,1316,805,157.53424657534248
Kolhapur,Papai,2016,420,1225,805,191.66666666666666
Pune-Moshi,Pavtta,2016,4330,5135,805,18.59122401847575
Umared,Gram,2016,3879,4684,805,20.752771332817737
Umared,Pigeon Pea (Tur),2015,6500,7305,805,12.384615384615385
Pune-Manjri,Cucumber,2014,942,1747,805,85.45647558386412
Kurdwadi,Onion,2015,388,1193,805,207.4742268041237
Lasur Station,BLACK GRAM,2016,5341,6146,805,15.07208387942333
Ahmednagar,Cucumber,2016,280,1084,804,287.14285714285717
Khed-Chakan,BITTER GOURD,2016,1024,1828,804,78.515625
Sangali,Soybean,2014,2750,3554,804,29.236363636363638
Indapur,Sorgum(Jawar),2016,1826,2630,804,44.030668127053666
Baramati,Ground Nut Pods (Dry),2015,3780,4584,804,21.26984126984127
Shrirampur,Ladies Finger,2015,1870,2674,804,42.99465240641711
Kolhapur,Water Melon,2015,156,960,804,515.3846153846154
Akot,Green Gram,2015,6738,7542,804,11.932324131789848
Akola,WHEAT(HUSKED),2016,2057,2861,804,39.08604764219737
Nashik,Shepu,2016,814,1618,804,98.77149877149877
Kalmeshwar,Pigeon Pea (Tur),2015,6255,7059,804,12.853717026378897
Mumbai,Green Peas (Dry),2016,3563,4367,804,22.565253999438674
Pune-Manjri,Kardai,2015,135,938,803,594.8148148148148
Khed (Shel Pimpalgaon),Cluster Bean,2016,3418,4221,803,23.493270918665885
Manmad,Gram,2016,5975,6778,803,13.439330543933055
Majalgaon,Sesamum,2014,8581,9384,803,9.357883696538865
Latur,Pigeon Pea (Tur),2014,4651,5454,803,17.26510427864975
Manchar,Onion,2016,867,1670,803,92.61822376009228
Kurdwadi,Gram,2015,3265,4068,803,24.59418070444104
Pusad,Pigeon Pea (Tur),2015,4740,5543,803,16.940928270042193
Kurdwadi,Onion,2016,97,900,803,827.8350515463917
Dhamangaon-Rly,Pigeon Pea (Tur),2016,8085,8887,802,9.91960420531849
Lasur Station,Pigeon Pea (Tur),2015,5460,6262,802,14.688644688644688
Katol,Ground Nut Pods (Dry),2015,3477,4279,802,23.065861374748348
Gangapur,Onion,2016,197,999,802,407.10659898477155
Mangrulpeer,Gram,2016,5758,6560,802,13.928447377561653
Kalamb (Yawatmal),Pigeon Pea (Tur),2015,7267,8069,802,11.036191000412826
Indapur,Onion,2016,107,909,802,749.5327102803739
Shirpur,Matki,2016,6074,6876,802,13.203819558775107
Devala,Green Gram,2014,6812,7614,802,11.77334116265414
Sonpeth,Gram,2015,3500,4301,801,22.885714285714286
Mangrulpeer,Pigeon Pea (Tur),2016,6162,6963,801,12.999026290165531
Patur,Pigeon Pea (Tur),2016,7570,8371,801,10.581241743725231
Manchar,Small Gourd,2016,700,1501,801,114.42857142857143
Chalisgaon,GREEN GRAM,2016,3625,4426,801,22.09655172413793
Sinner,Ground Nut Pods (Dry),2015,3500,4301,801,22.885714285714286
Loha,Pigeon Pea (Tur),2015,8584,9385,801,9.331314072693383
Akola,Gram,2015,3778,4579,801,21.201694017998943
Lasalgaon-Niphad,Onion,2015,532,1333,801,150.5639097744361
Pimpalgaon Basawant,Onion,2016,258,1059,801,310.4651162790698
Chandur Bajar,Gram,2015,3875,4676,801,20.670967741935485
Sindi,Soybean,2015,2896,3697,801,27.658839779005525
Lasalgaon-Niphad,Onion,2015,370,1171,801,216.48648648648648
Vadgaon Peth,Cucumber,2015,700,1500,800,114.28571428571429
Pathardi,Pigeon Pea (Tur),2016,7757,8557,800,10.313265437669202
Jalgaon Jamod-Aasalgaon,Green Gram,2015,5000,5800,800,16.0
Shahapur,Shevga,2016,1000,1800,800,80.0
Pune,Elephant Root,2016,2125,2925,800,37.64705882352941
Pune,Cucumber,2014,617,1417,800,129.65964343598054
Vadgaon Peth,Bitter Gourd,2015,1500,2300,800,53.333333333333336
Pachora,Pigeon Pea (Tur),2015,7000,7800,800,11.428571428571429
Jalgaon Jamod-Aasalgaon,Pigeon Pea (Tur),2015,8400,9200,800,9.523809523809524
Manchar,Carrot,2016,1000,1800,800,80.0
Akkolkot,Green Gram,2015,7800,8600,800,10.256410256410257
Shrirampur,Onion,2016,161,961,800,496.8944099378882
Varud,Orange,2016,1667,2467,800,47.990401919616076
Ratanagari,Cucumber,2015,1750,2550,800,45.714285714285715
Osmanabad,Cucumber,2015,533,1333,800,150.093808630394
Ashti-Karanja,Gram,2016,5310,6110,800,15.065913370998116
Shrirampur,Custard Apple,2015,1900,2700,800,42.10526315789474
Pune-Manjri,Raddish,2014,1425,2225,800,56.14035087719298
Akole,Gram,2015,3300,4100,800,24.242424242424242
Aurangabad,Shevga,2014,2938,3738,800,27.22940776038121
Kej,Sesamum,2014,8900,9700,800,8.98876404494382
Akluj,Goats,2016,1200,2000,800,66.66666666666667
Pune,Tomato,2015,718,1518,800,111.42061281337047
Mohol,Sorgum(Jawar),2014,1609,2409,800,49.720323182100685
Katol,Orange,2016,923,1723,800,86.6738894907909
Ratanagari,Capsicum,2016,2433,3233,800,32.88121660501439
Phaltan,Bajri,2014,1338,2138,800,59.79073243647235
Akkalkuwa,Pigeon Pea (Tur),2016,6700,7500,800,11.940298507462687
Nagpur,Pigeon Pea (Tur),2015,4575,5375,800,17.48633879781421
Ratanagari,Maize(Corn.),2015,4000,4800,800,20.0
Aurangabad,Shevga,2014,3267,4067,800,24.487297214569942
Pune-Manjri,Pavtta,2014,2176,2976,800,36.76470588235294
Kamthi,Papai,2016,1000,1800,800,80.0
Kamthi,Lemon,2016,1067,1867,800,74.97656982193065
Bhivandi,Wheat(Husked),2016,2000,2800,800,40.0
Aurangabad,Orange,2015,1050,1850,800,76.19047619047619
Jalgaon Jamod-Aasalgaon,Black Gram,2015,9400,10200,800,8.51063829787234
Baramati,Sorgum(Jawar),2014,2150,2950,800,37.2093023255814
Mumbai,Gram,2014,2984,3784,800,26.80965147453083
Karmala,Green Gram,2016,4028,4828,800,19.860973187686195
Jalgaon Jamod-Aasalgaon,Gram,2015,3500,4300,800,22.857142857142858
Barshi,Methi (Bhaji),2015,700,1500,800,114.28571428571429
Osmanabad,Bottle Gourd,2015,700,1500,800,114.28571428571429
Bhivandi,Potato,2015,3025,3825,800,26.446280991735538
Jalgaon,Shevga,2016,2667,3467,800,29.996250468691414
Rahuri,Bor,2015,600,1400,800,133.33333333333334
Rahuri,Potato,2015,500,1300,800,160.0
Karad,Snake Gourd,2015,1000,1800,800,80.0
Pune,Black Gram,2015,7667,8467,800,10.434328942219903
Karad,Onion,2015,1163,1963,800,68.78761822871883
Karad,Pavata,2015,2750,3550,800,29.09090909090909
Jalgaon Jamod-Aasalgaon,Pigeon Pea (Tur),2016,7944,8744,800,10.070493454179255
Anajngaon Surji,Ground Nut Pods (Dry),2016,4500,5300,800,17.77777777777778
Pune-Manjri,Shepu,2014,650,1450,800,123.07692307692308
Shrirampur,Ground Nut Pods (Dry),2015,3500,4300,800,22.857142857142858
Barshi,GHEVDA,2016,1250,2050,800,64.0
Jalgaon,Squash Gourd,2015,1200,2000,800,66.66666666666667
Karad,Ground Nut Pods (Dry),2016,2729,3529,800,29.314767314034444
Jalgaon Jamod,Pigeon Pea (Tur),2015,6050,6850,800,13.223140495867769
Shahapur,Cluster Bean,2015,1000,1800,800,80.0
Shahapur,Ridge Gourd,2015,3000,3800,800,26.666666666666668
Barshi,Sorgum(Jawar),2016,1543,2343,800,51.84705119896306
Shahapur,Brinjal,2016,1000,1800,800,80.0
Ghoti,SQUASH GOURD,2016,1000,1800,800,80.0
Akluj,Chikoo,2015,1511,2311,800,52.945069490403704
Solapur,Carrot,2015,700,1500,800,114.28571428571429
Babhulgaon,Pigeon Pea (Tur),2015,9151,9951,800,8.74221396568681
Pune-Manjri,Hemp,2015,0,800,800,inf
Barshi,Lemon,2016,2106,2906,800,37.98670465337132
Shahapur,Ladies Finger,2015,2078,2878,800,38.498556304138596
Ratanagari,Ginger (Fresh),2015,3200,4000,800,25.0
Sakri,SHEEP,2016,1200,2000,800,66.66666666666667
Palus,Flower,2016,1721,2521,800,46.48460197559558
Umared,Green Gram,2016,5133,5933,800,15.585427625170466
Achalpur,Black Gram,2016,7200,8000,800,11.11111111111111
Rahata,Brinjal,2015,622,1422,800,128.61736334405145
Pune,Black Gram,2015,6463,7263,800,12.37815256073031
Mangalwedha,Pigeon Pea (Tur),2016,7830,8630,800,10.217113665389528
Palus,Shevga,2016,2200,3000,800,36.36363636363637
Ratanagari,Green-Peas,2015,4500,5300,800,17.77777777777778
Osmanabad,Guava,2015,950,1750,800,84.21052631578948
Shirur,Indian Bean,2014,3375,4175,800,23.703703703703702
Baramati,Sorgum(Jawar),2015,1500,2300,800,53.333333333333336
Taloda,Black Gram,2014,3195,3995,800,25.039123630672925
Pune-Pimpri,Squash Gourd,2016,3786,4586,800,21.130480718436345
Shahapur,Cucumber,2016,2500,3300,800,32.0
Palus,Squash Gourd,2016,5200,6000,800,15.384615384615385
Karad,Capsicum,2014,1700,2500,800,47.05882352941177
Umared,Gram,2015,2829,3629,800,28.278543655001766
Manchar,Bottle Gourd,2016,200,1000,800,400.0
Palus,Shevga,2016,750,1550,800,106.66666666666667
Paranda,Green Gram,2016,4200,5000,800,19.047619047619047
Ratanagari,Cucumber,2016,2300,3100,800,34.78260869565217
Paranda,Sorgum(Jawar),2015,1250,2050,800,64.0
Mumbai,Cluster Bean,2015,800,1600,800,100.0
Karad,Jaggery,2014,2400,3200,800,33.333333333333336
Aurangabad,Ladies Finger,2015,2700,3500,800,29.62962962962963
Anajngaon Surji,Sunflower,2014,2000,2800,800,40.0
Ausa,Wheat(Husked),2016,2200,3000,800,36.36363636363637
Karad,Squash Gourd,2014,1000,1800,800,80.0
Nagpur,Wal Bhaji,2015,2838,3638,800,28.188865398167724
Anajngaon Surji,Black Gram,2015,7780,8580,800,10.282776349614396
Vasai,Tomato,2016,1000,1800,800,80.0
Sangali,Black Gram,2015,4575,5375,800,17.48633879781421
Mumbai,Cluster Bean,2015,2400,3200,800,33.333333333333336
Anajngaon Surji,Gram,2015,3944,4744,800,20.28397565922921
Pune-Pimpri,Ladies Finger,2015,2600,3400,800,30.76923076923077
Manchar,Farshi,2016,2200,3000,800,36.36363636363637
Varora,Cotton,2016,4200,5000,800,19.047619047619047
Patur,Gram,2015,3975,4775,800,20.12578616352201
Mantha,Gram,2015,4200,5000,800,19.047619047619047
Kalyan,Custard Apple,2016,6700,7500,800,11.940298507462687
Chandrapur-Ganjwad,Bitter Gourd,2015,1300,2100,800,61.53846153846154
Chandrapur-Ganjwad,Bitter Gourd,2015,900,1700,800,88.88888888888889
Sangrampur,Soybean,2016,2900,3700,800,27.586206896551722
Rahuri,Mosambi,2016,367,1167,800,217.98365122615803
Chandrapur,Banana,2016,773,1573,800,103.49288486416559
Nashik,Wal Papdi,2015,1200,2000,800,66.66666666666667
Chandrapur,Spinach,2015,1200,2000,800,66.66666666666667
Lasur Station,Green Gram,2015,8248,9048,800,9.699321047526674
Pune,Tamarind,2014,4115,4915,800,19.441069258809236
Pandharpur,Bor,2015,400,1200,800,200.0
Khed-Chakan,Squash Gourd,2016,3440,4240,800,23.25581395348837
Jintur,Sesamum,2015,8250,9050,800,9.696969696969697
Ramtek,Bitter Gourd,2015,2200,3000,800,36.36363636363637
Jalgaon,Chavli (Shenga ),2015,1272,2072,800,62.893081761006286
Nashik,Melon,2015,700,1500,800,114.28571428571429
Malegaon (Washim),Pigeon Pea (Tur),2016,5100,5900,800,15.686274509803921
Pune,Curry Leaves,2015,1333,2133,800,60.01500375093774
Chandrapur,Chikoo,2015,1800,2600,800,44.44444444444444
Sangrampur,Black Gram,2015,5500,6300,800,14.545454545454545
Vadgaon Peth,Green Chilli,2015,927,1727,800,86.29989212513485
Vai,Pavata,2016,4000,4800,800,20.0
Jintur,Black Gram,2016,6149,6949,800,13.010245568385104
Kalyan,Matki,2016,6000,6800,800,13.333333333333334
Hadgaon,Gram,2016,7100,7900,800,11.267605633802816
Vadgaon Peth,Pavtta,2015,1075,1875,800,74.4186046511628
Sangali,Sorgum(Jawar),2016,1749,2549,800,45.740423098913666
Vai,PAVATA,2016,3600,4400,800,22.22222222222222
Vai,Ladies Finger,2016,3200,4000,800,25.0
Chalisgaon,Ground Nut Pods (Dry),2015,3600,4400,800,22.22222222222222
Nandura,Sesamum,2015,6013,6813,800,13.304506901712955
Solapur,Matki,2015,7450,8250,800,10.738255033557047
Mangalwedha,Green Gram,2014,4800,5600,800,16.666666666666668
Chalisgaon,Black Gram,2014,3532,4332,800,22.650056625141563
Nagpur,Chino,2014,1200,2000,800,66.66666666666667
Manchar,Ladies Finger,2016,2283,3083,800,35.04161191414805
Chandrapur-Ganjwad,Small Gourd,2016,1000,1800,800,80.0
Pune-Pimpri,Cluster Bean,2016,3023,3823,800,26.463777704267283
Nashik,Kharbuj,2016,800,1600,800,100.0
Pune-Pimpri,Carrot,2016,700,1500,800,114.28571428571429
Yawal,Sesamum,2016,7700,8500,800,10.38961038961039
Rahuri-Songaon,Flower,2016,1700,2500,800,47.05882352941177
Dound,Green Gram,2015,7900,8700,800,10.126582278481013
Kalyan,Guava,2014,1400,2200,800,57.142857142857146
Chandrapur-Ganjwad,Math (Bhaji),2016,1000,1800,800,80.0
Chandrapur-Ganjwad,Ladies Finger,2016,1200,2000,800,66.66666666666667
Indapur,ONION,2016,100,900,800,800.0
Chandrapur-Ganjwad,Dhemse,2016,2000,2800,800,40.0
Chandrapur-Ganjwad,Cucumber,2016,900,1700,800,88.88888888888889
Rahata,Brinjal,2014,1567,2367,800,51.052967453733245
Yawal,Ground Nut Pods (Dry),2016,4350,5150,800,18.39080459770115
Ramtek,Lemon,2016,3250,4050,800,24.615384615384617
Chandrapur-Ganjwad,Raddish,2015,700,1500,800,114.28571428571429
Nashik,Shepu,2016,500,1300,800,160.0
Pune-Pimpri,Ghevda,2015,3085,3885,800,25.93192868719611
Nashik,Carrot,2016,2100,2900,800,38.095238095238095
Mangaon(Bhadav),Nagali,2016,1325,2125,800,60.37735849056604
Kalyan,Gram,2015,5300,6100,800,15.09433962264151
Indapur,GROUND NUT PODS (DRY),2016,4500,5300,800,17.77777777777778
Chandrapur-Ganjwad,Ladies Finger,2015,1600,2400,800,50.0
Kalyan,Green Gram,2015,8000,8800,800,10.0
Mantha,Wheat(Husked),2015,1408,2208,800,56.81818181818182
Lonar,Green Gram,2015,6119,6919,800,13.074031704526883
Indapur,Chillies(Red),2016,9500,10300,800,8.421052631578947
Koregaon,Onion,2016,860,1660,800,93.02325581395348
Patan,Flower,2014,1600,2400,800,50.0
Ahmednagar,Pigeon Pea (Tur),2016,6900,7700,800,11.594202898550725
Mangalwedha,Sorgum(Jawar),2015,1276,2076,800,62.69592476489028
Vadgaon Peth,Bottle Gourd,2016,600,1400,800,133.33333333333334
Ahmednagar,Ghosali(Bhaji),2015,1625,2425,800,49.23076923076923
Nagpur,Coriander (Dry),2015,7983,8783,800,10.021295252411374
Bhor,Rice(Paddy-Hus),2016,3200,4000,800,25.0
Kada,Onion,2016,100,900,800,800.0
Kada,Onion,2016,100,900,800,800.0
Jalgaon,Mango(Raw),2015,1200,2000,800,66.66666666666667
Kamthi,Mosambi,2015,1200,2000,800,66.66666666666667
Nilanga,Black Gram,2014,4000,4800,800,20.0
Aurangabad,Fig,2016,3000,3800,800,26.666666666666668
Kolhapur-Laxmipuri,Wheat(Husked),2014,1950,2750,800,41.02564102564103
Ratanagari,Capsicum,2015,3000,3800,800,26.666666666666668
Kurdwadi-Modnimb,Wheat(Husked),2015,1285,2085,800,62.2568093385214
Ahmednagar,CAPSICUM,2016,800,1600,800,100.0
Ratanagari,Ladies Finger,2016,2167,2967,800,36.91739732348869
Nira,Rice(Paddy-Hus),2015,2800,3600,800,28.571428571428573
Pune,Green Gram,2016,7691,8491,800,10.401768300611105
Nira,Rice(Paddy-Hus),2015,2800,3600,800,28.571428571428573
Indapur-Bhigwan,Chillies(Red),2015,8200,9000,800,9.75609756097561
Junnar-Otur,Mango(Raw),2016,1000,1800,800,80.0
Vadgaon Peth,Carrot,2016,700,1500,800,114.28571428571429
Indapur-Bhigwan,Ghevda Seed,2015,3000,3800,800,26.666666666666668
Parbhani,Pigeon Pea (Tur),2016,5800,6600,800,13.793103448275861
Khed-Chakan,Math (Bhaji),2016,1000,1800,800,80.0
Malkapur,Green Gram,2015,6283,7083,800,12.73277096928219
Malegaon,Sorgum(Jawar),2015,1977,2777,800,40.46535154274153
Junnar-Otur,Flower,2016,589,1389,800,135.8234295415959
Sailu,Pigeon Pea (Tur),2015,5724,6524,800,13.97624039133473
Junnar-Otur,Garlic,2014,3200,4000,800,25.0
Jalgaon,Pigeon Pea (Tur),2016,6300,7100,800,12.698412698412698
Ahmednagar,Ground Nut Pods (Dry),2015,3000,3800,800,26.666666666666668
Solapur,Flower,2015,400,1200,800,200.0
Vadgaon Peth,Green-Peas,2016,1600,2400,800,50.0
Manchar,GREEN CHILLI,2016,550,1350,800,145.45454545454547
Solapur,Flower,2016,640,1440,800,125.0
Amalner,Coriander (Dry),2015,7180,7980,800,11.142061281337048
Ramtek,Maize(Corn.),2015,2200,3000,800,36.36363636363637
Kamthi,Amla,2014,1200,2000,800,66.66666666666667
Amarawati,Mosambi,2016,1933,2733,800,41.38644593895499
Ratanagari,Green-Peas,2016,4600,5400,800,17.391304347826086
Sangali,Jaggery,2016,3255,4055,800,24.577572964669738
Manchar,CHAVLI (SHENGA ),2016,850,1650,800,94.11764705882354
Rahata,Shevga,2015,2300,3100,800,34.78260869565217
Pune,PARWAR,2016,2056,2856,800,38.91050583657587
Gadhinglaj,Jaggery,2015,2100,2900,800,38.095238095238095
Murbad,Capsicum,2016,4159,4959,800,19.23539312334696
Shrirampur,Ladies Finger,2016,2520,3320,800,31.746031746031747
Akola,Sesamum,2015,5400,6200,800,14.814814814814815
Pune-Manjri,Spinach,2015,300,1100,800,266.6666666666667
Buldhana,Pigeon Pea (Tur),2016,7500,8300,800,10.666666666666666
Jalgaon,GUAVA,2016,1167,1967,800,68.55184233076264
Jalna-Badnapur,Pigeon Pea (Tur),2014,4300,5100,800,18.6046511627907
Ratanagari,Ginger (Fresh),2016,3500,4300,800,22.857142857142858
Pune-Moshi,Bottle Gourd,2016,1202,2002,800,66.55574043261231
Satara,Flower,2015,1519,2319,800,52.666227781435154
Ramtek,Shevga,2015,2200,3000,800,36.36363636363637
Kamthi,Zendu,2014,800,1600,800,100.0
Shrirampur,Cluster Bean,2015,2900,3700,800,27.586206896551722
Khed,Ladies Finger,2016,1825,2625,800,43.83561643835616
Kamthi,Amla,2015,1200,2000,800,66.66666666666667
Kamthi,Amla,2015,1200,2000,800,66.66666666666667
Barshi,Pigeon Pea (Tur),2015,5702,6501,799,14.012627148368994
Ahmednagar,Pigeon Pea (Tur),2015,4601,5400,799,17.365790045642253
Murum,Black Gram,2016,7201,8000,799,11.095681155395084
Ahmednagar,Gram,2016,7836,8635,799,10.196528841245533
Pusad,Batbati,2016,4317,5116,799,18.50822330321983
Nashik,Bottle Gourd,2015,335,1134,799,238.50746268656715
Mangalwedha,Wheat(Husked),2016,1655,2454,799,48.27794561933535
Majalgaon,Soybean,2015,2952,3751,799,27.06639566395664
Sailu,Pigeon Pea (Tur),2015,8253,9052,799,9.68132800193869
Varora,Cotton,2016,4160,4959,799,19.20673076923077
Jalna,Mosambi,2016,911,1710,799,87.70581778265642
Lonand,Sorgum(Jawar),2016,1679,2478,799,47.587849910661106
Kolhapur,Onion,2016,152,951,799,525.6578947368421
Gevrai,Pigeon Pea (Tur),2016,7263,8061,798,10.987195373812474
Sindi (Selu),Gram,2016,5693,6491,798,14.01721412260671
Jalna,Mosambi,2014,750,1548,798,106.4
Indapur-Bhigwan,Wheat(Husked),2015,1519,2317,798,52.534562211981566
Malkapur,Soybean,2015,2870,3668,798,27.804878048780488
Akola,Gram,2015,3436,4234,798,23.22467986030268
Nashik,Potato,2016,550,1348,798,145.0909090909091
Akola,Green Gram,2016,5990,6788,798,13.32220367278798
Kolhapur,Papai,2016,588,1386,798,135.71428571428572
Ambad(Vadi Godri),Sorgum(Jawar),2016,1653,2451,798,48.275862068965516
Kopargaon,Onion,2016,145,943,798,550.3448275862069
Jalna,Sorgum(Jawar),2015,1325,2123,798,60.22641509433962
Katol,Soybean,2016,3116,3913,797,25.577663671373557
Daryapur,Green Gram,2016,4735,5532,797,16.83210137275607
Akola,Pigeon Pea (Tur),2015,5110,5907,797,15.596868884540118
Paithan,Onion,2016,102,899,797,781.3725490196078
Vadgaon Peth,Capsicum,2015,1040,1837,797,76.63461538461539
Koregaon,Ghevda Seed,2016,5041,5838,797,15.810355088276136
Barshi,Black Gram,2015,6095,6892,797,13.076292042657917
Mohol,Sorgum(Jawar),2014,1560,2357,797,51.08974358974359
Kamthi,Brinjal,2016,863,1660,797,92.35225955967555
Kalvan,ONION,2016,227,1024,797,351.10132158590307
Jalgaon,Onion,2016,484,1281,797,164.6694214876033
Jalna,Pigeon Pea (Tur),2015,7780,8577,797,10.244215938303341
Kamthi,Brinjal,2015,556,1352,796,143.16546762589928
Kurdwadi-Modnimb,Sorgum(Jawar),2015,1286,2082,796,61.897356143079314
Vadgaon Peth,Tomato,2014,596,1392,796,133.55704697986576
Malkapur,Green Gram,2016,5121,5917,796,15.543839093926968
Phaltan,WHEAT(HUSKED),2016,1500,2296,796,53.06666666666667
Nagpur,Chikoo,2015,919,1715,796,86.6158868335147
Khed-Chakan,Squash Gourd,2016,3315,4111,796,24.01206636500754
Dhule,Gram,2015,3319,4115,796,23.983127448026515
Rahata,Bottle Gourd,2016,618,1414,796,128.80258899676375
Nashik,Carrot,2016,1113,1909,796,71.51841868823001
Barshi,Lemon,2016,2114,2910,796,37.65373699148534
Nilanga,Gram,2016,3763,4559,796,21.15333510496944
Lonand,Onion,2015,672,1468,796,118.45238095238095
Akluj,Bitter Gourd,2015,1768,2563,795,44.96606334841629
Mangalwedha,Bitter Gourd,2015,1870,2665,795,42.51336898395722
Barshi,Sorgum(Jawar),2016,1691,2486,795,47.01360141927854
Pune-Manjri,Spinach,2015,600,1395,795,132.5
Mangrulpeer,Green Gram,2016,4508,5303,795,17.635314995563444
Pune-Manjri,Chavli (Pala),2015,435,1230,795,182.75862068965517
Hingoli,Gram,2016,8554,9349,795,9.293897591769932
Loha,Wheat(Husked),2015,1306,2101,795,60.872894333843796
Pune,Onion,2015,537,1332,795,148.04469273743015
Indapur,Wheat(Husked),2016,1638,2433,795,48.53479853479853
Rahata,Brinjal,2014,1597,2392,795,49.780839073262364
Sinner,Onion,2016,98,893,795,811.2244897959183
Jalgaon,Cluster Bean,2016,3270,4065,795,24.31192660550459
Patur,Pigeon Pea (Tur),2016,8170,8965,795,9.730722154222766
Yeotmal,Sesamum,2015,5555,6350,795,14.311431143114312
Rahata,Capsicum,2016,1938,2733,795,41.021671826625386
Shrirampur,Green Chilli,2014,3091,3886,795,25.719831769653833
Dudhani,Sorgum(Jawar),2015,943,1738,795,84.30540827147402
Latur,Gram,2015,2532,3327,795,31.398104265402843
Kolhapur,Bottle Gourd,2016,620,1415,795,128.2258064516129
Pachora,Sesamum,2016,4520,5315,795,17.588495575221238
Malkapur,Gram,2015,3383,4177,794,23.470292639668934
Kalamb (Os),Gram,2014,1895,2689,794,41.89973614775725
Jalgaon,Black Gram,2015,10242,11036,794,7.752392110915837
Akluj,Chikoo,2014,2113,2907,794,37.5769048745859
Jalgaon,Chavli (Shenga ),2016,3000,3794,794,26.466666666666665
Chandur Bajar,Pigeon Pea (Tur),2016,8100,8894,794,9.802469135802468
Khamgaon,Cotton,2016,4126,4920,794,19.243819680077557
Umared,Wheat(Husked),2015,1475,2269,794,53.83050847457627
Pune-Moshi,Chavli (Shenga ),2016,2295,3089,794,34.59694989106754
Pune,Bottle Gourd,2015,547,1341,794,145.15539305301644
Nandurbar,Gram,2015,2312,3106,794,34.34256055363322
Tasgaon,Tamarind,2015,4601,5395,794,17.25711801782221
Ratanagari,Green-Peas,2015,4265,5059,794,18.61664712778429
Wardha,Cotton,2016,4229,5023,794,18.775124142823362
Nashik,Kanda Pat,2016,710,1504,794,111.83098591549296
Barshi,Wheat(Husked),2015,1649,2443,794,48.15039417828987
Manchar,Mango(Raw),2016,1390,2183,793,57.05035971223022
Umared,Cotton,2016,4003,4796,793,19.810142393205098
Chandrapur-Ganjwad,Onion,2015,1075,1868,793,73.76744186046511
Kolhapur,Maize(Corn.),2015,416,1209,793,190.625
Rahata,Onion,2016,189,982,793,419.5767195767196
Kopargaon,Onion,2016,338,1131,793,234.6153846153846
Phaltan,Sorgum(Jawar),2016,1625,2418,793,48.8
Aurangabad,Kharbuj,2016,1520,2313,793,52.171052631578945
Solapur,Wheat(Husked),2015,1814,2607,793,43.715545755237045
Kolhapur,Guava,2015,477,1270,793,166.24737945492663
Chandrapur-Ganjwad,Potato,2015,1067,1860,793,74.32052483598875
Nagpur,Mango,2016,1798,2591,793,44.10456062291435
Vai,Green Chilli,2014,2948,3741,793,26.899592944369065
Kolhapur-Laxmipuri,Spilt Pigeon Pea,2016,12580,13373,793,6.3036565977742445
Jalgaon,Flower,2014,1513,2306,793,52.412425644415066
Kalyan,Lemon,2016,3993,4786,793,19.85975457049837
Pusad,Gram,2016,5897,6690,793,13.447515685942005
Lonand,Wheat(Husked),2015,1463,2256,793,54.20369104579631
Satara,Flower,2015,1424,2217,793,55.688202247191015
Kurdwadi,Pigeon Pea (Tur),2015,4232,5025,793,18.738185255198488
Udgir,GRAM,2016,8000,8793,793,9.9125
Mangalwedha,Pigeon Pea (Tur),2015,4174,4967,793,18.998562529947293
Akluj,Tomato,2014,1364,2157,793,58.13782991202346
Devala,Green Gram,2016,4790,5583,793,16.555323590814197
Jalgaon,Onion,2014,802,1595,793,98.87780548628429
Kamthi,Cucumber,2015,765,1558,793,103.66013071895425
Telhara,Gram,2016,6842,7634,792,11.57556270096463
Ausa,Pigeon Pea (Tur),2016,8135,8927,792,9.735709895513214
Khed-Chakan,Ground Nut Pods (Dry),2016,3125,3917,792,25.344
Pandharpur,Math (Bhaji),2015,625,1417,792,126.72
Baramati,Gram,2015,2088,2880,792,37.93103448275862
Pune-Manjri,Kardai,2015,0,792,792,inf
Bhokar,Cotton,2016,3977,4769,792,19.91450842343475
Indapur,Gram,2015,3200,3992,792,24.75
Rahata,Cucumber,2016,1350,2142,792,58.666666666666664
Shegaon,Thymol/Lovage,2015,7750,8542,792,10.219354838709677
Akluj,Chikoo,2015,1185,1977,792,66.83544303797468
Rahata,Tomato,2014,650,1442,792,121.84615384615384
Kalyan,Small Gourd,2016,3796,4587,791,20.8377239199157
Varora,Pigeon Pea (Tur),2016,7162,7953,791,11.044401005305781
Pune-Manjri,Cabbage,2015,209,1000,791,378.4688995215311
Indapur,Wheat(Husked),2015,1546,2337,791,51.16429495472186
Risod,Gram,2016,7361,8152,791,10.745822578454014
Vai,Green-Peas,2016,2682,3473,791,29.492915734526473
Malegaon,GREEN GRAM,2016,3900,4691,791,20.28205128205128
Shrirampur,Pomegranate,2014,3667,4458,791,21.570766293973275
Manchar,Methi (Bhaji),2015,228,1019,791,346.9298245614035
Shrirampur,Bitter Gourd,2015,2364,3155,791,33.46023688663283
Shirpur,SOYBEAN,2016,1958,2749,791,40.39836567926456
Satara,Cucumber,2016,992,1783,791,79.73790322580645
Malkapur,Soybean,2015,3053,3844,791,25.908942024238453
Nagpur,Pigeon Pea (Tur),2015,6486,7277,791,12.19549799568301
Manchar,Chavli (Shenga ),2016,1191,1982,791,66.41477749790093
Latur,Green Gram,2015,7376,8167,791,10.723969631236443
Jalgaon,Coriander (Dry),2016,9547,10338,791,8.285325233057504
Pune,Bottle Gourd,2016,542,1333,791,145.9409594095941
Solapur,Chikoo,2015,413,1203,790,191.28329297820824
Kalyan,Gr.Nut Kernels,2015,6600,7390,790,11.969696969696969
Pune,Carrot,2015,745,1535,790,106.04026845637584
Patan,Ginger (Fresh),2014,3863,4653,790,20.450427129174216
Kej,Gram,2015,3675,4465,790,21.496598639455783
Satara,Shevga,2015,3289,4079,790,24.019458802067497
Ausa,Pigeon Pea (Tur),2016,7522,8312,790,10.502525923956394
Kamthi,Pumpkin,2015,786,1576,790,100.5089058524173
Dhule,Cowpea,2015,2964,3754,790,26.653171390013494
Nashik,Cabbage,2015,250,1040,790,316.0
Pune,Sweet Potato,2015,1010,1800,790,78.21782178217822
Palghar(Bevur),Rice(Paddy-Hus),2015,2213,3003,790,35.69814731134207
Pathari,Green Gram,2015,8200,8990,790,9.634146341463415
Dhule,Soybean,2015,2870,3660,790,27.526132404181183
Washim,Pigeon Pea (Tur),2015,8833,9623,790,8.943733725800973
Jalgaon,Maize(Corn.),2016,1100,1889,789,71.72727272727273
Pune-Manjri,Bitter Gourd,2016,1304,2093,789,60.50613496932515
Pusad,Pigeon Pea (Tur),2016,7628,8417,789,10.343471421080231
Ahmedpur,Sorgum(Jawar),2014,1019,1808,789,77.4288518155054
Indapur-Bhigwan,Wheat(Husked),2016,1592,2381,789,49.56030150753769
Kurdwadi,Pigeon Pea (Tur),2014,3036,3825,789,25.988142292490117
Kurdwadi,Gram,2015,2175,2964,789,36.275862068965516
Aurangabad,Fig,2015,1982,2771,789,39.80827447023209
Nashik,Green Chilli,2015,1400,2189,789,56.357142857142854
Kopargaon,Gram,2015,3581,4370,789,22.032951689472213
Nashik-Devlali,Shepu,2016,1693,2482,789,46.60366213821619
Ratanagari,Ladies Finger,2015,2474,3263,789,31.891673403395313
Ratanagari,Flower,2016,2211,3000,789,35.68521031207598
Osmanabad,Wheat(Husked),2015,1900,2689,789,41.526315789473685
Amarawati,Mango,2016,2744,3533,789,28.753644314868804
Vaduj,Gram,2016,6944,7733,789,11.362327188940093
Indapur-Bhigwan,Gram,2016,5957,6746,789,13.244921940574114
Solapur,Matki,2016,5149,5938,789,15.32336375995339
Shrirampur,Ladies Finger,2016,2553,3342,789,30.904817861339602
Shrirampur,Cluster Bean,2015,2632,3421,789,29.977203647416413
Kamthi,Chavli (Pala),2016,900,1689,789,87.66666666666667
Karanja,Pigeon Pea (Tur),2016,8150,8939,789,9.680981595092025
Pathari,Bajri,2016,654,1442,788,120.48929663608563
Nandurbar,Sunflower,2016,4396,5184,788,17.925386715195632
Kamthi,Small Gourd,2016,648,1436,788,121.60493827160494
Pune,Flower,2016,868,1656,788,90.78341013824885
Vadgaon Peth,Bitter Gourd,2014,1781,2569,788,44.24480628860191
Khed-Chakan,Bitter Gourd,2016,1072,1860,788,73.50746268656717
Sindi (Selu),Cotton,2015,3650,4438,788,21.589041095890412
Kalyan,Shevga,2015,2871,3659,788,27.446882619296414
Majalgaon,Gram,2015,2785,3573,788,28.29443447037702
Pune,Mula Shenga,2016,1425,2213,788,55.29824561403509
Chakur,Pigeon Pea (Tur),2016,8383,9171,788,9.399976142192532
Mumbai,Split Gram,2016,5488,6276,788,14.358600583090379
Chalisgaon,Pigeon Pea (Tur),2015,4441,5229,788,17.74375140734069
Satara,Green-Peas,2015,3780,4568,788,20.84656084656085
Shahapur,Cluster Bean,2015,4056,4844,788,19.42800788954635
Indapur,Sorgum(Jawar),2016,1765,2553,788,44.64589235127479
Aurangabad,CHIKOO,2016,1900,2688,788,41.473684210526315
Hingoli-Kanegaon Naka,GRAM,2016,6662,7450,788,11.8282797958571
Ahmednagar,Green Gram,2016,4735,5522,787,16.62090813093981
Vadgaon Peth,Cucumber,2015,913,1700,787,86.19934282584884
Kalamb (Os),Gram,2015,3427,4214,787,22.96469215056901
Nandura,Gram,2015,3534,4321,787,22.2693831352575
Parbhani,Green Gram,2015,6401,7188,787,12.294953913451023
Nagpur,Chikoo,2014,989,1776,787,79.57532861476238
Murbad,CAPSICUM,2016,2913,3700,787,27.016821146584277
Jalgaon,Brinjal,2016,769,1556,787,102.3407022106632
Satara,LADIES FINGER,2016,1652,2439,787,47.639225181598064
Vasai,Onion,2015,1160,1947,787,67.84482758620689
Nagpur,Chikoo,2015,913,1700,787,86.19934282584884
Kamthi,Tomato,2015,663,1450,787,118.7028657616893
Murum,Pigeon Pea (Tur),2015,5305,6092,787,14.835061262959472
Pune-Moshi,Capsicum,2016,2390,3177,787,32.92887029288703
Nira-Saswad,Bajri,2016,1550,2337,787,50.774193548387096
Amarawati,Coriander  ,2015,2838,3625,787,27.730796335447497
Kalyan,Mosambi,2015,2194,2981,787,35.87055606198724
Kolhapur,Maize(Corn.),2016,486,1272,786,161.7283950617284
Kada,Wheat(Husked),2016,1493,2279,786,52.64567983924983
Mahagaon,Pigeon Pea (Tur),2016,7993,8779,786,9.833604403853371
Ratanagari,Cucumber,2016,2071,2857,786,37.95267986479961
Varud,Orange,2016,1500,2286,786,52.4
Patan,Ladies Finger,2014,3857,4643,786,20.37853253824216
Ratanagari,Cucumber,2016,727,1513,786,108.11554332874827
Nandgaon Khandeshwar,Gram,2016,6937,7723,786,11.330546345682572
Kalvan,Ground Nut Pods (Dry),2014,3778,4564,786,20.804658549497088
Shrirampur,Mosambi,2015,2500,3286,786,31.44
Shrirampur,Grapes,2015,3857,4643,786,20.37853253824216
Nandurbar,Sorgum(Jawar),2015,1403,2189,786,56.02280826799715
Satara,Pavtta,2014,5024,5810,786,15.644904458598726
Osmanabad,Sorgum(Jawar),2015,1146,1932,786,68.58638743455498
Pune,Pumpkin,2016,1562,2348,786,50.32010243277849
Kalyan,Cluster Bean,2016,3119,3905,786,25.2003847386983
Ratanagari,Flower,2014,2333,3119,786,33.690527218174026
Karad,Pomegranate,2015,2571,3357,786,30.57176196032672
Mangrulpeer,Soybean,2015,3215,4001,786,24.447900466562984
Rahata,Brinjal,2016,871,1657,786,90.24110218140069
Vai,Pavata,2015,4000,4786,786,19.65
Ratanagari,Bitter Gourd,2015,2750,3536,786,28.581818181818182
Kamthi,Spinach,2014,807,1593,786,97.39776951672863
Shrirampur,Gram,2015,3595,4381,786,21.863699582753824
Ratanagari,Cluster Bean,2015,2071,2857,786,37.95267986479961
Jalna,Gram,2015,4023,4809,786,19.537658463832962
Vai,Pavtta,2015,4000,4786,786,19.65
Aurangabad,Lemon,2016,1764,2550,786,44.5578231292517
Ratanagari,Ginger (Fresh),2015,4071,4857,786,19.307295504789977
Vai,Ladies Finger,2016,2929,3714,785,26.800955957664733
Ambejogai,Gram,2015,3992,4777,785,19.66432865731463
Bhivandi,RICE(PADDY-HUS),2016,2092,2877,785,37.523900573613766
Rahuri-Vambori,Onion,2016,150,935,785,523.3333333333334
Ahmednagar,Tamarind,2016,6804,7589,785,11.537330981775426
Pune,Bitter Gourd,2014,1426,2211,785,55.04908835904628
Sinner,Pigeon Pea (Tur),2015,3364,4149,785,23.335315101070154
Solapur,Ghevda,2015,746,1531,785,105.22788203753352
Kamthi,Flower,2015,830,1615,785,94.57831325301204
Satara,Tomato,2015,1296,2081,785,60.57098765432099
Pune-Moshi,SHEVGA,2016,2810,3595,785,27.93594306049822
Solapur,Wheat(Husked),2015,2017,2802,785,38.919186911254336
Vasai,Wheat(Husked),2016,1903,2688,785,41.25065685759327
Pune-Pimpri,Ghevda,2016,3286,4071,785,23.889227023737067
Mangrulpeer,Gram,2015,3776,4561,785,20.78919491525424
Pune,Cucumber,2014,675,1460,785,116.29629629629629
Rahata,Tomato,2014,1138,1923,785,68.98066783831283
Lasur Station,Gram,2015,3569,4354,785,21.994956570467917
Pune,Brinjal,2015,550,1335,785,142.72727272727272
Kolhapur,Maize(Corn.),2015,393,1178,785,199.74554707379136
Rahata,Green Chilli,2015,2746,3531,785,28.587035688273854
Murbad,Ladies Finger,2016,2789,3574,785,28.14628899247042
Pandharpur,Capsicum,2015,400,1185,785,196.25
Kamthi,WAL BHAJI,2016,1193,1978,785,65.80050293378038
Shirpur,Chillies(Red),2015,1396,2180,784,56.16045845272206
Kolhapur,Onion,2016,132,916,784,593.939393939394
Jalgaon,Bitter Gourd,2015,1874,2658,784,41.83564567769477
Dondaicha,Pigeon Pea (Tur),2016,5853,6637,784,13.39484025286178
Kej,Gram,2016,4755,5539,784,16.487907465825447
Taloda,Gram,2015,3031,3815,784,25.86605080831409
Phaltan,Wheat(Husked),2015,1525,2309,784,51.40983606557377
Akluj,Onion,2014,985,1769,784,79.59390862944163
Ahmednagar,Carrot,2016,633,1417,784,123.85466034755135
Ratanagari,Cucumber,2016,1558,2342,784,50.3209242618742
Akot,Gram,2016,7155,7939,784,10.95737246680643
Gangakhed,Cotton,2016,4100,4884,784,19.121951219512194
Kamthi,Small Gourd,2015,758,1542,784,103.43007915567283
Khamgaon,Cotton,2016,4229,5013,784,18.538661622132892
Khed-Chakan,GREEN CHILLI,2016,972,1756,784,80.65843621399176
Rahata,Onion,2016,133,917,784,589.4736842105264
Kalyan,Mosambi,2016,3708,4492,784,21.14347357065804
Akot,Pigeon Pea (Tur),2015,5819,6602,783,13.455920261213267
Kolhapur-Laxmipuri,Bajri,2015,1017,1800,783,76.99115044247787
Katol,Soybean,2016,2873,3656,783,27.25374173337974
Nandgaon Khandeshwar,Soybean,2016,2787,3570,783,28.094725511302475
Nashik,Onion,2015,768,1551,783,101.953125
Nandurbar,Black Gram,2016,6189,6972,783,12.651478429471643
Beed,Gram,2016,7777,8560,783,10.068149672110069
Sangamner,Tomato,2015,345,1128,783,226.95652173913044
Daryapur,Green Gram,2015,5052,5835,783,15.498812351543943
Ramtek,Shevga,2016,1300,2083,783,60.23076923076923
Hinganghat,Soybean,2016,3000,3783,783,26.1
Sinner,Onion,2016,99,882,783,790.9090909090909
Mangalwedha,Sorgum(Jawar),2015,1467,2249,782,53.30606680299932
Vasai,Potato,2016,1130,1912,782,69.20353982300885
Vadgaon Peth,Capsicum,2015,773,1555,782,101.16429495472187
Nira-Saswad,Sorgum(Jawar),2016,1600,2382,782,48.875
Dindori-Vani,Onion,2015,1695,2477,782,46.13569321533923
Indapur,Wheat(Husked),2016,1581,2363,782,49.46236559139785
Kalamb (Os),Wheat(Husked),2015,1478,2260,782,52.90933694181326
Amarawati,Math (Bhaji),2016,5023,5805,782,15.568385427035636
Umared,Gram,2014,2150,2932,782,36.372093023255815
Sailu,Green Gram,2014,6299,7081,782,12.414668995078584
Karad,Bitter Gourd,2015,2091,2873,782,37.39837398373984
Satara,Cluster Bean,2015,2141,2923,782,36.52498832321345
Nashik,Cucumber,2015,938,1719,781,83.26226012793177
Indapur (Nimgaon Ketki),Sorgum(Jawar),2015,1375,2156,781,56.8
Pune,Bitter Gourd,2015,1871,2652,781,41.74238375200427
Shrirampur,Bitter Gourd,2016,3188,3969,781,24.498117942283564
Katol,Soybean,2016,2851,3632,781,27.39389687828832
Barshi,Gram,2015,3272,4053,781,23.869193154034228
Satara,Brinjal,2015,1600,2381,781,48.8125
Kalamb (Os),Wheat(Husked),2015,1666,2446,780,46.8187274909964
Khed-Chakan,Squash Gourd,2016,3660,4440,780,21.311475409836067
Murbad,Brinjal,2016,3100,3880,780,25.161290322580644
Pathardi,WHEAT(HUSKED),2016,1620,2400,780,48.148148148148145
Pune,Sweet Potato,2015,1600,2380,780,48.75
Sangrampur,Black Gram,2014,3720,4500,780,20.967741935483872
Dudhani,Gram,2015,4136,4916,780,18.85880077369439
Kalyan,Lemon,2016,2640,3420,780,29.545454545454547
Pune-Manjri,Hemp,2015,0,780,780,inf
Kalamb (Yawatmal),Pigeon Pea (Tur),2016,7733,8513,780,10.086641665589035
Umarkhed,Gram,2014,2320,3100,780,33.62068965517241
Ahmednagar,Lemon,2015,840,1620,780,92.85714285714286
Jalna,Mosambi,2016,1677,2457,780,46.51162790697674
Pune-Manjri,Spinach,2015,330,1110,780,236.36363636363637
Khed-Chakan,FARSHI,2016,1240,2020,780,62.903225806451616
Sinner,Gram,2014,1878,2658,780,41.533546325878596
Phaltan,Gram,2014,2600,3380,780,30.0
Nilanga,Gram,2015,3350,4130,780,23.28358208955224
Chalisgaon,Ground Nut Pods (Dry),2015,4828,5608,780,16.15575807787904
Nagpur,Chikoo,2014,1048,1828,780,74.42748091603053
Solapur,Chikoo,2015,637,1416,779,122.29199372056515
Akluj,Bitter Gourd,2014,1971,2750,779,39.52308472856418
Purna,Green Gram,2016,4552,5331,779,17.11335676625659
Yeola,GREEN GRAM,2016,4034,4813,779,19.31085770946951
Manwat,Soybean,2015,3000,3779,779,25.966666666666665
Lasur Station,Sorgum(Jawar),2015,1296,2075,779,60.108024691358025
Jalgaon,Orange,2015,664,1443,779,117.31927710843374
Kamthi,Flower,2016,862,1641,779,90.37122969837587
Khed (Shel Pimpalgaon),Cluster Bean,2016,3595,4374,779,21.668984700973574
Chandur Bajar,Gram,2014,1870,2648,778,41.60427807486631
Shrirampur,Cluster Bean,2015,2500,3278,778,31.12
Varud-Rajura Bazar,Gram,2015,2629,3407,778,29.593001141118297
Khed-Chakan,Green-Peas,2016,2870,3648,778,27.10801393728223
Dhamangaon-Rly,Pigeon Pea (Tur),2015,5600,6378,778,13.892857142857142
Mangalwedha,Gram,2015,3399,4177,778,22.889085025007354
Junnar (Alephata),Onion,2014,1375,2153,778,56.58181818181818
Pune-Pimpri,Tomato,2015,961,1739,778,80.9573361082206
Nagpur,Pigeon Pea (Tur),2015,4975,5753,778,15.638190954773869
Jalna,Black Gram,2015,8675,9453,778,8.968299711815561
Akot,Green Gram,2016,5353,6131,778,14.53390622081076
Rahata,Green Chilli,2015,2778,3556,778,28.005759539236863
Chandrapur-Ganjwad,Carrot,2014,1037,1815,778,75.02410800385728
Amarawati,Ginger (Fresh),2015,2528,3306,778,30.775316455696203
Ratanagari,Ladies Finger,2014,2222,3000,778,35.013501350135016
Amarawati,GRAM,2016,9309,10086,777,8.346761198839832
Pandharpur,Onion,2016,129,906,777,602.3255813953489
Lonand,Sorgum(Jawar),2016,1648,2425,777,47.148058252427184
Amarawati,Mosambi,2016,1717,2494,777,45.2533488642982
Aurangabad,Green Chilli,2015,1377,2154,777,56.42701525054466
Osmanabad,Tomato,2015,602,1379,777,129.06976744186048
Parbhani,Pigeon Pea (Tur),2015,8305,9082,777,9.355809753160747
Kurdwadi-Modnimb,Sorgum(Jawar),2015,1584,2361,777,49.053030303030305
Pune-Moshi,Shevga,2016,3750,4527,777,20.72
Kamthi,Potato,2015,633,1410,777,122.74881516587678
Akluj,Brinjal,2014,1546,2323,777,50.25873221216042
Karad,Bor,2015,877,1654,777,88.59749144811859
Washim,Gram,2016,5927,6704,777,13.109498903323773
Dudhani,Green Gram,2015,7925,8701,776,9.79179810725552
Amalner,Pigeon Pea (Tur),2016,7573,8349,776,10.246929882477222
Sangali,Chillies(Red),2015,8553,9329,776,9.07283993920262
Loha,Gram,2014,1800,2576,776,43.111111111111114
Solapur,Potato,2016,544,1320,776,142.64705882352942
Solapur,Wheat(Husked),2015,2067,2843,776,37.542331881954524
Dhule,Pigeon Pea (Tur),2016,6930,7706,776,11.197691197691197
Phaltan,Green Chilli,2016,1165,1941,776,66.60944206008584
Hingoli,Turmeric,2016,8698,9474,776,8.921591170383996
Mumbai,Shevga,2014,3168,3944,776,24.494949494949495
Umarga,Gram,2016,7003,7779,776,11.080965300585463
Kamthi,Small Gourd,2015,765,1541,776,101.43790849673202
Mumbai,Jaggery,2014,3343,4119,776,23.21268321866587
Sangali,Sorgum(Jawar),2016,1780,2556,776,43.59550561797753
Nashik,Ghosali(Bhaji),2016,1228,2004,776,63.192182410423456
Sangali,Sorgum(Jawar),2016,1794,2570,776,43.25529542920847
Karad,Ghevda,2014,2025,2800,775,38.27160493827161
Karad,Onion,2014,1375,2150,775,56.36363636363637
Akluj,Bor,2016,1138,1913,775,68.10193321616872
Amarawati,Mosambi,2016,1575,2350,775,49.20634920634921
Kalyan,Small Gourd,2015,1400,2175,775,55.357142857142854
Pune-Moshi,Cabbage,2016,1452,2227,775,53.37465564738292
Ratanagari,Ladies Finger,2016,2925,3700,775,26.495726495726494
Karad,Potato,2014,2050,2825,775,37.80487804878049
Solapur,Potato,2014,1762,2537,775,43.98410896708286
Manchar,Cluster Bean,2015,4550,5325,775,17.032967032967033
Akluj,Bor,2016,725,1500,775,106.89655172413794
Ratanagari,Flower,2016,1650,2425,775,46.96969696969697
Nira-Saswad,Rice(Paddy-Hus),2016,2834,3609,775,27.34650670430487
Nashik,Melon,2015,750,1525,775,103.33333333333333
Baramati,Soybean,2016,2810,3585,775,27.580071174377224
Ambejogai,Pigeon Pea (Tur),2015,8091,8866,775,9.578544061302683
Jalgaon,Wal Papdi,2015,1825,2600,775,42.465753424657535
Jalgaon,Methi (Bhaji),2016,915,1690,775,84.69945355191257
Wardha,Pigeon Pea (Tur),2016,7469,8244,775,10.376221716427901
Akluj,Brinjal,2016,1119,1894,775,69.25826630920464
Chandur Bajar,Pigeon Pea (Tur),2016,7391,8166,775,10.485725882830469
Vasai,Wheat(Husked),2016,1827,2602,775,42.419266557197595
Nashik,Papai,2016,538,1313,775,144.05204460966542
Kolhapur,Ginger (Fresh),2016,1521,2296,775,50.953320184089414
Indapur,Gram,2015,3162,3937,775,24.50980392156863
Phaltan,Onion,2016,350,1125,775,221.42857142857142
Shrirampur,Black Gram,2016,5125,5900,775,15.121951219512194
Chandvad,LADIES FINGER,2016,659,1434,775,117.60242792109257
Kalmeshwar,Gram,2016,4913,5688,775,15.774475880317524
Kille Dharur,Gram,2015,3200,3975,775,24.21875
Gadhinglaj,Jaggery,2016,3225,4000,775,24.031007751937985
Dondaicha,Gram,2014,2199,2974,775,35.243292405638925
Aurangabad,Chikoo,2015,1575,2350,775,49.20634920634921
Ahmednagar,GHEVDA,2016,1350,2125,775,57.407407407407405
Bhokar,Gram,2016,6425,7200,775,12.062256809338521
Patan,Ghevda,2016,2350,3125,775,32.97872340425532
Katol,Orange,2016,1180,1955,775,65.67796610169492
Dound,BAJRI,2016,1237,2012,775,62.65157639450283
Indapur-Bhigwan,Pigeon Pea (Tur),2014,3050,3825,775,25.40983606557377
Kalyan,Gr.Nut Kernels,2015,8300,9075,775,9.337349397590362
Jamkhed,SORGUM(JAWAR),2016,2025,2800,775,38.27160493827161
Varud-Rajura Bazar,Gram,2015,2850,3625,775,27.19298245614035
Jalgaon,Gram,2015,3353,4128,775,23.11362958544587
Jalna-Badnapur,Green Gram,2014,7450,8225,775,10.40268456375839
Lonar,Green Gram,2015,6875,7650,775,11.272727272727273
Palus,Bitter Gourd,2016,4000,4775,775,19.375
Solapur,Potato,2016,823,1598,775,94.16767922235724
Shegaon,Pigeon Pea (Tur),2016,8008,8782,774,9.665334665334665
Indapur-Bhigwan,Wheat(Husked),2015,1530,2304,774,50.588235294117645
Barshi-Vairag,Sorgum(Jawar),2016,1693,2467,774,45.717660956881275
Latur-Murud,Gram,2015,3501,4275,774,22.10796915167095
Lasalgaon,Onion,2015,919,1693,774,84.22198041349293
Bhivandi,Potato,2015,1240,2014,774,62.41935483870968
Ghoti,Brinjal,2016,1374,2148,774,56.33187772925764
Pandharpur,Green Chilli,2016,439,1213,774,176.3097949886105
Kamthi,Bottle Gourd,2014,791,1565,774,97.85082174462705
Ambad(Vadi Godri),Wheat(Husked),2016,1693,2467,774,45.717660956881275
Aarni,Pigeon Pea (Tur),2016,7438,8212,774,10.406023124495832
Kopargaon,Gram,2015,3323,4097,774,23.292205838098106
Mangrulpeer,Green Gram,2014,6319,7093,774,12.248773540117107
Dhule,Soybean,2015,2758,3532,774,28.0638143582306
Barshi,Flower,2016,673,1447,774,115.0074294205052
Akola,Gram,2015,3146,3920,774,24.602670057215512
Sangali,Sorgum(Jawar),2016,1744,2518,774,44.38073394495413
Nashik,METHI (BHAJI),2016,783,1557,774,98.85057471264368
Pune-Manjri,GHOSALI(BHAJI),2016,1834,2607,773,42.148309705561616
Amarawati-Fruit And Vegetables,GINGER (FRESH),2016,2060,2833,773,37.52427184466019
Satara,Green Chilli,2016,3077,3850,773,25.12187195320117
Indapur-Bhigwan,Wheat(Husked),2015,1590,2363,773,48.61635220125786
Ratanagari,Capsicum,2015,2182,2955,773,35.42621448212649
Pune-Manjri,Chavli (Pala),2015,495,1268,773,156.16161616161617
Vadgaon Peth,Cabbage,2015,617,1390,773,125.2836304700162
Rahuri-Vambori,Onion,2016,135,908,773,572.5925925925926
Manmad,Gram,2015,4240,5013,773,18.2311320754717
Pune,Potato,2015,577,1350,773,133.9688041594454
Aurangabad,Chavli (Shenga ),2016,2227,3000,773,34.7103726986978
Satara,Brinjal,2015,1655,2428,773,46.70694864048338
Barshi,Wheat(Husked),2015,1417,2190,773,54.55187014820042
Jalgaon,Flower,2016,1157,1930,773,66.81071737251513
Amarawati-Fruit And Vegetables,Chikoo,2016,1487,2260,773,51.98386012104909
Mumbai,Green-Peas,2015,4808,5581,773,16.07737104825291
Pusad,Ground Nut Pods (Dry),2016,5250,6023,773,14.723809523809523
Pune-Manjri,Kanda Pat,2016,698,1471,773,110.74498567335243
Nandgaon Khandeshwar,Green Gram,2016,5400,6173,773,14.314814814814815
Pune,SWEET POTATO,2016,809,1582,773,95.55006180469715
Rahata,Ladies Finger,2015,827,1600,773,93.47037484885126
Vadgaon Peth,Ladies Finger,2015,818,1591,773,94.49877750611248
Umarga,Pigeon Pea (Tur),2016,7194,7967,773,10.745065332221296
Kurdwadi-Modnimb,Onion,2015,1393,2166,773,55.49174443646805
Solapur,Ghevda,2016,1873,2645,772,41.21729845168179
Sinner,Onion,2016,91,863,772,848.3516483516484
Pandharpur,Cabbage,2015,455,1227,772,169.67032967032966
Devala,Gram,2015,3102,3874,772,24.88716956802063
Jalna,Gram,2016,4607,5379,772,16.757108747558064
Dhamangaon-Rly,Pigeon Pea (Tur),2016,8072,8844,772,9.56392467789891
Nashik,Bottle Gourd,2016,540,1312,772,142.96296296296296
Rahuri-Vambori,Onion,2016,189,961,772,408.46560846560845
Indapur-Bhigwan,Gram,2016,3750,4522,772,20.586666666666666
Kalamb (Os),Pigeon Pea (Tur),2014,3252,4024,772,23.739237392373923
Dudhani,Gram,2016,5340,6112,772,14.456928838951312
Sonpeth,Cotton,2016,3662,4434,772,21.081376297105408
Jalkot,Sorgum(Jawar),2016,1858,2630,772,41.55005382131324
Chandrapur-Ganjwad,Coriander  ,2015,967,1739,772,79.83453981385729
Gevrai,Pigeon Pea (Tur),2016,7901,8673,772,9.77091507404126
Kolhapur,Carrot,2016,457,1229,772,168.92778993435448
Kamthi,Chavli (Shenga ),2016,919,1690,771,83.89553862894451
Shirpur,Gram,2015,3970,4741,771,19.420654911838792
Kada,Green Gram,2015,6800,7571,771,11.338235294117647
Umared,Pigeon Pea (Tur),2015,4870,5641,771,15.831622176591376
Akluj,Shevga,2015,1235,2006,771,62.42914979757085
Malkapur,Gram,2016,4545,5316,771,16.963696369636963
Solapur,Ghevda,2015,858,1629,771,89.86013986013987
Hadgaon,Gram,2016,3550,4321,771,21.718309859154928
Manchar,Cabbage,2016,1711,2482,771,45.06136762127411
Kurdwadi-Modnimb,Wheat(Husked),2015,1338,2109,771,57.62331838565022
Satara,Brinjal,2015,1396,2167,771,55.22922636103152
Gevrai,Pigeon Pea (Tur),2016,5444,6215,771,14.162380602498164
Rahata,Brinjal,2015,829,1600,771,93.00361881785284
Manmad,Onion,2016,584,1355,771,132.0205479452055
Jamkhed,Sorgum(Jawar),2016,1771,2542,771,43.53472614342179
Karanja,Ground Nut Pods (Dry),2015,4174,4945,771,18.471490177287972
Kalamb (Os),Gram,2015,3538,4309,771,21.791972866026004
Aurangabad,Brinjal,2016,1129,1900,771,68.29052258635961
Mumbai,Green Peas (Dry),2015,2938,3709,771,26.24234172906739
Satara,Ginger (Fresh),2015,2343,3114,771,32.90653008962868
Patur,Gram,2015,3443,4214,771,22.39326169038629
Raver,Pigeon Pea (Tur),2016,6637,7407,770,11.601627241223444
Sangli-Phale Bhajipalam,Onion,2016,382,1152,770,201.57068062827224
Kalamb (Os),Wheat(Husked),2015,1679,2449,770,45.86063132817153
Kamthi,CHAVLI (PALA),2016,1013,1783,770,76.01184600197433
Ahmednagar,Cabbage,2015,560,1330,770,137.5
Vai,Ridge Gourd,2016,4192,4962,770,18.36832061068702
Shegaon,Green Gram,2015,7466,8236,770,10.313420841146531
Manora,Pigeon Pea (Tur),2015,4776,5546,770,16.122278056951423
Chandrapur,Papai,2016,560,1330,770,137.5
Umarga,Pigeon Pea (Tur),2015,5408,6178,770,14.238165680473372
Nanded,Wheat(Husked),2015,1381,2151,770,55.756698044895
Kalvan,GROUND NUT PODS (DRY),2016,3884,4654,770,19.824922760041193
Khamgaon,Green Gram,2014,7346,8116,770,10.481894908793901
Akola,Green Gram,2015,7250,8020,770,10.620689655172415
Pune-Moshi,GHEVDA,2016,1913,2683,770,40.250914793518035
Malkapur,Soybean,2016,2202,2972,770,34.968210717529516
Paranda,Sorgum(Jawar),2016,1680,2450,770,45.833333333333336
Indapur-Bhigwan,Wheat(Husked),2016,1583,2353,770,48.641819330385346
Kurdwadi-Modnimb,Sorgum(Jawar),2016,1591,2361,770,48.39723444374607
Nandurbar,Chillies(Red),2016,919,1689,770,83.7867247007617
Yeotmal,Gram,2016,4754,5524,770,16.196886832141356
Pune,Tomato,2014,575,1345,770,133.91304347826087
Umarga,Pigeon Pea (Tur),2014,3954,4723,769,19.448659585230146
Indapur,Gram,2016,5175,5944,769,14.859903381642512
Kamthi,Carrot,2016,723,1492,769,106.36237897648687
Pune-Manjri,Rajgira,2015,225,994,769,341.77777777777777
Barshi-Vairag,Ground Nut Pods (Dry),2014,3150,3919,769,24.41269841269841
Rahuri,Melon,2016,244,1013,769,315.1639344262295
Nagpur,Pigeon Pea (Tur),2016,5414,6183,769,14.203915773919467
Akkolkot,Pigeon Pea (Tur),2015,9806,10575,769,7.842137466857026
Akluj,Bitter Gourd,2015,1231,2000,769,62.46953696181966
Solapur,Green Chilli,2016,396,1165,769,194.1919191919192
Katol,Gram,2016,5852,6621,769,13.140806561859193
Akola,GREEN GRAM,2016,4325,5094,769,17.78034682080925
Akluj,Chikoo,2015,1725,2494,769,44.57971014492754
Murtizapur,Pigeon Pea (Tur),2015,5098,5867,769,15.084346802667714
Satana,Gram,2016,3535,4304,769,21.753889674681755
Osmanabad,Cucumber,2015,819,1588,769,93.89499389499389
Indapur-Bhigwan,Pigeon Pea (Tur),2015,3963,4732,769,19.404491546807975
Pune-Pimpri,Ghosali(Bhaji),2016,2323,3092,769,33.10374515712441
Pune,Bitter Gourd,2015,945,1714,769,81.37566137566138
Beed,Wheat(Husked),2015,1696,2464,768,45.283018867924525
Nandura,Onion,2015,1087,1855,768,70.65317387304508
Kolhapur,Maize(Corn.),2015,488,1256,768,157.37704918032787
Nagpur,Ginger (Fresh),2015,2813,3581,768,27.301813011020265
Pune,Green Gram,2016,6616,7384,768,11.608222490931077
Dhule,Gram,2014,2285,3053,768,33.61050328227571
Pune,Snake Gourd,2015,809,1577,768,94.93201483312731
Washim,Turmeric,2016,6500,7268,768,11.815384615384616
Pune-Pimpri,Bottle Gourd,2016,1632,2400,768,47.05882352941177
Pune,Green Gram,2016,7503,8271,768,10.235905637744903
Latur,Pigeon Pea (Tur),2015,5094,5862,768,15.07656065959953
Kamthi,Mint,2016,912,1680,768,84.21052631578948
Pune-Moshi,Cluster Bean,2016,2048,2816,768,37.5
Sinner,Gram,2015,3575,4343,768,21.482517482517483
Junnar-Otur,Cluster Bean,2016,561,1329,768,136.89839572192514
Mumbai,Cucumber,2014,644,1412,768,119.25465838509317
Sangali,Wheat(Unhusked),2014,3800,4567,767,20.18421052631579
Manchar,Shevga,2016,1233,2000,767,62.206001622060015
Sangali,Gram,2015,4233,5000,767,18.119536971415073
Osmanabad,Pigeon Pea (Tur),2016,7667,8434,767,10.003912873353332
Akole,Wheat(Husked),2016,1533,2300,767,50.032615786040445
Kalyan,Shevga,2016,4933,5700,767,15.548347861341982
Kamthi,Tomato,2016,770,1537,767,99.6103896103896
Yeotmal,Pigeon Pea (Tur),2016,8167,8934,767,9.391453410064896
Latur-Murud,Wheat(Husked),2016,1423,2190,767,53.9002108222066
Dudhani,Pigeon Pea (Tur),2015,11128,11895,767,6.892523364485982
Khed-Chakan,Shevga,2016,2346,3113,767,32.69394714407502
Pathardi,Gram,2015,3500,4267,767,21.914285714285715
Akhadabalapur,Black Gram,2015,5333,6100,767,14.38214888430527
Kamthi,Flower,2016,510,1277,767,150.3921568627451
Mangalwedha,Sorgum(Jawar),2014,1580,2347,767,48.54430379746835
Buldhana,Pigeon Pea (Tur),2016,7389,8156,767,10.380295033157395
Satara,Brinjal,2016,1354,2121,767,56.646971935007386
Taloda,Gram,2015,3150,3917,767,24.349206349206348
Lasalgaon-Vinchur,Soybean,2016,3116,3883,767,24.614890885750963
Patan,Cluster Bean,2014,3550,4317,767,21.6056338028169
Shirur,Tamarind,2015,1490,2257,767,51.47651006711409
Nagpur,Ginger (Dry),2016,1733,2500,767,44.25851125216388
Katol,Ground Nut Pods (Dry),2015,5000,5767,767,15.34
Nandgaon,Green Gram,2016,4751,5518,767,16.143969690591454
Latur,Coriander (Dry),2016,6500,7267,767,11.8
Udgir,Gram,2014,2179,2946,767,35.199632859109684
Mangrulpeer,Gram,2016,3532,4299,767,21.715741789354475
Chandrapur,Chikoo,2016,1550,2317,767,49.483870967741936
Umarga,Pigeon Pea (Tur),2016,8185,8952,767,9.37080024434942
Indapur,Wheat(Husked),2016,1657,2423,766,46.22812311406156
Vaijapur,Onion,2016,229,995,766,334.49781659388645
Pune-Pimpri,Ghevda,2015,1767,2533,766,43.35031126202603
Balapur,Black Gram,2015,4567,5333,766,16.7724983577841
Murtizapur,Gram,2016,7150,7916,766,10.713286713286713
Vadgaon Peth,Cucumber,2014,778,1544,766,98.45758354755785
Nagpur,Potato,2016,669,1435,766,114.49925261584454
Rahata,Brinjal,2014,778,1544,766,98.45758354755785
Nandgaon Khandeshwar,Soybean,2015,2880,3646,766,26.59722222222222
Pune,BRINJAL,2016,617,1383,766,124.14910858995138
Khamgaon,Pigeon Pea (Tur),2014,4270,5036,766,17.939110070257613
Savner,Pigeon Pea (Tur),2015,6892,7658,766,11.114335461404528
Karad,Green Chilli,2016,4119,4885,766,18.596746783199805
Phaltan,Brinjal,2016,1188,1954,766,64.47811447811448
Nagpur,Green Chilli,2016,2638,3404,766,29.037149355572403
Solapur,Carrot,2015,547,1313,766,140.036563071298
Kolhapur,Tomato,2016,194,960,766,394.8453608247423
Pandharpur,Coriander  ,2015,317,1083,766,241.6403785488959
Katol,Mosambi,2016,1267,2033,766,60.45777426992897
Satara,Ladies Finger,2015,2962,3727,765,25.827143821742066
Dondaicha,Pigeon Pea (Tur),2016,6658,7423,765,11.489936917993392
Pathari,Soybean,2015,2922,3687,765,26.18069815195072
Sinner,Ground Nut Pods (Dry),2015,4063,4828,765,18.828451882845187
Nandgaon Khandeshwar,BLACK GRAM,2016,5564,6329,765,13.749101365923796
Pathardi,Onion,2016,173,938,765,442.1965317919075
Ratanagari,Capsicum,2014,3088,3853,765,24.773316062176164
Pathardi,Black Gram,2015,7250,8015,765,10.551724137931034
Jintur,Green Gram,2014,6391,7156,765,11.969957753090283
Lonand,Wheat(Husked),2015,1502,2267,765,50.93209054593875
Jamkhed,Green Gram,2014,5680,6445,765,13.46830985915493
Ratanagari,Capsicum,2015,3219,3984,765,23.76514445479963
Pune-Manjri,Harbara(Pendi),2015,585,1350,765,130.76923076923077
Pimpalgaon Basawant,Onion,2016,264,1029,765,289.77272727272725
Nashik,KANDA PAT,2016,908,1673,765,84.2511013215859
Rahata,Onion,2016,154,919,765,496.75324675324674
Yeotmal,Pigeon Pea (Tur),2016,8123,8888,765,9.417702819155485
Khed-Chakan,Onion,2016,861,1625,764,88.73403019744484
Pune,BOTTLE GOURD,2016,400,1164,764,191.0
Ratanagari,Ladies Finger,2014,3912,4676,764,19.529652351738243
Shirpur,Ground Nut Pods (Dry),2014,2989,3753,764,25.560388089662094
Kurdwadi,Sorgum(Jawar),2015,1057,1821,764,72.28003784295176
Hadgaon,Pigeon Pea (Tur),2016,8280,9044,764,9.227053140096618
Dondaicha-Sindkheda,Green Gram,2016,4351,5115,764,17.55918179728798
Mumbai,Squash Gourd,2016,2786,3550,764,27.422828427853553
Ahmedpur,Pigeon Pea (Tur),2015,7870,8634,764,9.707750952986023
Phaltan,Wheat(Husked),2016,1525,2289,764,50.09836065573771
Kada,Gram,2016,6079,6843,764,12.5678565553545
Mangalwedha,Sorgum(Jawar),2014,1632,2396,764,46.81372549019608
Raver,Pigeon Pea (Tur),2015,4721,5485,764,16.183012073713197
Ratanagari,Capsicum,2016,1357,2121,764,56.30066322770818
Kalyan,Small Gourd,2015,2365,3129,764,32.30443974630021
Junnar,Onion,2014,1029,1793,764,74.24684159378037
Pune,Lentil,2014,6324,7088,764,12.080961416824794
Khed-Chakan,Onion,2015,900,1664,764,84.88888888888889
Aurangabad,Lemon,2014,2632,3396,764,29.027355623100306
Kamthi,SPINACH,2016,907,1671,764,84.23373759647188
Pune,Capsicum,2015,709,1473,764,107.75740479548661
Varora,Pigeon Pea (Tur),2016,7943,8707,764,9.618532040790633
Vadgaon Peth,Bitter Gourd,2014,1529,2293,764,49.9672988881622
Pune,Tamarind,2016,5750,6513,763,13.269565217391305
Aarni,Ground Nut Pods (Dry),2016,5160,5923,763,14.786821705426357
Ramtek,Onion,2015,3053,3816,763,24.99181133311497
Shrirampur,Tomato,2016,1605,2368,763,47.53894080996885
Ratanagari,Green Chilli,2015,2921,3684,763,26.121191372817528
Ahmednagar,Gram,2016,4790,5553,763,15.92901878914405
Karad,Onion,2014,1225,1988,763,62.285714285714285
Pandharpur,CUCUMBER,2016,623,1386,763,122.47191011235955
Mumbai,Split Gram,2016,5354,6117,763,14.251027269331342
Sangrampur-Varvatbakal,Green Gram,2016,3600,4363,763,21.194444444444443
Ratanagari,Green Chilli,2015,2605,3368,763,29.28982725527831
Ambejogai,Pigeon Pea (Tur),2016,5764,6527,763,13.23733518390007
Dindori,Onion,2015,800,1563,763,95.375
Sillod-Bharadi,Green Gram,2014,7170,7933,763,10.641562064156206
Lonar,Green Gram,2015,5430,6193,763,14.051565377532228
Pune,Flower,2015,655,1418,763,116.4885496183206
Palghar(Bevur),Rice(Paddy-Hus),2016,2370,3133,763,32.19409282700422
Kamthi,Pumpkin,2015,655,1418,763,116.4885496183206
Shrirampur,Lemon,2016,3342,4105,763,22.830640335128667
Pune,Gr.Nut Kernels,2015,8106,8869,763,9.412780656303973
Vadgaon Peth,Green Chilli,2015,882,1645,763,86.5079365079365
Pune,Black Gram,2015,8200,8963,763,9.304878048780488
Nagpur,Chikoo,2015,825,1588,763,92.48484848484848
Kurdwadi-Modnimb,Onion,2016,201,963,762,379.1044776119403
Karad,Pomegranate,2016,3857,4619,762,19.756287269898884
Phaltan,Green Chilli,2016,1000,1762,762,76.2
Nashik,Bitter Gourd,2015,2084,2846,762,36.56429942418426
Pune-Moshi,Green-Peas,2016,5694,6456,762,13.38250790305585
Patan,Pavtta,2015,2546,3308,762,29.92930086410055
Mumbai,Ginger (Dry),2016,1638,2400,762,46.52014652014652
Nandura,Black Gram,2016,8801,9563,762,8.658107033291671
Nagpur,Coriander  ,2015,3588,4350,762,21.237458193979933
Satara,Shevga,2015,4357,5119,762,17.48909800321322
Anajngaon Surji,Pigeon Pea (Tur),2015,5140,5902,762,14.82490272373541
Osmanabad,Cabbage,2016,1213,1975,762,62.819455894476505
Kamthi,Potato,2016,1095,1857,762,69.58904109589041
Mumbai,Jaggery,2015,2771,3533,762,27.499097798628654
Amarawati,Ground Nut Pods (Dry),2016,4694,5456,762,16.233489561141884
Shrirampur,Orange,2015,1119,1881,762,68.09651474530831
Nampur,Gram,2016,2963,3725,762,25.71717853526831
Rahata,Brinjal,2016,1315,2077,762,57.946768060836504
Vasai,Wheat(Husked),2016,1491,2253,762,51.10663983903421
Shrirampur,Gram,2015,3374,4136,762,22.58446947243628
Jalgaon,Coriander (Dry),2015,8057,8818,761,9.44520292912995
Pune,Cucumber,2016,478,1239,761,159.20502092050208
Shrirampur,Tomato,2014,1929,2690,761,39.45049248315189
Pulgaon,Cotton,2015,3713,4474,761,20.495556154053325
Pandharpur,Cucumber,2015,360,1121,761,211.38888888888889
Lohara,Pigeon Pea (Tur),2016,7443,8204,761,10.224371893053876
Udgir,Soybean,2016,2587,3348,761,29.416312330885194
Malkapur,Soybean,2016,3225,3986,761,23.5968992248062
Sangli-Phale Bhajipalam,Pineapple,2015,155,916,761,490.96774193548384
Savner,Pigeon Pea (Tur),2016,7818,8579,761,9.733947301100025
Yeola,Gram,2015,3505,4266,761,21.711840228245364
Pune,Capsicum,2016,1287,2048,761,59.12975912975913
Pulgaon,Cotton,2016,4165,4926,761,18.271308523409363
Manchar,Farshi,2015,2521,3282,761,30.18643395477985
Kurdwadi-Modnimb,ONION,2016,125,886,761,608.8
Washim,Pigeon Pea (Tur),2015,8521,9282,761,8.930876657669288
Rahata,Green Chilli,2016,2331,3092,761,32.64693264693265
Chandrapur-Ganjwad,Tomato,2015,709,1470,761,107.3342736248237
Solapur,Potato,2015,428,1189,761,177.80373831775702
Ramtek,Coriander  ,2016,2295,3055,760,33.11546840958606
Kurdwadi,Pigeon Pea (Tur),2014,2640,3400,760,28.78787878787879
Risod,Green Gram,2015,7140,7900,760,10.644257703081232
Aurangabad,Chavli (Shenga ),2014,2240,3000,760,33.92857142857143
Aurangabad,Capsicum,2014,2360,3120,760,32.20338983050848
Aurangabad,Bor,2014,683,1443,760,111.27379209370424
Barshi,Pigeon Pea (Tur),2015,5718,6478,760,13.29136061559986
Patan,Tomato,2016,3737,4497,760,20.337168852020337
Pandharpur,Cabbage,2016,590,1350,760,128.8135593220339
Aurangabad,Ground Nut Pods (Dry),2016,3300,4060,760,23.03030303030303
Ahmednagar,Cucumber,2015,680,1440,760,111.76470588235294
Nagpur,Gram,2015,3207,3967,760,23.69816027439975
Shrirampur,Tomato,2016,3320,4080,760,22.89156626506024
Nashik,Carrot,2015,863,1623,760,88.0648899188876
Ausa,Gram,2014,2102,2862,760,36.15604186489058
Aurangabad,Flower,2016,1516,2276,760,50.13192612137203
Beed,Wheat(Husked),2016,1652,2412,760,46.00484261501211
Dondaicha-Sindkheda,Matki,2016,4477,5237,760,16.975653339289703
Manchar,Cluster Bean,2015,4500,5260,760,16.88888888888889
Osmanabad,Chikoo,2015,780,1540,760,97.43589743589743
Karanja,Pigeon Pea (Tur),2016,5912,6672,760,12.855209742895806
Kolhapur,Maize(Corn.),2015,430,1190,760,176.74418604651163
Satara,Shevga,2016,1740,2500,760,43.67816091954023
Chandrapur-Ganjwad,Spinach,2016,1240,2000,760,61.29032258064516
Kalyan,Chikoo,2016,2000,2760,760,38.0
Palus,Bitter Gourd,2016,3180,3940,760,23.89937106918239
Vadgaon Peth,Ladies Finger,2015,813,1573,760,93.4809348093481
Akluj,Shevga,2016,753,1513,760,100.92961487383798
Jalna,Gram,2015,2911,3671,760,26.107866712469942
Pune-Moshi,Garlic,2016,6759,7519,760,11.244266903388075
Babhulgaon,Pigeon Pea (Tur),2016,8087,8846,759,9.385433411648325
Ahmednagar,Sorgum(Jawar),2016,1695,2454,759,44.7787610619469
Lasalgaon,Onion,2016,711,1470,759,106.75105485232068
Kolhapur,Orange,2016,935,1694,759,81.17647058823529
Bhokar,Cotton,2015,3778,4537,759,20.089994706193753
Kille Dharur,Pigeon Pea (Tur),2015,5824,6583,759,13.032280219780219
Akluj,Ladies Finger,2014,2153,2912,759,35.25313516024152
Kolhapur,Onion,2016,279,1038,759,272.0430107526882
Nashik,Kanda Pat,2016,519,1278,759,146.242774566474
Sangali,Lentil,2016,5559,6318,759,13.65353480841878
Aurangabad,Wal Bhaji,2016,3000,3759,759,25.3
Nashik,Squash Gourd,2014,537,1296,759,141.34078212290504
Mumbai,Potato,2014,1629,2388,759,46.59300184162063
Kamthi,Cabbage,2015,676,1434,758,112.1301775147929
Vadgaon Peth,Ladies Finger,2015,863,1621,758,87.83314020857473
Rahata,Potato,2015,588,1346,758,128.91156462585033
Lasalgaon,Wheat(Husked),2015,1318,2076,758,57.51138088012139
Pune,Parwar,2016,2500,3258,758,30.32
Hinganghat,Soybean,2016,3000,3758,758,25.266666666666666
Baramati,Soybean,2016,2920,3678,758,25.958904109589042
Umared,Wheat(Husked),2016,1600,2358,758,47.375
Pune-Manjri,Chavli (Pala),2016,553,1311,758,137.07052441229658
Karanja,Sesamum,2014,7479,8237,758,10.135044792084503
Chalisgaon,Ladies Finger,2016,1000,1758,758,75.8
Shahada,Sorgum(Jawar),2016,1601,2359,758,47.345409119300434
Chikhali,Green Gram,2016,3517,4275,758,21.552459482513505
Mumbai,Green-Peas,2015,4667,5425,758,16.24169702164131
Shrirampur,Gram,2015,3340,4098,758,22.694610778443113
Phaltan,GREEN CHILLI,2016,1100,1858,758,68.9090909090909
Mumbai,Melon,2015,940,1698,758,80.63829787234043
Dhadgaon,Maize,2016,1485,2243,758,51.043771043771045
Majalgaon,Sorgum(Jawar),2015,1104,1862,758,68.65942028985508
Ghoti,Tomato,2015,1971,2729,758,38.45763571790969
Karad,Brinjal,2014,2057,2814,757,36.801166747690814
Kamthi,Ladies Finger,2016,790,1547,757,95.82278481012658
Khamgaon,Lemon,2016,150,907,757,504.6666666666667
Nira-Saswad,Sorgum(Jawar),2016,1600,2357,757,47.3125
Jalgaon Jamod-Aasalgaon,Pigeon Pea (Tur),2016,7214,7971,757,10.493484890490713
Gadhinglaj,Jaggery,2016,2786,3543,757,27.17157214644652
Manchar,Flower,2016,667,1424,757,113.49325337331334
Manchar,Shepu,2015,415,1172,757,182.40963855421685
Bhiwapur,Pigeon Pea (Tur),2016,7743,8500,757,9.776572387963322
Digras,Black Gram,2016,6029,6786,757,12.555979432741749
Bhivandi,Wheat(Husked),2014,1388,2145,757,54.538904899135446
Barshi,Pigeon Pea (Tur),2015,5853,6610,757,12.933538356398428
Dhule,Gram,2015,3561,4318,757,21.25807357483853
Pune-Manjri,Tomato,2016,1023,1780,757,73.9980449657869
Aurangabad,Chikoo,2015,1200,1957,757,63.083333333333336
Indapur,Sorgum(Jawar),2015,1618,2374,756,46.72435105067985
Nandurbar,Sunflower,2016,4148,4904,756,18.225650916104147
Pune,Bottle Gourd,2016,820,1576,756,92.1951219512195
Raver,Pigeon Pea (Tur),2015,4427,5183,756,17.077027332279197
Bhivandi,Onion,2014,1433,2189,756,52.75645498953245
Indapur-Bhigwan,Sorgum(Jawar),2016,1600,2356,756,47.25
Karanja,Green Gram,2016,4275,5031,756,17.68421052631579
Lonand,Gram,2015,3344,4100,756,22.607655502392344
Kalyan,Shevga,2016,4022,4778,756,18.79661859771258
Indapur,Onion,2016,109,865,756,693.5779816513761
Mantha,Sorgum(Jawar),2014,1400,2156,756,54.0
Solapur,Potato,2016,710,1466,756,106.47887323943662
Katol,Pigeon Pea (Tur),2016,7689,8445,756,9.83222785797893
Chikhali,Gram,2015,2390,3146,756,31.631799163179917
Solapur,Cabbage,2015,464,1220,756,162.93103448275863
Aurangabad,Brinjal,2015,1311,2067,756,57.66590389016018
Khamgaon,Gram,2014,2144,2900,756,35.26119402985075
Khed-Chakan,WALVAD,2016,1248,2004,756,60.57692307692308
Malkapur,Pigeon Pea (Tur),2015,3911,4667,756,19.33009460496037
Partur,Wheat(Husked),2016,1708,2464,756,44.26229508196721
Manora,Gram,2016,6200,6956,756,12.193548387096774
Patan,Ginger (Fresh),2015,2941,3697,756,25.705542332539952
Majalgaon,Gram,2016,4491,5247,756,16.83366733466934
Indapur-Bhigwan,WHEAT(HUSKED),2016,1700,2456,756,44.470588235294116
Pune,Gr.Nut Kernels,2014,6700,7455,755,11.26865671641791
Pusad,Soybean,2016,2359,3114,755,32.00508690122933
Vadgaon Peth,CAPSICUM,2016,927,1682,755,81.44552319309601
Pune-Manjri,Chavli (Pala),2016,767,1522,755,98.4354628422425
Kalamb (Os),Gram,2015,2273,3028,755,33.2160140783106
Ahmednagar,Cucumber,2015,789,1544,755,95.69074778200253
Pune,Sweet Potato,2015,925,1680,755,81.62162162162163
Ratanagari,Cabbage,2016,1750,2505,755,43.142857142857146
Manchar,Bottle Gourd,2016,706,1461,755,106.94050991501416
Sangali,Sorgum(Jawar),2016,1724,2479,755,43.793503480278424
Pune-Pimpri,Tomato,2015,1535,2290,755,49.185667752442995
Pune,Lentil,2016,6595,7350,755,11.448066717210008
Nandura,Gram,2016,5730,6485,755,13.176265270506109
Gadhinglaj,Jaggery,2016,2292,3047,755,32.94066317626527
Kalyan,Shevga,2015,3835,4590,755,19.687092568448502
Mantha,Green Gram,2014,6040,6795,755,12.5
Washim,Pigeon Pea (Tur),2016,8924,9679,755,8.46033168982519
Dondaicha,Gram,2014,2147,2902,755,35.16534699580811
Aurangabad,Bitter Gourd,2015,1545,2300,755,48.86731391585761
Jalkot,Black Gram,2016,6609,7364,755,11.423816008473294
Pune,Beet Root,2014,665,1420,755,113.53383458646617
Satara,Green Chilli,2015,2077,2831,754,36.30235917188252
Sangamner,Gram,2016,5818,6572,754,12.959779993124785
Satara,Green Chilli,2014,1981,2735,754,38.06158505805149
Ahmednagar,Maize(Corn.),2016,991,1745,754,76.08476286579213
Khed-Chakan,Farshi,2016,1267,2021,754,59.51065509076559
Khed-Chakan,Ladies Finger,2016,1069,1823,754,70.533208606174
Raver,Pigeon Pea (Tur),2016,7301,8055,754,10.327352417477059
Shrirampur,Brinjal,2016,1414,2168,754,53.323903818953326
Jalna,Pigeon Pea (Tur),2014,4452,5206,754,16.936208445642407
Pune-Manjri,Green-Peas,2015,2441,3195,754,30.88897992625973
Latur-Murud,Pigeon Pea (Tur),2016,7194,7948,754,10.480956352515985
Sengaon,Turmeric,2016,8150,8904,754,9.251533742331288
Osmanabad,Wheat(Husked),2015,1796,2550,754,41.98218262806236
Nagpur,Ginger (Fresh),2015,3281,4035,754,22.980798537031394
Amarawati-Fruit And Vegetables,Chikoo,2016,2069,2823,754,36.44272595456742
Mumbai,Split Lentil,2016,6400,7154,754,11.78125
Akluj,Ground Nut Pods (Dry),2015,2200,2954,754,34.27272727272727
Osmanabad,CAPSICUM,2016,708,1462,754,106.49717514124293
Ghatanji,Cotton,2016,4225,4978,753,17.82248520710059
Jalgaon,Mango(Raw),2016,1400,2153,753,53.785714285714285
Lasalgaon,Pigeon Pea (Tur),2016,7183,7936,753,10.483085061951831
Karmala,Sorgum(Jawar),2016,1584,2337,753,47.53787878787879
Murbad,Brinjal,2016,5047,5800,753,14.919754309490786
Hingoli,Green Gram,2015,7448,8201,753,10.110096670247046
Pune-Manjri,Ghevda,2015,1989,2742,753,37.85822021116139
Pune,Wal Bhaji,2015,1506,2259,753,50.0
Khed-Chakan,Chavli (Shenga ),2016,1362,2115,753,55.286343612334804
Dhule,Green Gram,2015,7256,8009,753,10.377618522601985
Indapur,Wheat(Husked),2016,1665,2418,753,45.22522522522522
Hingoli-Kanegaon Naka,BLACK GRAM,2016,6069,6822,753,12.40731586752348
Daryapur,Gram,2014,2261,3014,753,33.30384785493145
Kopargaon,Gram,2015,3421,4174,753,22.011107863197896
Kalmeshwar,Coriander  ,2015,5485,6238,753,13.728350045578852
Sindi,Pigeon Pea (Tur),2016,7725,8478,753,9.74757281553398
Pune-Manjri,Bottle Gourd,2015,586,1338,752,128.32764505119454
Jalna,Pigeon Pea (Tur),2014,3967,4719,752,18.956390219309302
Mandhal,Chillies(Red),2015,6274,7026,752,11.985973860376156
Kolhapur-Laxmipuri,Split Gram,2016,9987,10739,752,7.529788725342946
Chandur Bajar,Soybean,2015,3157,3909,752,23.820082356667722
Latur,GREEN GRAM,2016,4282,5034,752,17.56188696870621
Kurdwadi-Modnimb,Sorgum(Jawar),2015,1141,1893,752,65.90709903593338
Nira,Jaggery,2016,3529,4281,752,21.30915273448569
Vita,Ladies Finger,2016,1444,2196,752,52.0775623268698
Aurangabad,Tomato,2015,620,1372,752,121.29032258064517
Daryapur,Sunflower,2014,2550,3301,751,29.45098039215686
Sonpeth,Wheat(Husked),2016,1500,2251,751,50.06666666666667
Shrirampur,Soybean,2016,2500,3251,751,30.04
Mangalwedha,Gram,2015,2435,3186,751,30.84188911704312
Karanja,Pigeon Pea (Tur),2016,7749,8500,751,9.691573106207253
Indapur-Bhigwan,Chillies(Red),2016,7800,8551,751,9.628205128205128
Lonand,Sorgum(Jawar),2015,1555,2306,751,48.29581993569132
Devala,Onion,2015,678,1429,751,110.7669616519174
Khamgaon,Sesamum,2015,6400,7151,751,11.734375
Nagpur,Orange,2014,656,1407,751,114.48170731707317
Rahata,Ladies Finger,2014,3100,3850,750,24.193548387096776
Jalgaon Jamod,Ground Nut Pods (Dry),2016,5000,5750,750,15.0
Kolhapur,Beet Root,2015,667,1417,750,112.44377811094452
Pune-Manjri,Walvad,2016,1250,2000,750,60.0
Pune-Pimpri,Ghevda,2015,2750,3500,750,27.272727272727273
Solapur,Guava,2015,1186,1936,750,63.23777403035413
Pathardi,Gram,2016,5750,6500,750,13.043478260869565
Ratanagari,Cluster Bean,2015,2750,3500,750,27.272727272727273
Chandrapur,Water Melon,2016,500,1250,750,150.0
Jalgaon,Custard Apple,2014,3867,4617,750,19.39487975174554
Akhadabalapur,Turmeric,2016,8500,9250,750,8.823529411764707
Amarawati-Fruit And Vegetables,Ginger (Fresh),2016,2000,2750,750,37.5
Chandrapur,Water Melon,2016,471,1221,750,159.23566878980893
Ratanagari,Capsicum,2015,2750,3500,750,27.272727272727273
Hingoli,Turmeric,2016,8100,8850,750,9.25925925925926
Rahata,Cucumber,2015,1417,2167,750,52.928722653493296
Akhadabalapur,Turmeric,2015,6750,7500,750,11.11111111111111
Satara,Cucumber,2015,2114,2864,750,35.47776726584674
Nira-Saswad,Wheat(Husked),2016,1620,2370,750,46.2962962962963
Ratanagari,Ginger (Fresh),2014,5000,5750,750,15.0
Shrigonda,Gram,2016,6000,6750,750,12.5
Kalyan,Guava,2015,2514,3264,750,29.832935560859188
Mumbai,Lentil,2014,5100,5850,750,14.705882352941176
Akhadabalapur,Pigeon Pea (Tur),2015,6750,7500,750,11.11111111111111
Ratanagari,Maize(Corn.),2015,2667,3417,750,28.1214848143982
Rahata,Flower,2016,1200,1950,750,62.5
Nira-Saswad,Gram,2016,4525,5275,750,16.574585635359117
Ratanagari,Bitter Gourd,2015,3083,3833,750,24.32695426532598
Rahata,Capsicum,2015,2292,3042,750,32.72251308900523
Shrirampur,Shevga,2015,2375,3125,750,31.57894736842105
Shrirampur,Shevga,2015,2875,3625,750,26.08695652173913
Aurangabad,Bitter Gourd,2015,3150,3900,750,23.80952380952381
Aurangabad,Chavli (Shenga ),2015,2500,3250,750,30.0
Pune-Manjri,Goosefoot,2016,0,750,750,inf
Kolhapur,Potato,2016,975,1725,750,76.92307692307692
Sindi,Pigeon Pea (Tur),2016,6500,7250,750,11.538461538461538
Katol,Gram,2015,3792,4542,750,19.77848101265823
Nashik-Devlali,Guava,2016,1250,2000,750,60.0
Sailu,Sorgum(Jawar),2015,1150,1900,750,65.21739130434783
Lonar,Black Gram,2014,4575,5325,750,16.39344262295082
Nandura,Black Gram,2016,9400,10150,750,7.9787234042553195
Pune-Pimpri,Potato,2015,1800,2550,750,41.666666666666664
Baramati,Bajri,2015,1250,2000,750,60.0
Kalyan,Cluster Bean,2016,3583,4333,750,20.932179737650014
Kolhapur,Snake Gourd,2016,600,1350,750,125.0
Bhivandi,Onion,2015,2050,2800,750,36.58536585365854
Chandrapur,Kharbuj,2015,1183,1933,750,63.39814032121724
Satara,Carrot,2016,2917,3667,750,25.711347274597188
Pune-Pimpri,Ginger (Fresh),2016,2500,3250,750,30.0
Satara,Cabbage,2016,2077,2827,750,36.10977371208474
Chandrapur,Chavli (Pala),2015,900,1650,750,83.33333333333333
Chandrapur,Banana,2015,840,1590,750,89.28571428571429
Khamgaon,Gram,2014,2090,2840,750,35.88516746411483
Kalyan,Lemon,2016,4000,4750,750,18.75
Sangali,Horse Gram,2016,2875,3625,750,26.08695652173913
Manwat,Green Gram,2016,3685,4435,750,20.352781546811396
Navapur,Coriander  ,2016,750,1500,750,100.0
Ratanagari,Cluster Bean,2014,3750,4500,750,20.0
Jalgaon Jamod,Gram,2016,5000,5750,750,15.0
Kalyan,Chikoo,2016,1108,1858,750,67.68953068592057
Palus,Bitter Gourd,2016,2500,3250,750,30.0
Pune-Manjri,Kardai,2016,0,750,750,inf
Patan,Bitter Gourd,2016,3250,4000,750,23.076923076923077
Pune-Manjri,Kanda Pat,2016,750,1500,750,100.0
Nashik,Flower,2015,714,1464,750,105.04201680672269
Manchar,Chavli (Shenga ),2014,1500,2250,750,50.0
Patan,Pavtta,2016,3000,3750,750,25.0
Karad,Potato,2015,990,1740,750,75.75757575757575
Shirala,PADDY-UNHUSKED,2016,1500,2250,750,50.0
Shrirampur,Mosambi,2016,3500,4250,750,21.428571428571427
Akole,Bajri,2016,1450,2200,750,51.724137931034484
Karad,Onion,2015,1600,2350,750,46.875
Patan,Green Chilli,2015,2500,3250,750,30.0
Vai,Ladies Finger,2016,3167,3917,750,23.68171771392485
Pune-Manjri,Hemp,2016,0,750,750,inf
Pune-Manjri,Harbara(Pendi),2016,750,1500,750,100.0
Pune-Manjri,Cucumber,2016,3000,3750,750,25.0
Vai,Pavata,2016,3850,4600,750,19.48051948051948
Devala,Cowpea,2015,3291,4041,750,22.789425706472198
Karad,Mango,2015,2750,3500,750,27.272727272727273
Aurangabad,Chikoo,2016,2550,3300,750,29.41176470588235
Nashik,Lemon,2015,1050,1800,750,71.42857142857143
Amarawati,Ginger (Fresh),2015,2563,3313,750,29.26258291065158
Majalgaon,Green Gram,2015,5750,6500,750,13.043478260869565
Pune,Green Gram,2014,6592,7342,750,11.37742718446602
Karad,Ginger (Fresh),2015,3000,3750,750,25.0
Aurangabad,Chavli (Shenga ),2016,2792,3542,750,26.86246418338109
Umarga,Wheat(Husked),2015,1791,2541,750,41.87604690117253
Tuljapur,Green Gram,2014,6650,7400,750,11.278195488721805
Patur,Green Gram,2014,5250,6000,750,14.285714285714286
Mumbai-Fruit Market,Fig,2016,2250,3000,750,33.333333333333336
Ramtek,Ground Nut Pods (Dry),2015,2000,2750,750,37.5
Patan,Bitter Gourd,2016,2750,3500,750,27.272727272727273
Kurdwadi,Lemon,2014,100,850,750,750.0
Vadgaon Peth,Cucumber,2016,875,1625,750,85.71428571428571
Indapur-Bhigwan,Green Gram,2015,7200,7950,750,10.416666666666666
Ahmednagar,Pigeon Pea (Tur),2015,9425,10175,750,7.957559681697613
Vai,Green-Peas,2015,4250,5000,750,17.647058823529413
Nandurbar,Safflower,2016,3767,4517,750,19.909742500663658
Jalgaon Jamod-Aasalgaon,Pigeon Pea (Tur),2016,7957,8707,750,9.425662938293327
Karad,Pavata,2016,6432,7182,750,11.66044776119403
Aurangabad,Kharbuj,2016,1000,1750,750,75.0
Barshi,Custard Apple,2016,1220,1970,750,61.47540983606557
Junnar-Otur,SMALL GOURD,2016,900,1650,750,83.33333333333333
Jalgaon,Beet Root,2014,1500,2250,750,50.0
Pune-Manjri,Ambat Chuka,2016,0,750,750,inf
Junnar,Potato,2014,900,1650,750,83.33333333333333
Indapur-Bhigwan,Cowpea,2015,3700,4450,750,20.27027027027027
Aurangabad,Fig,2016,6000,6750,750,12.5
Karad,Green-Peas,2016,7167,7917,750,10.464629552113855
Karanja,Black Gram,2015,6359,7109,750,11.794307281019028
Manchar,Squash Gourd,2016,4250,5000,750,17.647058823529413
Vasai,Potato,2016,980,1730,750,76.53061224489795
Rahata,Shevga,2016,3250,4000,750,23.076923076923077
Kada (Ashti),Sorgum(Jawar),2016,1635,2385,750,45.87155963302752
Ahmednagar,Gram,2016,7188,7938,750,10.434056761268781
Solapur,Carrot,2015,500,1250,750,150.0
Murbad,Ghosali(Bhaji),2016,2871,3621,750,26.12330198537095
Jalgaon,Bitter Gourd,2015,3250,4000,750,23.076923076923077
Shrirampur,Shevga,2016,2143,2893,750,34.997666822211855
Khed-Chakan,Sweet Potato,2016,2750,3500,750,27.272727272727273
Jalgaon,Sweet Potato,2015,1250,2000,750,60.0
Pune-Moshi,Green-Peas,2016,5750,6500,750,13.043478260869565
Shrirampur,Garlic,2015,2500,3250,750,30.0
Nandurbar,Black Gram,2015,5350,6100,750,14.018691588785046
Pune-Manjri,Carrot,2015,500,1250,750,150.0
Karad,Chikoo,2015,2250,3000,750,33.333333333333336
Jalgaon Jamod-Aasalgaon,Green Gram,2015,7000,7750,750,10.714285714285714
Shrirampur,Onion,2016,192,942,750,390.625
Chikhali,Gram,2014,2001,2751,750,37.481259370314845
Shrirampur,Mango,2016,3542,4292,750,21.174477696216826
Osmanabad,Tomato,2015,500,1250,750,150.0
Pune-Pimpri,CLUSTER BEAN,2016,3625,4375,750,20.689655172413794
Kannad,Gram,2015,3650,4400,750,20.54794520547945
Palus,Ginger (Fresh),2016,2250,3000,750,33.333333333333336
Kalvan,Green Gram,2015,7114,7864,750,10.542592071970763
Patan,Ghevda,2014,2750,3500,750,27.272727272727273
Shrirampur,CUSTARD APPLE,2016,1500,2250,750,50.0
Latur-Murud,Pigeon Pea (Tur),2016,5701,6451,750,13.155586739168568
Pune-Pimpri,Chavli (Pala),2016,2500,3250,750,30.0
Palus,Ginger (Fresh),2016,2500,3250,750,30.0
Rahata,Ginger (Fresh),2015,3464,4214,750,21.651270207852193
Pune,Snake Gourd,2016,704,1454,750,106.5340909090909
Sindi (Selu),Pigeon Pea (Tur),2016,7484,8234,750,10.021378941742384
Jalgaon,Flower,2015,1230,1980,750,60.97560975609756
Patan,Cluster Bean,2014,2250,3000,750,33.333333333333336
Lonar,Green Gram,2016,5828,6578,750,12.868908716540837
Balapur,Gram,2015,3180,3930,750,23.58490566037736
Kalyan,Small Gourd,2014,2750,3500,750,27.272727272727273
Aurangabad,Tomato,2015,618,1368,750,121.35922330097087
Vadgaon Peth,Cluster Bean,2014,2500,3250,750,30.0
Vadgaon Peth,Green Chilli,2016,1164,1914,750,64.43298969072166
Rahata,Sweet Potato,2015,1000,1750,750,75.0
Pune-Moshi,GREEN CHILLI,2016,1153,1903,750,65.04770164787512
Patan,Cluster Bean,2015,2250,3000,750,33.333333333333336
Pune-Manjri,Ridge Gourd,2016,5250,6000,750,14.285714285714286
Daryapur,Pigeon Pea (Tur),2014,4600,5350,750,16.304347826086957
Aurangabad,Chavli (Shenga ),2016,3750,4500,750,20.0
Palus,Chavli (Shenga ),2016,3000,3750,750,25.0
Aurangabad,Carrot,2016,1500,2250,750,50.0
Nashik,Tomato,2015,650,1400,750,115.38461538461539
Sangrampur,Green Gram,2016,5000,5750,750,15.0
Phaltan,Green Gram,2016,4850,5600,750,15.463917525773196
Ratanagari,Ground Nut Pods (Dry),2015,3750,4500,750,20.0
Pandharpur,Cucumber,2015,323,1073,750,232.19814241486068
Sangrampur,Soybean,2016,2500,3250,750,30.0
Palus,Tomato,2016,550,1300,750,136.36363636363637
Sangrampur-Varvatbakal,Gram,2016,3314,4064,750,22.631261315630656
Pune-Manjri,Chavli (Pala),2015,525,1275,750,142.85714285714286
Karad,Bitter Gourd,2015,3000,3750,750,25.0
Varud-Rajura Bazar,Pigeon Pea (Tur),2016,5550,6300,750,13.513513513513514
Bhandara,Green Gram,2016,5250,6000,750,14.285714285714286
Ratanagari,CARROT,2016,2000,2750,750,37.5
Mangaon(Bhadav),Nachani,2016,1333,2083,750,56.264066016504124
Varud-Rajura Bazar,Green Chilli,2014,1127,1877,750,66.54835847382431
Kolhapur,Peer,2015,8000,8750,750,9.375
Osmanabad,Ginger (Fresh),2015,3750,4500,750,20.0
Ratanagari,French Bean,2016,2000,2750,750,37.5
Chandrapur-Ganjwad,GREEN CHILLI,2016,1161,1911,750,64.59948320413437
Kada,Sorgum(Jawar),2015,1449,2198,749,51.690821256038646
Dindori,Onion,2015,1100,1849,749,68.0909090909091
Chandrapur-Ganjwad,Tomato,2015,856,1605,749,87.5
Shahada,Gram,2014,2216,2965,749,33.79963898916967
Ghoti,Brinjal,2016,1271,2020,749,58.92997639653816
Jalgaon,Coriander (Dry),2015,10793,11542,749,6.939683127953303
Dudhani,Gram,2016,6207,6956,749,12.067021105203802
Umared,Soybean,2015,3322,4071,749,22.54665863937387
Vasai,Wheat(Husked),2015,1529,2278,749,48.986265533028124
Ahmedpur,Pigeon Pea (Tur),2014,3925,4673,748,19.05732484076433
Jamkhed,Black Gram,2014,5371,6119,748,13.926643083224725
Ratanagari,Tomato,2014,1065,1813,748,70.23474178403755
Parli-Vaijnath,Green Gram,2014,5481,6229,748,13.64714468162744
Shrirampur,Gram,2014,2103,2851,748,35.56823585354256
Malegaon,Gram,2014,2076,2824,748,36.030828516377646
Murtizapur,Green Gram,2014,6494,7242,748,11.518324607329843
Ausa,Wheat(Husked),2016,2093,2841,748,35.738174868609654
Chikhali,Gram,2014,2173,2921,748,34.42245743212149
Patan,Ginger (Fresh),2014,3237,3985,748,23.107815878900215
Pune,Bottle Gourd,2016,792,1540,748,94.44444444444444
Ahmedpur,Gram,2016,3428,4176,748,21.820303383897315
Kolhapur-Laxmipuri,Spilt Gerrn Gram,2016,8015,8763,748,9.332501559575796
Nagpur,ONION,2016,499,1247,748,149.8997995991984
Shahapur,Ladies Finger,2016,1310,2058,748,57.099236641221374
Lasalgaon,ONION,2016,458,1206,748,163.3187772925764
Kolhapur,Bottle Gourd,2016,347,1095,748,215.56195965417868
Pune,Snake Gourd,2015,973,1720,747,76.77286742034943
Gangapur,Onion,2016,236,983,747,316.52542372881356
Murum,Pigeon Pea (Tur),2015,5556,6303,747,13.444924406047516
Katol,Soybean,2016,3009,3756,747,24.825523429710866
Mangalwedha,Green Chilli,2016,705,1452,747,105.95744680851064
Latur-Murud,SOYBEAN,2016,2063,2810,747,36.2094037809016
Kannad,Green Gram,2014,5362,6109,747,13.931368892204402
Indapur,Sorgum(Jawar),2016,1810,2557,747,41.270718232044196
Nagpur,Gram,2015,3700,4447,747,20.18918918918919
Vadgaon Peth,Bitter Gourd,2015,1237,1984,747,60.38803556992724
Ausa,Wheat(Husked),2015,1488,2235,747,50.20161290322581
Jalgaon,METHI (BHAJI),2016,1029,1776,747,72.59475218658892
Pune-Pimpri,SQUASH GOURD,2016,2600,3347,747,28.73076923076923
Junnar (Narayangaon),Tomato,2016,393,1140,747,190.0763358778626
Nashik,Flower,2016,822,1569,747,90.87591240875912
Nashik,GHEVDA,2016,1011,1758,747,73.88724035608308
Pune,Beet Root,2015,329,1076,747,227.0516717325228
Pune-Pimpri,Ladies Finger,2015,2292,3038,746,32.54799301919721
Mumbai,Cluster Bean,2016,2836,3582,746,26.304654442877293
Kalyan,Chikoo,2016,1804,2550,746,41.352549889135254
Umarga,Sesamum,2015,7866,8612,746,9.483854563946098
Latur,Gram,2015,4376,5122,746,17.047531992687386
Kamthi,Chavli (Pala),2016,447,1193,746,166.8903803131991
Lonand,Onion,2016,693,1439,746,107.64790764790764
Yeola,Pigeon Pea (Tur),2016,7126,7872,746,10.468706146505754
Malkapur,Pigeon Pea (Tur),2016,5867,6613,746,12.71518663712289
Pune,Pumpkin,2015,854,1600,746,87.35362997658079
Pathardi,Onion,2016,173,919,746,431.21387283236993
Kej,Soybean,2015,2885,3631,746,25.8578856152513
Aurangabad,Bitter Gourd,2016,2808,3554,746,26.566951566951566
Indapur (Nimgaon Ketki),Sorgum(Jawar),2016,1528,2274,746,48.82198952879581
Nashik,Lemon,2015,1029,1775,746,72.49757045675413
Khed-Chakan,Walvad,2016,2281,3027,746,32.70495396755809
Indapur-Bhigwan,Gram,2015,3580,4326,746,20.837988826815643
Junnar-Otur,GREEN CHILLI,2016,867,1613,746,86.04382929642445
Karad,Onion,2015,933,1678,745,79.84994640943194
Chikhali,Gram,2015,2184,2929,745,34.11172161172161
Umared,Gram,2015,2510,3255,745,29.681274900398407
Aurangabad,Onion,2015,650,1395,745,114.61538461538461
Majalgaon,Wheat(Husked),2015,1356,2101,745,54.94100294985251
Satara,Green-Peas,2015,2432,3177,745,30.633223684210527
Jamkhed,Gram,2016,4088,4833,745,18.224070450097848
Kolhapur,Potato,2015,711,1456,745,104.78199718706048
Mumbai,Brinjal,2015,896,1641,745,83.14732142857143
Jalgaon,Chavli (Shenga ),2015,2711,3456,745,27.480634452231648
Dondaicha-Sindkheda,GREEN GRAM,2016,3689,4434,745,20.195174844131202
Ausa,Gram,2015,3506,4251,745,21.249286936679976
Kolhapur-Malkapur,Cabbage,2016,322,1067,745,231.3664596273292
Manchar,Cabbage,2016,1465,2210,745,50.85324232081911
Kalyan,Mosambi,2015,2222,2967,745,33.52835283528353
Lasalgaon,Black Gram,2015,4942,5687,745,15.074868474301901
Sangamner,Tomato,2015,1325,2070,745,56.22641509433962
Chandrapur-Ganjwad,Capsicum,2016,1664,2409,745,44.77163461538461
Manchar,Coriander  ,2016,201,946,745,370.6467661691542
Sindi (Selu),Soybean,2015,2978,3723,745,25.01678979180658
Aurangabad,Custard Apple,2015,2000,2744,744,37.2
Aurangabad,Chavli (Shenga ),2015,2419,3163,744,30.756510954940058
Anajngaon Surji,Pigeon Pea (Tur),2016,5556,6300,744,13.390928725701944
Chandrapur,Papai,2015,800,1544,744,93.0
Chandrapur-Ganjwad,Capsicum,2014,1204,1948,744,61.794019933554814
Mangalwedha,Green Chilli,2016,589,1333,744,126.3157894736842
Pune,Potato,2016,930,1674,744,80.0
Jalgaon,Tomato,2015,943,1687,744,78.89713679745493
Mumbai,Ginger (Dry),2016,2416,3160,744,30.794701986754966
Pune-Moshi,Cabbage,2016,923,1667,744,80.60671722643553
Sangrampur,Ground Nut Pods (Dry),2015,4707,5451,744,15.806246016571064
Aurangabad,Mango(Raw),2015,756,1500,744,98.41269841269842
Dhule,Matki,2015,5571,6315,744,13.354873451803986
Mangalwedha,Tomato,2015,196,940,744,379.59183673469386
Satana,Onion,2015,810,1554,744,91.85185185185185
Khed,Cabbage,2016,621,1365,744,119.80676328502416
Udgir,Pigeon Pea (Tur),2014,4689,5433,744,15.866922584772873
Khed-Chakan,Green Chilli,2015,2212,2956,744,33.634719710669074
Kalyan,CHIKOO,2016,1467,2211,744,50.715746421267895
Akot,Soybean,2015,2872,3616,744,25.905292479108635
Mumbai,Shevga,2014,3480,4224,744,21.379310344827587
Satara,ONION,2016,357,1100,743,208.1232492997199
Pune,Green Gram,2014,7588,8331,743,9.791776489193463
Varud-Rajura Bazar,Gram,2016,6368,7111,743,11.667713567839195
Mantha,Pigeon Pea (Tur),2015,7845,8588,743,9.471000637348629
Ulhasnagar,Bajri,2016,1714,2457,743,43.348891481913654
Khamgaon,Gram,2015,3978,4721,743,18.677727501256914
Akola,Wheat(Husked),2016,1991,2734,743,37.31793068809643
Patan,Green Chilli,2014,1900,2643,743,39.10526315789474
Jalkot,BLACK GRAM,2016,5957,6700,743,12.472721168373342
Pune-Pimpri,Brinjal,2016,1657,2400,743,44.84007242003621
Amarawati,Green Gram,2015,6292,7035,743,11.80864589955499
Kolhapur-Laxmipuri,Spilt Pigeon Pea,2015,4543,5286,743,16.354831609068896
Shrirampur,Brinjal,2016,1400,2143,743,53.07142857142857
Sangali,Lentil,2016,6486,7229,743,11.455442491520197
Jalgaon,Chavli (Shenga ),2015,2783,3525,742,26.66187567373338
Dound,Pigeon Pea (Tur),2015,6540,7282,742,11.345565749235474
Pune,Snake Gourd,2015,942,1684,742,78.76857749469214
Gevrai,Wheat(Husked),2016,1551,2293,742,47.840103159252095
Barshi-Vairag,Black Gram,2015,8229,8971,742,9.016891481346457
Gadhinglaj,Jaggery,2016,3151,3893,742,23.548079974611234
Washim,Pigeon Pea (Tur),2015,9132,9874,742,8.125273762593078
Lonand,Onion,2015,644,1386,742,115.21739130434783
Akluj,Ground Nut Pods (Dry),2016,3063,3805,742,24.224616389160953
Kolhapur-Laxmipuri,Green Gram,2015,9350,10092,742,7.935828877005347
Mangalwedha,Sorgum(Jawar),2016,1622,2364,742,45.745992601726265
Samudrapur,Pigeon Pea (Tur),2016,6954,7696,742,10.670117917745182
Nandurbar,Green Gram,2016,4469,5211,742,16.603266950100693
Rahata,Cucumber,2015,800,1542,742,92.75
Rahuri,TOMATO,2016,137,879,742,541.6058394160584
Lasur Station,Gram,2015,3479,4221,742,21.327967806841045
Lasur Station,Pigeon Pea (Tur),2015,7982,8723,741,9.283387622149837
Pune,Tomato,2015,418,1159,741,177.27272727272728
Pune-Manjri,Rajgira,2015,159,900,741,466.0377358490566
Vasai,Potato,2015,831,1572,741,89.16967509025271
Aurangabad,Ladies Finger,2016,1674,2415,741,44.2652329749104
Malegaon,Onion,2015,529,1270,741,140.07561436672967
Pusad,Gram,2016,3786,4527,741,19.572107765451666
Nagpur,Orange,2015,267,1008,741,277.5280898876405
Ahmednagar,Sorgum(Jawar),2016,1636,2377,741,45.293398533007334
Khed-Chakan,Farshi,2016,2407,3148,741,30.785209804736187
Osmanabad,Ground Nut Pods (Dry),2015,2773,3514,741,26.721961774251714
Pune-Moshi,Bitter Gourd,2016,2394,3135,741,30.952380952380953
Ausa,Wheat(Husked),2016,2188,2929,741,33.86654478976234
Aurangabad,Brinjal,2016,1092,1833,741,67.85714285714286
Vadgaon Peth,Bitter Gourd,2014,1227,1968,741,60.391198044009776
Kurdwadi-Modnimb,Gram,2015,3067,3808,741,24.160417345940658
Khamgaon,Gram,2015,3886,4627,741,19.068450849202264
Vadgaon Peth,Ghevda,2015,880,1620,740,84.0909090909091
Pune,Curry Leaves,2015,1270,2010,740,58.267716535433074
Kurdwadi-Modnimb,Gram,2016,6561,7301,740,11.278768480414572
Savner,Pigeon Pea (Tur),2015,5573,6313,740,13.27830611878701
Ratanagari,Tomato,2014,900,1640,740,82.22222222222223
Nira-Saswad,Sorgum(Jawar),2015,1610,2350,740,45.962732919254655
Lonand,Wheat(Husked),2015,1450,2190,740,51.03448275862069
Nagpur,Chikoo,2015,840,1580,740,88.0952380952381
Gadhinglaj,Jaggery,2015,2355,3095,740,31.422505307855626
Hingoli,Turmeric,2015,7497,8237,740,9.87061491263172
Akola,Gram,2015,3967,4707,740,18.653894630703302
Kalyan,Green Chilli,2015,2400,3140,740,30.833333333333332
Satara,Shevga,2016,3130,3870,740,23.642172523961662
Hingoli,Green Gram,2014,5428,6168,740,13.633014001473839
Rahuri,Onion,2016,223,963,740,331.8385650224215
Pune-Manjri,Kardai,2015,111,851,740,666.6666666666666
Nashik,Cabbage,2015,330,1070,740,224.24242424242425
Umarkhed,Gram,2014,2360,3100,740,31.35593220338983
Dhamangaon-Rly,Pigeon Pea (Tur),2015,5393,6133,740,13.721490821435193
Kurdwadi,Sorgum(Jawar),2016,1628,2368,740,45.45454545454545
Chandrapur-Ganjwad,Capsicum,2016,900,1640,740,82.22222222222223
Morshi,Pigeon Pea (Tur),2016,8067,8807,740,9.17317466220404
Manchar,Farshi,2015,3313,4053,740,22.336251131904618
Rahata,Brinjal,2015,1050,1790,740,70.47619047619048
Devala,Onion,2015,565,1305,740,130.97345132743362
Pune,Gr.Nut Kernels,2014,6760,7500,740,10.946745562130177
Jalgaon Jamod-Aasalgaon,Black Gram,2016,6140,6880,740,12.052117263843648
Ahmednagar,Ginger (Fresh),2016,1300,2040,740,56.92307692307692
Sangli-Phale Bhajipalam,Papai,2016,235,975,740,314.8936170212766
Chandrapur-Ganjwad,SPINACH,2016,680,1420,740,108.82352941176471
Satara,Brinjal,2016,2140,2880,740,34.57943925233645
Osmanabad,Bor,2015,561,1300,739,131.729055258467
Shegaon,Gram,2016,5815,6554,739,12.708512467755805
Ahmedpur,Paddy-Unhusked,2015,621,1360,739,119.00161030595814
Jalgaon,Bor,2015,1178,1917,739,62.73344651952462
Satara,Ladies Finger,2015,3690,4429,739,20.02710027100271
Mumbai-Fruit Market,GUAVA,2016,1048,1787,739,70.51526717557252
Pune,Parwar,2015,2123,2862,739,34.80923221855864
Vani,Pigeon Pea (Tur),2016,7827,8566,739,9.441676248882075
Nashik,CARROT,2016,892,1631,739,82.847533632287
Satara,Capsicum,2014,1652,2391,739,44.73365617433414
Murtizapur,Pigeon Pea (Tur),2014,4452,5191,739,16.59928122192273
Mumbai,Onion,2014,1438,2177,739,51.39082058414465
Akot,Ground Nut Pods (Dry),2015,4643,5382,739,15.916433340512599
Chamorshi,Paddy-Unhusked,2015,1925,2664,739,38.38961038961039
Pimpalgaon Basawant,Onion,2016,182,921,739,406.04395604395603
Mumbai,Brinjal,2015,809,1548,739,91.34734239802225
Dound,Sorgum(Jawar),2015,1846,2585,739,40.03250270855904
Yeola,Black Gram,2016,5920,6659,739,12.483108108108109
Amarawati,SUNFLOWER,2016,4870,5609,739,15.174537987679672
Jalgaon,Chavli (Shenga ),2015,1367,2106,739,54.059985369422094
Chandur Bajar,Soybean,2016,2315,3054,739,31.922246220302377
Manchar,GHEVDA,2016,625,1363,738,118.08
Ratanagari,Ginger (Fresh),2014,3825,4563,738,19.294117647058822
Manchar,Maize(Corn.),2016,922,1660,738,80.04338394793926
Kamthi,Bottle Gourd,2016,600,1338,738,123.0
Kurdwadi-Modnimb,Sorgum(Jawar),2016,1696,2434,738,43.514150943396224
Aurangabad,Ground Nut Pods (Dry),2016,3231,3969,738,22.841225626740947
Akot,Gram,2016,6188,6926,738,11.926308985132515
Khed-Chakan,Brinjal,2016,1504,2242,738,49.069148936170215
Shahada,Green Gram,2016,4207,4945,738,17.542191585452816
Ratanagari,FLOWER,2016,2000,2738,738,36.9
Mohol,Sorgum(Jawar),2016,1744,2482,738,42.31651376146789
Shirpur,Onion,2016,151,889,738,488.7417218543046
Jalgaon,Tomato,2015,2400,3138,738,30.75
Nashik,Onion,2016,153,891,738,482.3529411764706
Malkapur,PIGEON PEA (TUR),2016,5260,5998,738,14.03041825095057
Aarni,Pigeon Pea (Tur),2016,7549,8287,738,9.776129288647503
Manchar,Brinjal,2016,450,1188,738,164.0
Pune-Manjri,Chavli (Pala),2016,378,1116,738,195.23809523809524
Pune,ONION,2016,416,1154,738,177.40384615384616
Akhadabalapur,Pigeon Pea (Tur),2016,7785,8523,738,9.479768786127167
Savner,Pigeon Pea (Tur),2015,6320,7058,738,11.677215189873417
Indapur,Wheat(Husked),2016,1638,2375,737,44.99389499389499
Pune,Curry Leaves,2015,1274,2011,737,57.84929356357928
Pandharpur,Onion,2016,66,803,737,1116.6666666666667
Pune,Flower,2015,571,1308,737,129.07180385288967
Kalmeshwar,Gram,2016,4481,5218,737,16.447221602320912
Barshi-Vairag,Sorgum(Jawar),2015,1538,2275,737,47.91937581274382
Washim,Black Gram,2016,6331,7068,737,11.641130942978993
Kolhapur,Cabbage,2015,639,1376,737,115.33646322378716
Kalyan,Shevga,2016,4750,5487,737,15.51578947368421
Patan,Ginger (Fresh),2015,2633,3370,737,27.990884922142044
Ambad(Vadi Godri),Gram,2016,5708,6445,737,12.911702873160477
Shirur,Gram,2016,5226,5963,737,14.102564102564102
Pune,Green Gram,2015,7818,8555,737,9.426963417753901
Umarga,Wheat(Husked),2015,1443,2180,737,51.074151074151075
Pune-Manjri,Pavtta,2015,2068,2805,737,35.638297872340424
Washim,Sorgum(Jawar),2015,1215,1951,736,60.5761316872428
Osmanabad,Onion,2015,914,1650,736,80.52516411378556
Ramtek,Pigeon Pea (Tur),2016,6275,7011,736,11.729083665338646
Chandvad,Onion,2016,210,946,736,350.4761904761905
Pune,Gram,2016,10844,11580,736,6.787163408336407
Shrirampur,Brinjal,2016,1553,2289,736,47.39214423696072
Karad,Green Chilli,2016,4396,5132,736,16.742493175614193
Chandrapur,Pigeon Pea (Tur),2016,7653,8389,736,9.617143603815498
Nandura,Pigeon Pea (Tur),2016,5905,6641,736,12.464013547840812
Phaltan,Ladies Finger,2016,1029,1765,736,71.52575315840622
Udgir,Gram,2014,2194,2930,736,33.54603463992707
Jamkhed,Sorgum(Jawar),2016,1612,2348,736,45.6575682382134
Gevrai,Wheat(Husked),2016,1576,2312,736,46.7005076142132
Osmanabad,Cucumber,2015,690,1426,736,106.66666666666667
Sindi,Pigeon Pea (Tur),2016,7889,8625,736,9.329446064139942
Karad,Potato,2016,824,1560,736,89.32038834951456
Akluj,Onion,2014,1200,1936,736,61.333333333333336
Ghoti,Flower,2016,1450,2186,736,50.758620689655174
Shahada,Pigeon Pea (Tur),2016,6400,7136,736,11.5
Jalgaon,Tomato,2016,1113,1848,735,66.0377358490566
Kalvan,Pigeon Pea (Tur),2016,6696,7431,735,10.976702508960573
Mangalwedha,Sorgum(Jawar),2016,1604,2339,735,45.82294264339152
Pune-Manjri,Rajgira,2014,300,1035,735,245.0
Mangalwedha,Bitter Gourd,2016,303,1038,735,242.5742574257426
Satara,Brinjal,2016,2115,2850,735,34.751773049645394
Nandura,Green Gram,2014,6530,7265,735,11.255742725880552
Lonar,Pigeon Pea (Tur),2015,5975,6710,735,12.301255230125523
Mangalwedha,Wheat(Husked),2015,1442,2177,735,50.970873786407765
Mumbai-Fruit Market,Papai,2016,1096,1831,735,67.06204379562044
Ramtek,Spinach,2016,1960,2695,735,37.5
Tumsar,Pigeon Pea (Tur),2016,6950,7685,735,10.575539568345324
Chalisgaon,Ground Nut Pods (Dry),2015,4036,4771,735,18.211100099108027
Nashik,Onion,2016,210,945,735,350.0
Nandgaon,Gram,2014,1917,2651,734,38.28899321857068
Chandrapur,Banana,2016,530,1264,734,138.49056603773585
Mantha,Sorgum(Jawar),2014,1133,1867,734,64.783759929391
Karad,CUSTARD APPLE,2016,3333,4067,734,22.022202220222024
Pusad,Gram,2016,6132,6866,734,11.969993476842792
Vadgaon Peth,Pavtta,2015,983,1717,734,74.66937945066124
Nagpur,PIGEON PEA (TUR),2016,4733,5467,734,15.508134375660259
Kada,Wheat(Husked),2016,1533,2267,734,47.879973907371166
Pune-Pimpri,Ladies Finger,2016,2623,3357,734,27.983225314525352
Jalgaon Jamod-Aasalgaon,Gram,2016,5733,6467,734,12.803069945927088
Kurdwadi,Gram,2016,4250,4984,734,17.270588235294117
Anajngaon Surji,Green Gram,2015,6725,7459,734,10.914498141263941
Aurangabad,Onion,2016,198,932,734,370.7070707070707
Amarawati-Fruit And Vegetables,Methi (Bhaji),2016,4871,5605,734,15.068774378977622
Kamthi,Pumpkin,2015,733,1467,734,100.13642564802183
Mumbai,Ginger (Dry),2015,2296,3030,734,31.968641114982578
Jalna,Black Gram,2016,6833,7567,734,10.741987414020196
Vadgaon Peth,Cucumber,2016,722,1456,734,101.66204986149584
Pune-Manjri,Chavli (Pala),2015,387,1121,734,189.6640826873385
Akhadabalapur,Turmeric,2015,6533,7267,734,11.235267105464564
Jalgaon,Chavli (Shenga ),2015,2783,3517,734,26.374416097736255
Chandrapur,Chikoo,2015,1933,2667,734,37.97206414899121
Vasai,Potato,2015,916,1650,734,80.13100436681222
Pune,Bottle Gourd,2016,457,1191,734,160.61269146608316
Ratanagari,Ginger (Fresh),2016,2933,3667,734,25.025571087623593
Satara,GINGER (FRESH),2016,800,1533,733,91.625
Pune,Pumpkin,2015,787,1520,733,93.13850063532402
Pachora,Green Gram,2016,4160,4893,733,17.620192307692307
Shrirampur,Ladies Finger,2015,2167,2900,733,33.82556529764651
Dhule,Black Gram,2015,9889,10622,733,7.412276266558803
Koregaon,Onion,2014,1000,1733,733,73.3
Ahmednagar,Ghevda,2015,2667,3400,733,27.484064491938508
Jalgaon,Black Gram,2016,9456,10189,733,7.751692047377326
Aurangabad,Dhemse,2016,1600,2333,733,45.8125
Kalyan,Guava,2016,3000,3733,733,24.433333333333334
Karanja,Green Gram,2015,7152,7885,733,10.248881431767337
Pandharkawada,Pigeon Pea (Tur),2015,5600,6333,733,13.089285714285714
Chalisgaon,Potato,2016,995,1728,733,73.66834170854271
Raver,Green Gram,2014,5134,5867,733,14.277366575769381
Rahuri,Bottle Gourd,2016,100,833,733,733.0
Chopda,Gram,2015,3313,4046,733,22.124962269846062
Umared,Gram,2014,2150,2883,733,34.093023255813954
Akluj,Ladies Finger,2015,1267,2000,733,57.85319652722968
Rahuri,Cabbage,2016,467,1200,733,156.9593147751606
Ahmednagar,TOMATO,2016,167,900,733,438.92215568862275
Sillod-Bharadi,Pigeon Pea (Tur),2016,6367,7100,733,11.512486257264017
Aurangabad,Chavli (Shenga ),2016,3029,3762,733,24.199405744470123
Kalyan,Rice(Paddy-Hus),2015,2367,3100,733,30.967469370511196
Kalyan,Mosambi,2015,2800,3533,733,26.178571428571427
Rahata,Tomato,2014,700,1433,733,104.71428571428571
Kada,Pigeon Pea (Tur),2016,6900,7633,733,10.623188405797102
Vadgaon Peth,Bottle Gourd,2016,767,1500,733,95.5671447196871
Jalna,BAJRI,2016,1226,1959,733,59.78792822185971
Ahmednagar,Potato,2016,965,1698,733,75.95854922279793
Sangali,Green Peas (Dry),2016,2717,3450,733,26.978284873021714
Shrirampur,Gram,2015,2264,2997,733,32.37632508833922
Chalisgaon,Ground Nut Pods (Dry),2014,3492,4225,733,20.990836197021764
Aurangabad,Bor,2016,1000,1733,733,73.3
Karad,Potato,2015,1411,2144,733,51.94897236002835
Satara,Shevga,2015,2000,2733,733,36.65
Kolhapur,Onion,2016,300,1033,733,244.33333333333334
Kalyan,Black Gram,2016,14000,14733,733,5.235714285714286
Ramtek,Green Chilli,2015,2229,2962,733,32.88470165993719
Osmanabad,Sorgum(Jawar),2015,1479,2212,733,49.5605138607167
Nashik,Melon,2016,425,1158,733,172.47058823529412
Shrirampur,Bitter Gourd,2016,2100,2833,733,34.904761904761905
Jalgaon Jamod-Aasalgaon,Pigeon Pea (Tur),2015,3956,4689,733,18.52881698685541
Karad,Ridge Gourd,2015,1892,2625,733,38.74207188160676
Lasur Station,Sorgum(Jawar),2016,1596,2328,732,45.86466165413534
Ulhasnagar,Potato,2016,1220,1952,732,60.0
Latur-Murud,Wheat(Husked),2015,1433,2165,732,51.08164689462666
Pune,Carrot,2015,809,1541,732,90.48207663782448
Palghar(Bevur),Rice(Paddy-Hus),2016,2598,3330,732,28.175519630484988
Kalvan,Ground Nut Pods (Dry),2015,3350,4082,732,21.850746268656717
Murum,Pigeon Pea (Tur),2016,8699,9431,732,8.414760317277848
Ashti-Karanja,Pigeon Pea (Tur),2016,6903,7635,732,10.604085180356368
Satara,Flower,2016,1180,1912,732,62.03389830508475
Pune,Pumpkin,2015,809,1541,732,90.48207663782448
Yawal,Ground Nut Pods (Dry),2016,4321,5053,732,16.940523027077067
Kamthi,Pumpkin,2016,763,1495,732,95.93709043250328
Paranda,Onion,2016,90,822,732,813.3333333333334
Vani,Pigeon Pea (Tur),2016,7189,7921,732,10.182222840450688
Indapur-Bhigwan,Sorgum(Jawar),2016,1784,2515,731,40.97533632286996
Mangalwedha,Gram,2016,5941,6672,731,12.304325871065478
Tuljapur,Green Gram,2014,5790,6521,731,12.625215889464593
Akluj,Tomato,2014,1338,2069,731,54.633781763826605
Mumbai,BRINJAL,2016,304,1035,731,240.46052631578948
Murum,Pigeon Pea (Tur),2016,8286,9017,731,8.822109582428192
Yeotmal,Ground Nut Pods (Dry),2016,4357,5088,731,16.77759926554969
Jalgaon,Flower,2014,1032,1763,731,70.83333333333333
Mumbai-Fruit Market,ORANGE,2016,1577,2308,731,46.35383639822448
Shrirampur,Lemon,2014,1538,2269,731,47.52925877763329
Chandur Rly.,Pigeon Pea (Tur),2016,8360,9091,731,8.74401913875598
Rahata,Tomato,2015,492,1223,731,148.5772357723577
Kamthi,Tomato,2015,559,1290,731,130.76923076923077
Satara,Bitter Gourd,2016,2615,3346,731,27.95411089866157
Shrirampur,Ladies Finger,2016,1692,2423,731,43.2033096926714
Shrirampur,Tomato,2015,1538,2269,731,47.52925877763329
Baramati,Gram,2016,6162,6893,731,11.863031483284647
Satara,Cluster Bean,2015,1878,2609,731,38.92438764643237
Latur,Green Gram,2015,6869,7600,731,10.642014849323045
Ulhasnagar,Onion,2015,1174,1905,731,62.265758091993185
Pune-Manjri,Methi (Bhaji),2015,413,1144,731,176.99757869249396
Ratanagari,Cucumber,2014,1200,1931,731,60.916666666666664
Kamthi,Raddish,2016,817,1548,731,89.47368421052632
Raver,Black Gram,2014,4613,5343,730,15.82484283546499
Sindi (Selu),Soybean,2016,2992,3722,730,24.398395721925134
Vaijapur,Gram,2016,5837,6567,730,12.506424533150591
Mumbai,Brinjal,2015,985,1715,730,74.11167512690355
Ratanagari,Bitter Gourd,2015,2385,3115,730,30.60796645702306
Nagpur,Ginger (Fresh),2015,2822,3552,730,25.868178596739902
Pune-Pimpri,Brinjal,2015,1590,2320,730,45.911949685534594
Murbad,Cabbage,2016,2220,2950,730,32.88288288288288
Pune-Manjri,Cabbage,2014,662,1392,730,110.27190332326283
Karanja,Pigeon Pea (Tur),2016,7829,8559,730,9.324307063481927
Chandrapur-Ganjwad,Potato,2015,660,1390,730,110.60606060606061
Daryapur,Gram,2014,2117,2847,730,34.48275862068966
Vadgaon Peth,Bottle Gourd,2014,1060,1790,730,68.86792452830188
Nira,Sorgum(Jawar),2015,1437,2167,730,50.80027835768963
Nira-Saswad,Wheat(Husked),2016,1563,2293,730,46.70505438259757
Phaltan,Onion,2016,100,830,730,730.0
Aurangabad,Bitter Gourd,2016,1233,1963,730,59.205190592051906
Nagpur,Onion,2015,1307,2037,730,55.8530986993114
Pusad,Pigeon Pea (Tur),2015,6400,7130,730,11.40625
Karad,Green Chilli,2015,2436,3165,729,29.926108374384235
Jalgaon Jamod-Aasalgaon,Green Gram,2014,5371,6100,729,13.572891454105381
Katol,Orange,2015,1154,1883,729,63.17157712305026
Solapur,Wheat(Husked),2016,2144,2873,729,34.00186567164179
Jintur-Bori,Pigeon Pea (Tur),2015,4746,5475,729,15.360303413400759
Umarga,Black Gram,2016,5987,6716,729,12.17638216134959
Karad,Green Chilli,2014,2514,3243,729,28.997613365155132
Dhamangaon-Rly,Pigeon Pea (Tur),2016,7438,8167,729,9.8010217800484
Kurdwadi-Modnimb,Gram,2015,3840,4569,729,18.984375
Satara,Ladies Finger,2016,2021,2750,729,36.07125185551707
Kalvan,Onion,2016,194,923,729,375.77319587628864
Mumbai,Gram,2014,3000,3729,729,24.3
Amalner,Black Gram,2016,6567,7296,729,11.100959342165373
Pune,Elephant Root,2014,1371,2100,729,53.17286652078774
Aurangabad,Shevga,2016,1233,1962,729,59.12408759124087
Aurangabad,Cluster Bean,2016,2768,3496,728,26.30057803468208
Indapur,Sorgum(Jawar),2015,1808,2536,728,40.26548672566372
Amarawati,Soybean,2015,2864,3592,728,25.41899441340782
Barshi,Pigeon Pea (Tur),2014,3923,4651,728,18.557226612286517
Katol,Soybean,2015,3036,3764,728,23.978919631093543
Jalgaon,Bitter Gourd,2015,1836,2564,728,39.651416122004356
Sailu,Gram,2014,2309,3037,728,31.528800346470334
Solapur,Carrot,2016,729,1457,728,99.86282578875172
Jalgaon,Flower,2014,1311,2039,728,55.530129672006105
Pune-Manjri,Shepu,2016,761,1489,728,95.66360052562418
Nagpur,Mango,2016,2349,3077,728,30.991911451681567
Mumbai,French Bean,2016,4600,5328,728,15.826086956521738
Kurdwadi-Modnimb,Sorgum(Jawar),2016,1403,2131,728,51.8888096935139
Parshiwani,Pigeon Pea (Tur),2016,7566,8294,728,9.621993127147766
Shrirampur,LEMON,2016,1405,2133,728,51.81494661921708
Lasur Station,Sorgum(Jawar),2014,1186,1914,728,61.38279932546374
Rahata,Ginger (Fresh),2014,4136,4864,728,17.60154738878143
Ratanagari,Cucumber,2016,786,1514,728,92.6208651399491
Nira-Saswad,Wheat(Husked),2016,1568,2296,728,46.42857142857143
Nashik,Shahale ,2015,1439,2167,728,50.590687977762336
Chandrapur,Banana,2016,715,1442,727,101.67832167832168
Udgir,Pigeon Pea (Tur),2015,6623,7350,727,10.976898686395893
Mumbai,Green Peas (Dry),2016,3373,4100,727,21.553513193003262
Mumbai,Shevga,2015,4088,4815,727,17.783757338551858
Sangli-Phale Bhajipalam,Onion,2016,208,935,727,349.5192307692308
Pathari,Green Gram,2016,3501,4228,727,20.765495572693517
Lonar,Pigeon Pea (Tur),2016,7655,8382,727,9.497060744611366
Karad,Pavtta,2015,2655,3382,727,27.382297551789076
Mangalwedha,Sorgum(Jawar),2015,1163,1890,727,62.51074806534824
Chandrapur-Ganjwad,Flower,2015,782,1509,727,92.96675191815856
Vita,Brinjal,2016,1804,2531,727,40.29933481152993
Ahmednagar,Cabbage,2015,418,1145,727,173.92344497607655
Dhule,Wheat(Husked),2015,1144,1871,727,63.54895104895105
Rahuri,Onion,2016,200,927,727,363.5
Kamthi,Coriander  ,2015,800,1526,726,90.75
Phaltan,Onion,2016,200,926,726,363.0
Kej,Pigeon Pea (Tur),2015,5619,6345,726,12.920448478376935
Satana,Onion,2016,275,1001,726,264.0
Akluj,Brinjal,2015,1274,2000,726,56.98587127158556
Phaltan,Wheat(Husked),2016,1525,2251,726,47.60655737704918
Umarga,Soybean,2015,3034,3760,726,23.928806855636125
Barshi,Lemon,2016,1767,2493,726,41.08658743633277
Pusad,Green Gram,2014,7280,8006,726,9.972527472527473
Dound,Sorgum(Jawar),2014,2010,2736,726,36.11940298507463
Dhadgaon,Sorgum(Jawar),2016,1460,2186,726,49.726027397260275
Paranda,Gram,2015,3400,4125,725,21.323529411764707
Aurangabad,Sweet Potato,2014,1525,2250,725,47.540983606557376
Chandrapur-Ganjwad,Bitter Gourd,2016,2275,3000,725,31.86813186813187
Amarawati,Pigeon Pea (Tur),2015,8488,9213,725,8.541470311027332
Vadgaon Peth,Snake Gourd,2015,1650,2375,725,43.93939393939394
Jalgaon Jamod,Ground Nut Pods (Dry),2015,4688,5413,725,15.465017064846416
Kalmeshwar,Gram,2016,5706,6431,725,12.705923589204346
Nandurbar,Ground Nut Pods (Dry),2015,2960,3685,725,24.493243243243242
Satara,Ginger (Fresh),2015,2188,2913,725,33.13528336380256
Ratanagari,Flower,2014,2625,3350,725,27.61904761904762
Pune-Manjri,Ambat Chuka,2015,200,925,725,362.5
Kalyan,Bitter Gourd,2016,4325,5050,725,16.76300578034682
Sangamner,Onion,2016,300,1025,725,241.66666666666666
Nashik,Tomato,2016,633,1358,725,114.53396524486571
Jalna,Gram,2014,2084,2809,725,34.78886756238004
Amarawati,Soybean,2016,3002,3727,725,24.150566289140574
Ahmedpur,Sesamum,2016,4825,5550,725,15.025906735751295
Ratanagari,Cucumber,2015,1100,1825,725,65.9090909090909
Rahuri-Vambori,Onion,2016,100,825,725,725.0
Patan,Ladies Finger,2014,3125,3850,725,23.2
Dound,Green Gram,2015,5875,6600,725,12.340425531914894
Karad,Pavtta,2015,1500,2225,725,48.333333333333336
Nira-Saswad,Pigeon Pea (Tur),2016,6300,7025,725,11.507936507936508
Chikhali,Black Gram,2014,4675,5400,725,15.508021390374331
Dound,Lemon,2016,800,1525,725,90.625
Rahata,Tomato,2015,713,1438,725,101.68302945301542
Jalgaon Jamod-Aasalgaon,Green Gram,2014,7150,7875,725,10.13986013986014
Barshi,Turmeric,2015,6697,7422,725,10.825742869941765
Balapur,Gram,2015,2875,3600,725,25.217391304347824
Jalgaon,Flower,2015,844,1569,725,85.9004739336493
Balapur,Gram,2015,3300,4025,725,21.96969696969697
Ausa,Gram,2014,2147,2872,725,33.76804843968328
Yeotmal,Pigeon Pea (Tur),2016,6141,6866,725,11.805894805406286
Lonand,Wheat(Husked),2016,1475,2200,725,49.152542372881356
Tuljapur,Black Gram,2014,4705,5430,725,15.40913921360255
Sangali,Gram,2015,3718,4443,725,19.499731038192575
Indapur-Bhigwan,Green Peas (Dry),2016,1675,2400,725,43.28358208955224
Kalamb (Os),Sorgum(Jawar),2014,1423,2148,725,50.94869992972593
Akluj,Bitter Gourd,2015,1750,2475,725,41.42857142857143
Dhamangaon-Rly,Pigeon Pea (Tur),2015,7600,8325,725,9.539473684210526
Khed-Chakan,Squash Gourd,2016,1029,1754,725,70.45675413022352
Vasai,Onion,2016,975,1700,725,74.35897435897436
Phaltan,Bajri,2015,1283,2008,725,56.50818394388153
Akole,Gram,2016,3450,4175,725,21.014492753623188
Hinganghat,Soybean,2015,3000,3725,725,24.166666666666668
Lonar,Black Gram,2014,4900,5625,725,14.795918367346939
Kalyan,Small Gourd,2015,1425,2150,725,50.87719298245614
Vadgaon Peth,Flower,2015,625,1350,725,116.0
Rahata,Ladies Finger,2016,2208,2933,725,32.835144927536234
Nagpur,GREEN PEAS (DRY),2016,2925,3650,725,24.786324786324787
Manmad,ONION,2016,329,1054,725,220.3647416413374
Akole,Wheat(Husked),2016,1475,2200,725,49.152542372881356
Aurangabad,Brinjal,2016,2464,3188,724,29.383116883116884
Khed-Chakan,Brinjal,2016,1624,2348,724,44.58128078817734
Nagpur,Onion,2014,1055,1779,724,68.62559241706161
Hingoli,Turmeric,2015,7143,7867,724,10.13579728405432
Satara,Green-Peas,2014,2940,3664,724,24.625850340136054
Satara,Cluster Bean,2014,2000,2724,724,36.2
Pune,Carrot,2015,614,1338,724,117.91530944625407
Pune,Potato,2014,2086,2810,724,34.70757430488974
Lonand,Onion,2015,656,1380,724,110.36585365853658
Ahmednagar,Gram,2016,4170,4894,724,17.362110311750598
Sailu,Green Gram,2014,6958,7682,724,10.405288876113826
Malegaon,Onion,2016,231,955,724,313.4199134199134
Solapur,Pigeon Pea (Tur),2014,4553,5276,723,15.879639797935427
Patan,Ginger (Fresh),2015,2731,3454,723,26.4738191138777
Dhule,Pigeon Pea (Tur),2015,5028,5751,723,14.379474940334129
Barshi-Vairag,Green Gram,2014,5252,5975,723,13.766184310738765
Vasai,Wheat(Husked),2016,1678,2401,723,43.08700834326579
Daryapur,SOYBEAN,2016,2113,2836,723,34.21675343114056
Akluj,BITTER GOURD,2016,1110,1833,723,65.13513513513513
Aurangabad,Lemon,2015,1896,2619,723,38.13291139240506
Dudhani,Pigeon Pea (Tur),2014,4388,5111,723,16.4767547857794
Indapur,Gram,2015,3613,4336,723,20.01107113202325
Nashik,Shahale ,2016,1632,2355,723,44.3014705882353
Devala,GREEN GRAM,2016,4410,5133,723,16.39455782312925
Chandrapur-Ganjwad,Potato,2014,1823,2546,723,39.65990126165661
Pandharpur,CAPSICUM,2016,416,1139,723,173.79807692307693
Shegaon,Gram,2016,5973,6696,723,12.10447011551984
Akluj,LADIES FINGER,2016,1068,1791,723,67.69662921348315
Pune-Manjri,Spinach,2015,968,1691,723,74.6900826446281
Pune,Tamarind,2014,4012,4735,723,18.020937188434697
Khed-Chakan,Brinjal,2016,2125,2848,723,34.023529411764706
Amarawati-Fruit And Vegetables,Kharbuj,2016,1664,2386,722,43.38942307692308
Majalgaon,Wheat(Husked),2015,1387,2109,722,52.054794520547944
Kille Dharur,Bajri,2015,1391,2113,722,51.90510424155284
Pune,Tamarind,2016,4611,5333,722,15.65820863153329
Baramati,Sorgum(Jawar),2016,1602,2324,722,45.068664169787766
Anajngaon Surji,Gram,2016,6800,7522,722,10.617647058823529
Pune-Manjri,Ghevda,2016,1622,2344,722,44.512946979038226
Patan,Ladies Finger,2015,2000,2722,722,36.1
Pune-Manjri,Chavli (Pala),2014,806,1528,722,89.57816377171216
Ratanagari,Cluster Bean,2015,1889,2611,722,38.2212811011117
Daryapur,Pigeon Pea (Tur),2014,4217,4939,722,17.121176191605407
Jalgaon,Onion,2014,750,1472,722,96.26666666666667
Gangapur,Wheat(Husked),2016,1595,2317,722,45.26645768025078
Shahada,Soybean,2014,2512,3234,722,28.74203821656051
Aurangabad,Flower,2015,1539,2261,722,46.91358024691358
Rahata,Shevga,2015,2278,3000,722,31.69446883230904
Nashik,Water Melon,2016,464,1186,722,155.60344827586206
Bhokar,Pigeon Pea (Tur),2015,5478,6200,722,13.179992698064988
Sangli-Phale Bhajipalam,Papai,2015,208,930,722,347.11538461538464
Nagpur,Chikoo,2014,877,1599,722,82.32611174458381
Pune,Capsicum,2016,735,1457,722,98.2312925170068
Shrirampur,Tamarind,2016,2178,2900,722,33.14967860422406
Kolhapur,Orange,2015,468,1190,722,154.27350427350427
Umarga,Pigeon Pea (Tur),2015,5744,6466,722,12.569637883008356
Umared,Gram,2015,3694,4415,721,19.518137520303195
Paithan,Onion,2016,186,907,721,387.63440860215053
Samudrapur,Pigeon Pea (Tur),2016,7840,8561,721,9.196428571428571
Jamkhed,Black Gram,2016,6579,7300,721,10.959112327101383
Newasa-Ghodegaon,Onion,2016,193,914,721,373.57512953367876
Osmanabad,Carrot,2016,663,1384,721,108.74811463046757
Kolhapur,Tomato,2015,248,969,721,290.7258064516129
Malkapur,Onion,2014,769,1490,721,93.75812743823147
Deglur,Black Gram,2015,8594,9315,721,8.389574121480102
Chandrapur,Banana,2015,1021,1742,721,70.61704211557297
Akole,Onion,2016,50,771,721,1442.0
Mumbai,Bitter Gourd,2016,2783,3504,721,25.907294286740928
Newasa-Ghodegaon,Onion,2016,200,921,721,360.5
Ahmednagar,Ginger (Fresh),2016,1360,2080,720,52.94117647058823
Kalyan,Green-Peas,2015,7840,8560,720,9.183673469387756
Manora,Pigeon Pea (Tur),2015,5760,6480,720,12.5
Parola,Green Gram,2016,3929,4649,720,18.32527360651565
Pune,Snake Gourd,2015,907,1627,720,79.38257993384785
Aurangabad,Cluster Bean,2015,2716,3436,720,26.50957290132548
Karad,Ground Nut Pods (Dry),2015,2300,3020,720,31.304347826086957
Kalyan,Black Gram,2015,7200,7920,720,10.0
Ramtek,Coriander  ,2015,2040,2760,720,35.294117647058826
Vadgaon Peth,Bottle Gourd,2014,740,1460,720,97.29729729729729
Jalgaon Jamod-Aasalgaon,Pigeon Pea (Tur),2016,7960,8680,720,9.045226130653266
Solapur,Green Peas (Dry),2015,3515,4235,720,20.483641536273115
Manchar,Green-Peas,2016,1760,2480,720,40.90909090909091
Partur,Pigeon Pea (Tur),2015,7440,8160,720,9.67741935483871
Aurangabad,Capsicum,2015,2350,3070,720,30.638297872340427
Pune,Black Gram,2015,6563,7283,720,10.97059271674539
Nashik-Devlali,Shepu,2016,1499,2219,720,48.03202134756504
Patur,Pigeon Pea (Tur),2015,4530,5250,720,15.894039735099337
Devala,Matki,2016,5650,6370,720,12.743362831858407
Jalgaon,Flower,2015,1210,1930,720,59.50413223140496
Sonpeth,Pigeon Pea (Tur),2016,7164,7884,720,10.050251256281408
Umared,Wheat(Husked),2016,1600,2320,720,45.0
Jalgaon,Ladies Finger,2015,1215,1935,720,59.25925925925926
Bhivandi,Other Vegetables,2015,1215,1935,720,59.25925925925926
Akola,Pigeon Pea (Tur),2016,8231,8951,720,8.747418296683271
Pathardi,Onion,2016,184,903,719,390.7608695652174
Shrirampur,Cluster Bean,2016,2000,2719,719,35.95
Umared,Wheat(Husked),2016,1525,2244,719,47.14754098360656
Akola,Ground Nut Pods (Dry),2016,5064,5783,719,14.19826224328594
Solapur,Green Chilli,2015,1587,2306,719,45.305608065532454
Satara,Green-Peas,2015,3904,4623,719,18.417008196721312
Mumbai,Curry Leaves,2015,2031,2750,719,35.401280157557856
Babhulgaon,Gram,2015,3046,3765,719,23.60472751149048
Chalisgaon,Matki,2015,4781,5500,719,15.038694833716796
Shrirampur,Green Chilli,2015,2481,3200,719,28.98024989923418
Gevrai,WHEAT(HUSKED),2016,1654,2373,719,43.47037484885127
Vasai,Wheat(Husked),2015,1530,2249,719,46.99346405228758
Murtizapur,Pigeon Pea (Tur),2015,5022,5741,719,14.317005177220231
Vani,Pigeon Pea (Tur),2015,7634,8353,719,9.41839140686403
Kada,Sorgum(Jawar),2016,1611,2329,718,44.56859093730602
Taloda,Black Gram,2015,4483,5201,718,16.016060673656035
Lasur Station,Pigeon Pea (Tur),2015,4693,5411,718,15.299382058384829
Kalamb (Os),Wheat(Husked),2015,1757,2475,718,40.8651109846329
Dhule,Sorgum(Jawar),2014,1516,2234,718,47.361477572559366
Satara,Capsicum,2016,1739,2457,718,41.28809660724554
Pune,Flower,2015,600,1318,718,119.66666666666667
Katol,Cotton,2016,4047,4765,718,17.74153694094391
Parbhani,Pigeon Pea (Tur),2015,8090,8808,718,8.875154511742892
Malegaon,Gram,2015,3831,4549,718,18.741842860871834
Shrirampur,Lemon,2015,2565,3283,718,27.992202729044834
Umarga,Pigeon Pea (Tur),2015,6234,6952,718,11.517484760988129
Aurangabad,Ladies Finger,2016,2043,2761,718,35.144395496818404
Murbad,Bitter Gourd,2016,5250,5968,718,13.676190476190476
Pune,Snake Gourd,2014,806,1524,718,89.08188585607941
Kurdwadi-Modnimb,Wheat(Husked),2016,1529,2247,718,46.958796599084366
Sangamner,Onion,2016,300,1017,717,239.0
Shrirampur,Gram,2016,5400,6117,717,13.277777777777779
Baramati,Ground Nut Pods (Dry),2016,2900,3617,717,24.724137931034484
Lasalgaon,Green Gram,2014,5900,6617,717,12.152542372881356
Hinganghat,Soybean,2016,3026,3743,717,23.694646397885
Devala,Matki,2015,7322,8039,717,9.79240644632614
Sangali,Jaggery,2016,3408,4125,717,21.038732394366196
Mangrulpeer,Gram,2015,3613,4330,717,19.84500415167451
Lonar,Pigeon Pea (Tur),2016,8449,9166,717,8.486211385962836
Nandurbar,Ground Nut Pods (Dry),2014,2799,3516,717,25.616291532690248
Umarga,Soybean,2015,3032,3749,717,23.647757255936675
Chandur Bajar,Pigeon Pea (Tur),2014,4300,5017,717,16.674418604651162
Pune-Pimpri,Gram,2016,4783,5500,717,14.99059167886264
Kolhapur,Bottle Gourd,2016,350,1067,717,204.85714285714286
Shahapur,Ladies Finger,2015,1550,2267,717,46.25806451612903
Ahmednagar,Tomato,2016,300,1017,717,239.0
Nandura,Gram,2015,2672,3389,717,26.83383233532934
Sangamner,Onion,2016,267,984,717,268.53932584269666
Shrirampur,Ginger (Fresh),2016,1500,2217,717,47.8
Barshi,Black Gram,2015,8408,9125,717,8.527592768791626
Shrirampur,Ladies Finger,2016,1761,2478,717,40.71550255536627
Jalna,Mosambi,2014,741,1458,717,96.76113360323886
Ahmednagar,Pigeon Pea (Tur),2015,8050,8767,717,8.906832298136646
Hingoli,Gram,2016,7050,7767,717,10.170212765957446
Chalisgaon,Soybean,2014,2500,3217,717,28.68
Mantha,Gram,2016,7750,8467,717,9.251612903225807
Satana,Gram,2015,4288,5004,716,16.69776119402985
Karad,Ghevda,2014,1817,2533,716,39.405613648871764
Junnar (Alephata),Onion,2016,318,1034,716,225.1572327044025
Mumbai,Split Gram,2014,3584,4300,716,19.977678571428573
Mahagaon,Ground Nut Pods (Dry),2016,4617,5333,716,15.507905566385098
Khamgaon,Black Gram,2014,3804,4520,716,18.82229232386961
Chalisgaon,Green Gram,2016,4602,5318,716,15.55845284658844
Chandrapur-Ganjwad,Onion,2015,969,1685,716,73.890608875129
Kalyan,Ghevda,2016,4524,5240,716,15.826702033598586
Devala,Onion,2015,813,1529,716,88.06888068880689
Dhamangaon-Rly,Pigeon Pea (Tur),2016,6100,6816,716,11.737704918032787
Barshi,Black Gram,2016,10873,11589,716,6.585119102363653
Karad,Ladies Finger,2014,2138,2854,716,33.489242282507014
Pune-Manjri,Cucumber,2016,971,1687,716,73.7384140061792
Osmanabad,Wheat(Husked),2016,1901,2617,716,37.664387164650186
Pandharpur,Tomato,2016,161,877,716,444.72049689440996
Satara,Green Chilli,2016,3440,4156,716,20.813953488372093
Kopargaon,Onion,2016,278,994,716,257.55395683453236
Ratanagari,Tomato,2015,655,1370,715,109.16030534351145
Akot,Green Gram,2015,8011,8726,715,8.925227811758832
Sangli-Phale Bhajipalam,Onion,2016,327,1042,715,218.65443425076452
Satara,Flower,2015,1474,2189,715,48.507462686567166
Shegaon,Pigeon Pea (Tur),2016,7567,8282,715,9.448922954935906
Devala,Onion,2015,860,1575,715,83.13953488372093
Sinner,Onion,2016,57,772,715,1254.3859649122808
Ratanagari,Green Chilli,2015,1714,2429,715,41.71528588098016
Jalgaon Jamod-Aasalgaon,Pigeon Pea (Tur),2015,4971,5686,715,14.383423858378595
Kalyan,Small Gourd,2016,2571,3286,715,27.810190587320108
Ratanagari,Ladies Finger,2015,3833,4548,715,18.65379598225933
Baramati,Ground Nut Pods (Dry),2014,3015,3730,715,23.71475953565506
Kopargaon,Gram,2014,1983,2698,715,36.05648008068583
Akluj,Tomato,2015,1108,1823,715,64.53068592057761
Amarawati,Ginger (Fresh),2016,3214,3929,715,22.24642190416926
Sangrampur-Varvatbakal,Pigeon Pea (Tur),2016,7371,8086,715,9.700176366843033
Akot,Pigeon Pea (Tur),2015,4125,4840,715,17.333333333333332
Nashik,Cucumber,2016,823,1538,715,86.87727825030376
Mumbai,Cluster Bean,2016,4262,4977,715,16.7761614265603
Pune,Pumpkin,2016,943,1657,714,75.71580063626723
Shevgaon-Bodhegaon,Gram,2016,5029,5743,714,14.197653609067409
Vadgaon Peth,Capsicum,2015,1729,2443,714,41.29554655870445
Mumbai,Potato,2014,1705,2419,714,41.87683284457478
Umared,Gram,2015,3513,4227,714,20.32450896669513
Ratanagari,Ginger (Fresh),2016,4500,5214,714,15.866666666666667
Gevrai,Sorgum(Jawar),2014,1625,2339,714,43.93846153846154
Jalgaon Jamod,Ground Nut Pods (Dry),2016,4929,5643,714,14.485696895922093
Rahata,Ladies Finger,2015,1857,2571,714,38.44911147011309
Vai,Green-Peas,2016,3643,4357,714,19.59923140269009
Latur-Murud,Gram,2016,6969,7683,714,10.24537236332329
Ramtek,Chavli (Pala),2015,2786,3500,714,25.628140703517587
Shrirampur,Lemon,2015,1548,2262,714,46.12403100775194
Shrirampur,Mango,2015,2643,3357,714,27.014755959137343
Pune-Pimpri,Ghosali(Bhaji),2016,4036,4750,714,17.690782953419227
Jamkhed,Coriander (Dry),2016,6000,6714,714,11.9
Akola,Pigeon Pea (Tur),2016,5998,6712,714,11.903967989329777
Arvi,Pigeon Pea (Tur),2015,6514,7228,714,10.961007061713232
Ratanagari,Flower,2015,2393,3107,714,29.837024655244463
Jalgaon,Onion,2015,512,1226,714,139.453125
Malkapur,Green Gram,2015,6534,7247,713,10.91215182124273
Vasai,Onion,2016,1110,1823,713,64.23423423423424
Beed,Sorgum(Jawar),2014,1614,2327,713,44.17596034696406
Amarawati-Fruit And Vegetables,Onion,2016,424,1137,713,168.16037735849056
Dhule,Matki,2014,5122,5835,713,13.920343615775089
Jalna,Mosambi,2015,721,1434,713,98.89042995839112
Indapur-Bhigwan,Cowpea,2016,3850,4563,713,18.51948051948052
Udgir,Gram,2014,2176,2889,713,32.76654411764706
Pune-Manjri,Shepu,2015,300,1013,713,237.66666666666666
Sangli-Phale Bhajipalam,Potato,2016,696,1409,713,102.44252873563218
Kurdwadi,ONION,2016,120,833,713,594.1666666666666
Vasai,Onion,2016,1053,1766,713,67.71130104463438
Wardha,GRAM,2016,7233,7946,713,9.857597124291441
Akkolkot,Green Gram,2016,4621,5334,713,15.429560701146938
Umared,WHEAT(HUSKED),2016,1600,2313,713,44.5625
Akluj,Bor,2015,1475,2188,713,48.33898305084746
Mehkar,Gram,2016,7293,8006,713,9.77649801179213
Ahmedpur,Black Gram,2015,9328,10041,713,7.643653516295026
Ratanagari,Cucumber,2015,1240,1953,713,57.5
Naigaon,Green Gram,2016,4381,5094,713,16.274823099748915
Daryapur,Black Gram,2014,4800,5513,713,14.854166666666666
Kamthi,Tomato,2016,457,1170,713,156.01750547045953
Indapur-Bhigwan,Black Gram,2016,6053,6766,713,11.779283000165208
Nira,Sorgum(Jawar),2015,1550,2263,713,46.0
Pathardi,Onion,2016,175,888,713,407.42857142857144
Bhokar,Pigeon Pea (Tur),2016,8350,9063,713,8.538922155688622
Nagpur,Pigeon Pea (Tur),2016,5663,6376,713,12.590499735122727
Kannad,Ginger (Fresh),2015,1575,2288,713,45.26984126984127
Jalgaon,Onion,2014,738,1450,712,96.4769647696477
Dhule,Pigeon Pea (Tur),2015,8434,9146,712,8.442020393644771
Vadgaon Peth,Cucumber,2014,1238,1950,712,57.51211631663974
Vai,Green-Peas,2015,4206,4918,712,16.928197812648598
Jalna,Bajri,2014,1050,1762,712,67.80952380952381
Kille Dharur,Cotton,2016,3867,4579,712,18.412205844323765
Pune,Sweet Potato,2015,788,1500,712,90.35532994923858
Satara,Brinjal,2016,1442,2154,712,49.375866851595006
Hinganghat,Soybean,2014,2665,3377,712,26.71669793621013
Lonand,Onion,2016,272,984,712,261.7647058823529
Aurangabad,Mango(Raw),2016,1516,2228,712,46.96569920844327
Shirpur,Gram,2016,6221,6933,712,11.44510528853882
Kalyan,Papai,2015,1794,2506,712,39.68784838350056
Osmanabad,SORGUM(JAWAR),2016,1851,2563,712,38.4656942193409
Satara,Onion,2015,1138,1850,712,62.565905096660806
Kalamb (Os),Wheat(Husked),2016,1605,2317,712,44.361370716510905
Phaltan,Maize,2016,1601,2313,712,44.47220487195503
Barshi,Sorgum(Jawar),2015,1647,2359,712,43.230115361262904
Aurangabad,Brinjal,2015,1207,1919,712,58.98922949461475
Mohol,Pigeon Pea (Tur),2015,4663,5375,712,15.269140038601758
Indapur,Sorgum(Jawar),2015,1641,2353,712,43.388177940280315
Nashik,Shahale ,2016,1843,2555,712,38.632664134563214
Kolhapur,Maize(Corn.),2016,1238,1950,712,57.51211631663974
Amarawati-Fruit And Vegetables,Lemon,2016,1236,1948,712,57.605177993527505
Khamgaon,Gram,2016,5141,5853,712,13.849445633145303
Satara,Cucumber,2016,1542,2254,712,46.17380025940337
Sangrampur-Varvatbakal,Soybean,2016,2942,3654,712,24.201223657375934
Pune-Moshi,Pavtta,2016,2835,3546,711,25.07936507936508
Patan,Green Chilli,2016,3635,4346,711,19.559834938101787
Aurangabad,Capsicum,2015,1918,2629,711,37.06986444212722
Nandgaon Khandeshwar,Pigeon Pea (Tur),2016,7692,8403,711,9.243369734789392
Rahuri,Onion,2016,300,1011,711,237.0
Amarawati,Black Gram,2016,6358,7069,711,11.182761874803397
Partur,Black Gram,2016,5868,6579,711,12.116564417177914
Umared,Pigeon Pea (Tur),2016,7133,7844,711,9.96775550259358
Solapur,Tomato,2016,177,888,711,401.6949152542373
Lasalgaon,Gram,2015,2316,3027,711,30.699481865284973
Vadgaon Peth,Bitter Gourd,2015,1622,2333,711,43.8347718865598
Ausa,Pigeon Pea (Tur),2016,8583,9294,711,8.283816847256205
Varora,Gram,2016,4971,5682,711,14.302957151478576
Loha,Green Gram,2015,6884,7595,711,10.328297501452644
Khed-Chakan,Tomato,2016,1440,2151,711,49.375
Amarawati,Green Gram,2015,6022,6733,711,11.806708734639654
Lasalgaon,Onion,2014,940,1651,711,75.63829787234043
Khed-Chakan,Potato,2016,739,1450,711,96.21109607577807
Ahmednagar,SOYBEAN,2016,2075,2786,711,34.265060240963855
Anajngaon Surji,Green Gram,2016,4050,4761,711,17.555555555555557
Mangrulpeer,Gram,2015,2699,3410,711,26.343090033345682
Lasur Station,Sorgum(Jawar),2015,1360,2071,711,52.279411764705884
Mumbai,Carrot,2015,1162,1873,711,61.18760757314974
Pune-Manjri,Spinach,2016,963,1674,711,73.83177570093459
Nagpur,Ground Nut Pods (Dry),2015,3481,4192,711,20.425165182418844
Sangrampur-Varvatbakal,Gram,2016,3400,4110,710,20.88235294117647
Aurangabad,Shevga,2016,1480,2190,710,47.972972972972975
Mangalwedha,Wheat(Unhusked),2015,2840,3550,710,25.0
Ratanagari,Brinjal,2015,1658,2368,710,42.822677925211096
Nashik,GREEN CHILLI,2016,960,1670,710,73.95833333333333
Bhivandi,Potato,2015,1170,1880,710,60.68376068376068
Ausa,Ground Nut Pods (Dry),2016,5801,6511,710,12.239269091535942
Manchar,SHEVGA,2016,3500,4210,710,20.285714285714285
Pune-Manjri,Shepu,2015,845,1555,710,84.02366863905326
Satara,Tomato,2015,1114,1824,710,63.73429084380611
Pusad,Green Gram,2015,6150,6860,710,11.544715447154472
Pune,Gr.Nut Kernels,2014,6809,7519,710,10.42737553238361
Pune,Beet Root,2014,525,1235,710,135.23809523809524
Khamgaon,Green Gram,2016,4428,5138,710,16.034327009936767
Murbad,BITTER GOURD,2016,2533,3243,710,28.03000394788788
Pune,Green Gram,2016,7133,7843,710,9.953736155895136
Nagpur,Papai,2014,860,1570,710,82.55813953488372
Malkapur,Black Gram,2014,3725,4435,710,19.06040268456376
Pune-Pimpri,Cabbage,2016,2214,2924,710,32.068654019873534
Hingoli,Ground Nut Pods (Dry),2015,4840,5550,710,14.669421487603305
Nashik,Shahale ,2016,1542,2252,710,46.04409857328145
Jalgaon,Amla,2014,1215,1925,710,58.43621399176955
Shirpur,Gram,2016,4794,5503,709,14.789319983312474
Jalna,Mosambi,2016,1274,1983,709,55.65149136577708
Dhamangaon-Rly,Gram,2016,7082,7791,709,10.01129624399887
Vasai,Potato,2016,1061,1770,709,66.82375117813383
Akola,Black Gram,2015,5158,5867,709,13.74563784412563
Buldhana,Gram,2016,5636,6345,709,12.57984386089425
Rahuri,Onion,2016,264,973,709,268.56060606060606
Kalyan,Orange,2015,1691,2400,709,41.92785334121822
Phaltan,Wheat(Husked),2016,1525,2234,709,46.49180327868852
Chandrapur-Ganjwad,Flower,2016,626,1335,709,113.25878594249201
Pune,Parwar,2015,2691,3400,709,26.347082868822
Pune,Elephant Root,2016,2048,2757,709,34.619140625
Murtizapur,Gram,2016,5905,6614,709,12.006773920406435
Pune,Black Gram,2015,6200,6909,709,11.435483870967742
Amarawati,Chikoo,2016,2100,2809,709,33.76190476190476
Vasai,Onion,2016,1026,1735,709,69.10331384015595
Aurangabad,Cluster Bean,2015,2443,3152,709,29.021694637740485
Shrirampur,Mosambi,2014,2354,3063,709,30.118946474086663
Nagpur,Onion,2015,818,1527,709,86.67481662591688
Jintur,Green Gram,2014,5351,6060,709,13.249859839282378
Lasur Station,Wheat(Husked),2015,1279,1988,709,55.43393275996873
Kolhapur,Cabbage,2015,700,1409,709,101.28571428571429
Phaltan,Onion,2016,300,1009,709,236.33333333333334
Ghoti,Flower,2016,1344,2052,708,52.67857142857143
Karad,Chikoo,2015,877,1585,708,80.72976054732041
Hingoli-Kanegaon Naka,Gram,2016,7996,8704,708,8.854427213606803
Dudhani,Green Gram,2014,6745,7453,708,10.49666419570052
Daryapur,Black Gram,2015,5242,5950,708,13.506295307134682
Hingoli,Pigeon Pea (Tur),2015,5993,6701,708,11.813782746537628
Dhule,Wheat(Husked),2015,1134,1842,708,62.43386243386244
Karad,Ladies Finger,2015,2342,3050,708,30.23057216054654
Jintur,Sorgum(Jawar),2014,1159,1867,708,61.087144089732526
Khamgaon,Black Gram,2016,7869,8577,708,8.997331300038125
Nashik-Devlali,Kanda Pat,2016,1521,2229,708,46.548323471400394
Khed-Chakan,Farshi,2016,2013,2721,708,35.17138599105812
Chandur Bajar,Gram,2016,5140,5848,708,13.77431906614786
Malkapur,Onion,2015,1105,1813,708,64.07239819004525
Ratanagari,Flower,2015,1556,2264,708,45.501285347043705
Ghatanji,Pigeon Pea (Tur),2016,7145,7853,708,9.909027291812457
Akola,Green Gram,2016,6028,6736,708,11.745189117451892
Pune,Arvi,2015,1750,2458,708,40.457142857142856
Mumbai,Split Gram,2015,5525,6233,708,12.81447963800905
Barshi,Wheat(Husked),2015,1480,2188,708,47.83783783783784
Nashik,Bor,2015,1077,1785,708,65.73816155988858
Sinner,Ground Nut Pods (Dry),2016,4313,5021,708,16.415488059355436
Dondaicha-Sindkheda,Sorgum(Jawar),2016,1540,2248,708,45.97402597402598
Pune,Tamarind,2015,4371,5079,708,16.197666437886067
Pune,Wal Bhaji,2015,2423,3131,708,29.21997523730912
Lonar,Pigeon Pea (Tur),2015,5188,5896,708,13.646877409406322
Shirpur,Wheat(Husked),2015,1157,1865,708,61.19273984442524
Shrirampur,Chikoo,2015,1542,2250,708,45.91439688715953
Vadgaon Peth,Tomato,2015,785,1492,707,90.06369426751593
Latur,Green Gram,2016,4470,5177,707,15.816554809843401
Pune-Manjri,Kardai,2015,300,1007,707,235.66666666666666
Pune,Flower,2015,531,1238,707,133.14500941619585
Indapur-Bhigwan,Horse Gram,2015,2813,3520,707,25.133309633842874
Amarawati,Orange,2016,1131,1838,707,62.51105216622458
Manmad,Gram,2014,2034,2741,707,34.7590953785644
Akluj,Brinjal,2015,1006,1713,707,70.27833001988071
Akluj,Onion,2016,593,1300,707,119.22428330522766
Vasai,Wheat(Husked),2015,1514,2221,707,46.697490092470275
Sangli-Phale Bhajipalam,Onion,2016,244,951,707,289.75409836065575
Jamkhed,Sorgum(Jawar),2016,1786,2493,707,39.585666293393054
Pune-Manjri,Flower,2016,1036,1743,707,68.24324324324324
Pune-Moshi,BRINJAL,2016,1393,2100,707,50.753768844221106
Pune,Flower,2015,656,1363,707,107.77439024390245
Koregaon,Ghevda Seed,2015,3550,4257,707,19.91549295774648
Vadgaon Peth,Brinjal,2015,814,1521,707,86.85503685503686
Mumbai-Fruit Market,Guava,2016,1531,2238,707,46.17896799477466
Jalna,Bajri,2016,1113,1820,707,63.522012578616355
Kolhapur-Malkapur,Tomato,2016,206,913,707,343.20388349514565
Pune-Moshi,PAVTTA,2016,2534,3241,707,27.900552486187845
Kolhapur,Onion,2016,296,1003,707,238.85135135135135
Jalgaon,Potato,2016,918,1625,707,77.01525054466231
Umared,Wheat(Husked),2016,1625,2331,706,43.44615384615385
Jalna,Gram,2015,3938,4644,706,17.92788217369223
Nira-Saswad,Sorgum(Jawar),2015,1625,2331,706,43.44615384615385
Loha,Pigeon Pea (Tur),2016,8567,9273,706,8.240924477646784
Lasur Station,Sorgum(Jawar),2015,1296,2002,706,54.47530864197531
Ausa,Gram,2015,3468,4174,706,20.35755478662053
Khed-Chakan,Onion,2016,538,1244,706,131.2267657992565
Barshi,Green Gram,2016,4474,5180,706,15.780062583817612
Karad,Mango,2016,2322,3028,706,30.404823428079244
Umared,Other Pulses,2015,5367,6073,706,13.15446245574809
Pune,Elephant Root,2016,2265,2971,706,31.169977924944813
Pune-Manjri,Cucumber,2015,1250,1956,706,56.48
Manchar,Potato,2016,319,1025,706,221.3166144200627
Pusad,Spilt Pigeon Pea,2015,10851,11557,706,6.506312782232053
Yeotmal,GRAM,2016,5430,6136,706,13.00184162062615
Nira,Sorgum(Jawar),2015,1600,2306,706,44.125
Murbad,LADIES FINGER,2016,2765,3471,706,25.533453887884267
Washim,Turmeric,2016,5650,6356,706,12.495575221238939
Nilanga,Pigeon Pea (Tur),2016,8453,9159,706,8.352064355849993
Nashik,Flower,2014,516,1222,706,136.8217054263566
Ratanagari,Tomato,2015,1005,1710,705,70.14925373134328
Manchar,Small Gourd,2016,1559,2264,705,45.22129570237332
Akot,Pigeon Pea (Tur),2016,8102,8807,705,8.701555171562577
Latur,Gram,2015,3894,4599,705,18.10477657935285
Murtizapur,Green Gram,2014,6041,6746,705,11.67025326932627
Palghar(Bevur),Rice(Paddy-Hus),2015,2276,2981,705,30.975395430579965
Murbad,Ladies Finger,2016,3852,4557,705,18.302180685358255
Devala,Pigeon Pea (Tur),2016,4900,5605,705,14.387755102040817
Aurangabad,Onion,2015,618,1323,705,114.07766990291262
Pathardi,Gram,2015,3825,4530,705,18.431372549019606
Ratanagari,Capsicum,2015,2324,3029,705,30.33562822719449
Hingoli,Pigeon Pea (Tur),2016,8525,9230,705,8.269794721407624
Shrirampur,Cluster Bean,2016,2000,2705,705,35.25
Mumbai,Water Melon,2015,1468,2173,705,48.02452316076294
Ratanagari,Flower,2015,2568,3273,705,27.453271028037385
Pathardi,Bajri,2016,2175,2880,705,32.41379310344828
Nashik-Devlali,Shepu,2016,1374,2078,704,51.2372634643377
Pune,Bitter Gourd,2016,764,1468,704,92.14659685863874
Nashik,Green-Peas,2016,1535,2239,704,45.86319218241042
Mumbai,Ginger (Dry),2016,2256,2960,704,31.20567375886525
Pune,Shevga,2016,883,1587,704,79.7281993204983
Nanded,Sorgum(Jawar),2015,1194,1898,704,58.96147403685092
Barshi,Cluster Bean,2016,1548,2252,704,45.47803617571059
Nashik,Flower,2016,743,1447,704,94.75100942126514
Patan,Ladies Finger,2016,3431,4135,704,20.518799183911398
Khed-Chakan,CHAVLI (SHENGA ),2016,1013,1717,704,69.49654491609083
Khed-Chakan,Squash Gourd,2016,1088,1792,704,64.70588235294117
Pune-Moshi,Mango(Raw),2016,1596,2300,704,44.11027568922306
Majalgaon,Wheat(Husked),2016,1587,2291,704,44.36042848141147
Hinganghat,Soybean,2015,3010,3714,704,23.388704318936878
Shegaon,BLACK GRAM,2016,5725,6429,704,12.296943231441048
Vaijapur,Onion,2016,233,937,704,302.14592274678114
Mohol,Sorgum(Jawar),2014,1543,2247,704,45.62540505508749
Jalna,Gram,2015,3593,4297,704,19.593654327859728
Mumbai,Ginger (Dry),2015,2537,3241,704,27.74931020890816
Kalvan,Onion,2016,287,991,704,245.29616724738676
Shirpur,Cowpea,2015,4458,5161,703,15.769403319874383
Akola,Pigeon Pea (Tur),2016,7988,8691,703,8.800701051577366
Nilanga,Pigeon Pea (Tur),2016,8121,8824,703,8.656569388006403
Akola,Gram,2016,4259,4962,703,16.506222117868045
Akola,Green Gram,2015,7194,7897,703,9.772032249096469
Majalgaon,Sesamum,2015,9069,9772,703,7.751681552541625
Kada (Ashti),Sorgum(Jawar),2015,1547,2250,703,45.44279250161603
Kolhapur,Bottle Gourd,2016,480,1183,703,146.45833333333334
Mumbai,Curry Leaves,2015,1685,2388,703,41.72106824925816
Bori,SOYBEAN,2016,2077,2780,703,33.84689455946076
Sinner,Gram,2015,3335,4038,703,21.079460269865066
Yeotmal,Ground Nut Pods (Dry),2016,4507,5210,703,15.597958730863102
Tuljapur,Black Gram,2014,4090,4793,703,17.188264058679707
Pune,Gr.Nut Kernels,2016,8363,9066,703,8.406074375224202
Yeotmal,Pigeon Pea (Tur),2015,5404,6107,703,13.008882309400445
Nashik,SQUASH GOURD,2016,1104,1806,702,63.58695652173913
Lasur Station,Pigeon Pea (Tur),2016,7528,8230,702,9.32518597236982
Amarawati,Soybean,2016,2912,3614,702,24.107142857142858
Sindi,Gram,2015,3267,3969,702,21.487603305785125
Barshi,Gram,2016,5083,5785,702,13.81074168797954
Daryapur,Black Gram,2016,7671,8373,702,9.151349237387564
Kopargaon,Gram,2015,2749,3451,702,25.53655874863587
Dhadgaon,Sorgum(Jawar),2016,1150,1852,702,61.04347826086956
Mangrulpeer,Wheat(Husked),2016,1401,2103,702,50.107066381156315
Barshi,Wheat(Husked),2015,1469,2171,702,47.78761061946903
Vasai,Potato,2016,971,1673,702,72.29660144181257
Dindori-Vani,Onion,2014,1107,1809,702,63.41463414634146
Dound,Sorgum(Jawar),2016,1732,2434,702,40.531177829099306
Phaltan,Onion,2016,100,801,701,701.0
Mangalwedha,Sorgum(Jawar),2016,1600,2301,701,43.8125
Shirpur,Cowpea,2015,6621,7322,701,10.587524543120374
Dondaicha,Matki,2016,5300,6001,701,13.226415094339623
Kalamb (Os),Wheat(Husked),2015,1953,2654,701,35.89349718381976
Nagpur,Gram,2015,4126,4827,701,16.989820649539507
Pandharpur,Tomato,2016,193,894,701,363.21243523316065
Akole,Tomato,2015,330,1031,701,212.42424242424244
Akkolkot,Wheat(Unhusked),2015,3300,4001,701,21.242424242424242
Pusad,Green Gram,2016,4648,5349,701,15.081755593803786
Sangrampur-Varvatbakal,Pigeon Pea (Tur),2016,5450,6151,701,12.862385321100918
Loha,Pigeon Pea (Tur),2015,5900,6601,701,11.88135593220339
Sangli-Phale Bhajipalam,Papai,2015,201,902,701,348.7562189054726
Dound,Pigeon Pea (Tur),2016,6083,6784,701,11.523919118855828
Jintur,Jaggery,2015,1200,1901,701,58.416666666666664
Indapur-Bhigwan,Bajri,2016,1233,1934,701,56.85320356853204
Tumsar,Gram,2015,3751,4452,701,18.68834977339376
Ratanagari,Bitter Gourd,2016,1200,1900,700,58.333333333333336
Khed,Brinjal,2016,1800,2500,700,38.888888888888886
Jalgaon,Amla,2014,1100,1800,700,63.63636363636363
Solapur,Coriander  ,2015,200,900,700,350.0
Barshi,Pigeon Pea (Tur),2014,4537,5237,700,15.428697377121447
Pathardi,Chino,2015,3700,4400,700,18.91891891891892
Lasur Station,Pigeon Pea (Tur),2015,6800,7500,700,10.294117647058824
Patur,Pigeon Pea (Tur),2015,4500,5200,700,15.555555555555555
Ausa,Ground Nut Pods (Dry),2014,3011,3711,700,23.248090335436732
Rahuri-Vambori,Onion,2016,200,900,700,350.0
Udgir,Sesamum,2015,5800,6500,700,12.068965517241379
Chopda,Sorgum(Jawar),2016,1400,2100,700,50.0
Ramtek,Ladies Finger,2016,800,1500,700,87.5
Nanded,Green Gram,2014,6300,7000,700,11.11111111111111
Ghoti,Bitter Gourd,2016,1300,2000,700,53.84615384615385
Morshi,Pigeon Pea (Tur),2015,5813,6513,700,12.041974883880956
Aurangabad,Papai,2016,1157,1857,700,60.501296456352634
Pune,Harbara(Pendi),2014,3100,3800,700,22.580645161290324
Khed-Chakan,Coriander  ,2016,500,1200,700,140.0
Manchar,Brinjal,2016,850,1550,700,82.3529411764706
Manchar,Maize(Corn.),2014,200,900,700,350.0
Aurangabad,Green Chilli,2016,3728,4428,700,18.776824034334766
Manchar,Ladies Finger,2016,2500,3200,700,28.0
Hinganghat,Soybean,2015,3053,3753,700,22.928267278087127
Akola,SESAMUM,2016,6000,6700,700,11.666666666666666
Wardha,Pigeon Pea (Tur),2016,8228,8928,700,8.50753524550316
Amalner,Coriander (Dry),2014,6500,7200,700,10.76923076923077
Vadgaon Peth,Bottle Gourd,2016,900,1600,700,77.77777777777777
Palus,Ladies Finger,2016,2000,2700,700,35.0
Baramati,SUNFLOWER,2016,2600,3300,700,26.923076923076923
Solapur,Methi (Bhaji),2015,700,1400,700,100.0
Sonpeth,Wheat(Husked),2015,1500,2200,700,46.666666666666664
Shrirampur,CLUSTER BEAN,2016,2250,2950,700,31.11111111111111
Amarawati,Green Chilli,2015,2800,3500,700,25.0
Kej,Green Peas (Dry),2016,3000,3700,700,23.333333333333332
Jawala-Bajar,Turmeric,2015,7000,7700,700,10.0
Ghoti,Ladies Finger,2016,2800,3500,700,25.0
Vadgaon Peth,Bottle Gourd,2016,800,1500,700,87.5
Akluj,Water Melon,2016,543,1243,700,128.9134438305709
Sinner,Mustard,2015,3151,3851,700,22.21516978736909
Mangaon(Bhadav),Nagali,2015,1383,2083,700,50.61460592913955
Pune-Manjri,Cabbage,2015,520,1220,700,134.6153846153846
Balapur,Green Gram,2015,6825,7525,700,10.256410256410257
Palus,Ginger (Fresh),2016,1900,2600,700,36.8421052631579
Palus,Ginger (Fresh),2016,1800,2500,700,38.888888888888886
Aurangabad,Carrot,2016,1300,2000,700,53.84615384615385
Manchar,Capsicum,2016,1000,1700,700,70.0
Rahata,Tomato,2015,806,1506,700,86.848635235732
Umared,Gram,2014,2050,2750,700,34.146341463414636
Phaltan,Wheat(Husked),2016,1525,2225,700,45.90163934426229
Ausa,Wheat(Husked),2016,2026,2726,700,34.550839091806516
Mangaon(Bhadav),Nachani,2016,1300,2000,700,53.84615384615385
Palus,Ginger (Fresh),2016,2067,2767,700,33.86550556361877
Palus,Flower,2016,1167,1867,700,59.98286203941731
Ahmednagar,Bottle Gourd,2015,500,1200,700,140.0
Sangrampur,Green Gram,2015,7100,7800,700,9.859154929577464
Kada (Ashti),Black Gram,2016,5400,6100,700,12.962962962962964
Ahmednagar,Ghevda,2016,6438,7138,700,10.872941907424666
Ulhasnagar,Jaggery,2015,2800,3500,700,25.0
Kolhapur-Laxmipuri,Split Gram,2014,3500,4200,700,20.0
Indapur-Bhigwan,Green Gram,2016,4200,4900,700,16.666666666666668
Ahmednagar,Tamarind,2015,3700,4400,700,18.91891891891892
Ramtek,Coriander  ,2016,1248,1948,700,56.08974358974359
Lasalgaon,Bajri,2016,1315,2015,700,53.2319391634981
Kolhapur-Laxmipuri,Spilt Gerrn Gram,2015,11067,11767,700,6.325110689437065
Nagpur,Ginger (Dry),2016,2000,2700,700,35.0
Kada,Gram,2016,4906,5606,700,14.268242967794537
Pune-Pimpri,Brinjal,2015,1594,2294,700,43.9146800501882
Jalgaon,Ladies Finger,2015,968,1668,700,72.31404958677686
Jalgaon,Flower,2015,1215,1915,700,57.61316872427984
Kolhapur-Laxmipuri,Spilt Pigeon Pea,2016,12800,13500,700,5.46875
Shrigonda,Gram,2016,4875,5575,700,14.35897435897436
Ramtek,Chillies(Red),2016,3900,4600,700,17.94871794871795
Ramtek,Bitter Gourd,2016,1633,2333,700,42.86589099816289
Pune,Gr.Nut Kernels,2015,7187,7887,700,9.73980798664255
Nashik,Bottle Gourd,2014,800,1500,700,87.5
Kolhapur-Malkapur,Snake Gourd,2016,300,1000,700,233.33333333333334
Lasalgaon,Ground Nut Pods (Dry),2015,2751,3451,700,25.44529262086514
Jalgaon,Green Gram,2015,6500,7200,700,10.76923076923077
Vadgaon Peth,SNAKE GOURD,2016,800,1500,700,87.5
Mantha,Gram,2016,6000,6700,700,11.666666666666666
Sinner,Black Gram,2016,6488,7188,700,10.789149198520345
Pune-Pimpri,Chavli (Shenga ),2015,1900,2600,700,36.8421052631579
Pathardi,Wheat(Husked),2014,1500,2200,700,46.666666666666664
Umarkhed,Pigeon Pea (Tur),2015,7500,8200,700,9.333333333333334
Ambad(Vadi Godri),Wheat(Husked),2016,1709,2409,700,40.95962551199532
Hingoli,Pigeon Pea (Tur),2015,6702,7402,700,10.444643390032827
Sangrampur,Green Gram,2015,6000,6700,700,11.666666666666666
Aurangabad,Shevga,2015,1738,2438,700,40.27617951668584
Aurangabad,Lemon,2015,2288,2988,700,30.594405594405593
Nashik,Papai,2016,300,1000,700,233.33333333333334
Amarawati,Ladies Finger,2015,900,1600,700,77.77777777777777
Rahata,Cucumber,2015,1380,2080,700,50.72463768115942
Aurangabad,Grapes,2015,2050,2750,700,34.146341463414636
Vai,Pavtta,2016,3800,4500,700,18.42105263157895
Malegaon,Ground Nut Pods (Dry),2016,3975,4675,700,17.61006289308176
Ramtek,Chavli (Shenga ),2015,2700,3400,700,25.925925925925927
Aurangabad,Green-Peas,2014,2900,3600,700,24.137931034482758
Akole,Gram,2015,3333,4033,700,21.002100210021002
Pune,Tamarind,2015,4318,5018,700,16.21120889300602
Kolhapur,Papai,2016,350,1050,700,200.0
Atpadi,Gram,2014,3500,4200,700,20.0
Umared,Cotton,2015,3200,3900,700,21.875
Akole,Tomato,2015,400,1100,700,175.0
Shirpur,Green Gram,2016,6467,7167,700,10.824184320395856
Murbad,Bottle Gourd,2016,3500,4200,700,20.0
Mangrulpeer,Black Gram,2016,9000,9700,700,7.777777777777778
Akole,Paddy-Unhusked,2016,1500,2200,700,46.666666666666664
Koregaon,Ghevda Seed,2015,3271,3971,700,21.400183430143688
Junnar,Onion,2015,514,1214,700,136.18677042801556
Kolhapur,Ground Nut Pods (Dry),2016,2800,3500,700,25.0
Murbad,Brinjal,2016,2000,2700,700,35.0
Akole,WHEAT(HUSKED),2016,1500,2200,700,46.666666666666664
Manchar,Bitter Gourd,2015,1433,2133,700,48.84856943475227
Patur,Pigeon Pea (Tur),2015,4713,5413,700,14.852535539995756
Chandrapur-Ganjwad,Mango(Raw),2016,1080,1780,700,64.81481481481481
Chandrapur,Banana,2016,558,1258,700,125.44802867383513
Satara,Potato,2014,1800,2500,700,38.888888888888886
Patan,Ghevda,2016,1975,2675,700,35.44303797468354
Jalna,Mosambi,2015,930,1630,700,75.26881720430107
Chalisgaon,Pigeon Pea (Tur),2016,7200,7900,700,9.722222222222221
Kamthi,Raddish,2016,750,1450,700,93.33333333333333
Junnar (Narayangaon),Coriander  ,2016,151,851,700,463.57615894039736
Manchar,Wal Papdi,2016,867,1567,700,80.73817762399078
Ratanagari,Brinjal,2014,1700,2400,700,41.1764705882353
Kalyan,Gr.Nut Kernels,2016,6000,6700,700,11.666666666666666
Varud-Rajura Bazar,Mosambi,2015,1100,1800,700,63.63636363636363
Akluj,Banana,2014,500,1200,700,140.0
Chandrapur,Flower,2015,1100,1800,700,63.63636363636363
Chandrapur,Ginger (Fresh),2015,2800,3500,700,25.0
Pune-Pimpri,Squash Gourd,2016,3600,4300,700,19.444444444444443
Osmanabad,Small Gourd,2015,500,1200,700,140.0
Akluj,Bor,2014,1150,1850,700,60.869565217391305
Chandrapur,Mosambi,2015,1300,2000,700,53.84615384615385
Kalyan,Curry Leaves,2016,1700,2400,700,41.1764705882353
Kalyan,Curry Leaves,2016,2500,3200,700,28.0
Chandrapur,Pigeon Pea (Tur),2015,6000,6700,700,11.666666666666666
Indapur-Bhigwan,Horse Gram,2014,2667,3367,700,26.246719160104988
Karad,Onion,2014,1313,2013,700,53.313023610053314
Akluj,Carrot,2014,1000,1700,700,70.0
Pune,Sweet Potato,2014,714,1414,700,98.03921568627452
Jalna,Horse Gram,2014,300,1000,700,233.33333333333334
Karad,Bor,2015,1625,2325,700,43.07692307692308
Chandrapur,Tomato,2015,800,1500,700,87.5
Osmanabad,Cabbage,2015,700,1400,700,100.0
Indapur-Bhigwan,Cowpea,2015,4667,5367,700,14.998928647953717
Kalyan,Mango,2016,3109,3809,700,22.515278224509487
Pune-Manjri,Kardai,2014,400,1100,700,175.0
Kamthi,Brinjal,2015,527,1227,700,132.82732447817835
Jalgaon,Amla,2015,1800,2500,700,38.888888888888886
Shrirampur,Pomegranate,2015,4100,4800,700,17.073170731707318
Satara,Ghevda,2015,1883,2583,700,37.174721189591075
Nagpur,Coriander (Dry),2015,8500,9200,700,8.235294117647058
Vadgaon Peth,Pavtta,2015,1650,2350,700,42.42424242424242
Buldhana,Green Gram,2015,7500,8200,700,9.333333333333334
Buldhana,Black Gram,2016,7150,7850,700,9.79020979020979
Buldhana,Black Gram,2016,6500,7200,700,10.76923076923077
Ratanagari,Sweet Potato,2014,1900,2600,700,36.8421052631579
Kamthi,Potato,2015,755,1455,700,92.71523178807946
Nira,Rice(Paddy-Hus),2015,2500,3200,700,28.0
Chalisgaon,Ground Nut Pods (Dry),2014,3267,3967,700,21.4263850627487
Junnar (Narayangaon),Math (Bhaji),2015,300,1000,700,233.33333333333334
Kalyan,Small Gourd,2016,2700,3400,700,25.925925925925927
Chalisgaon,Green Gram,2015,5000,5700,700,14.0
Pune-Pimpri,Rice(Paddy-Hus),2016,3900,4600,700,17.94871794871795
Patan,Ginger (Fresh),2016,2221,2921,700,31.517334533993697
Nira-Saswad,Pigeon Pea (Tur),2016,6300,7000,700,11.11111111111111
Rahuri,Cucumber,2016,100,800,700,700.0
Nandurbar,Gram,2016,2725,3425,700,25.68807339449541
Patan,Ginger (Fresh),2016,1918,2618,700,36.496350364963504
Jalna,Sesamum,2015,6700,7400,700,10.447761194029852
Kamthi,KANDA PAT,2016,968,1668,700,72.31404958677686
Pune,Flower,2016,664,1364,700,105.42168674698796
Chalisgaon,Coriander  ,2016,1300,2000,700,53.84615384615385
Osmanabad,Cabbage,2016,500,1200,700,140.0
Chandrapur,Potato,2015,700,1400,700,100.0
Shahapur,Cluster Bean,2014,3800,4500,700,18.42105263157895
Ratanagari,Ladies Finger,2015,3500,4200,700,20.0
Kalyan,Lemon,2015,1300,2000,700,53.84615384615385
Amarawati,Green Gram,2014,7500,8200,700,9.333333333333334
Ratanagari,Ginger (Fresh),2015,3600,4300,700,19.444444444444443
Shahapur,Ridge Gourd,2015,4250,4950,700,16.470588235294116
Barshi,Ladies Finger,2016,1150,1850,700,60.869565217391305
Junnar-Otur,Brinjal,2015,300,1000,700,233.33333333333334
Junnar-Otur,Beet Root,2016,200,900,700,350.0
Nashik,Sweet Potato,2016,1500,2200,700,46.666666666666664
Chandrapur-Ganjwad,Math (Bhaji),2015,1000,1700,700,70.0
Mumbai,Cluster Bean,2015,2950,3650,700,23.728813559322035
Karad,Tomato,2016,3281,3981,700,21.334958854007926
Dound,Pigeon Pea (Tur),2016,6250,6950,700,11.2
Phaltan,LADIES FINGER,2016,1700,2400,700,41.1764705882353
Kalyan,Matki,2015,6500,7200,700,10.76923076923077
Chandrapur-Ganjwad,Capsicum,2016,708,1408,700,98.87005649717514
Osmanabad,Water Melon,2016,300,1000,700,233.33333333333334
Nagpur,Sorgum(Jawar),2014,1600,2300,700,43.75
Pachora,Gram,2015,3000,3700,700,23.333333333333332
Barshi,Methi (Bhaji),2015,600,1300,700,116.66666666666667
Junnar-Otur,Brinjal,2016,300,1000,700,233.33333333333334
Shrirampur,Tamarind,2016,2333,3033,700,30.00428632661809
Kalyan,Banana,2015,1800,2500,700,38.888888888888886
Digras,Green Gram,2015,6598,7298,700,10.60927553804183
Karmala,Wheat(Husked),2016,1500,2200,700,46.666666666666664
Shrirampur,Onion,2016,150,850,700,466.6666666666667
Akluj,Banana,2016,600,1300,700,116.66666666666667
Barshi,Methi (Bhaji),2016,867,1567,700,80.73817762399078
Kalyan,Guava,2015,1300,2000,700,53.84615384615385
Kalyan,Onion,2015,1571,2271,700,44.55760661998727
Shahapur,Chavli (Shenga ),2015,1089,1789,700,64.2791551882461
Chandrapur,Onion,2016,500,1200,700,140.0
Chandrapur,Tomato,2016,300,1000,700,233.33333333333334
Junnar-Otur,Cucumber,2015,500,1200,700,140.0
Chandrapur,WATER MELON,2016,500,1200,700,140.0
Junnar-Otur,Flower,2015,300,1000,700,233.33333333333334
Lonar,Green Gram,2014,7167,7867,700,9.766987581972932
Mumbai,Split Lentil,2015,7790,8490,700,8.985879332477536
Akluj,Bor,2015,800,1500,700,87.5
Manchar,Green-Peas,2016,2500,3200,700,28.0
Indapur,Gram,2016,6500,7200,700,10.76923076923077
Jalkot,Green Gram,2015,7500,8200,700,9.333333333333334
Karad,Pomegranate,2015,1650,2350,700,42.42424242424242
Akluj,Brinjal,2015,680,1380,700,102.94117647058823
Patur,Pigeon Pea (Tur),2016,6164,6863,699,11.340038935756002
Chopda,Green Gram,2015,6453,7152,699,10.832171083217109
Kurdwadi,SORGUM(JAWAR),2016,2048,2747,699,34.130859375
Partur,Pigeon Pea (Tur),2015,5750,6449,699,12.156521739130435
Jalna,SOYBEAN,2016,2130,2829,699,32.816901408450704
Chalisgaon,Pigeon Pea (Tur),2016,6513,7212,699,10.732381391064026
Ahmedpur,Tamarind,2016,5401,6100,699,12.94204776893168
Bhokardan-Pimpalgaon Renu,Black Gram,2016,5420,6119,699,12.896678966789668
Shegaon,Soybean,2016,3233,3932,699,21.62078564800495
Nilanga,Gram,2015,3906,4605,699,17.895545314900154
Jintur,Gram,2014,2256,2955,699,30.98404255319149
Shegaon,Pigeon Pea (Tur),2016,8166,8865,699,8.559882439382807
Umarga,Pigeon Pea (Tur),2014,4430,5129,699,15.778781038374717
Khamgaon,Gram,2015,3748,4447,699,18.649946638207044
Palghar(Bevur),Rice(Paddy-Hus),2015,2220,2919,699,31.486486486486488
Kalmeshwar,Cotton,2015,3809,4508,699,18.35127330007876
Gevrai,Green Gram,2016,4362,5061,699,16.024759284731775
Nandurbar,Ground Nut Pods (Dry),2016,3618,4317,699,19.320066334991708
Lonar,Pigeon Pea (Tur),2015,5265,5964,699,13.276353276353277
Risod,Turmeric,2016,6500,7198,698,10.738461538461538
Barshi-Vairag,Sorgum(Jawar),2015,1441,2139,698,48.438584316446914
Kolhapur,Flower,2015,230,928,698,303.4782608695652
Samudrapur,Soybean,2015,3038,3736,698,22.975641869651085
Ratanagari,Flower,2014,2947,3645,698,23.68510349507974
Yeola,Green Gram,2015,7307,8005,698,9.552483919529218
Gevrai,Bajri,2015,1153,1851,698,60.53772766695577
Mangalwedha,BITTER GOURD,2016,654,1352,698,106.72782874617737
Chandur Bajar,Gram,2016,4850,5547,697,14.371134020618557
Ratanagari,Flower,2015,1842,2539,697,37.83930510314875
Dhule,Gram,2015,2494,3191,697,27.947072975140337
Jalgaon,Black Gram,2016,9800,10497,697,7.112244897959184
Kada,Sorgum(Jawar),2016,1610,2307,697,43.29192546583851
Washim,Wheat(Husked),2016,1460,2157,697,47.73972602739726
Kalamb (Os),GREEN GRAM,2016,4045,4742,697,17.23114956736712
Solapur,Green Peas (Dry),2014,4264,4961,697,16.346153846153847
Kada,Black Gram,2016,6225,6922,697,11.196787148594378
Chalisgaon,Ginger (Fresh),2016,1478,2175,697,47.15832205683356
Amarawati,Soybean,2016,3095,3792,697,22.520193861066236
Patan,Green Chilli,2016,3906,4603,697,17.844342037890424
Indapur,Sorgum(Jawar),2016,1818,2515,697,38.33883388338834
Shrirampur,Mango(Raw),2016,2217,2913,696,31.39377537212449
Bhokar,Sesamum,2014,9863,10559,696,7.056676467606205
Pulgaon,Soybean,2014,2400,3096,696,29.0
Pune,Pumpkin,2015,627,1323,696,111.00478468899522
Shrirampur,Ginger (Fresh),2015,3217,3913,696,21.63506372396643
Dhule,Gram,2014,2072,2768,696,33.59073359073359
Satara,Carrot,2015,1600,2296,696,43.5
Lasur Station,ONION,2016,110,806,696,632.7272727272727
Shrirampur,Tomato,2016,1674,2370,696,41.577060931899645
Pune,Potato,2016,788,1484,696,88.3248730964467
Pachora,Soybean,2016,2900,3596,696,24.0
Akot,Green Gram,2016,4080,4776,696,17.058823529411764
Karad,Shevga,2016,3769,4465,696,18.466436720615548
Mehkar,Gram,2014,2125,2821,696,32.752941176470586
Indapur-Bhigwan,Wheat(Husked),2016,1586,2282,696,43.88398486759142
Lasur Station,Gram,2014,2023,2719,696,34.404349975284234
Mumbai,Ginger (Dry),2016,1936,2632,696,35.950413223140494
Mangrulpeer,Pigeon Pea (Tur),2016,5894,6590,696,11.80861893450967
Osmanabad,Onion,2015,653,1349,696,106.58499234303216
Amarawati,Onion,2016,600,1296,696,116.0
Nashik,Onion,2016,181,877,696,384.5303867403315
Lasalgaon,Pigeon Pea (Tur),2015,5068,5764,696,13.733228097868983
Ratanagari,Cabbage,2016,1016,1711,695,68.40551181102362
Malkapur,Onion,2015,685,1380,695,101.45985401459853
Dhule,Soybean,2016,3238,3933,695,21.463866584311305
Shahapur,Cluster Bean,2016,3422,4117,695,20.309760374050263
Pune-Pimpri,Bottle Gourd,2015,1100,1795,695,63.18181818181818
Jalna,Gram,2015,3677,4372,695,18.901278215936905
Pune-Manjri,Tomato,2015,762,1457,695,91.20734908136482
Satana,Gram,2014,2064,2759,695,33.67248062015504
Solapur,Gram,2015,3369,4064,695,20.629266844761055
Pune-Manjri,Tomato,2015,770,1465,695,90.25974025974025
Jalgaon,Cabbage,2016,1185,1880,695,58.64978902953587
Nandurbar,Pigeon Pea (Tur),2016,7121,7816,695,9.75986518747367
Vadgaon Peth,Tomato,2015,463,1158,695,150.10799136069116
Hingoli,Turmeric,2016,8625,9320,695,8.057971014492754
Pune,Chavli (Shenga ),2015,1380,2075,695,50.36231884057971
Majalgaon,Sorgum(Jawar),2015,1179,1873,694,58.86344359626803
Nashik-Devlali,Raddish,2016,1743,2437,694,39.81640849110729
Manchar,Flower,2016,909,1603,694,76.34763476347635
Dound,Gram,2016,6627,7321,694,10.472310245963483
Kada (Ashti),Green Gram,2016,4156,4850,694,16.698748796920114
Lasur Station,Onion,2016,100,794,694,694.0
Gevrai,Sorgum(Jawar),2014,1676,2370,694,41.408114558472555
Pandharkawada,Ground Nut Pods (Dry),2016,4445,5139,694,15.61304836895388
Pune-Manjri,Shepu,2016,578,1272,694,120.06920415224913
Lasalgaon,Soybean,2016,2461,3155,694,28.199918732222674
Karanja,Black Gram,2014,4223,4917,694,16.43381482358513
Dondaicha,Sorgum(Jawar),2015,1345,2039,694,51.59851301115241
Tumsar,Pigeon Pea (Tur),2016,7286,7980,694,9.525116662091683
Amarawati,Lemon,2016,1256,1950,694,55.254777070063696
Pune,Black Gram,2014,5406,6100,694,12.837587865334813
Jawala-Bajar,Pigeon Pea (Tur),2015,7219,7913,694,9.61351987809946
Shrirampur,Mosambi,2014,2306,3000,694,30.095403295750216
Aurangabad,Bitter Gourd,2015,1774,2468,694,39.120631341600905
Malkapur,Soybean,2016,2960,3654,694,23.445945945945947
Pune-Manjri,Chavli (Shenga ),2016,1536,2230,694,45.182291666666664
Pimpalgaon Basawant,Onion,2016,250,943,693,277.2
Barshi-Vairag,Ground Nut Pods (Dry),2015,3977,4670,693,17.425194870505408
Solapur,Cabbage,2015,407,1100,693,170.27027027027026
Khed-Chakan,Farshi,2016,2863,3556,693,24.205378973105134
Washim,Pigeon Pea (Tur),2015,5315,6008,693,13.03857008466604
Latur,Gram,2014,2368,3061,693,29.2652027027027
Mehkar,Black Gram,2016,7770,8463,693,8.91891891891892
Bhokar,Cotton,2016,3739,4432,693,18.534367477935277
Phaltan,Wheat(Husked),2015,1400,2093,693,49.5
Khamgaon,Gram,2015,3656,4349,693,18.955142231947484
Pune-Manjri,Rajgira,2014,488,1181,693,142.00819672131146
Patur,Pigeon Pea (Tur),2016,7586,8279,693,9.13524914315845
Akot,Ground Nut Pods (Dry),2016,5040,5732,692,13.73015873015873
Kalamb (Os),Green Gram,2014,6754,7446,692,10.245780278353568
Mohol,Sorgum(Jawar),2016,1650,2342,692,41.93939393939394
Manchar,BITTER GOURD,2016,675,1367,692,102.51851851851852
Shrigonda,Lemon,2016,3208,3900,692,21.571072319201996
Ratanagari,Bitter Gourd,2014,1654,2346,692,41.83796856106409
Aurangabad,Brinjal,2016,1746,2438,692,39.63344788087056
Mangalwedha,GREEN CHILLI,2016,612,1304,692,113.0718954248366
Kopargaon,Onion,2016,383,1075,692,180.67885117493472
Shahada,Pigeon Pea (Tur),2016,7377,8069,692,9.380506981157652
Kopargaon,Gram,2015,3537,4229,692,19.56460277070964
Mumbai,Ginger (Dry),2015,3408,4100,692,20.305164319248828
Pune-Moshi,Shevga,2016,2596,3288,692,26.656394453004623
Malegaon,Gram,2015,3795,4487,692,18.23451910408432
Pune,Bottle Gourd,2015,508,1200,692,136.2204724409449
Bhokar,Turmeric,2015,5906,6598,692,11.716898069759566
Vadgaon Peth,Ladies Finger,2015,1125,1817,692,61.51111111111111
Khed-Chakan,Capsicum,2016,2352,3044,692,29.421768707482993
Pandharpur,Math (Bhaji),2015,308,1000,692,224.67532467532467
Hingoli,Pigeon Pea (Tur),2015,7732,8424,692,8.949818934299017
Solapur,Pigeon Pea (Tur),2016,7908,8600,692,8.750632271117855
Yeola,Onion,2016,231,923,692,299.56709956709955
Sangamner,Tomato,2015,418,1110,692,165.55023923444975
Satana,Onion,2016,193,885,692,358.5492227979275
Kolhapur,Tomato,2016,141,833,692,490.78014184397165
Nandura,Gram,2016,5821,6513,692,11.887991753994159
Chandrapur-Ganjwad,Potato,2014,1600,2291,691,43.1875
Barshi,Green Chilli,2016,1459,2150,691,47.361206305688825
Jalgaon,Mango(Raw),2016,2373,3064,691,29.119258322798146
Amarawati,Lemon,2015,1218,1909,691,56.73234811165845
Kej,Wheat(Husked),2016,1984,2675,691,34.828629032258064
Risod,Pigeon Pea (Tur),2015,5235,5926,691,13.199617956064948
Rahata,Ladies Finger,2014,1617,2308,691,42.733457019171304
Kolhapur,Cabbage,2015,348,1039,691,198.5632183908046
Nandurbar,Gram,2016,4659,5350,691,14.831508907490878
Nira,Jaggery,2016,4006,4697,691,17.249126310534198
Jalna,Gram,2015,3065,3756,691,22.544861337683525
Manchar,Cluster Bean,2015,1577,2268,691,43.81737476220672
Murum,Black Gram,2014,4847,5538,691,14.256240973798226
Ausa,Sesamum,2014,8710,9401,691,7.933409873708381
Akole,Tomato,2015,241,932,691,286.7219917012448
Parli-Vaijnath,Pigeon Pea (Tur),2015,5690,6381,691,12.144112478031634
Pune,GR.NUT KERNELS,2016,7516,8207,691,9.193720063863758
Malkapur,Gram,2015,2508,3199,691,27.5518341307815
Solapur,Cabbage,2015,418,1109,691,165.311004784689
Barshi-Vairag,Sorgum(Jawar),2016,1872,2563,691,36.912393162393165
Pusad,Ground Nut Pods (Dry),2016,4856,5547,691,14.229818780889621
Shirpur,Sorgum(Jawar),2015,1184,1875,691,58.361486486486484
Ahmednagar,Sorgum(Jawar),2015,1684,2375,691,41.033254156769594
Kurdwadi,Onion,2016,250,940,690,276.0
Indapur-Bhigwan,Wheat(Husked),2015,2269,2959,690,30.409872190392242
Aurangabad,Chikoo,2016,1600,2290,690,43.125
Savali,Paddy-Unhusked,2014,1723,2413,690,40.04643064422519
Akot,Black Gram,2015,6505,7195,690,10.607225211375864
Aurangabad,Ginger (Fresh),2016,1000,1690,690,69.0
Nashik,Methi (Bhaji),2015,543,1233,690,127.07182320441989
Kille Dharur,Gram,2015,3640,4330,690,18.956043956043956
Jalgaon,Coriander (Dry),2014,11603,12293,690,5.946737912608808
Pune,Bottle Gourd,2015,515,1205,690,133.98058252427185
Latur-Murud,Wheat(Husked),2015,1217,1907,690,56.696795398520955
Solapur,Tomato,2015,130,820,690,530.7692307692307
Vasai,Potato,2016,960,1650,690,71.875
Kille Dharur,Bajri,2015,1455,2145,690,47.422680412371136
Dindori-Vani,Onion,2015,881,1571,690,78.32009080590238
Jalgaon,Cluster Bean,2015,2215,2905,690,31.151241534988714
Solapur,Chikoo,2015,384,1074,690,179.6875
Phaltan,Bajri,2015,1275,1965,690,54.11764705882353
Indapur (Nimgaon Ketki),Gram,2015,2513,3203,690,27.457222443294867
Taloda,Gram,2015,3057,3747,690,22.571148184494604
Satara,Cucumber,2015,1084,1774,690,63.65313653136531
Kalamb (Os),Gram,2016,3775,4465,690,18.278145695364238
Loha,Green Gram,2015,6980,7670,690,9.885386819484241
Dhule,Gram,2015,2330,3020,690,29.613733905579398
Akluj,Chikoo,2015,1172,1861,689,58.78839590443686
Pune,Curry Leaves,2015,1311,2000,689,52.55530129672006
Ambad(Vadi Godri),Wheat(Husked),2016,1659,2348,689,41.531042796865584
Ambejogai,SOYBEAN,2016,2209,2898,689,31.19058397464916
Pune-Pimpri,Bottle Gourd,2015,1200,1889,689,57.416666666666664
Dondaicha,Gram,2014,2388,3077,689,28.852596314907874
Akola,Green Gram,2014,6736,7425,689,10.228622327790974
Chalisgaon,Soybean,2016,2834,3523,689,24.31192660550459
Malegaon,Onion,2016,221,910,689,311.7647058823529
Majalgaon,Soybean,2016,3281,3970,689,20.999695214873515
Jalna,Mosambi,2015,1029,1718,689,66.95821185617103
Beed,Green Gram,2015,8061,8750,689,8.547326634412604
Aurangabad,Mango(Raw),2015,858,1547,689,80.3030303030303
Kalamb (Os),Green Gram,2014,6956,7645,689,9.905117883841289
Loha,Green Gram,2015,8361,9050,689,8.240641071642148
Amarawati-Fruit And Vegetables,Ginger (Fresh),2016,2053,2742,689,33.560642961519726
Junnar,Onion,2015,704,1393,689,97.86931818181819
Digras,Gram,2016,5612,6301,689,12.277263007840341
Satara,Ginger (Fresh),2016,1033,1722,689,66.69893514036787
Lasur Station,Gram,2015,3656,4345,689,18.845733041575492
Mumbai,Green Chilli,2014,2416,3104,688,28.47682119205298
Barshi,Sorgum(Jawar),2015,1832,2520,688,37.55458515283843
Nira-Saswad,WHEAT(HUSKED),2016,1650,2338,688,41.696969696969695
Morshi,Pigeon Pea (Tur),2015,7875,8563,688,8.736507936507936
Jalgaon,Potato,2014,1732,2420,688,39.722863741339495
Khed-Chakan,BRINJAL,2016,1036,1724,688,66.40926640926641
Satana,Onion,2016,284,972,688,242.25352112676057
Sailu,Green Gram,2014,6488,7176,688,10.604192355117139
Karad,Potato,2014,1750,2438,688,39.31428571428572
Kolhapur,Onion,2016,300,988,688,229.33333333333334
Vani,Pigeon Pea (Tur),2016,7145,7833,688,9.629111266620013
Alibag,Rice(Paddy-Hus),2016,3500,4188,688,19.65714285714286
Satara,Bitter Gourd,2015,3656,4344,688,18.818380743982495
Navapur,Green Chilli,2016,2854,3542,688,24.106517168885773
Nagpur,Onion,2016,739,1427,688,93.09878213802436
Mangrulpeer,Black Gram,2015,6961,7649,688,9.88363740841833
Nashik,Onion,2016,169,857,688,407.10059171597635
Nira,Sorgum(Jawar),2015,1725,2413,688,39.88405797101449
Shahapur,Bitter Gourd,2016,3525,4213,688,19.5177304964539
Nashik,Shahale ,2015,1316,2004,688,52.27963525835866
Karad,Capsicum,2015,1625,2313,688,42.33846153846154
Yeola,Gram,2015,3354,4041,687,20.483005366726296
Junnar,ONION,2016,586,1273,687,117.23549488054607
Nira-Saswad,Wheat(Husked),2016,1550,2237,687,44.32258064516129
Aurangabad,Bor,2016,952,1639,687,72.16386554621849
Rahata,Ginger (Fresh),2015,3063,3750,687,22.428991185112636
Shahapur,Brinjal,2016,1063,1750,687,64.62841015992474
Jalna,Gram,2015,3661,4348,687,18.765364654465994
Indapur,Sorgum(Jawar),2015,1917,2604,687,35.83724569640063
Nagpur,Gram,2016,5258,5945,687,13.06580448839863
Amarawati,GROUND NUT PODS (DRY),2016,3355,4042,687,20.476900149031298
Khed-Chakan,Capsicum,2016,992,1679,687,69.25403225806451
Ratanagari,Ginger (Fresh),2015,3938,4625,687,17.44540375825292
Majalgaon,Soybean,2016,3214,3901,687,21.375233354075917
Kopargaon,Onion,2016,225,912,687,305.3333333333333
Pune,Lentil,2015,6200,6887,687,11.080645161290322
Dudhani,Sorgum(Jawar),2015,1323,2010,687,51.92743764172336
Ghoti,Capsicum,2016,1106,1793,687,62.11573236889693
Akluj,Onion,2015,919,1606,687,74.75516866158868
Jalgaon,Methi (Bhaji),2015,794,1481,687,86.52392947103274
Nandurbar,Sunflower,2016,3413,4100,687,20.128918839730442
Kamthi,Pumpkin,2016,614,1300,686,111.72638436482085
Vasai,Potato,2015,957,1643,686,71.68234064785788
Malkapur,SOYBEAN,2016,2185,2871,686,31.39588100686499
Jalgaon,Coriander  ,2015,742,1428,686,92.45283018867924
Kopargaon,Gram,2016,3585,4271,686,19.13528591352859
Jalgaon Jamod,Gram,2016,4657,5343,686,14.730513205926561
Daryapur,Gram,2015,2688,3374,686,25.520833333333332
Chandrapur-Ganjwad,Carrot,2014,1250,1936,686,54.88
Amarawati,Ground Nut Pods (Dry),2015,4545,5231,686,15.093509350935093
Amarawati,Chikoo,2016,1743,2429,686,39.3574297188755
Akola,Green Gram,2016,5352,6038,686,12.817638266068759
Kamthi,AMBAT CHUKA,2016,1214,1900,686,56.50741350906095
Ahmednagar,Gram,2015,3659,4345,686,18.74829188302815
Amalner,Sesamum,2016,4786,5472,686,14.333472628499791
Tumsar,Gram,2015,3148,3834,686,21.79161372299873
Karad,PAVATA,2016,3500,4186,686,19.6
Karanja,Green Gram,2015,7954,8640,686,8.62459140055318
Kolhapur-Laxmipuri,Split Lentil,2015,6700,7386,686,10.238805970149254
Solapur,Matki,2015,6100,6786,686,11.245901639344263
Kalamb (Os),Soybean,2016,2736,3421,685,25.03654970760234
Parbhani,Pigeon Pea (Tur),2015,6083,6768,685,11.260891007726451
Telhara,Pigeon Pea (Tur),2016,8127,8812,685,8.428694475206104
Baramati,Onion,2016,200,885,685,342.5
Majalgaon,Sorgum(Jawar),2015,1566,2251,685,43.74201787994892
Pune,Lentil,2014,6246,6931,685,10.967018892090937
Sindi,Pigeon Pea (Tur),2015,4954,5639,685,13.82721033508276
Satara,Tomato,2014,1211,1896,685,56.56482246077622
Pune-Manjri,Cucumber,2016,954,1639,685,71.80293501048219
Sangrampur,Black Gram,2015,5169,5854,685,13.252079705939254
Solapur,Matki,2015,5823,6508,685,11.763695689507127
Ahmedpur,SORGUM(JAWAR),2016,1147,1832,685,59.72101133391456
Pune,Wal Bhaji,2015,1023,1708,685,66.95992179863147
Nashik,Carrot,2014,1115,1800,685,61.43497757847533
Akola,Green Gram,2015,6992,7677,685,9.796910755148742
Patan,Ginger (Fresh),2016,2579,3264,685,26.560682435052346
Shrirampur,Green Gram,2015,6509,7194,685,10.523889998463666
Gangapur,Onion,2016,235,920,685,291.48936170212767
Barshi,Black Gram,2015,4296,4981,685,15.945065176908752
Kalyan,Flower,2016,1492,2177,685,45.911528150134046
Vadgaon Peth,Capsicum,2015,1269,1954,685,53.97951142631994
Sangrampur-Varvatbakal,Soybean,2015,2855,3540,685,23.992994746059544
Pathari,Soybean,2015,3061,3746,685,22.378307742567788
Palghar(Bevur),Rice(Paddy-Hus),2015,2291,2976,685,29.899607158446095
Naigaon,Black Gram,2015,11046,11730,684,6.19228680065182
Vaijapur,Onion,2016,233,917,684,293.56223175965664
Phaltan,Sorgum(Jawar),2016,1625,2309,684,42.09230769230769
Khamgaon,Soybean,2015,3138,3822,684,21.797323135755256
Chandur Bajar,Soybean,2016,3200,3884,684,21.375
Lonand,Bajri,2014,1283,1967,684,53.31254871395168
Ghoti,Tomato,2015,1526,2210,684,44.82306684141547
Kada (Ashti),Green Gram,2016,3983,4667,684,17.17298518704494
Shegaon,Sesamum,2015,8719,9403,684,7.844936345911228
Lasalgaon-Vinchur,Soybean,2016,2235,2919,684,30.604026845637584
Shirpur,Gram,2015,3465,4149,684,19.74025974025974
Ratanagari,Flower,2015,1895,2579,684,36.09498680738786
Ahmednagar,CABBAGE,2016,283,967,684,241.69611307420496
Pandharpur,Coriander  ,2015,244,928,684,280.327868852459
Indapur-Bhigwan,Black Gram,2015,7100,7784,684,9.633802816901408
Karad,Capsicum,2016,3485,4169,684,19.62697274031564
Aurangabad,Shevga,2016,1731,2415,684,39.51473136915078
Barshi,Turmeric,2016,5883,6567,684,11.626721060683325
Mumbai,Chikoo,2016,1008,1692,684,67.85714285714286
Ratanagari,Flower,2015,2316,3000,684,29.533678756476682
Mumbai,Ginger (Dry),2016,2262,2946,684,30.23872679045093
Lasalgaon,Wheat(Husked),2016,1523,2207,684,44.91135915955351
Shrirampur,Ginger (Fresh),2016,1786,2469,683,38.24188129899216
Kopargaon,Onion,2016,240,923,683,284.5833333333333
Sangali,Wheat(Unhusked),2015,2590,3273,683,26.37065637065637
Vadgaon Peth,Brinjal,2015,567,1250,683,120.45855379188713
Sangamner,Onion,2016,308,991,683,221.75324675324674
Pune-Moshi,SQUASH GOURD,2016,1476,2159,683,46.27371273712737
Sillod,Gram,2016,6100,6783,683,11.19672131147541
Chandur Bajar,Soybean,2015,3133,3816,683,21.80019150973508
Nashik,Wal Papdi,2016,955,1638,683,71.51832460732984
Pathardi,Gram,2015,3817,4500,683,17.893633743777837
Rahata,Bottle Gourd,2016,1425,2108,683,47.92982456140351
Chopda,Ground Nut Pods (Dry),2015,3430,4113,683,19.91253644314869
Karad,Ladies Finger,2015,2326,3009,683,29.36371453138435
Ashti-Karanja,Soybean,2016,3174,3857,683,21.518588531821045
Pune,Snake Gourd,2014,567,1250,683,120.45855379188713
Dhule,Matki,2015,6359,7042,683,10.740682497247995
Aarni,Green Gram,2016,4867,5550,683,14.033285391411548
Umared,Wheat(Husked),2015,1500,2183,683,45.53333333333333
Rahuri-Vambori,Gram,2016,6812,7495,683,10.026423957721669
Akot,Pigeon Pea (Tur),2016,5713,6396,683,11.95518991773149
Tumsar,Rice(Paddy-Hus),2014,2532,3215,683,26.97472353870458
Kamthi,Ladies Finger,2015,907,1589,682,75.19294377067254
Rahata,Ginger (Fresh),2015,3409,4091,682,20.005866823115284
Ramtek,Green Chilli,2015,1932,2614,682,35.30020703933747
Sangrampur,Pigeon Pea (Tur),2015,3964,4646,682,17.204843592330977
Nandgaon Khandeshwar,Black Gram,2016,6194,6876,682,11.010655473038424
Osmanabad,Potato,2016,600,1282,682,113.66666666666667
Lasalgaon,BAJRI,2016,1293,1975,682,52.74555297757154
Ashti (Jalna),Pigeon Pea (Tur),2016,6902,7584,682,9.881193856853086
Mumbai,French Bean,2016,5500,6182,682,12.4
Shrirampur,Shevga,2016,1591,2273,682,42.866121935889375
Kalyan,Chikoo,2015,1818,2500,682,37.51375137513752
Sangali,Gram,2016,5970,6652,682,11.423785594639867
Karanja,Pigeon Pea (Tur),2016,7690,8372,682,8.868660598179455
Sailu,Pigeon Pea (Tur),2015,5011,5693,682,13.610057872680104
Khed-Chakan,Brinjal,2016,1711,2393,682,39.85973115137347
Solapur,TOMATO,2016,162,844,682,420.98765432098764
Rahata,Garlic,2015,5773,6455,682,11.813615104798199
Mangalwedha,Pigeon Pea (Tur),2015,3875,4557,682,17.6
Ratanagari,Green-Peas,2015,2818,3500,682,24.20156139105749
Khed,Cucumber,2016,293,975,682,232.76450511945393
Kamthi,Cabbage,2016,875,1557,682,77.94285714285714
Chandrapur,Awala,2014,1055,1736,681,64.54976303317535
Manmad,Green Gram,2014,7551,8232,681,9.018673023440604
Yeola,Gram,2015,3481,4162,681,19.56334386670497
Pandharpur,Tomato,2015,179,860,681,380.44692737430165
Jalna,Green Gram,2015,5650,6331,681,12.053097345132743
Kurdwadi,Sorgum(Jawar),2016,1796,2477,681,37.91759465478842
Sangli-Phale Bhajipalam,Potato,2016,850,1531,681,80.11764705882354
Devala,ONION,2016,346,1027,681,196.82080924855492
Satara,Pavtta,2014,2731,3412,681,24.935920908092275
Akole,Wheat(Husked),2016,1519,2200,681,44.83212639894668
Osmanabad,Ground Nut Pods (Dry),2014,2628,3309,681,25.91324200913242
Shegaon,Gram,2016,7198,7879,681,9.4609613781606
Arvi,Pigeon Pea (Tur),2016,7453,8134,681,9.137260163692472
Akluj,Onion,2016,500,1181,681,136.2
Sangali,Gram,2015,4202,4883,681,16.20656830080914
Pusad,Pigeon Pea (Tur),2015,7089,7770,681,9.606432501057977
Babhulgaon,SOYBEAN,2016,2175,2856,681,31.310344827586206
Satara,Flower,2016,2692,3373,681,25.297176820208023
Lasur Station,Pigeon Pea (Tur),2015,4887,5568,681,13.934929404542665
Pune-Moshi,Cluster Bean,2016,1552,2233,681,43.878865979381445
Karad,Custard Apple,2016,2813,3494,681,24.209029505865622
Satara,Cucumber,2015,1305,1986,681,52.18390804597701
Amarawati-Fruit And Vegetables,Ginger (Fresh),2016,3139,3820,681,21.6948072634597
Lasur Station,Onion,2016,175,856,681,389.14285714285717
Ralegaon,Cotton,2016,4286,4967,681,15.88894073728418
Bhokar,Pigeon Pea (Tur),2015,7249,7930,681,9.394399227479653
Pune-Manjri,Ambat Chuka,2016,388,1069,681,175.51546391752578
Karad,Banana,2014,2390,3070,680,28.451882845188283
Raver,Black Gram,2015,7650,8330,680,8.88888888888889
Baramati,Gram,2015,3500,4180,680,19.428571428571427
Kalyan,Chikoo,2016,1933,2613,680,35.17847904811175
Satara,CARROT,2016,1267,1947,680,53.67008681925809
Sakri,Gram,2016,4884,5564,680,13.923013923013922
Ratanagari,Brinjal,2015,1095,1775,680,62.10045662100457
Lonand,Sorgum(Jawar),2016,1630,2310,680,41.717791411042946
Shevgaon,Gram,2016,6980,7660,680,9.742120343839542
Pune-Moshi,Flower,2016,1015,1695,680,66.99507389162562
Palus,Bitter Gourd,2016,2080,2760,680,32.69230769230769
Akluj,Ladies Finger,2016,1012,1692,680,67.19367588932806
Gangapur,Onion,2016,143,823,680,475.5244755244755
Kalyan,Mosambi,2015,1920,2600,680,35.416666666666664
Osmanabad,Kharbuj,2016,1140,1820,680,59.64912280701754
Bhokar,Pigeon Pea (Tur),2015,4971,5651,680,13.67934017300342
Satara,Cucumber,2016,1780,2460,680,38.20224719101124
Ausa,Pigeon Pea (Tur),2016,8116,8796,680,8.378511582060128
Pandharpur,Capsicum,2016,1360,2040,680,50.0
Kamthi,Kand,2016,800,1480,680,85.0
Ahmednagar,Cabbage,2015,540,1220,680,125.92592592592592
Solapur,Mosambi,2015,170,850,680,400.0
Vai,Green Chilli,2016,3633,4313,680,18.717313515001376
Sangrampur,Soybean,2015,2860,3540,680,23.776223776223777
Satara,Cluster Bean,2014,3120,3800,680,21.794871794871796
Akkolkot,Pigeon Pea (Tur),2015,5840,6520,680,11.643835616438356
Karad,Onion,2015,1480,2160,680,45.945945945945944
Shahapur,Capsicum,2015,1960,2640,680,34.69387755102041
Kamthi,Small Gourd,2016,760,1440,680,89.47368421052632
Mohol,Sorgum(Jawar),2016,1716,2395,679,39.56876456876457
Varud-Rajura Bazar,Green Chilli,2015,900,1579,679,75.44444444444444
Shegaon,Pigeon Pea (Tur),2016,5712,6391,679,11.887254901960784
Akluj,Ladies Finger,2015,1432,2111,679,47.41620111731844
Sindi,Soybean,2015,3033,3712,679,22.387075502802507
Sinner,Sorgum(Jawar),2016,1248,1927,679,54.407051282051285
Kolhapur,Potato,2016,1015,1694,679,66.89655172413794
Loha,Wheat(Husked),2016,1465,2144,679,46.3481228668942
Gevrai,Wheat(Husked),2016,1715,2394,679,39.59183673469388
Washim,Gram,2016,5134,5813,679,13.225555122711336
Aurangabad,Flower,2014,1291,1970,679,52.594887683965915
Umared,Wheat(Husked),2016,1600,2279,679,42.4375
Mumbai,Onion,2014,1213,1892,679,55.976916735366856
Sangli-Phale Bhajipalam,Water Melon,2016,248,927,679,273.7903225806452
Nashik-Devlali,Raddish,2016,1672,2351,679,40.610047846889955
Kamthi,Methi (Bhaji),2016,438,1117,679,155.02283105022832
Majalgaon,Soybean,2016,3174,3853,679,21.392564587271583
Chikhali,Pigeon Pea (Tur),2015,4950,5629,679,13.717171717171718
Kada,Sorgum(Jawar),2016,1607,2286,679,42.252644679527066
Morshi,Pigeon Pea (Tur),2016,7508,8187,679,9.04368673415024
Jalgaon Jamod-Aasalgaon,Pigeon Pea (Tur),2016,7822,8500,678,8.667859882383022
Sinner,Gram,2015,2311,2989,678,29.33794893985288
Khed-Chakan,Walvad,2016,2007,2685,678,33.78176382660688
Karanja,Gram,2015,4308,4986,678,15.73816155988858
Karmala,Sunflower,2016,2740,3418,678,24.744525547445257
Shrirampur,Gram,2015,3422,4100,678,19.812974868497953
Ausa,Wheat(Husked),2016,1833,2511,678,36.9885433715221
Solapur,Potato,2015,446,1124,678,152.01793721973095
Satana,Gram,2016,5035,5713,678,13.46573982125124
Amalner,Chillies(Red),2016,4350,5028,678,15.586206896551724
Udgir,Pigeon Pea (Tur),2014,4520,5198,678,15.0
Osmanabad,Ground Nut Pods (Dry),2015,2800,3478,678,24.214285714285715
Hingoli,BLACK GRAM,2016,5978,6656,678,11.34158581465373
Shrirampur,Green-Peas,2015,2643,3321,678,25.65266742338252
Ratanagari,CAPSICUM,2016,1393,2071,678,48.67193108399139
Pune,Tamarind,2014,3989,4667,678,16.9967410378541
Pune,Bottle Gourd,2015,486,1164,678,139.50617283950618
Lasalgaon,Bajri,2016,1429,2107,678,47.445766270118966
Indapur-Bhigwan,Ground Nut Pods (Dry),2016,5125,5803,678,13.229268292682926
Chandrapur-Ganjwad,Flower,2014,537,1215,678,126.25698324022346
Shirur,Gram,2016,4683,5361,678,14.477898782831518
Pune,Parwar,2015,2278,2956,678,29.762949956101842
Malkapur,Pigeon Pea (Tur),2014,3750,4428,678,18.08
Navapur,Wal Papdi,2016,2143,2821,678,31.637890807279515
Shrirampur,Cluster Bean,2015,1735,2412,677,39.02017291066282
Pune-Pimpri,Bottle Gourd,2016,1603,2280,677,42.233312538989395
Pune-Pimpri,Ghevda,2014,3108,3785,677,21.782496782496782
Chikhali,Gram,2016,5900,6577,677,11.474576271186441
Pusad,Wheat(Husked),2015,1350,2027,677,50.148148148148145
Majalgaon,Green Gram,2014,6712,7389,677,10.086412395709178
Chandur Bajar,Pigeon Pea (Tur),2015,4233,4910,677,15.993385305929602
Phaltan,Sorgum(Jawar),2016,1613,2290,677,41.97148171109733
Sonpeth,Sorgum(Jawar),2015,1512,2189,677,44.77513227513227
Pune,Beet Root,2016,431,1108,677,157.07656612529001
Shevgaon,Pigeon Pea (Tur),2015,8214,8891,677,8.242025809593377
Mangalwedha,Tomato,2015,177,854,677,382.4858757062147
Indapur-Bhigwan,Cowpea,2014,2761,3438,677,24.52010141253169
Lasalgaon-Vinchur,SOYBEAN,2016,2128,2805,677,31.81390977443609
Sengaon,Turmeric,2015,6392,7069,677,10.591364205256571
Akola,Pigeon Pea (Tur),2015,4828,5505,677,14.022369511184756
Lasur Station,Sorgum(Jawar),2015,1243,1920,677,54.465004022526145
Hinganghat,Soybean,2016,3181,3858,677,21.282615529707638
Nashik,Carrot,2016,647,1324,677,104.63678516228748
Nira-Saswad,Sorgum(Jawar),2016,1666,2343,677,40.63625450180072
Ratanagari,Green Chilli,2016,1235,1912,677,54.81781376518219
Rahata,Ladies Finger,2016,3369,4046,677,20.094983674680915
Hingoli-Kanegaon Naka,PIGEON PEA (TUR),2016,5240,5916,676,12.900763358778626
Satara,Pavtta,2016,3559,4235,676,18.994099466142174
Satara,Ladies Finger,2016,1492,2168,676,45.30831099195711
Jalgaon,Amla,2015,762,1438,676,88.71391076115485
Pune,Gram,2016,8426,9102,676,8.022786612864941
Manchar,Methi (Bhaji),2014,295,971,676,229.15254237288136
Sangamner,Onion,2016,257,933,676,263.0350194552529
Wardha,Pigeon Pea (Tur),2016,7715,8391,676,8.762151652624757
Satara,Flower,2014,1612,2288,676,41.935483870967744
Anajngaon Surji,Pigeon Pea (Tur),2015,6365,7041,676,10.620581304006285
Hinganghat,PIGEON PEA (TUR),2016,5165,5841,676,13.08809293320426
Majalgaon,Gram,2014,1964,2640,676,34.419551934826885
Karanja,Green Gram,2016,4503,5179,676,15.012214079502554
Shrirampur,Bitter Gourd,2014,1929,2605,676,35.044064282011405
Osmanabad,Flower,2016,900,1576,676,75.11111111111111
Baramati,Wheat(Husked),2015,1700,2375,675,39.705882352941174
Chandrapur,Awala,2016,1700,2375,675,39.705882352941174
Darwha,Pigeon Pea (Tur),2015,8040,8715,675,8.395522388059701
Pune,Elephant Root,2014,1425,2100,675,47.36842105263158
Patur,Green Gram,2015,5875,6550,675,11.48936170212766
Katol,Gram,2016,7118,7793,675,9.483000842933409
Osmanabad,Cucumber,2015,575,1250,675,117.3913043478261
Chalisgaon,Potato,2016,1163,1838,675,58.039552880481516
Pune-Manjri,Rajgira,2016,0,675,675,inf
Jalna,Gram,2014,2252,2927,675,29.97335701598579
Manchar,Green-Peas,2016,2688,3363,675,25.111607142857142
Jalgaon,Coriander (Dry),2016,7403,8078,675,9.117925165473457
Pune-Manjri,Chavli (Pala),2016,300,975,675,225.0
Koregaon,Potato,2016,415,1090,675,162.65060240963857
Amalner,Pigeon Pea (Tur),2016,6275,6950,675,10.756972111553784
Akole,Gram,2015,3300,3975,675,20.454545454545453
Baramati,Soybean,2015,3026,3701,675,22.306675479180438
Aurangabad,Bitter Gourd,2014,2605,3280,675,25.911708253358924
Pandharpur,Potato,2015,225,900,675,300.0
Solapur,Matki,2015,4550,5225,675,14.835164835164836
Ausa,Green Gram,2016,4403,5078,675,15.330456506927096
Shrirampur,Mango(Raw),2016,1475,2150,675,45.76271186440678
Mangaon(Bhadav),Nachani,2016,1325,2000,675,50.943396226415096
Pusad,BAJRI,2016,1445,2120,675,46.71280276816609
Sakri,SOYBEAN,2016,2567,3242,675,26.29528632645111
Mangrulpeer,Green Gram,2015,5827,6502,675,11.584005491676677
Balapur,Gram,2015,3275,3950,675,20.610687022900763
Balapur,Gram,2015,2650,3325,675,25.471698113207548
Palus,Capsicum,2016,2500,3175,675,27.0
Karad,Shevga,2014,2625,3300,675,25.714285714285715
Aurangabad,Ladies Finger,2015,1280,1955,675,52.734375
Barshi,Chikoo,2016,1200,1875,675,56.25
Kalyan,Ghevda,2016,4350,5025,675,15.517241379310345
Kille Dharur,WHEAT(HUSKED),2016,1850,2525,675,36.486486486486484
Pune-Manjri,Guava,2016,4490,5165,675,15.033407572383073
Khed (Shel Pimpalgaon),Cluster Bean,2015,1402,2077,675,48.14550641940085
Jalgaon Jamod-Aasalgaon,Gram,2016,7300,7975,675,9.246575342465754
Khed (Shel Pimpalgaon),Farshi,2015,1878,2553,675,35.94249201277955
Mumbai,Green Chilli,2015,2775,3450,675,24.324324324324323
Ratanagari,Brinjal,2016,915,1590,675,73.77049180327869
Barshi,Sorgum(Jawar),2016,1673,2348,675,40.346682606096834
Karanja,Green Gram,2015,6132,6807,675,11.007827788649706
Karad,Bor,2015,800,1475,675,84.375
Akluj,Tomato,2015,958,1633,675,70.45929018789144
Aurangabad,SHEVGA,2016,3250,3925,675,20.76923076923077
Dudhani,Sorgum(Jawar),2014,1094,1769,675,61.70018281535649
Amalner,Ground Nut Pods (Dry),2016,4120,4795,675,16.383495145631066
Pathardi,Gram,2014,2100,2775,675,32.142857142857146
Satara,Ginger (Fresh),2015,2525,3200,675,26.73267326732673
Pathardi,Pigeon Pea (Tur),2015,4900,5575,675,13.775510204081632
Mehkar,Gram,2015,3822,4497,675,17.660910518053374
Nashik,Cabbage,2015,1127,1802,675,59.89352262644188
Satara,Pavtta,2015,3725,4400,675,18.120805369127517
Jalgaon,Carrot,2014,1825,2500,675,36.986301369863014
Gangapur,Gram,2016,6184,6859,675,10.915265200517464
Sillod,Pigeon Pea (Tur),2016,6675,7350,675,10.112359550561798
Pune-Manjri,Shepu,2015,725,1400,675,93.10344827586206
Phaltan,Bajri,2014,1283,1958,675,52.61106780982073
Kalyan,Lemon,2016,1900,2575,675,35.526315789473685
Bhokar,Cotton,2016,4142,4817,675,16.296475132786092
Vadgaon Peth,Flower,2015,1008,1683,675,66.96428571428571
Sillod-Bharadi,Green Gram,2016,4575,5250,675,14.754098360655737
Buldhana,Gram,2015,2200,2875,675,30.681818181818183
Indapur-Bhigwan,Black Gram,2015,7400,8075,675,9.121621621621621
Lonand,Sorgum(Jawar),2015,1600,2275,675,42.1875
Phaltan,Wheat(Husked),2015,1450,2125,675,46.55172413793103
Ramtek,Pigen-Pea (Bhaji),2015,2450,3125,675,27.551020408163264
Pune,Bottle Gourd,2014,460,1135,675,146.7391304347826
Daryapur,Gram,2016,3710,4384,674,18.16711590296496
Kurdwadi-Modnimb,Onion,2016,83,757,674,812.0481927710844
Satara,Cluster Bean,2016,3674,4348,674,18.34512792596625
Jalna,Sorgum(Jawar),2015,1210,1884,674,55.70247933884298
Khed (Shel Pimpalgaon),Green Chilli,2014,2259,2933,674,29.836210712704737
Hingoli,Turmeric,2016,6690,7364,674,10.07473841554559
Shevgaon,Pigeon Pea (Tur),2016,7735,8409,674,8.713639301874595
Satara,Pavtta,2016,3326,4000,674,20.26458208057727
Varora,Pigeon Pea (Tur),2016,7986,8660,674,8.43976959679439
Satara,Bitter Gourd,2016,4348,5022,674,15.501379944802208
Parbhani,Pigeon Pea (Tur),2015,5261,5935,674,12.811252613571565
Manmad,Gram,2015,3421,4095,674,19.701841566793334
Sangli-Phale Bhajipalam,Potato,2016,713,1387,674,94.53015427769986
Mumbai,Spilt Gerrn Gram,2016,6196,6870,674,10.877985797288574
Aurangabad,Cucumber,2015,1313,1987,674,51.33282559025133
Purna,Ground Nut Pods (Dry),2014,3592,4266,674,18.76391982182628
Satara,Bitter Gourd,2015,3065,3739,674,21.99021207177814
Satara,Bitter Gourd,2016,4289,4963,674,15.714618792259268
Solapur,BLACK GRAM,2016,5892,6566,674,11.439239646978955
Wardha,Cotton,2016,4195,4868,673,16.04290822407628
Pune,Gr.Nut Kernels,2016,9069,9742,673,7.420884331238284
Patan,Ginger (Fresh),2016,2561,3234,673,26.278797344787193
Kille Dharur,Gram,2016,5539,6212,673,12.150207618703737
Kolhapur-Laxmipuri,Wheat(Husked),2016,2325,2998,673,28.946236559139784
Nashik,Raddish,2016,813,1486,673,82.77982779827798
Khed (Shel Pimpalgaon),Flower,2014,450,1123,673,149.55555555555554
Lasur Station,Gram,2015,3480,4153,673,19.339080459770116
Jalgaon,Tomato,2015,1044,1717,673,64.46360153256705
Lasalgaon-Niphad,Onion,2015,632,1305,673,106.4873417721519
Nashik,SHAHALE,2016,1745,2418,673,38.56733524355301
Dudhani,Gram,2016,6877,7550,673,9.786244001744947
Pune-Moshi,Brinjal,2016,1442,2115,673,46.67128987517337
Amarawati-Fruit And Vegetables,LEMON,2016,1485,2158,673,45.31986531986532
Satara,Capsicum,2016,3192,3865,673,21.083959899749374
Karad,Chikoo,2014,1414,2086,672,47.524752475247524
Amarawati,Onion,2015,1322,1994,672,50.832072617246595
Manmad,Gram,2014,2096,2768,672,32.06106870229008
Nandgaon,Ground Nut Pods (Dry),2015,5276,5948,672,12.736921910538287
Chikhali,Gram,2015,3793,4465,672,17.716846823095175
Satara,Green-Peas,2016,2160,2832,672,31.11111111111111
Mumbai,Lentil,2014,5028,5700,672,13.365155131264917
Kalyan,Cluster Bean,2016,3900,4572,672,17.23076923076923
Vadgaon Peth,TOMATO,2016,539,1211,672,124.67532467532467
Jalna,Mosambi,2016,1455,2127,672,46.18556701030928
Barshi,Squash Gourd,2016,922,1594,672,72.88503253796095
Mumbai,Brinjal,2016,616,1288,672,109.0909090909091
Junnar,Potato,2015,614,1286,672,109.44625407166124
Umared,Green Gram,2015,5314,5986,672,12.645841174256681
Kalyan,Orange,2015,1264,1936,672,53.164556962025316
Pandharkawada,Pigeon Pea (Tur),2016,7970,8642,672,8.431618569636136
Lasur Station,Green Gram,2015,6920,7592,672,9.710982658959537
Khed-Chakan,Capsicum,2016,1980,2652,672,33.93939393939394
Chandrapur-Ganjwad,Bitter Gourd,2015,1264,1936,672,53.164556962025316
Ulhasnagar,Sugarcane,2016,300,972,672,224.0
Solapur,Papai,2015,753,1425,672,89.24302788844622
Pimpalgaon Basawant,Onion,2016,373,1044,671,179.89276139410188
Kamthi,SMALL GOURD,2016,893,1564,671,75.13997760358343
Sengaon,Gram,2016,8252,8923,671,8.13136209403781
Ramtek,Onion,2015,3079,3750,671,21.792789866839883
Patan,Pavtta,2016,2836,3507,671,23.660084626234134
Chopda,Ground Nut Pods (Dry),2016,3727,4398,671,18.003756372417495
Kalyan,Green-Peas,2016,4853,5524,671,13.826499072738512
Umared,Gram,2016,5457,6128,671,12.29613340663368
Chandrapur,Papai,2015,729,1400,671,92.04389574759945
Lonar,Pigeon Pea (Tur),2014,4145,4816,671,16.188178528347407
Mumbai,Brinjal,2015,767,1438,671,87.48370273794002
Devala,Gram,2015,4265,4936,671,15.732708089097304
Pandharpur,Tomato,2015,218,889,671,307.79816513761466
Pandharpur,TOMATO,2016,215,886,671,312.09302325581393
Shahapur,Ridge Gourd,2016,3286,3957,671,20.419963481436398
Malegaon,Onion,2015,471,1142,671,142.46284501061572
Kalyan,Papai,2016,2329,3000,671,28.810648346930012
Shegaon,Gram,2016,6075,6746,671,11.045267489711934
Barshi,Pigeon Pea (Tur),2015,7491,8162,671,8.95741556534508
Satara,Ghevda,2015,2942,3613,671,22.807613868116928
Nagpur,Wal Bhaji,2016,1886,2557,671,35.5779427359491
Ahmedpur,Gram,2016,8079,8750,671,8.305483351899987
Pune,Wheat(Husked),2015,2086,2757,671,32.166826462128476
Varud-Rajura Bazar,Gram,2014,2238,2909,671,29.98212689901698
Aurangabad,Capsicum,2016,2533,3204,671,26.49032767469404
Pune-Pimpri,Ladies Finger,2016,2586,3257,671,25.94740912606342
Akluj,Brinjal,2015,1138,1808,670,58.87521968365554
Karad,Ghevda,2015,1930,2600,670,34.715025906735754
Nandura,Green Gram,2015,6740,7410,670,9.940652818991097
Indapur,Green Gram,2015,5110,5780,670,13.111545988258317
Barshi,Wheat(Husked),2015,1474,2144,670,45.45454545454545
Chandrapur-Ganjwad,Bitter Gourd,2016,1580,2250,670,42.40506329113924
Solapur,Chikoo,2015,527,1197,670,127.13472485768501
Karad,Pavata,2016,3805,4475,670,17.608409986859396
Khed-Chakan,Bottle Gourd,2016,1013,1683,670,66.14017769002962
Khamgaon,Sesamum,2016,5300,5970,670,12.641509433962264
Kundalwadi,Pigeon Pea (Tur),2015,7550,8220,670,8.874172185430464
Dondaicha,Green Gram,2016,4256,4926,670,15.742481203007518
Savner,Ground Nut Pods (Dry),2016,4101,4771,670,16.33747866374055
Nashik,Potato,2016,576,1246,670,116.31944444444444
Mumbai,Cluster Bean,2016,2400,3070,670,27.916666666666668
Risod,Green Gram,2015,7530,8200,670,8.897742363877821
Mangrulpeer,Soybean,2015,2995,3665,670,22.370617696160267
Satara,Cucumber,2016,1589,2259,670,42.16488357457521
Shahapur,Cluster Bean,2015,2560,3230,670,26.171875
Sailu,Sorgum(Jawar),2015,1140,1810,670,58.771929824561404
Akot,Gram,2015,4074,4744,670,16.44575355915562
Osmanabad,Cucumber,2016,568,1238,670,117.95774647887323
Jalna,Gram,2015,2413,3083,670,27.766266058847908
Jalna,Black Gram,2014,4116,4786,670,16.2779397473275
Manchar,Shepu,2015,834,1504,670,80.3357314148681
Osmanabad,CUCUMBER,2016,738,1408,670,90.78590785907859
Indapur-Bhigwan,Bajri,2016,1430,2100,670,46.85314685314685
Mumbai,Split Gram,2016,9413,10083,670,7.1178157866779985
Nashik,Bottle Gourd,2016,952,1622,670,70.3781512605042
Manchar,Ghevda,2016,1006,1675,669,66.50099403578528
Pune,Parwar,2015,2300,2969,669,29.08695652173913
Nagpur,Chikoo,2015,858,1527,669,77.97202797202797
Mangalwedha,Tomato,2015,154,823,669,434.4155844155844
Akola,Green Gram,2015,7314,7983,669,9.146841673502871
Mohol,Gram,2015,3825,4494,669,17.49019607843137
Mangrulpeer,SOYBEAN,2016,2339,3008,669,28.601966652415562
Osmanabad,Potato,2016,712,1381,669,93.96067415730337
Bhokar,Cotton,2016,4250,4919,669,15.741176470588234
Pune,Flower,2016,481,1150,669,139.0852390852391
Kille Dharur,Pigeon Pea (Tur),2014,3434,4103,669,19.48165404775772
Jalna,Gram,2016,6160,6829,669,10.86038961038961
Jamkhed,Sorgum(Jawar),2016,1613,2282,669,41.47551146931184
Hadgaon-Tamsa,Pigeon Pea (Tur),2016,8562,9231,669,7.813594954449895
Shahapur,Chavli (Shenga ),2015,2306,2975,669,29.011274934952297
Pathardi,Wheat(Husked),2016,1554,2223,669,43.05019305019305
Nashik,POTATO,2016,496,1165,669,134.8790322580645
Ratanagari,Capsicum,2014,3789,4458,669,17.65637371338084
Baramati,Sorgum(Jawar),2016,1640,2309,669,40.792682926829265
Katol,Gram,2015,3998,4667,669,16.73336668334167
Kurdwadi,Pigeon Pea (Tur),2014,3020,3688,668,22.119205298013245
Ramtek,CORIANDER ,2016,2027,2695,668,32.95510606808091
Shrirampur,Ladies Finger,2014,2377,3045,668,28.102650399663442
Pune,POTATO,2016,596,1264,668,112.08053691275168
Ramtek,Jack Fruit,2016,670,1338,668,99.70149253731343
Kalyan,Green Chilli,2016,2807,3475,668,23.797648735304595
Nagpur,Ginger (Fresh),2016,2000,2668,668,33.4
Umarga,Black Gram,2014,4772,5440,668,13.998323554065381
Pusad,Wheat(Husked),2016,1677,2345,668,39.83303518187239
Akola,Green Gram,2014,7312,7980,668,9.135667396061269
Kalyan,Ridge Gourd,2016,3172,3840,668,21.059268600252206
Gevrai,Sorgum(Jawar),2014,1500,2168,668,44.53333333333333
Nampur,Gram,2016,5307,5975,668,12.587149048426607
Gevrai,Wheat(Husked),2016,1605,2273,668,41.61993769470405
Jalgaon,Methi (Bhaji),2014,1282,1950,668,52.106084243369736
Chalisgaon,Pigeon Pea (Tur),2016,7071,7739,668,9.447037194173385
Solapur,Guava,2015,1368,2036,668,48.83040935672515
Nira,Sorgum(Jawar),2015,1600,2268,668,41.75
Nagpur,Mango,2015,1438,2106,668,46.453407510431155
Kalyan,Chikoo,2016,1700,2368,668,39.294117647058826
Barshi,Sorgum(Jawar),2015,1612,2280,668,41.43920595533499
Kalvan,Ground Nut Pods (Dry),2015,4157,4825,668,16.069280731296608
Paithan,Onion,2016,173,841,668,386.1271676300578
Aurangabad,Capsicum,2016,2152,2820,668,31.04089219330855
Karad,Green Chilli,2015,2433,3100,667,27.414714344430745
Yeola,Onion,2016,266,933,667,250.75187969924812
Sillod-Bharadi,Black Gram,2014,3500,4167,667,19.057142857142857
Ratanagari,Brinjal,2015,861,1528,667,77.46806039488966
Jalgaon Jamod-Aasalgaon,Green Gram,2015,6333,7000,667,10.532133270172114
Chalisgaon,Ground Nut Pods (Dry),2014,3500,4167,667,19.057142857142857
Amarawati,Chikoo,2015,1000,1667,667,66.7
Shrirampur,Garlic,2015,2500,3167,667,26.68
Shrirampur,Mosambi,2015,2375,3042,667,28.08421052631579
Ratanagari,Cluster Bean,2015,4000,4667,667,16.675
Ratanagari,Cluster Bean,2015,3000,3667,667,22.233333333333334
Kamthi,PUMPKIN,2016,833,1500,667,80.0720288115246
Ratanagari,Carrot,2014,2333,3000,667,28.58979854264895
Ahmednagar,Bottle Gourd,2015,300,967,667,222.33333333333334
Chandrapur-Ganjwad,Green-Peas,2016,1200,1867,667,55.583333333333336
Barshi,GREEN CHILLI,2016,944,1611,667,70.65677966101696
Manchar,Bitter Gourd,2014,1400,2067,667,47.642857142857146
Manchar,BEET ROOT,2016,233,900,667,286.26609442060084
Malkapur,Pigeon Pea (Tur),2014,4350,5017,667,15.333333333333334
Satara,Ghevda,2015,4333,5000,667,15.393491807062082
Satara,Ghevda,2015,3000,3667,667,22.233333333333334
Shrigonda,GRAM,2016,5700,6367,667,11.701754385964913
Satara,Ghevda,2015,2500,3167,667,26.68
Chandrapur-Ganjwad,Mango(Raw),2016,800,1467,667,83.375
Ratanagari,Green Chilli,2015,2889,3556,667,23.087573554863276
Satara,Pavtta,2015,3229,3896,667,20.65655001548467
Barshi,Pigeon Pea (Tur),2016,7081,7748,667,9.419573506566868
Dhule,Wheat(Husked),2015,1158,1825,667,57.5993091537133
Shrirampur,Green-Peas,2016,2833,3500,667,23.543946346629014
Shrirampur,Ladies Finger,2016,1979,2646,667,33.70389085396665
Washim,Sorgum(Jawar),2016,1127,1794,667,59.183673469387756
Lonar,Black Gram,2015,4833,5500,667,13.800951789778605
Kurdwadi,Pigeon Pea (Tur),2016,6100,6767,667,10.934426229508198
Pune-Manjri,Chavli (Pala),2014,350,1017,667,190.57142857142858
Karad,Green-Peas,2015,3333,4000,667,20.01200120012001
Shrirampur,Ground Nut Pods (Dry),2016,3500,4167,667,19.057142857142857
Chandrapur-Ganjwad,Chavli (Shenga ),2016,1000,1667,667,66.7
Vadgaon Peth,Bottle Gourd,2015,833,1500,667,80.0720288115246
Ratanagari,Bitter Gourd,2016,3500,4167,667,19.057142857142857
Paranda,Pigeon Pea (Tur),2016,6500,7167,667,10.261538461538462
Aurangabad,Fig,2014,1500,2167,667,44.46666666666667
Rahata,Green Peas (Dry),2016,3500,4167,667,19.057142857142857
Khed-Chakan,Chavli (Shenga ),2016,2250,2917,667,29.644444444444446
Mumbai,Ginger (Dry),2014,2948,3615,667,22.62550881953867
Mumbai,Gram,2014,3000,3667,667,22.233333333333334
Baramati,Sorgum(Jawar),2015,1558,2225,667,42.81129653401797
Jamkhed,Green Gram,2014,6500,7167,667,10.261538461538462
Pune-Pimpri,Ghosali(Bhaji),2016,3583,4250,667,18.615685180016747
Indapur (Nimgaon Ketki),Sorgum(Jawar),2015,1176,1843,667,56.71768707482993
Ratanagari,Snake Gourd,2015,2000,2667,667,33.35
Pune-Manjri,Mango(Raw),2015,1000,1667,667,66.7
Solapur,Guava,2016,1540,2207,667,43.311688311688314
Rahata,Capsicum,2016,3333,4000,667,20.01200120012001
Jalgaon,Green Gram,2015,7892,8559,667,8.45159655347187
Barshi,Black Gram,2015,5167,5834,667,12.908844590671569
Shahapur,Chavli (Shenga ),2015,1933,2600,667,34.50594930160373
Ahmednagar,Black Gram,2016,7700,8367,667,8.662337662337663
Ratanagari,Flower,2016,2139,2806,667,31.182795698924732
Vai,Ladies Finger,2014,3000,3667,667,22.233333333333334
Shrirampur,Pomegranate,2016,2357,3024,667,28.298684768773864
Kolhapur,Cabbage,2015,329,996,667,202.7355623100304
Osmanabad,Onion,2015,3500,4167,667,19.057142857142857
Achalpur,BLACK GRAM,2016,5000,5667,667,13.34
Khamgaon,Gram,2015,3805,4472,667,17.529566360052563
Shrirampur,Lemon,2014,3143,3810,667,21.221762647152403
Shirpur,Green Gram,2015,5808,6475,667,11.484159779614325
Kalyan,Cluster Bean,2016,3533,4200,667,18.879139541466177
Satara,Green Chilli,2015,2452,3119,667,27.202283849918434
Kolhapur,Small Gourd,2015,1000,1667,667,66.7
Ghansawangi,Soybean,2015,3300,3967,667,20.21212121212121
Rahata,Garlic,2014,2333,3000,667,28.58979854264895
Ahmednagar,Sorgum(Jawar),2016,1653,2320,667,40.35087719298246
Ratanagari,Bottle Gourd,2014,1167,1833,666,57.0694087403599
Daryapur,Soybean,2016,2869,3535,666,23.21366329731614
Satara,Tomato,2016,1646,2312,666,40.46172539489672
Ramtek,Elephant Root,2015,1667,2333,666,39.95200959808039
Kannad,Gram,2016,7667,8333,666,8.68657884439807
Pune-Manjri,Bottle Gourd,2014,756,1422,666,88.0952380952381
Vai,Green-Peas,2015,4667,5333,666,14.27040925648168
Chopda,Green Gram,2016,4165,4831,666,15.990396158463385
Khamgaon,Black Gram,2014,4766,5432,666,13.973982375157364
Patan,Bitter Gourd,2016,3167,3833,666,21.029365329965266
Ahmednagar,Potato,2016,1117,1783,666,59.623992837958816
Amarawati,Soybean,2015,3013,3679,666,22.1042150680385
Patan,Bitter Gourd,2016,3167,3833,666,21.029365329965266
Kamthi,Pumpkin,2015,478,1144,666,139.3305439330544
Buldhana,Pigeon Pea (Tur),2016,5267,5933,666,12.64476931839757
Ratanagari,Ghevda,2015,2667,3333,666,24.9718785151856
Pune,Tamarind,2015,3792,4458,666,17.563291139240505
Shrirampur,Garlic,2014,2667,3333,666,24.9718785151856
Amarawati,Green Chilli,2016,4667,5333,666,14.27040925648168
Kalyan,Jaggery,2016,3667,4333,666,18.161985274065994
Junnar (Narayangaon),Tomato,2014,1627,2293,666,40.93423478795329
Satara,Brinjal,2014,1778,2444,666,37.457817772778405
Pune-Pimpri,Ghosali(Bhaji),2015,2167,2833,666,30.733733271804336
Jalgaon,Flower,2015,1034,1700,666,64.4100580270793
Kej,Soybean,2016,3341,4007,666,19.93415145166118
Parshiwani,Other Vegetables,2016,2167,2833,666,30.733733271804336
Telhara,Pigeon Pea (Tur),2016,7288,7954,666,9.138309549945115
Nandgaon,Onion,2016,220,886,666,302.72727272727275
Karad,Bitter Gourd,2016,4029,4695,666,16.530156366344006
Mantha,Pigeon Pea (Tur),2016,8096,8762,666,8.226284584980236
Shrirampur,Orange,2015,1167,1833,666,57.0694087403599
Jalgaon,Chavli (Shenga ),2015,3667,4333,666,18.161985274065994
Mangalwedha,Gram,2016,3557,4223,666,18.723643519820072
Kalvan,Onion,2016,290,956,666,229.6551724137931
Vai,Ridge Gourd,2014,2778,3444,666,23.974082073434126
Kalyan,Shevga,2015,3667,4333,666,18.161985274065994
Rahata,Cucumber,2014,1578,2244,666,42.20532319391635
Chandrapur-Ganjwad,Chavli (Shenga ),2016,1667,2333,666,39.95200959808039
Kamthi,Pumpkin,2016,467,1133,666,142.61241970021413
Ratanagari,French Bean,2015,3167,3833,666,21.029365329965266
Kalamb (Os),Soybean,2015,3109,3774,665,21.389514313284014
Jalgaon,Onion,2015,511,1176,665,130.13698630136986
Mangrulpeer,Wheat(Husked),2015,1195,1860,665,55.64853556485355
Nandgaon,Sorgum(Jawar),2016,1267,1932,665,52.48618784530387
Daryapur,Pigeon Pea (Tur),2014,4790,5455,665,13.883089770354905
Kalvan,Onion,2016,279,944,665,238.35125448028674
Telhara,Green Gram,2015,8050,8715,665,8.26086956521739
Akola,Pigeon Pea (Tur),2016,6164,6829,665,10.788449059052564
Patan,Brinjal,2016,2379,3044,665,27.952921395544347
Gevrai,Pigeon Pea (Tur),2016,7616,8281,665,8.731617647058824
Lasur Station,Sorgum(Jawar),2016,1608,2273,665,41.35572139303483
Mehkar,Gram,2015,2433,3098,665,27.332511302918206
Akot,Pigeon Pea (Tur),2016,8393,9058,665,7.923269391159299
Chalisgaon,Pigeon Pea (Tur),2015,4506,5171,665,14.758100310696848
Jamkhed,Sorgum(Jawar),2016,1612,2277,665,41.2531017369727
Gevrai,Wheat(Husked),2016,1597,2262,665,41.64057608015028
Nandurbar,Green Gram,2015,7212,7877,665,9.220743205768164
Shahada,Soybean,2015,3054,3719,665,21.77472167648985
Manwat,Pigeon Pea (Tur),2016,7846,8510,664,8.462911037471322
Sangli-Phale Bhajipalam,Papai,2016,208,872,664,319.2307692307692
Pandharpur,Cabbage,2015,341,1005,664,194.72140762463343
Pune-Manjri,Flower,2015,1229,1893,664,54.02766476810415
Ratanagari,Cluster Bean,2015,1893,2557,664,35.076597992604334
Kalyan,MOSAMBI,2016,3336,4000,664,19.904076738609113
Ulhasnagar,Sorgum(Jawar),2016,1829,2493,664,36.3039912520503
Umarga,Pigeon Pea (Tur),2016,7645,8309,664,8.68541530412034
Lonar,Green Gram,2014,6226,6890,664,10.664953421137167
Barshi,Black Gram,2014,4750,5414,664,13.978947368421053
Ratanagari,Tomato,2016,586,1250,664,113.31058020477816
Mohol,Sorgum(Jawar),2015,1686,2350,664,39.383155397390276
Barshi-Vairag,Sorgum(Jawar),2016,1680,2344,664,39.523809523809526
Kalyan,Mosambi,2016,1800,2464,664,36.888888888888886
Karad,Green Chilli,2016,2828,3492,664,23.47949080622348
Sangamner,Tomato,2016,531,1195,664,125.04708097928437
Kolhapur,Bottle Gourd,2015,324,988,664,204.93827160493828
Yeotmal,Ground Nut Pods (Dry),2016,3946,4610,664,16.827166751140396
Nagpur,Coriander  ,2016,1718,2382,664,38.64959254947613
Mumbai,Bitter Gourd,2016,2752,3416,664,24.127906976744185
Kille Dharur,Wheat(Husked),2016,2419,3083,664,27.449359239355104
Karad,Green Chilli,2014,2464,3127,663,26.907467532467532
Akkolkot,Black Gram,2015,8755,9418,663,7.572815533980583
Solapur,Mosambi,2015,200,863,663,331.5
Nashik,Shahale ,2016,1906,2569,663,34.78488982161595
Bhokar,Turmeric,2016,7662,8325,663,8.6530931871574
Ausa,Pigeon Pea (Tur),2015,6614,7277,663,10.02419110976716
Pune-Pimpri,Ghosali(Bhaji),2015,2875,3538,663,23.06086956521739
Kamthi,Onion,2016,656,1319,663,101.0670731707317
Pune-Moshi,Squash Gourd,2016,2030,2693,663,32.66009852216749
Gevrai,Wheat(Husked),2015,1533,2196,663,43.24853228962818
Mumbai,Green Chilli,2016,7152,7815,663,9.270134228187919
Pune-Pimpri,Ladies Finger,2016,1857,2520,663,35.70274636510501
Solapur,Green Peas (Dry),2016,3850,4513,663,17.22077922077922
Pimpalgaon (B)-Saykheda,Onion,2016,206,869,663,321.84466019417476
Ratanagari,Tomato,2015,1316,1979,663,50.379939209726444
Mukhed,Pigeon Pea (Tur),2015,8393,9056,663,7.8994400095317525
Ashti-Karanja,Soybean,2016,3096,3759,663,21.414728682170544
Kopargaon,Green Gram,2015,7225,7888,663,9.176470588235293
Parner,Onion,2016,308,971,663,215.25974025974025
Phaltan,Bajri,2015,1275,1938,663,52.0
Khed-Chakan,Brinjal,2016,2944,3607,663,22.52038043478261
Nandgaon,Onion,2016,323,986,663,205.26315789473685
Chandur Bajar,Soybean,2015,3186,3849,663,20.80979284369115
Jalgaon,Potato,2016,1002,1665,663,66.16766467065868
Bhokar,Pigeon Pea (Tur),2015,8093,8755,662,8.17990856295564
Shahapur,Bitter Gourd,2015,4063,4725,662,16.293379276396752
Jalna,Pigeon Pea (Tur),2014,4216,4878,662,15.702087286527513
Parli-Vaijnath,Pigeon Pea (Tur),2015,8313,8975,662,7.9634307710814385
Nagpur,Math (Bhaji),2015,3192,3854,662,20.739348370927317
Pune,Pumpkin,2016,617,1279,662,107.29335494327391
Bhokardan,Gram,2016,4938,5600,662,13.406237343053869
Devala,Gram,2016,3813,4475,662,17.36165748754262
Karad,Ginger (Fresh),2015,2063,2725,662,32.0891904992729
Sangali,Lentil,2016,6115,6777,662,10.825838103025347
Chandrapur-Ganjwad,Onion,2015,1814,2476,662,36.49393605292172
Ratanagari,Capsicum,2016,1515,2177,662,43.696369636963695
Karad,Cucumber,2015,1563,2225,662,42.35444657709533
Yawal,Ground Nut Pods (Dry),2016,4563,5225,662,14.507999123383739
Lohara,Gram,2016,3646,4308,662,18.156884256719692
Barshi,Onion,2016,88,750,662,752.2727272727273
Pulgaon,Pigeon Pea (Tur),2016,7457,8119,662,8.87756470430468
Sangrampur,Soybean,2014,2600,3262,662,25.46153846153846
Lasalgaon,Bajri,2016,1326,1987,661,49.84917043740573
Chandrapur-Ganjwad,Cabbage,2016,1011,1672,661,65.38081107814045
Jalgaon,Methi (Bhaji),2015,518,1179,661,127.60617760617761
Dondaicha,Matki,2015,6576,7237,661,10.05170316301703
Dondaicha,Green Gram,2014,7659,8320,661,8.630369499934718
Amalner,Green Gram,2015,7600,8261,661,8.697368421052632
Dhule,Soybean,2016,2967,3628,661,22.278395685877992
Khamgaon,Black Gram,2015,6960,7621,661,9.49712643678161
Satara,Flower,2015,1587,2248,661,41.650913673597984
Dound,Lemon,2016,500,1161,661,132.2
Kalamb (Os),Gram,2014,2043,2704,661,32.35438081253059
Alibag,Betelnuts,2016,1240,1901,661,53.306451612903224
Amalner,Green Gram,2016,4442,5103,661,14.880684376407023
Bhandara,Gram,2015,4586,5247,661,14.413432184910597
Umared,Soybean,2015,3082,3743,661,21.447112264763142
Kalyan,Cluster Bean,2015,2180,2840,660,30.275229357798164
Nira-Saswad,Pigeon Pea (Tur),2016,5220,5880,660,12.64367816091954
Junnar,Onion,2016,557,1217,660,118.49192100538599
Wardha,Pigeon Pea (Tur),2016,6273,6933,660,10.52128168340507
Barshi-Vairag,Ground Nut Pods (Dry),2014,2902,3562,660,22.742935906271537
Lasur Station,Wheat(Husked),2015,1309,1969,660,50.42016806722689
Akole,Wheat(Husked),2016,1500,2160,660,44.0
Chandrapur-Ganjwad,Onion,2014,1495,2155,660,44.147157190635454
Vadgaon Peth,Cucumber,2014,740,1400,660,89.1891891891892
Katol,Soybean,2016,3059,3719,660,21.575678326250408
Pune-Manjri,Chavli (Shenga ),2016,2470,3130,660,26.720647773279353
Pune,Flower,2014,535,1195,660,123.3644859813084
Nira-Saswad,Wheat(Husked),2015,1580,2240,660,41.77215189873418
Ahmedpur,SOYBEAN,2016,2171,2831,660,30.400736987563334
Pune-Manjri,Chavli (Pala),2015,780,1440,660,84.61538461538461
Arvi,Pigeon Pea (Tur),2015,6670,7330,660,9.89505247376312
Aurangabad,Bitter Gourd,2016,2830,3490,660,23.32155477031802
Shrirampur,Gram,2015,2687,3347,660,24.562709341272797
Latur,Sunflower,2015,3308,3968,660,19.951632406287786
Nashik,Green-Peas,2016,1843,2503,660,35.81117742810635
Shrirampur,Bitter Gourd,2016,3300,3960,660,20.0
Jalgaon,Cucumber,2015,1107,1767,660,59.62059620596206
Sonpeth,Soybean,2016,2220,2880,660,29.72972972972973
Kolhapur-Malkapur,Capsicum,2016,620,1280,660,106.45161290322581
Kalamb (Os),Wheat(Husked),2016,2000,2660,660,33.0
Mumbai,French Bean,2016,1045,1705,660,63.1578947368421
Pune,Beet Root,2014,640,1300,660,103.125
Bhivandi,Onion,2015,1570,2230,660,42.038216560509554
Rahuri,Cucumber,2016,160,820,660,412.5
Sailu,SOYBEAN,2016,2138,2798,660,30.86997193638915
Navapur,Flower,2016,1340,2000,660,49.25373134328358
Pune,Bottle Gourd,2015,455,1115,660,145.05494505494505
Aurangabad,Guava,2014,1300,1960,660,50.76923076923077
Shahapur,Brinjal,2016,1860,2520,660,35.483870967741936
Kolhapur,Potato,2015,805,1465,660,81.98757763975155
Pune-Manjri,Flower,2015,800,1460,660,82.5
Chandur Rly.,Pigeon Pea (Tur),2015,5180,5840,660,12.741312741312742
Shirur,Tamarind,2016,2205,2864,659,29.886621315192745
Akluj,Brinjal,2015,929,1588,659,70.93649085037674
Kalmeshwar,Pigeon Pea (Tur),2016,7445,8104,659,8.851578240429818
Manchar,Onion,2016,425,1084,659,155.05882352941177
Parner,Onion,2016,300,959,659,219.66666666666666
Ghatanji,Pigeon Pea (Tur),2016,7421,8080,659,8.88020482414769
Akola,Black Gram,2015,7281,7940,659,9.050954539211647
Lasalgaon,Gram,2015,2503,3162,659,26.328405912904515
Khed (Shel Pimpalgaon),Farshi,2014,1680,2339,659,39.226190476190474
Partur,Pigeon Pea (Tur),2016,5658,6317,659,11.647225167903853
Pandharpur,Cabbage,2015,553,1212,659,119.16817359855335
Jalgaon,Cluster Bean,2015,2533,3192,659,26.016581129095933
Malegaon,Pigeon Pea (Tur),2016,7011,7670,659,9.399515047782057
Malegaon,Green Gram,2015,8057,8716,659,8.17922303586943
Chandvad,Onion,2016,198,857,659,332.82828282828285
Pimpalgaon (B)-Saykheda,ONION,2016,227,886,659,290.3083700440529
Mangrulpeer,Gram,2015,3505,4164,659,18.801711840228247
Mumbai,Split Gram,2016,6283,6942,659,10.488620085946204
Nandgaon,Onion,2016,164,823,659,401.8292682926829
Udgir,Pigeon Pea (Tur),2014,4544,5203,659,14.502640845070422
Kamthi,Kand,2016,594,1253,659,110.94276094276094
Shirpur,Soybean,2016,2657,3316,659,24.80240873165224
Pandharpur,Math (Bhaji),2015,397,1056,659,165.99496221662469
Jalgaon,Orange,2015,653,1312,659,100.9188361408882
Satara,Carrot,2014,1333,1992,659,49.437359339834956
Sakri,Ground Nut Pods (Dry),2014,2891,3550,659,22.79488066413006
Aurangabad,Green Chilli,2016,2991,3650,659,22.032764961551322
Mumbai-Fruit Market,Orange,2016,1432,2091,659,46.0195530726257
Shrirampur,Green-Peas,2016,2342,3000,658,28.095644748078566
Nashik,Shepu,2016,545,1203,658,120.73394495412845
Pune-Manjri,Flower,2015,900,1558,658,73.11111111111111
Ahmedpur,Green Gram,2015,7231,7889,658,9.09970958373669
Chandrapur,Banana,2016,552,1210,658,119.20289855072464
Jalgaon,Orange,2014,725,1383,658,90.75862068965517
Pune-Manjri,Bottle Gourd,2015,795,1453,658,82.76729559748428
Kamthi,Cucumber,2016,627,1285,658,104.94417862838915
Murum,Black Gram,2014,5068,5726,658,12.98342541436464
Amarawati,Sesamum,2016,5966,6624,658,11.029165269862554
Manora,Black Gram,2016,6585,7243,658,9.992406985573272
Khed-Chakan,Capsicum,2016,1167,1825,658,56.38389031705227
Udgir,Black Gram,2015,10921,11579,658,6.025089277538687
Kada (Ashti),Sorgum(Jawar),2016,1614,2272,658,40.76827757125155
Shegaon,Pigeon Pea (Tur),2016,7565,8223,658,8.697951090548578
Shirpur,Gram,2015,4038,4696,658,16.295195641406636
Khamgaon,Black Gram,2016,5342,6000,658,12.317484088356421
Sindi (Selu),Cotton,2015,3679,4337,658,17.88529491709704
Satara,Ginger (Fresh),2014,2671,3329,658,24.634968176712842
Gevrai,Wheat(Husked),2015,1475,2133,658,44.610169491525426
Kamthi,Squash Gourd,2016,800,1457,657,82.125
Pune-Manjri,Tomato,2015,864,1521,657,76.04166666666667
Karad,Tomato,2015,1329,1986,657,49.43566591422122
Murum,Pigeon Pea (Tur),2016,8365,9022,657,7.85415421398685
Ashti-Karanja,Pigeon Pea (Tur),2016,7781,8438,657,8.443644775735766
Barshi,Green Gram,2014,6329,6986,657,10.380786854163375
Malkapur,Green Gram,2015,6502,7159,657,10.104583205167641
Mehkar,Green Gram,2015,6013,6670,657,10.926326293031764
Vani,Pigeon Pea (Tur),2015,4815,5472,657,13.644859813084112
Shahapur,Bitter Gourd,2015,2114,2771,657,31.078524124881742
Varud-Rajura Bazar,Gram,2015,4056,4713,657,16.198224852071007
Mangrulpeer,Soybean,2014,2682,3339,657,24.496644295302012
Parli-Vaijnath,Pigeon Pea (Tur),2015,5860,6517,657,11.211604095563139
Dhule,Pigeon Pea (Tur),2015,4674,5331,657,14.056482670089858
Chikhali,Gram,2015,3637,4294,657,18.064338740720373
Pathardi,Onion,2016,200,857,657,328.5
Jalgaon,Wal Papdi,2016,1124,1781,657,58.45195729537367
Umared,Wheat(Husked),2015,1500,2157,657,43.8
Kolhapur-Laxmipuri,Spilt Pigeon Pea,2016,10900,11557,657,6.027522935779817
Pandharpur,Cabbage,2015,425,1082,657,154.58823529411765
Dudhani,Pigeon Pea (Tur),2015,5717,6374,657,11.492041280391813
Hingoli,Black Gram,2016,6507,7164,657,10.096818810511756
Pimpalgaon (B)-Saykheda,Onion,2016,218,874,656,300.91743119266056
Kalyan,Cluster Bean,2015,2994,3650,656,21.910487641950567
Kada,Gram,2015,3632,4288,656,18.061674008810574
Lonar,Black Gram,2015,6539,7195,656,10.03211500229393
Mumbai,Shevga,2015,2800,3456,656,23.428571428571427
Mumbai,Bitter Gourd,2016,3048,3704,656,21.522309711286088
Jalgaon,Cabbage,2015,961,1617,656,68.26222684703434
Nandgaon Khandeshwar,Soybean,2016,2933,3589,656,22.36617797476986
Karad,Potato,2016,770,1426,656,85.1948051948052
Morshi,Pigeon Pea (Tur),2016,7455,8111,656,8.799463447350771
Shegaon,Soybean,2016,3147,3803,656,20.845249443914838
Shrirampur,Orange,2016,1438,2094,656,45.618915159944365
Aurangabad,Bor,2016,869,1525,656,75.48906789413118
Achalpur,Gram,2016,7113,7769,656,9.222550260087164
Partur,Sorgum(Jawar),2015,1128,1784,656,58.156028368794324
Ambad(Vadi Godri),Pigeon Pea (Tur),2016,7780,8436,656,8.431876606683804
Shahapur,Ladies Finger,2016,3496,4152,656,18.76430205949657
Nagpur,Orange,2015,284,940,656,230.98591549295776
Jalgaon,Cucumber,2016,1208,1864,656,54.3046357615894
Ashti-Karanja,Soybean,2016,3037,3693,656,21.60026341784656
Kolhapur,Ghevda,2016,1288,1944,656,50.93167701863354
Kolhapur-Laxmipuri,Green Gram,2016,8404,9060,656,7.80580675868634
Jalgaon,Potato,2016,757,1413,656,86.65785997357992
Khed-Chakan,Sweet Potato,2016,978,1633,655,66.97341513292433
Malkapur,Soybean,2015,3209,3864,655,20.411343097538175
Akluj,POTATO,2016,886,1541,655,73.92776523702031
Jalgaon,Tomato,2015,725,1380,655,90.34482758620689
Aurangabad,Shevga,2015,1756,2411,655,37.300683371298405
Jalgaon,Brinjal,2015,761,1416,655,86.07095926412615
Pune,Tomato,2015,415,1070,655,157.83132530120483
Vaduj,Gram,2016,5667,6322,655,11.558143638609494
Kej,Pigeon Pea (Tur),2016,5778,6433,655,11.336102457597784
Karad,Pavata,2014,2109,2764,655,31.05737316263632
Mangalwedha,Sorgum(Jawar),2015,1149,1804,655,57.00609225413403
Ambad(Vadi Godri),Pigeon Pea (Tur),2015,5080,5735,655,12.893700787401574
Dhule,Castor Seed,2015,2650,3305,655,24.71698113207547
Tumsar,Other Pulses,2015,2219,2874,655,29.517800811176205
Aurangabad,Cluster Bean,2015,1600,2255,655,40.9375
Indapur-Bhigwan,Bajri,2016,1525,2180,655,42.950819672131146
Akluj,Brinjal,2015,956,1611,655,68.51464435146444
Shahapur,Bitter Gourd,2015,1209,1864,655,54.17700578990902
Jamner,Cotton,2016,4174,4829,655,15.692381408720651
Majalgaon,Pigeon Pea (Tur),2016,8305,8960,655,7.886815171583383
Barshi,Gram,2014,2198,2853,655,29.799818016378527
Sangali,Soybean,2015,3375,4030,655,19.40740740740741
Amarawati,Green Gram,2015,6408,7062,654,10.205992509363297
Chikhali,Green Gram,2016,4239,4893,654,15.42816702052371
Ulhasnagar,Potato,2016,1750,2404,654,37.371428571428574
Taloda,Black Gram,2015,2865,3519,654,22.827225130890053
Jalgaon,Coriander (Dry),2015,9975,10629,654,6.556390977443609
Vai,Ladies Finger,2016,3000,3654,654,21.8
Lasur Station,Onion,2016,219,873,654,298.63013698630135
Ratanagari,Green-Peas,2016,3654,4308,654,17.898193760262725
Pune,Elephant Root,2015,1482,2136,654,44.12955465587044
Vai,RIDGE GOURD,2016,2192,2846,654,29.835766423357665
Umared,Coriander (Dry),2015,6957,7611,654,9.40060370849504
Mumbai,Potato,2016,1073,1727,654,60.950605778191985
Nagpur,Brinjal,2015,1021,1675,654,64.05484818805093
Pune-Pimpri,Ghevda,2014,2619,3273,654,24.971363115693013
Kurdwadi-Modnimb,Wheat(Husked),2015,1430,2084,654,45.73426573426573
Nashik,Guava,2014,764,1418,654,85.6020942408377
Pune-Manjri,Bottle Gourd,2016,1215,1869,654,53.82716049382716
Indapur (Nimgaon Ketki),Wheat(Husked),2016,1553,2207,654,42.11204121056021
Dudhani,Gram,2016,4061,4715,654,16.104407781334647
Satara,Cluster Bean,2016,2558,3212,654,25.566849100860047
Aurangabad,Tomato,2015,761,1415,654,85.9395532194481
Nira-Saswad,Bajri,2016,1573,2226,653,41.51303242212333
Pathari,Bajri,2016,979,1632,653,66.70071501532176
Pusad,Pigeon Pea (Tur),2016,8481,9134,653,7.699563730692136
Kalyan,Onion,2015,3835,4488,653,17.027379400260756
Kamthi,Raddish,2015,763,1416,653,85.5832241153342
Jalgaon,Wal Papdi,2015,1129,1782,653,57.83879539415412
Satara,Shevga,2016,1043,1696,653,62.607861936720994
Pachora,Pigeon Pea (Tur),2016,6964,7617,653,9.376794945433659
Parner,Onion,2016,171,824,653,381.87134502923976
Mangalwedha,Sorgum(Jawar),2016,1721,2374,653,37.943056362579895
Hingoli,Pigeon Pea (Tur),2016,6144,6797,653,10.628255208333334
Shegaon,Green Gram,2015,7128,7781,653,9.161054994388328
Shegaon,Pigeon Pea (Tur),2016,5562,6215,653,11.740381157856886
Solapur,Wheat(Husked),2015,2153,2806,653,30.329772410589875
Latur,Gram,2014,2275,2928,653,28.703296703296704
Pandharpur,Tomato,2016,185,838,653,352.97297297297297
Shegaon,Black Gram,2016,7458,8111,653,8.755698578707428
Akluj,Bor,2015,882,1535,653,74.03628117913833
Dondaicha-Sindkheda,Ground Nut Pods (Dry),2016,4285,4938,653,15.239206534422404
Barshi,Black Gram,2016,6929,7582,653,9.4241593303507
Ramtek,Flower,2016,2358,3011,653,27.692960135708226
Dound,Sorgum(Jawar),2014,1743,2395,652,37.40676993689042
Bhivandi,Rice(Paddy-Hus),2014,1467,2119,652,44.44444444444444
Satara,PAVTTA,2016,2978,3630,652,21.893888515782404
Lasur Station,Gram,2015,2804,3456,652,23.25249643366619
Gevrai,Sorgum(Jawar),2015,1602,2254,652,40.69912609238452
Jalgaon,Brinjal,2015,716,1368,652,91.06145251396649
Ausa,Sunflower,2016,3394,4046,652,19.210371243370655
Yeotmal,Pigeon Pea (Tur),2016,5210,5862,652,12.514395393474087
Jalgaon,Ladies Finger,2016,681,1333,652,95.74155653450808
Devala,Gram,2014,2793,3445,652,23.34407447189402
Mumbai,French Bean,2016,2674,3326,652,24.3829468960359
Pune-Manjri,CHAVLI (SHENGA ),2016,1844,2496,652,35.35791757049891
Satara,Shevga,2016,2184,2836,652,29.853479853479854
Nira-Saswad,Wheat(Husked),2016,1560,2212,652,41.794871794871796
Chandrapur-Ganjwad,Flower,2016,778,1430,652,83.80462724935732
Shirur,Green Gram,2016,4294,4946,652,15.183977643223102
Nagpur,Spinach,2016,1984,2636,652,32.86290322580645
Lasalgaon,Ground Nut Pods (Dry),2014,2667,3318,651,24.409448818897637
Nandurbar,Sunflower,2015,3931,4582,651,16.560671584838463
Akluj,CARROT,2016,900,1551,651,72.33333333333333
Gevrai,Wheat(Husked),2015,1578,2229,651,41.254752851711025
Indapur-Bhigwan,Pigeon Pea (Tur),2016,6000,6651,651,10.85
Gangakhed,Cotton,2016,4100,4751,651,15.878048780487806
Washim,Green Gram,2015,6578,7229,651,9.896625114016418
Sinner,Gram,2015,2612,3263,651,24.92343032159265
Sillod-Bharadi,Pigeon Pea (Tur),2015,4900,5551,651,13.285714285714286
Malegaon,Green Gram,2015,7380,8031,651,8.821138211382113
Kada (Ashti),Sorgum(Jawar),2016,1600,2251,651,40.6875
Sinner,Black Gram,2015,5000,5651,651,13.02
Baramati,Soybean,2015,2500,3151,651,26.04
Nira-Saswad,Bajri,2016,1525,2175,650,42.622950819672134
Karad,Sweet Potato,2014,1350,2000,650,48.148148148148145
Sindi,Soybean,2015,2920,3570,650,22.26027397260274
Ramtek,GRAM,2016,6550,7200,650,9.923664122137405
Karad,Pavata,2015,1480,2130,650,43.91891891891892
Lonand,SORGUM(JAWAR),2016,1650,2300,650,39.39393939393939
Bhusaval,Green Gram,2014,4440,5090,650,14.63963963963964
Ghansawangi,Green Gram,2015,7300,7950,650,8.904109589041095
Akole,Bhagar/Vari,2016,2550,3200,650,25.49019607843137
Katol,Soybean,2015,3019,3669,650,21.530308049022857
Pusad,Gram,2014,2065,2715,650,31.476997578692494
Ratanagari,BITTER GOURD,2016,1450,2100,650,44.827586206896555
Akkalkuwa,Gram,2015,2800,3450,650,23.214285714285715
Mantha,Wheat(Husked),2016,1388,2038,650,46.829971181556196
Sindi (Selu),Soybean,2015,3000,3650,650,21.666666666666668
Nashik,Melon,2016,450,1100,650,144.44444444444446
Nagpur,Paddy-Unhusked,2014,1448,2098,650,44.889502762430936
Patan,Ghevda,2015,2575,3225,650,25.24271844660194
Manchar,Flower,2016,150,800,650,433.3333333333333
Pune,Dhemse,2014,1250,1900,650,52.0
Pune-Moshi,CAPSICUM,2016,1357,2007,650,47.899778924097276
Yeotmal,Gram,2016,6951,7601,650,9.351172493166452
Murbad,Cabbage,2016,2600,3250,650,25.0
Ratanagari,Cluster Bean,2016,2100,2750,650,30.952380952380953
Shrigonda,Onion,2016,150,800,650,433.3333333333333
Udgir,Gram,2014,2320,2970,650,28.017241379310345
Jalgaon Jamod,Ground Nut Pods (Dry),2016,4400,5050,650,14.772727272727273
Kej,Pigeon Pea (Tur),2015,5784,6434,650,11.23789764868603
Varud-Rajura Bazar,Soybean,2015,3003,3653,650,21.645021645021647
Karanja,Green Gram,2016,4549,5199,650,14.288854693339195
Vadgaon Peth,Potato,2015,850,1500,650,76.47058823529412
Kalvan,Onion,2016,218,868,650,298.1651376146789
Kolhapur,Awala,2015,1500,2150,650,43.333333333333336
Lasalgaon,Bajri,2016,1384,2034,650,46.96531791907515
Aurangabad,Chikoo,2015,1767,2417,650,36.78551216751556
Jalgaon,Cabbage,2016,827,1477,650,78.59733978234583
Pathardi,Gram,2015,3850,4500,650,16.883116883116884
Ratanagari,Ladies Finger,2015,1806,2456,650,35.991140642303435
Rahata,Capsicum,2016,1650,2300,650,39.39393939393939
Pune,Dhemse,2015,1000,1650,650,65.0
Amarawati,Mosambi,2015,800,1450,650,81.25
Manchar,Wal Papdi,2016,683,1333,650,95.1683748169839
Kada,Green Gram,2014,7500,8150,650,8.666666666666666
Paithan,Onion,2016,150,800,650,433.3333333333333
Umared,Wheat(Husked),2016,1600,2250,650,40.625
Jalgaon Jamod,Green Gram,2016,4250,4900,650,15.294117647058824
Lasur Station,Onion,2016,180,830,650,361.1111111111111
Buldhana,Sorgum(Jawar),2014,1150,1800,650,56.52173913043478
Solapur,Green Peas (Dry),2015,2975,3625,650,21.84873949579832
Aarni,Pigeon Pea (Tur),2015,5500,6150,650,11.818181818181818
Kalvan,GREEN GRAM,2016,4450,5100,650,14.606741573033707
Gevrai,Matki,2015,7000,7650,650,9.285714285714286
Kamthi,LEMON,2016,813,1463,650,79.95079950799509
Mumbai,French Bean,2016,2175,2825,650,29.885057471264368
Malkapur,Onion,2015,619,1269,650,105.0080775444265
Ghoti,Brinjal,2014,1092,1742,650,59.523809523809526
Anajngaon Surji,Gram,2015,3239,3889,650,20.067922198209324
Chandur Bajar,Gram,2016,3780,4430,650,17.195767195767196
Pune,Potato,2014,2004,2654,650,32.43512974051896
Karad,Cluster Bean,2015,2250,2900,650,28.88888888888889
Aurangabad,Dhemse,2016,900,1550,650,72.22222222222223
Pune-Manjri,Pavtta,2016,2100,2750,650,30.952380952380953
Nashik,Shepu,2015,350,1000,650,185.71428571428572
Kalyan,Jaggery,2015,2888,3538,650,22.506925207756233
Sangrampur,Soybean,2015,2560,3210,650,25.390625
Lasur Station,Sorgum(Jawar),2014,1275,1925,650,50.98039215686274
Rahata,Garlic,2015,5250,5900,650,12.380952380952381
Vai,Cluster Bean,2014,2250,2900,650,28.88888888888889
Indapur-Bhigwan,Green Gram,2014,6725,7375,650,9.66542750929368
Rahata,Ladies Finger,2015,990,1640,650,65.65656565656566
Manchar,Cucumber,2016,100,750,650,650.0
Akole,Wheat(Husked),2016,1500,2150,650,43.333333333333336
Jalgaon,Shevga,2016,2100,2750,650,30.952380952380953
Amarawati,Onion,2016,353,1003,650,184.1359773371105
Aurangabad,Kharbuj,2016,1600,2250,650,40.625
Nira-Saswad,Gram,2015,4100,4750,650,15.853658536585366
Nashik,Potato,2015,550,1200,650,118.18181818181819
Shrirampur,Cluster Bean,2015,1700,2350,650,38.23529411764706
Junnar (Alephata),Onion,2015,800,1450,650,81.25
Kolhapur,Snake Gourd,2016,850,1500,650,76.47058823529412
Aurangabad,Coriander  ,2016,250,900,650,260.0
Jalkot,Green Gram,2014,5988,6638,650,10.855043420173681
Buldhana,Gram,2016,6000,6650,650,10.833333333333334
Palus,SQUASH GOURD,2016,1475,2125,650,44.067796610169495
Mangaon(Bhadav),Nachani,2016,1450,2100,650,44.827586206896555
Barshi-Vairag,Sorgum(Jawar),2015,1807,2457,650,35.97122302158273
Chalisgaon,Banana,2015,1100,1750,650,59.09090909090909
Ahmednagar,Horse Gram,2015,8200,8850,650,7.926829268292683
Ausa,Tamarind,2016,6067,6717,650,10.713697049612659
Shahapur,Chavli (Shenga ),2015,2113,2763,650,30.76194983435873
Junnar-Otur,Potato,2016,825,1475,650,78.78787878787878
Barshi,Coriander  ,2016,500,1150,650,130.0
Pune,Potato,2015,983,1633,650,66.12410986775178
Aurangabad,ONION,2016,223,873,650,291.47982062780267
Pune-Manjri,Kardai,2015,200,850,650,325.0
Ratanagari,Green-Peas,2014,3875,4525,650,16.774193548387096
Mumbai,Green-Peas,2016,5688,6338,650,11.427566807313642
Sangrampur,Pigeon Pea (Tur),2016,8000,8650,650,8.125
Naigaon,Green Gram,2015,7700,8350,650,8.441558441558442
Manchar,Bottle Gourd,2014,500,1150,650,130.0
Ahmednagar,Black Gram,2015,8950,9600,650,7.262569832402234
Barshi-Vairag,Ground Nut Pods (Dry),2016,7175,7825,650,9.059233449477352
Nira,Rice(Paddy-Hus),2015,2950,3600,650,22.033898305084747
Amarawati-Fruit And Vegetables,Ginger (Fresh),2016,1778,2428,650,36.55793025871766
Sangamner,Tomato,2015,650,1300,650,100.0
Kolhapur-Laxmipuri,Spilt Pigeon Pea,2016,12483,13133,650,5.207081631018185
Buldhana,Pigeon Pea (Tur),2015,3350,4000,650,19.402985074626866
Barshi,Green Gram,2016,4463,5112,649,14.541788034954067
Nagpur,Paddy-Unhusked,2014,1412,2061,649,45.963172804532576
Sakri,Onion,2016,113,762,649,574.3362831858407
Baramati,Sorgum(Jawar),2015,1501,2150,649,43.237841439040636
Indapur,BAJRI,2016,1151,1800,649,56.38575152041703
Mumbai,Potato,2016,539,1188,649,120.40816326530613
Manwat,Gram,2016,6101,6750,649,10.637600393378134
Sonpeth,Pigeon Pea (Tur),2016,8343,8992,649,7.778976387390627
Manmad,Sorgum(Jawar),2016,1352,2000,648,47.928994082840234
Aurangabad,Brinjal,2014,1152,1800,648,56.25
Hingoli,Green Gram,2015,6749,7397,648,9.60142243295303
Hinganghat,Pigeon Pea (Tur),2015,4666,5314,648,13.887698242606087
Shahada,Green Gram,2014,6970,7618,648,9.296987087517934
Ambad(Vadi Godri),Wheat(Husked),2016,1626,2274,648,39.85239852398524
Pune-Manjri,Flower,2015,790,1438,648,82.0253164556962
Umarga,SOYBEAN,2016,1982,2630,648,32.694248234106965
Dhule,Gram,2015,3639,4287,648,17.807089859851608
Ghoti,Tomato,2016,2059,2707,648,31.471588149587177
Mumbai,Carrot,2014,1912,2560,648,33.89121338912134
Dhule,Black Gram,2016,8652,9300,648,7.489597780859917
Barshi-Vairag,Green Gram,2016,4174,4822,648,15.52467656923814
Shirpur,Gram,2015,3781,4428,647,17.111875165300184
Akluj,Bor,2014,682,1329,647,94.86803519061584
Barshi,Onion,2016,100,747,647,647.0
Shrirampur,Green Gram,2015,7281,7928,647,8.88614201345969
Taloda,Gram,2015,3133,3780,647,20.65113309926588
Jintur,Sorgum(Jawar),2015,1110,1757,647,58.288288288288285
Jintur-Bori,Pigeon Pea (Tur),2015,5927,6574,647,10.916146448456217
Chopda,Green Gram,2015,7881,8528,647,8.209618068772999
Jalgaon,Flower,2016,1732,2379,647,37.35565819861432
Kopargaon,Gram,2015,3620,4267,647,17.87292817679558
Mumbai-Fruit Market,Pineapple,2016,1515,2162,647,42.70627062706271
Shrirampur,Bitter Gourd,2016,1500,2147,647,43.13333333333333
Savner,Pigeon Pea (Tur),2016,5220,5867,647,12.39463601532567
Chandur Bajar,Gram,2015,3333,3980,647,19.41194119411941
Indapur-Bhigwan,Gram,2014,2120,2767,647,30.5188679245283
Jalgaon,Coriander  ,2015,537,1184,647,120.48417132216015
Umared,Lentil,2015,3475,4122,647,18.618705035971225
Mangalwedha,Wheat(Husked),2015,1403,2050,647,46.115466856735566
Jalna,Mosambi,2015,853,1500,647,75.84994138335287
Osmanabad,Cabbage,2016,756,1403,647,85.58201058201058
Barshi,Green Gram,2015,6080,6727,647,10.641447368421053
Dhule,Gram,2014,2143,2790,647,30.19132057862809
Jalgaon,Ladies Finger,2016,1096,1743,647,59.03284671532847
Lasur Station,Onion,2016,160,807,647,404.375
Kalmeshwar,Soybean,2015,3334,3981,647,19.40611877624475
Kalyan,Small Gourd,2015,1900,2546,646,34.0
Nagpur,Ginger (Fresh),2014,2919,3565,646,22.130866735183282
Mumbai,Melon,2015,1217,1863,646,53.08134757600657
Satara,Green Chilli,2015,2250,2896,646,28.711111111111112
Rahata,Bottle Gourd,2015,437,1083,646,147.82608695652175
Junnar-Otur,GHEVDA,2016,590,1236,646,109.49152542372882
Indapur,Sorgum(Jawar),2016,1921,2567,646,33.6283185840708
Sangamner,Gram,2016,4698,5344,646,13.75053214133674
Dhamangaon-Rly,Pigeon Pea (Tur),2015,7018,7664,646,9.204901681390709
Karad,Chikoo,2014,1223,1869,646,52.82093213409648
Karad,Green-Peas,2016,5577,6223,646,11.58328850636543
Rahata,Tomato,2016,531,1177,646,121.6572504708098
Pune,Pumpkin,2014,1042,1688,646,61.99616122840691
Osmanabad,Bor,2014,785,1431,646,82.29299363057325
Dhule,Onion,2016,179,825,646,360.89385474860336
Nagpur,Coriander  ,2014,3204,3850,646,20.162297128589262
Jintur,Pigeon Pea (Tur),2016,8304,8950,646,7.779383429672447
Rahata,Bitter Gourd,2014,2131,2777,646,30.31440638198029
Nira-Saswad,Sorgum(Jawar),2016,1594,2240,646,40.52697616060226
Pune,Onion,2016,461,1107,646,140.1301518438178
Barshi-Vairag,Sorgum(Jawar),2016,1819,2465,646,35.51401869158879
Chandrapur-Ganjwad,Coriander  ,2015,708,1354,646,91.24293785310735
Shrirampur,Ginger (Fresh),2014,4083,4729,646,15.821699730590252
Nira,Jaggery,2016,3352,3998,646,19.272076372315034
Pune,Elephant Root,2015,1418,2064,646,45.55712270803949
Shahapur,Ladies Finger,2015,3230,3875,645,19.96904024767802
Varora,Pigeon Pea (Tur),2015,6210,6855,645,10.38647342995169
Nashik,Onion,2016,163,808,645,395.70552147239266
Nashik,BITTER GOURD,2016,958,1603,645,67.3277661795407
Mangrulpeer,Soybean,2015,3045,3690,645,21.182266009852217
Gevrai,Gram,2015,3202,3847,645,20.14366021236727
Kej,Gram,2016,5498,6143,645,11.731538741360495
Kalyan,Onion,2015,2361,3006,645,27.318932655654383
Manchar,Maize(Corn.),2016,505,1150,645,127.72277227722772
Nandura,Soybean,2015,3181,3826,645,20.27664256523106
Kalamb (Os),Wheat(Husked),2016,1795,2440,645,35.93314763231198
Khamgaon,Green Gram,2016,4848,5493,645,13.304455445544555
Sindi (Selu),Ground Nut Pods (Dry),2016,4831,5476,645,13.351273028358518
Buldhana,Green Gram,2016,4300,4945,645,15.0
Parbhani,Green Gram,2014,7090,7735,645,9.097320169252468
Karad,Pavata,2016,2859,3504,645,22.560335781741866
Aurangabad,Tomato,2015,930,1575,645,69.35483870967742
Kundalwadi,Pigeon Pea (Tur),2016,8167,8812,645,7.897636831149749
Pune,Wal Bhaji,2015,2020,2665,645,31.93069306930693
Tumsar,Rice(Paddy-Hus),2016,2733,3378,645,23.600439077936333
Udgir,Gram,2015,4056,4701,645,15.902366863905325
Pune,Potato,2015,560,1205,645,115.17857142857143
Pusad,Black Gram,2016,6333,6978,645,10.184746565608716
Pune,Arvi,2015,2006,2650,644,32.1036889332004
Kille Dharur,Wheat(Husked),2015,1992,2636,644,32.329317269076306
Kamthi,Potato,2016,578,1222,644,111.41868512110727
Ratanagari,Cucumber,2015,1025,1669,644,62.829268292682926
Shegaon,GRAM,2016,6891,7535,644,9.345523146132637
Parli-Vaijnath,Green Gram,2015,7922,8566,644,8.12926028780611
Pune-Manjri,Kardai,2014,194,838,644,331.9587628865979
Baramati,Bajri,2016,1690,2334,644,38.10650887573964
Satara,Green Chilli,2015,1130,1774,644,56.991150442477874
Shegaon,Gram,2015,4160,4804,644,15.48076923076923
Vadgaon Peth,Bottle Gourd,2015,667,1311,644,96.55172413793103
Hadgaon-Tamsa,Pigeon Pea (Tur),2016,8356,9000,644,7.707036859741503
Karad,Onion,2016,792,1436,644,81.31313131313131
Mumbai,Carrot,2015,1593,2237,644,40.42686754551161
Khed-Chakan,Green-Peas,2015,2992,3636,644,21.524064171122994
Pathardi,Wheat(Husked),2015,1489,2133,644,43.2505036937542
Sakri,Onion,2016,162,806,644,397.5308641975309
Ahmedpur,Black Gram,2015,7863,8507,644,8.190258171181483
Pune-Pimpri,BRINJAL,2016,1304,1948,644,49.38650306748466
Karad,Ridge Gourd,2015,2056,2700,644,31.32295719844358
Shahapur,Ridge Gourd,2016,3278,3922,644,19.646125686394143
Shrirampur,Mosambi,2015,1893,2536,643,33.96724775488642
Satara,Shevga,2016,2595,3238,643,24.778420038535646
Kamthi,Brinjal,2015,693,1336,643,92.78499278499278
Manmad,Pigeon Pea (Tur),2016,6276,6919,643,10.245379222434671
Nandurbar,Gram,2016,5633,6276,643,11.414876619918338
Pune,Parwar,2014,2143,2786,643,30.004666355576294
Jintur,Pigeon Pea (Tur),2015,5952,6595,643,10.803091397849462
Vita,ONION,2016,550,1193,643,116.9090909090909
Patan,Ladies Finger,2015,2714,3357,643,23.691967575534267
Armori,Ground Nut Pods (Dry),2015,2636,3279,643,24.393019726858878
Shrirampur,POMEGRANATE,2016,2214,2857,643,29.04245709123758
Mumbai,Split Lentil,2015,7443,8086,643,8.638989654709123
Nandgaon Khandeshwar,Gram,2016,5834,6477,643,11.021597531710661
Devala,Onion,2016,283,926,643,227.20848056537102
Karad,Ridge Gourd,2014,1900,2543,643,33.8421052631579
Dhule,Gram,2015,2688,3331,643,23.921130952380953
Nashik-Devlali,Methi (Bhaji),2016,832,1475,643,77.28365384615384
Varora,Pigeon Pea (Tur),2016,7604,8247,643,8.456075749605471
Shrirampur,Bitter Gourd,2015,1500,2143,643,42.86666666666667
Dondaicha,Chillies(Red),2015,2838,3481,643,22.656800563777306
Jalgaon,Wal Papdi,2015,871,1514,643,73.82319173363949
Chalisgaon,ONION,2016,300,943,643,214.33333333333334
Satara,Flower,2015,1118,1761,643,57.513416815742396
Lasalgaon-Niphad,SOYBEAN,2016,2172,2815,643,29.60405156537753
Pune,Tamarind,2016,5462,6105,643,11.772244599047967
Ratanagari,Bitter Gourd,2015,3286,3929,643,19.567863664029215
Mumbai,Green Chilli,2015,3122,3765,643,20.595771941063422
Jintur,Black Gram,2015,7698,8341,643,8.352818914003638
Rahata,Tomato,2015,664,1307,643,96.83734939759036
Ramtek,Ginger (Fresh),2015,3714,4357,643,17.312870220786213
Kamthi,Ladies Finger,2016,727,1370,643,88.44566712517194
Pune-Moshi,Bottle Gourd,2016,843,1486,643,76.27520759193357
Pune-Manjri,Hemp,2015,0,643,643,inf
Baramati,Onion,2016,175,818,643,367.42857142857144
Pune-Moshi,Onion,2016,357,1000,643,180.11204481792717
Mumbai,Green-Peas,2016,6171,6813,642,10.403500243072436
Babhulgaon,Pigeon Pea (Tur),2015,4972,5614,642,12.912308930008045
Ratanagari,Cucumber,2016,1050,1692,642,61.142857142857146
Chandrapur-Ganjwad,Potato,2014,1821,2463,642,35.25535420098847
Mumbai,Split Lentil,2015,7846,8488,642,8.182513382615346
Shirpur,Cowpea,2015,7125,7767,642,9.010526315789473
Phaltan,Bajri,2015,1250,1892,642,51.36
Barshi,Brinjal,2016,813,1455,642,78.96678966789668
Mohol,Sorgum(Jawar),2016,1651,2293,642,38.885523924894
Mohol,Pigeon Pea (Tur),2015,4658,5300,642,13.782739373121512
Nandgaon Khandeshwar,Gram,2016,5867,6509,642,10.942560081813534
Ashti-Karanja,Pigeon Pea (Tur),2016,7831,8473,642,8.198186693908823
Ghatanji,Pigeon Pea (Tur),2016,7842,8484,642,8.186687069625096
Mumbai-Fruit Market,PINEAPPLE,2016,1277,1919,642,50.274079874706345
Nagpur,Onion,2015,762,1404,642,84.25196850393701
Ratanagari,Ladies Finger,2015,1579,2221,642,40.65864471184294
Chalisgaon,Gram,2015,2558,3200,642,25.097732603596558
Chandrapur-Ganjwad,Brinjal,2016,832,1474,642,77.16346153846153
Khed,Cucumber,2016,570,1212,642,112.63157894736842
Pune,Tomato,2015,346,988,642,185.5491329479769
Mangalwedha,Wheat(Husked),2014,1392,2034,642,46.12068965517241
Satara,Bitter Gourd,2016,3429,4071,642,18.722659667541556
Nagpur,Gram,2015,4066,4708,642,15.789473684210526
Patan,Tomato,2015,2383,3025,642,26.940830885438523
Aurangabad,Brinjal,2016,1146,1787,641,55.93368237347295
Hingoli,Pigeon Pea (Tur),2016,8514,9155,641,7.5287761334272965
Gevrai,Gram,2014,1935,2576,641,33.1266149870801
Pathardi,Wheat(Husked),2015,1572,2213,641,40.776081424936386
Buldhana,Pigeon Pea (Tur),2016,7167,7808,641,8.943770057206642
Shirur,Gram,2016,6076,6717,641,10.54970375246873
Pune,Pumpkin,2016,518,1159,641,123.74517374517374
Solapur,Jaggery,2015,1857,2498,641,34.51803984921917
Jalgaon,Amla,2015,1006,1647,641,63.71769383697813
Chikhali,Green Gram,2016,4366,5007,641,14.681630783325698
Rahata,Brinjal,2016,1692,2333,641,37.88416075650118
Loha,Ground Nut Pods (Dry),2014,3401,4042,641,18.847397824169363
Shegaon,Gram,2015,2384,3025,641,26.88758389261745
Rahata,Brinjal,2015,992,1633,641,64.61693548387096
Nandura,Pigeon Pea (Tur),2016,7706,8347,641,8.31819361536465
Ambad(Vadi Godri),Maize,2015,970,1611,641,66.08247422680412
Aurangabad,Capsicum,2015,1468,2109,641,43.664850136239785
Nashik-Devlali,Tandulja,2016,363,1004,641,176.5840220385675
Risod,Gram,2016,5842,6483,641,10.972269770626498
Lasur Station,Gram,2014,2018,2659,641,31.76412289395441
Aurangabad,Chikoo,2016,1141,1782,641,56.178790534618756
Lasalgaon,Sunflower,2015,3441,4081,640,18.59924440569602
Indapur-Bhigwan,Ground Nut Pods (Dry),2016,3760,4400,640,17.02127659574468
Ramtek,Green Chilli,2015,2060,2700,640,31.067961165048544
Lonar,Black Gram,2016,7950,8590,640,8.050314465408805
Tuljapur,Pigeon Pea (Tur),2015,8974,9614,640,7.1317138399821705
Vasai,Potato,2016,965,1605,640,66.32124352331606
Shrirampur,Green Gram,2014,5900,6540,640,10.847457627118644
Mantha,Wheat(Husked),2016,1720,2360,640,37.2093023255814
Mumbai,Ridge Gourd,2016,1640,2280,640,39.02439024390244
Baramati,Soybean,2015,3050,3690,640,20.983606557377048
Aurangabad,Brinjal,2015,1488,2128,640,43.01075268817204
Mumbai,Capsicum,2014,2160,2800,640,29.62962962962963
Rahata,Cucumber,2014,1860,2500,640,34.40860215053763
Ambejogai,Sesamum,2014,9800,10440,640,6.530612244897959
Pune,Tomato,2016,496,1136,640,129.03225806451613
Khed-Chakan,CAPSICUM,2016,808,1448,640,79.20792079207921
Vadgaon Peth,Ladies Finger,2015,1215,1855,640,52.674897119341566
Satara,Tomato,2014,1208,1848,640,52.980132450331126
Indapur,SORGUM(JAWAR),2016,2011,2651,640,31.82496270512183
Paranda,Onion,2016,180,820,640,355.55555555555554
Solapur,Apple,2015,410,1050,640,156.09756097560975
Pune-Moshi,CUCUMBER,2016,993,1633,640,64.45115810674723
Patur,Black Gram,2016,6070,6710,640,10.543657331136737
Vaijapur,Onion,2016,173,813,640,369.9421965317919
Mehkar,Wheat(Husked),2015,1281,1921,640,49.96096799375488
Shirpur,Pigeon Pea (Tur),2015,4343,4983,640,14.736357356665899
Ralegaon,Cotton,2016,4313,4953,640,14.83885926269418
Ratanagari,Brinjal,2015,1511,2150,639,42.289874255459964
Varud,Mosambi,2015,1100,1739,639,58.09090909090909
Chandur Rly.,SOYBEAN,2016,2211,2850,639,28.900949796472183
Dhule,Cowpea,2014,3265,3904,639,19.571209800918837
Dhule,Matki,2015,6263,6902,639,10.202778221299697
Ulhasnagar,SORGUM(JAWAR),2016,1739,2378,639,36.74525589419206
Dhamangaon-Rly,Gram,2016,5052,5691,639,12.648456057007126
Bhivandi,Other Vegetables,2014,1021,1660,639,62.58570029382958
Shrirampur,Mosambi,2014,1528,2167,639,41.81937172774869
Nira,Jaggery,2015,3029,3668,639,21.096071310663586
Kamthi,Cabbage,2015,703,1342,639,90.89615931721195
Aurangabad,Chikoo,2016,823,1462,639,77.64277035236938
Nashik,Ghosali(Bhaji),2016,1127,1766,639,56.69920141969831
Rahata,Capsicum,2016,1325,1964,639,48.22641509433962
Latur,Sunflower,2014,2508,3147,639,25.47846889952153
Chandrapur,Banana,2015,938,1577,639,68.12366737739872
Mumbai,Bitter Gourd,2016,3113,3752,639,20.526823000321233
Kille Dharur,Bajri,2015,1548,2187,639,41.27906976744186
Ratanagari,Capsicum,2015,2361,3000,639,27.064803049555273
Kamthi,Cucumber,2015,854,1493,639,74.82435597189695
Hinganghat,Pigeon Pea (Tur),2014,4456,5095,639,14.340215439856374
Satara,Ginger (Fresh),2016,950,1588,638,67.15789473684211
Shahapur,Mango(Raw),2015,1385,2023,638,46.064981949458485
Karad,Chikoo,2016,2231,2869,638,28.597041685342894
Tumsar,Rice(Paddy-Hus),2016,1810,2448,638,35.248618784530386
Jalkot,Green Gram,2015,7575,8213,638,8.422442244224422
Jalkot,Black Gram,2014,4175,4813,638,15.281437125748504
Buldhana,Gram,2016,5831,6469,638,10.94151946492883
Pachora,Sunflower,2015,3210,3848,638,19.87538940809969
Pune,Capsicum,2016,879,1517,638,72.58248009101251
Solapur,Carrot,2015,400,1038,638,159.5
Umarga,Gram,2015,2469,3107,638,25.840421223167276
Sindi (Selu),Ground Nut Pods (Dry),2016,4145,4783,638,15.392038600723764
Chandrapur-Ganjwad,Tomato,2014,729,1367,638,87.51714677640604
Karad,Pavata,2016,2967,3605,638,21.50320188742838
Mangalwedha,Sorgum(Jawar),2015,1274,1912,638,50.07849293563579
Rahuri,CABBAGE,2016,125,763,638,510.4
Pune,Cabbage,2015,657,1295,638,97.10806697108067
Mandhal,Chillies(Red),2015,6669,7307,638,9.56665167191483
Daryapur,PIGEON PEA (TUR),2016,5190,5828,638,12.292870905587668
Shirpur,Matki,2014,6650,7288,638,9.593984962406015
Balapur,Gram,2016,4575,5213,638,13.94535519125683
Ausa,Pigeon Pea (Tur),2015,5872,6510,638,10.865122615803815
Amarawati-Fruit And Vegetables,Chikoo,2016,1326,1964,638,48.114630467571644
Nashik,Cabbage,2014,775,1413,638,82.3225806451613
Pune,Snake Gourd,2015,829,1467,638,76.96019300361881
Lasalgaon-Niphad,Onion,2016,515,1153,638,123.88349514563107
Phaltan,Wheat(Husked),2016,1525,2163,638,41.83606557377049
Sangrampur-Varvatbakal,Green Gram,2016,4282,4919,637,14.876226062587575
Varud-Rajura Bazar,GREEN CHILLI,2016,830,1467,637,76.74698795180723
Chikhali,Black Gram,2014,3412,4049,637,18.669402110199297
Vadgaon Peth,Brinjal,2015,518,1155,637,122.97297297297297
Barshi,Gram,2015,3097,3734,637,20.56829189538263
Pune,Snake Gourd,2015,813,1450,637,78.35178351783517
Karad,Ladies Finger,2014,2438,3075,637,26.12797374897457
Koregaon,Potato,2014,1800,2437,637,35.388888888888886
Nira-Saswad,Wheat(Husked),2015,1587,2224,637,40.13862633900441
Partur,Pigeon Pea (Tur),2015,4720,5357,637,13.495762711864407
Pune-Pimpri,LADIES FINGER,2016,3389,4026,637,18.796105045736205
Shrirampur,Ladies Finger,2014,1977,2614,637,32.220536165907944
Aurangabad,Tomato,2014,638,1275,637,99.84326018808777
Baramati,Sorgum(Jawar),2014,1755,2392,637,36.2962962962963
Lasur Station,Onion,2016,165,802,637,386.06060606060606
Arvi,SOYBEAN,2016,2175,2812,637,29.28735632183908
Shahapur,Bitter Gourd,2015,2579,3216,637,24.699495928654517
Zarijamini,Pigeon Pea (Tur),2015,4913,5550,637,12.965601465499695
Kolhapur-Laxmipuri,Lentil,2015,7927,8564,637,8.03582692065094
Jalgaon,Mango(Raw),2016,1027,1664,637,62.0253164556962
Lasalgaon,Wheat(Husked),2015,1360,1997,637,46.838235294117645
Katol,Pigeon Pea (Tur),2016,5893,6530,637,10.80943492278975
Nashik,BRINJAL,2016,665,1302,637,95.78947368421052
Ratanagari,Flower,2015,2188,2825,637,29.113345521023767
Satara,Shevga,2015,2523,3159,636,25.20808561236623
Manchar,Bottle Gourd,2016,543,1179,636,117.12707182320442
Paranda,Sorgum(Jawar),2016,1430,2066,636,44.47552447552447
Pune,Flower,2014,560,1196,636,113.57142857142857
Kamthi,Zendu,2016,950,1586,636,66.94736842105263
Junnar (Alephata),Onion,2016,670,1306,636,94.92537313432835
Amarawati,Kharbuj,2016,1773,2409,636,35.87140439932318
Shahapur,Cluster Bean,2015,2064,2700,636,30.813953488372093
Sangali,Gram,2015,4200,4836,636,15.142857142857142
Vaijapur,Ground Nut Pods (Dry),2016,3484,4120,636,18.2548794489093
Bhokar,Cotton,2015,3900,4536,636,16.307692307692307
Indapur (Nimgaon Ketki),Sorgum(Jawar),2015,1190,1826,636,53.445378151260506
Risod,Pigeon Pea (Tur),2016,5397,6033,636,11.784324624791552
Umrane,Onion,2015,945,1581,636,67.3015873015873
Jalgaon,Black Gram,2014,4091,4727,636,15.546321192862381
Vadgaon Peth,Tomato,2016,492,1128,636,129.26829268292684
Dondaicha,Green Gram,2014,7599,8235,636,8.369522305566521
Dhule,Green Gram,2015,6159,6795,636,10.326351680467608
Kolhapur,BOTTLE GOURD,2016,278,914,636,228.77697841726618
Kolhapur,GINGER (FRESH),2016,1368,2004,636,46.49122807017544
Khamgaon,PIGEON PEA (TUR),2016,5348,5983,635,11.8735976065819
Navapur,Flower,2016,1577,2212,635,40.26632847178186
Pune-Pimpri,Brinjal,2014,3019,3654,635,21.033454786353097
Pune-Pimpri,Bottle Gourd,2015,1804,2439,635,35.19955654101996
Kolhapur,Cabbage,2016,517,1152,635,122.82398452611218
Pune-Manjri,Raddish,2015,953,1588,635,66.63168940188878
Nandura,Black Gram,2015,4960,5595,635,12.80241935483871
Solapur,Bitter Gourd,2016,426,1061,635,149.06103286384976
Akluj,Ladies Finger,2015,1065,1700,635,59.624413145539904
Bhokar,BLACK GRAM,2016,6361,6996,635,9.982707121521774
Umared,Wheat(Husked),2016,1586,2221,635,40.037831021437576
Murtizapur,Black Gram,2014,4151,4786,635,15.297518670199953
Chandur Bajar,Pigeon Pea (Tur),2016,5931,6566,635,10.706457595683696
Pune-Pimpri,Bottle Gourd,2015,1770,2405,635,35.87570621468927
Ambad(Vadi Godri),Soybean,2015,2700,3335,635,23.51851851851852
Jalna,Bajri,2014,1017,1652,635,62.438544739429695
Buldhana,Gram,2016,6294,6929,635,10.088973625675246
Jalgaon,Tomato,2015,755,1390,635,84.10596026490066
Majalgaon,Bajri,2016,1274,1909,635,49.84301412872841
Jintur-Bori,Pigeon Pea (Tur),2016,7978,8613,635,7.959388317874154
Mohol,Gram,2015,3873,4508,635,16.395558998192616
Nira-Saswad,BAJRI,2016,1560,2195,635,40.705128205128204
Lasur Station,Gram,2015,3128,3763,635,20.300511508951406
Jamkhed,Black Gram,2016,6326,6961,635,10.037938665823585
Chopda,Sunflower,2015,2469,3104,635,25.718914540299718
Kamthi,Pumpkin,2016,665,1300,635,95.48872180451127
Pusad,Wheat(Husked),2016,1505,2139,634,42.12624584717608
Satara,Capsicum,2016,1981,2615,634,32.004038364462396
Pune-Pimpri,Ladies Finger,2015,3033,3667,634,20.903395977579954
Kalyan,Mango,2016,3076,3710,634,20.611183355006503
Nandgaon Khandeshwar,Pigeon Pea (Tur),2016,5636,6270,634,11.249112845990064
Tumsar,Rice(Paddy-Hus),2016,2406,3040,634,26.350789692435576
Kolhapur,Sweet Potato,2016,1333,1967,634,47.56189047261815
Pune,Cucumber,2015,383,1017,634,165.53524804177545
Kamthi,Chavli (Pala),2015,445,1079,634,142.47191011235955
Dhule,Gram,2015,3457,4091,634,18.339600809950824
Satara,Capsicum,2014,1722,2356,634,36.81765389082462
Aurangabad,Flower,2016,1207,1841,634,52.52692626346313
Chandrapur-Ganjwad,Chavli (Pala),2014,1144,1778,634,55.41958041958042
Rajura,Cotton,2015,3632,4266,634,17.455947136563875
Ahmednagar,Cucumber,2016,314,948,634,201.9108280254777
Shrirampur,Brinjal,2014,1652,2286,634,38.37772397094431
Kurdwadi-Modnimb,Onion,2016,197,831,634,321.8274111675127
Dudhani,Gram,2016,4983,5617,634,12.723259080874975
Umared,Green Gram,2014,5308,5942,634,11.944235116804823
Yeotmal,Ground Nut Pods (Dry),2015,4876,5510,634,13.002461033634127
Pune,Green Gram,2016,7044,7678,634,9.000567859170925
Chopda,Green Gram,2015,6335,6969,634,10.00789265982636
Manchar,Farshi,2015,2333,2967,634,27.17531075867981
Savner,Pigeon Pea (Tur),2016,7877,8511,634,8.04874952393043
Ulhasnagar,Onion,2016,883,1517,634,71.80067950169875
Lasalgaon-Niphad,Soybean,2016,3229,3863,634,19.634561783834005
Pune-Manjri,Rajgira,2015,733,1367,634,86.49386084583902
Kej,Wheat(Husked),2015,1866,2500,634,33.97642015005359
Ambejogai,Sesamum,2015,8608,9242,634,7.365241635687732
Shahada,Green Gram,2015,6601,7234,633,9.589456143008634
Dondaicha,Matki,2014,5001,5634,633,12.65746850629874
Sangali,LENTIL,2016,6092,6725,633,10.390676296782665
Shahapur,Brinjal,2015,1500,2133,633,42.2
Shrirampur,Brinjal,2014,1292,1925,633,48.9938080495356
Sinner,Soybean,2015,2729,3362,633,23.195309637229755
Akola,Green Gram,2014,7540,8173,633,8.39522546419098
Murbad,Bitter Gourd,2016,3817,4450,633,16.583704479958083
Mumbai,Chikoo,2014,1200,1833,633,52.75
Satara,Onion,2014,1400,2033,633,45.214285714285715
Ratanagari,Capsicum,2015,3167,3800,633,19.987369750552574
Barshi-Vairag,Sorgum(Jawar),2016,1782,2415,633,35.52188552188552
Ahmednagar,Bottle Gourd,2015,300,933,633,211.0
Aurangabad,Chikoo,2014,1356,1989,633,46.68141592920354
Karad,CHIKOO,2016,2313,2946,633,27.36705577172503
Ratanagari,Brinjal,2015,1040,1673,633,60.86538461538461
Basmat,Ground Nut Pods (Dry),2015,4916,5549,633,12.876322213181448
Vai,Green Chilli,2015,3367,4000,633,18.8001188001188
Babhulgaon,Pigeon Pea (Tur),2016,7557,8190,633,8.376339817387853
Shrirampur,Green Chilli,2015,1667,2300,633,37.972405518896224
Pune-Manjri,Cucumber,2015,1217,1850,633,52.01314708299096
Shahapur,Ghosali(Bhaji),2015,1300,1933,633,48.69230769230769
Ausa,Pigeon Pea (Tur),2014,4700,5333,633,13.46808510638298
Mantha,Pigeon Pea (Tur),2015,5492,6125,633,11.52585579024035
Kolhapur-Laxmipuri,Cowpea,2016,4792,5425,633,13.209515859766277
Pandharpur,Bor,2014,500,1133,633,126.6
Umarkhed-Danki,Gram,2014,2467,3100,633,25.658694770976894
Sangali,Gram,2015,3624,4257,633,17.466887417218544
Kolhapur-Laxmipuri,Split Gram,2015,4000,4633,633,15.825
Jalkot,Green Gram,2015,7161,7794,633,8.839547549224969
Jalgaon,Squash Gourd,2014,1367,2000,633,46.305779078273595
Shahapur,Mango(Raw),2015,1192,1825,633,53.104026845637584
Nira-Saswad,Wheat(Husked),2016,1600,2233,633,39.5625
Sailu,Black Gram,2016,5734,6367,633,11.039414021625392
Shahapur,Bitter Gourd,2016,3667,4300,633,17.26206708481047
Ashti-Karanja,Pigeon Pea (Tur),2015,7495,8128,633,8.445630420280187
Aurangabad,Papai,2016,1600,2233,633,39.5625
Buldhana,GREEN GRAM,2016,4167,4800,633,15.190784737221023
Chandrapur-Ganjwad,Wal Bhaji,2016,925,1558,633,68.43243243243244
Jalgaon,Gram,2016,5490,6123,633,11.530054644808743
Junnar-Otur,Ladies Finger,2016,400,1033,633,158.25
Akole,Wheat(Husked),2016,1517,2150,633,41.72709294660514
Pimpalgaon Basawant,Onion,2016,247,880,633,256.27530364372467
Kej,Sesamum,2016,7134,7767,633,8.87300252312868
Umared,Gram,2016,5600,6233,633,11.303571428571429
Pune,Snake Gourd,2016,400,1032,632,158.0
Khed,Flower,2016,289,921,632,218.68512110726644
Indapur,Cowpea,2016,4477,5109,632,14.116595934777752
Satara,Pavtta,2015,3000,3632,632,21.066666666666666
Akola,Soybean,2016,2365,2997,632,26.723044397463003
Anajngaon Surji,Gram,2015,4309,4941,632,14.666976096542122
Shrirampur,Capsicum,2016,1447,2079,632,43.67657221838286
Jalgaon,Cucumber,2015,763,1395,632,82.83093053735256
Karad,Shevga,2016,2676,3308,632,23.61733931240658
Satara,Flower,2016,1940,2572,632,32.577319587628864
Babhulgaon,Soybean,2015,3114,3746,632,20.29543994861914
Solapur,Banana,2014,561,1193,632,112.65597147950089
Sangli-Phale Bhajipalam,Onion,2016,223,855,632,283.4080717488789
Jalna,Black Gram,2014,3887,4519,632,16.259325958322613
Nashik,Shahale ,2016,1852,2484,632,34.125269978401725
Partur,Sorgum(Jawar),2014,1155,1787,632,54.71861471861472
Sinner,Matki,2015,6914,7545,631,9.126410182238935
Pune-Pimpri,Ladies Finger,2014,2752,3383,631,22.92877906976744
Akola,Gram,2016,4666,5297,631,13.52336048006858
Akola,Gram,2016,5701,6332,631,11.068233643220488
Jintur,Turmeric,2016,7941,8572,631,7.946102505981615
Akot,Pigeon Pea (Tur),2016,8157,8788,631,7.7356871398798575
Junnar (Alephata),Onion,2015,1154,1785,631,54.679376083188906
Pune,Parwar,2014,2192,2823,631,28.786496350364963
Indapur-Bhigwan,Wheat(Husked),2016,1619,2250,631,38.97467572575664
Hinganghat,Soybean,2016,3138,3769,631,20.108349267049075
Dhamangaon-Rly,Pigeon Pea (Tur),2015,5190,5821,631,12.157996146435453
Manchar,Brinjal,2016,1347,1978,631,46.84484038604306
Lasur Station,Gram,2016,5895,6526,631,10.703986429177268
Jamner-Neri,Cotton,2016,4186,4817,631,15.074056378404205
Amarawati,Soybean,2015,2955,3586,631,21.35363790186125
Jalgaon,Brinjal,2016,1016,1647,631,62.10629921259842
Chopda,Sunflower,2015,2250,2881,631,28.044444444444444
Jintur,Turmeric,2015,6678,7309,631,9.448936807427373
Nashik,Carrot,2016,929,1560,631,67.92249730893434
Jalgaon,Wal Papdi,2015,1154,1785,631,54.679376083188906
Devala,Onion,2015,493,1124,631,127.99188640973631
Kolhapur,Potato,2016,1437,2068,631,43.91092553931802
Manmad,Onion,2016,311,942,631,202.89389067524115
Chopda,Pigeon Pea (Tur),2016,6886,7517,631,9.163520185884403
Rahata,Green Chilli,2015,2100,2730,630,30.0
Alibag,Rice(Paddy-Hus),2015,3370,4000,630,18.694362017804153
Pune,Gram,2015,4430,5060,630,14.221218961625283
Khamgaon,Gram,2014,2177,2807,630,28.938906752411576
Ashti-Karanja,Soybean,2015,3076,3706,630,20.48114434330299
Shrigonda,Sorgum(Jawar),2016,1600,2230,630,39.375
Sangali,Lentil,2016,6208,6838,630,10.14819587628866
Satara,Flower,2014,1163,1793,630,54.17024935511608
Aurangabad,Bitter Gourd,2016,1983,2613,630,31.770045385779124
Kamthi,Green Chilli,2014,800,1430,630,78.75
Shahada,Green Gram,2016,5219,5849,630,12.071278022609695
Barshi,Ground Nut Pods (Dry),2014,3251,3881,630,19.378652722239313
Akole,Paddy-Unhusked,2016,1500,2130,630,42.0
Pulgaon,Soybean,2015,3105,3735,630,20.28985507246377
Chopda,Ground Nut Pods (Dry),2016,4586,5216,630,13.737461840383776
Khed-Chakan,Bitter Gourd,2016,1085,1715,630,58.064516129032256
Indapur,Wheat(Husked),2016,1721,2351,630,36.60662405578152
Mumbai,Carrot,2015,1783,2413,630,35.3337072349972
Shrirampur,Cluster Bean,2015,1522,2152,630,41.39290407358739
Bhivandi,Other Vegetables,2014,1057,1687,630,59.602649006622514
Satara,Pavtta,2016,2774,3404,630,22.710886806056237
Mumbai,Split Gram,2014,3600,4230,630,17.5
Pune,Carrot,2016,535,1165,630,117.75700934579439
Babhulgaon,Gram,2014,1900,2530,630,33.1578947368421
Phaltan,Brinjal,2016,932,1561,629,67.4892703862661
Pune,Lemon,2016,124,753,629,507.258064516129
Aurangabad,Bitter Gourd,2015,1219,1848,629,51.59967186218211
Mangrulpeer,Wheat(Husked),2016,1407,2036,629,44.70504619758351
Karanja,Soybean,2016,2466,3095,629,25.506893755068937
Jalgaon,Flower,2014,1098,1727,629,57.28597449908926
Lasalgaon-Niphad,Gram,2015,3751,4380,629,16.768861636896826
Aurangabad,Ladies Finger,2015,2514,3143,629,25.01988862370724
Nashik,Raddish,2016,1552,2181,629,40.52835051546392
Barshi,Black Gram,2016,9443,10072,629,6.661018744043207
Baramati,Sorgum(Jawar),2016,1562,2190,628,40.204865556978234
Kej,Gram,2016,4947,5575,628,12.694562361026884
Aurangabad,Carrot,2016,1243,1871,628,50.52292839903459
Ratanagari,Ladies Finger,2015,2179,2807,628,28.820559889857734
Karanja,Soybean,2016,3226,3854,628,19.466831990080596
Manchar,Bottle Gourd,2016,1061,1689,628,59.189443920829405
Gangapur,Bajri,2016,1516,2144,628,41.42480211081794
Nashik,Tomato,2016,529,1157,628,118.71455576559546
Sillod-Bharadi,Green Gram,2015,6100,6728,628,10.295081967213115
Shahada,Gram,2015,3285,3913,628,19.117199391171994
Yeola,Onion,2016,214,842,628,293.4579439252336
Hingoli,Turmeric,2016,7662,8290,628,8.196293395980161
Nilanga,Gram,2015,4192,4820,628,14.98091603053435
Kalamb (Os),Black Gram,2014,4410,5038,628,14.240362811791384
Vadgaon Peth,Bottle Gourd,2015,729,1357,628,86.14540466392319
Devala,Onion,2016,211,839,628,297.6303317535545
Pune,Cucumber,2016,596,1224,628,105.36912751677852
Umarga,Pigeon Pea (Tur),2015,6289,6917,628,9.98568929877564
Gevrai,Cotton,2016,3820,4448,628,16.43979057591623
Pandharpur,Tomato,2015,160,788,628,392.5
Kamthi,Brinjal,2016,500,1128,628,125.6
Aurangabad,Cucumber,2016,1108,1736,628,56.67870036101083
Daryapur,Soybean,2016,3222,3850,628,19.490999379267535
Karad,Potato,2016,1081,1708,627,58.00185013876041
Shahapur,Chavli (Shenga ),2015,1791,2418,627,35.00837520938023
Nagpur,Mango,2015,1685,2312,627,37.210682492581604
Barshi,Tamarind,2016,6300,6927,627,9.952380952380953
Nagpur,Gram,2015,4005,4632,627,15.655430711610487
Bhokar,Gram,2014,2452,3079,627,25.570962479608482
Jalgaon,Brinjal,2016,1096,1723,627,57.20802919708029
Barshi,Wheat(Husked),2015,1487,2114,627,42.1654337592468
Lonar,Pigeon Pea (Tur),2015,4949,5576,627,12.669226106284098
Akluj,Bor,2016,573,1200,627,109.42408376963351
Satara,Bitter Gourd,2015,2023,2650,627,30.993573900148295
Dudhani,Sorgum(Jawar),2014,1142,1769,627,54.903677758318736
Aurangabad,Papai,2016,2420,3047,627,25.90909090909091
Pandharpur,Cabbage,2015,440,1067,627,142.5
Mumbai,Squash Gourd,2016,2155,2782,627,29.095127610208817
Nashik-Devlali,Coriander  ,2016,321,948,627,195.3271028037383
Jamkhed,Pigeon Pea (Tur),2016,6825,7452,627,9.186813186813186
Sangali,Lentil,2016,5940,6567,627,10.555555555555555
Shrirampur,Capsicum,2016,1743,2370,627,35.97246127366609
Karad,Bitter Gourd,2016,2638,3265,627,23.76800606520091
Indapur-Bhigwan,Bajri,2016,1413,2040,627,44.37367303609342
Shahapur,Ridge Gourd,2016,3726,4353,627,16.82769726247987
Khed,Flower,2016,456,1083,627,137.5
Nashik,Water Melon,2016,568,1194,626,110.21126760563381
Ahmednagar,Potato,2016,1037,1663,626,60.36644165863066
Hingoli,GRAM,2016,7536,8162,626,8.3067940552017
Pune-Manjri,Flower,2016,784,1410,626,79.84693877551021
Mangrulpeer,Gram,2015,3727,4353,626,16.79635095250872
Kurdwadi,Sorgum(Jawar),2015,1191,1817,626,52.56087321578505
Arvi,Cotton,2015,4000,4626,626,15.65
Dhule,BAJRI,2016,1080,1706,626,57.96296296296296
Kolhapur,Mango,2016,2874,3500,626,21.781489213639528
Solapur,Jaggery,2015,2158,2784,626,29.008341056533826
Amarawati,SOYBEAN,2016,2219,2845,626,28.210905813429473
Devala,BLACK GRAM,2016,6178,6804,626,10.132729038523793
Indapur-Bhigwan,Gram,2014,1950,2576,626,32.1025641025641
Satara,Capsicum,2015,1761,2387,626,35.547984099943214
Anajngaon Surji,Pigeon Pea (Tur),2016,6214,6840,626,10.074026392018023
Kamthi,Green Chilli,2016,807,1433,626,77.57125154894672
Gadhinglaj,Jaggery,2014,2274,2900,626,27.52858399296394
Ratanagari,Tomato,2015,1032,1658,626,60.65891472868217
Pune,Arvi,2015,1722,2348,626,36.35307781649245
Pune-Manjri,Cucumber,2015,942,1568,626,66.4543524416136
Nashik,CAPSICUM,2016,973,1598,625,64.23432682425488
Kolhapur,Grapes,2015,250,875,625,250.0
Amalner,Coriander (Dry),2015,8750,9375,625,7.142857142857143
Vadgaon Peth,Capsicum,2015,1250,1875,625,50.0
Pune,Potato,2016,1125,1750,625,55.55555555555556
Shrirampur,Shevga,2016,1500,2125,625,41.666666666666664
Sailu,Pigeon Pea (Tur),2015,7786,8411,625,8.027228358592346
Karad,Pavtta,2015,2338,2963,625,26.732249786142003
Sillod-Bharadi,Pigeon Pea (Tur),2014,3050,3675,625,20.491803278688526
Hingoli,Pigeon Pea (Tur),2015,7210,7835,625,8.668515950069349
Nandgaon,Wheat(Husked),2016,1661,2286,625,37.62793497892836
Mehkar,Gram,2015,2883,3508,625,21.67880679847381
Rahata,Ladies Finger,2015,2158,2783,625,28.96200185356812
Pathardi,Wheat(Husked),2014,1508,2133,625,41.44562334217507
Aurangabad,Chikoo,2016,944,1569,625,66.20762711864407
Kolhapur,Strawberi,2015,825,1450,625,75.75757575757575
Dudhani,Bajri,2016,1218,1843,625,51.3136288998358
Kalamb (Os),Wheat(Husked),2016,2119,2744,625,29.495044832468146
Kalyan,Mosambi,2016,2355,2980,625,26.53927813163482
Kolhapur,Beet Root,2016,708,1333,625,88.2768361581921
Mumbai,Split Gram,2016,5454,6079,625,11.45947928126146
Shrirampur,Wal Papdi,2016,2250,2875,625,27.77777777777778
Osmanabad,Potato,2015,650,1275,625,96.15384615384616
Akluj,Ground Nut Pods (Dry),2014,2992,3617,625,20.88903743315508
Pune,Potato,2015,708,1333,625,88.2768361581921
Phaltan,Flower,2016,1300,1925,625,48.07692307692308
Dharangaon,BLACK GRAM,2016,5675,6300,625,11.013215859030836
Karad,Pavata,2015,3000,3625,625,20.833333333333332
Pandharpur,Capsicum,2016,1275,1900,625,49.01960784313726
Shrirampur,Green-Peas,2016,2458,3083,625,25.427176566314078
Pandharpur,Math (Bhaji),2015,875,1500,625,71.42857142857143
Ramtek,Custard Apple,2016,1625,2250,625,38.46153846153846
Karad,Pomegranate,2015,2375,3000,625,26.31578947368421
Vai,Green-Peas,2016,3313,3938,625,18.865076969514035
Shahapur,Bitter Gourd,2015,2525,3150,625,24.752475247524753
Ratanagari,Cluster Bean,2015,3375,4000,625,18.51851851851852
Ramtek,Bottle Gourd,2015,1625,2250,625,38.46153846153846
Kolhapur,Beet Root,2015,1125,1750,625,55.55555555555556
Rahata,Ground Nut Pods (Dry),2015,2938,3563,625,21.272974812797823
Karad,Shevga,2015,2675,3300,625,23.364485981308412
Junnar (Narayangaon),Tomato,2014,1375,2000,625,45.45454545454545
Karad,Green Chilli,2014,2175,2800,625,28.735632183908045
Shrirampur,Orange,2015,1375,2000,625,45.45454545454545
Osmanabad,Carrot,2015,675,1300,625,92.5925925925926
Chandrapur,Papai,2015,1375,2000,625,45.45454545454545
Satara,Ghevda,2014,2875,3500,625,21.73913043478261
Vai,Pavata,2014,2250,2875,625,27.77777777777778
Nandura,Gram,2016,3585,4210,625,17.433751743375176
Sillod,Gram,2016,6425,7050,625,9.727626459143968
Patan,Cluster Bean,2014,2500,3125,625,25.0
Jintur-Bori,Pigeon Pea (Tur),2016,7890,8515,625,7.921419518377693
Bori Arab,Soybean,2014,2610,3235,625,23.946360153256705
Pune-Pimpri,Green-Peas,2016,4500,5125,625,13.88888888888889
Ahmednagar,Cabbage,2016,275,900,625,227.27272727272728
Patan,Pavtta,2016,3875,4500,625,16.129032258064516
Jalgaon Jamod-Aasalgaon,GREEN GRAM,2016,4100,4725,625,15.24390243902439
Patan,Cluster Bean,2014,3000,3625,625,20.833333333333332
Gadhinglaj,Jaggery,2016,2388,3013,625,26.172529313232832
Pune,Tomato,2014,330,955,625,189.3939393939394
Chopda,Sesamum,2015,5385,6010,625,11.606313834726091
Ratanagari,Bitter Gourd,2015,3125,3750,625,20.0
Lonand,Gram,2015,3900,4525,625,16.025641025641026
Chandrapur-Ganjwad,Green-Peas,2015,800,1425,625,78.125
Murud,Rice(Paddy-Hus),2016,2542,3167,625,24.586939417781274
Jalgaon Jamod-Aasalgaon,PIGEON PEA (TUR),2016,4825,5450,625,12.953367875647668
Kurdwadi-Modnimb,Onion,2016,117,742,625,534.1880341880342
Shrirampur,Lemon,2014,2813,3438,625,22.218272307145398
Ratanagari,Bitter Gourd,2014,2625,3250,625,23.80952380952381
Rahata,Brinjal,2016,1158,1783,625,53.972366148531954
Ratanagari,Green-Peas,2015,3333,3958,625,18.751875187518753
Shrirampur,Orange,2014,2375,3000,625,26.31578947368421
Pune,Gr.Nut Kernels,2016,7525,8150,625,8.305647840531561
Sangrampur-Varvatbakal,Green Gram,2016,4990,5615,625,12.525050100200401
Shegaon,Black Gram,2016,7625,8250,625,8.19672131147541
Jalgaon,Methi (Bhaji),2016,456,1081,625,137.06140350877192
Satara,Carrot,2016,1708,2333,625,36.59250585480094
Akhadabalapur,Pigeon Pea (Tur),2016,7875,8500,625,7.936507936507937
Manchar,Ladies Finger,2015,3325,3950,625,18.796992481203006
Amarawati,Ginger (Fresh),2016,2058,2683,625,30.369290573372204
Ahmednagar,Green Gram,2015,7350,7975,625,8.503401360544217
Ratanagari,Bottle Gourd,2016,1250,1875,625,50.0
Shrirampur,Grapes,2015,2479,3104,625,25.211778943122226
Aurangabad,Tomato,2014,1144,1768,624,54.54545454545455
Aurangabad,Cluster Bean,2016,2124,2748,624,29.37853107344633
Chandrapur-Ganjwad,Flower,2016,271,895,624,230.25830258302582
Pune,Potato,2015,581,1205,624,107.40103270223752
Mumbai-Fruit Market,Chikoo,2016,1194,1818,624,52.26130653266332
Mumbai,Tomato,2014,460,1084,624,135.65217391304347
Gevrai,Wheat(Husked),2015,1523,2147,624,40.97176625082075
Ratanagari,Capsicum,2015,1424,2048,624,43.82022471910113
Pune,Carrot,2015,714,1338,624,87.39495798319328
Jalgaon,Black Gram,2015,10282,10906,624,6.068858198794009
Aurangabad,Sorgum(Jawar),2014,1645,2269,624,37.933130699088146
Sakri,Onion,2016,198,821,623,314.64646464646466
Ambad(Vadi Godri),Sorgum(Jawar),2016,1485,2108,623,41.95286195286195
Mumbai,Grapes,2014,3148,3771,623,19.790343074968234
Aarni,Soybean,2016,3075,3698,623,20.260162601626018
Majalgaon,Sorgum(Jawar),2015,1455,2078,623,42.81786941580756
Ambejogai,Gram,2014,2162,2785,623,28.8159111933395
Shegaon,Thymol/Lovage,2016,11065,11688,623,5.630366018978762
Kurdwadi,Onion,2016,220,843,623,283.1818181818182
Nandura,Pigeon Pea (Tur),2016,8543,9166,623,7.292520191970034
Lasalgaon,Onion,2016,343,966,623,181.6326530612245
Gevrai,Green Gram,2015,7413,8036,623,8.404154863078375
Mumbai,Flower,2016,758,1381,623,82.18997361477572
Akot,Gram,2015,4381,5004,623,14.22049760328692
Pune,Sweet Potato,2016,1006,1629,623,61.92842942345924
Pune,Gram,2014,3100,3723,623,20.096774193548388
Aurangabad,Cucumber,2016,1292,1915,623,48.21981424148607
Umared,Pigeon Pea (Tur),2015,6175,6798,623,10.089068825910932
Mumbai,Split Gram,2015,5845,6468,623,10.658682634730539
Nandurbar,Sunflower,2015,2866,3489,623,21.73761339846476
Malegaon,Bajri,2016,1600,2223,623,38.9375
Shegaon,Pigeon Pea (Tur),2016,7634,8257,623,8.160859313597065
Nashik,Onion,2016,170,793,623,366.47058823529414
Osmanabad,Wheat(Husked),2016,2418,3040,622,25.723738626964433
Karad,Cluster Bean,2015,2478,3100,622,25.10088781275222
Karad,Chikoo,2016,2389,3011,622,26.03599832565927
Aurangabad,Ladies Finger,2015,2105,2727,622,29.548693586698338
Kalvan,Pigeon Pea (Tur),2015,7592,8214,622,8.192834562697577
Lonar,Gram,2015,4142,4764,622,15.016900048285851
Sangrampur-Varvatbakal,PIGEON PEA (TUR),2016,4764,5386,622,13.056255247691016
Barshi,Pigeon Pea (Tur),2015,7543,8165,622,8.246055945910115
Aarni,Gram,2016,5938,6560,622,10.47490737622095
Patan,Ghevda,2016,2339,2961,622,26.59256092347157
Raver,Black Gram,2016,12059,12681,622,5.157973297951737
Amalner,Pigeon Pea (Tur),2016,6254,6876,622,9.945634793732012
Patan,Pavtta,2015,2467,3089,622,25.212809079854075
Satara,Cucumber,2014,1574,2196,622,39.51715374841169
Barshi-Vairag,Pigeon Pea (Tur),2015,4630,5252,622,13.434125269978402
Karad,Cluster Bean,2014,2100,2722,622,29.61904761904762
Karad,Ghevda,2014,2122,2744,622,29.3119698397738
Ramtek,Ladies Finger,2016,1069,1691,622,58.18521983161833
Sindi (Selu),Cotton,2016,3830,4452,622,16.240208877284594
Satara,Flower,2016,815,1437,622,76.31901840490798
Latur,Gram,2016,6423,7045,622,9.683948310758213
Barshi,Flower,2016,1019,1641,622,61.040235525024535
Pune,Bottle Gourd,2016,383,1004,621,162.1409921671018
Dindori-Vani,Onion,2015,1126,1747,621,55.150976909413856
Pune,Lentil,2015,7175,7796,621,8.655052264808363
Daryapur,Pigeon Pea (Tur),2016,5971,6592,621,10.400267961815441
Yeola,Gram,2014,2929,3550,621,21.20177534994879
Pune,Black Gram,2014,5853,6474,621,10.609943618657098
Tuljapur,Black Gram,2015,8480,9101,621,7.32311320754717
Dudhani,Gram,2015,3824,4445,621,16.239539748953973
Mangrulpeer,Pigeon Pea (Tur),2016,8514,9135,621,7.293868921775899
Manchar,Methi (Bhaji),2015,222,843,621,279.72972972972974
Sindi (Selu),Gram,2016,5208,5829,621,11.923963133640553
Dhule,Horse Gram,2015,2082,2703,621,29.827089337175792
Nandura,Soybean,2016,2249,2870,621,27.61227212094264
Ratanagari,Ladies Finger,2015,2132,2753,621,29.127579737335836
Phaltan,Onion,2016,200,821,621,310.5
Jalgaon,Mango(Raw),2015,1063,1684,621,58.419567262464724
Karad,Jaggery,2016,3240,3861,621,19.166666666666668
Dound,Lemon,2016,475,1096,621,130.73684210526315
Ausa,Gram,2014,1888,2508,620,32.83898305084746
Aurangabad,Bor,2015,1070,1690,620,57.94392523364486
Udgir,Tamarind,2016,6433,7053,620,9.637805067620084
Pathardi,Gram,2015,3580,4200,620,17.318435754189945
Karad,Bor,2015,590,1210,620,105.08474576271186
Nandura,Pigeon Pea (Tur),2016,5868,6488,620,10.565780504430812
Telhara,Pigeon Pea (Tur),2016,7050,7670,620,8.794326241134751
Karad,Chikoo,2014,1120,1740,620,55.357142857142854
Osmanabad,Tomato,2015,560,1180,620,110.71428571428571
Rahuri,Cabbage,2016,200,820,620,310.0
Ashti-Karanja,Gram,2016,5031,5651,620,12.323593718942556
Kamthi,LADIES FINGER,2016,660,1280,620,93.93939393939394
Pune,Tomato,2016,415,1035,620,149.3975903614458
Dound,Sorgum(Jawar),2015,1605,2225,620,38.62928348909657
Pune,BEET ROOT,2016,404,1024,620,153.46534653465346
Nandura,Soybean,2015,3080,3700,620,20.12987012987013
Shirpur,Cowpea,2015,4374,4994,620,14.17466849565615
Manchar,Green Chilli,2015,2470,3090,620,25.101214574898787
Satara,Green-Peas,2015,2625,3245,620,23.61904761904762
Pune,Flower,2015,415,1035,620,149.3975903614458
Jalna,Gram,2015,3748,4368,620,16.542155816435432
Satara,Shevga,2016,1100,1720,620,56.36363636363637
Amarawati-Fruit And Vegetables,Papai,2016,1660,2280,620,37.34939759036145
Nagpur,Wal Bhaji,2015,2487,3107,620,24.929634097305993
Amalner,Pigeon Pea (Tur),2015,7116,7736,620,8.712759977515459
Jalgaon,Potato,2014,1762,2382,620,35.18728717366629
Ramtek,Flower,2015,1406,2026,620,44.09672830725462
Chandrapur-Ganjwad,Carrot,2014,1610,2230,620,38.50931677018634
Pandharpur,Potato,2016,355,975,620,174.64788732394365
Paranda,Pigeon Pea (Tur),2015,8449,9069,620,7.3381465262161205
Kalyan,Guava,2016,2520,3140,620,24.603174603174605
Pune,Gram,2014,3147,3767,620,19.701302828090245
Pathardi,Wheat(Husked),2015,1513,2133,620,40.97818902842036
Dindori,Onion,2015,655,1275,620,94.65648854961832
Majalgaon,Soybean,2016,3064,3684,620,20.234986945169712
Telhara,Pigeon Pea (Tur),2015,8900,9520,620,6.966292134831461
Bhivandi,Wheat(Husked),2014,1460,2080,620,42.465753424657535
Hinganghat,Cotton,2016,4100,4720,620,15.121951219512194
Pune-Manjri,BOTTLE GOURD,2016,683,1303,620,90.77598828696925
Vai,Ginger (Fresh),2015,3081,3700,619,20.09087958455047
Hingoli,Turmeric,2015,6937,7556,619,8.923165633559176
Parner,Onion,2016,300,919,619,206.33333333333334
Indapur-Bhigwan,Bajri,2016,1475,2094,619,41.96610169491525
Khed (Shel Pimpalgaon),Ladies Finger,2016,1601,2220,619,38.663335415365395
Pune-Pimpri,Bottle Gourd,2015,1295,1914,619,47.7992277992278
Hinganghat,Gram,2015,2848,3467,619,21.734550561797754
Rahata,Bitter Gourd,2015,1536,2155,619,40.299479166666664
Sailu,Pigeon Pea (Tur),2016,8156,8775,619,7.58950465914664
Malkapur,Soybean,2015,3002,3621,619,20.61958694203864
Khamgaon,Gram,2016,4727,5346,619,13.094986249206684
Akluj,Potato,2015,1017,1636,619,60.86529006882989
Pune-Manjri,Ghosali(Bhaji),2016,3343,3962,619,18.516302722105895
Pandharpur,Tomato,2015,179,798,619,345.8100558659218
Phaltan,Bajri,2015,1275,1894,619,48.549019607843135
Samudrapur,Soybean,2015,3111,3730,619,19.89713918354227
Dhule,Onion,2016,281,900,619,220.28469750889678
Osmanabad,Sweet Potato,2015,736,1355,619,84.10326086956522
Chandrapur-Ganjwad,Flower,2016,833,1452,619,74.30972388955583
Malegaon,Sorgum(Jawar),2015,2151,2770,619,28.777312877731287
Satara,Flower,2016,1976,2595,619,31.32591093117409
Ambad(Vadi Godri),Wheat(Husked),2015,1537,2156,619,40.27325959661679
Karmala,Sunflower,2016,2575,3194,619,24.038834951456312
Manchar,Maize(Corn.),2016,783,1402,619,79.05491698595146
Pune,Snake Gourd,2015,695,1314,619,89.06474820143885
Nagpur,Soybean,2015,3154,3773,619,19.62587190868738
Ashti-Karanja,Soybean,2016,3100,3719,619,19.967741935483872
Sakri,Onion,2016,122,741,619,507.37704918032784
Jalgaon,Chavli (Shenga ),2016,1382,2000,618,44.7178002894356
Jalgaon,Potato,2014,1909,2527,618,32.3729701414353
Murud,Rice(Paddy-Hus),2015,2456,3074,618,25.1628664495114
Palghar(Bevur),Rice(Paddy-Hus),2016,2426,3044,618,25.474031327287715
Amarawati-Fruit And Vegetables,Ginger (Fresh),2016,2417,3035,618,25.56888705006206
Lonar,Pigeon Pea (Tur),2015,6624,7242,618,9.329710144927537
Aurangabad,Guava,2015,894,1512,618,69.12751677852349
Taloda,Green Gram,2015,5676,6294,618,10.887949260042284
Arvi,Soybean,2015,2736,3354,618,22.587719298245613
Wardha,Gram,2016,6451,7069,618,9.57991009145869
Karad,BOR,2016,2182,2800,618,28.32263978001833
Nandura,Gram,2016,4702,5320,618,13.143343258188006
Ahmednagar,Pigeon Pea (Tur),2016,7273,7891,618,8.497181355699162
Jalgaon,Wal Papdi,2016,1827,2445,618,33.825944170771756
Pune,Flower,2016,391,1009,618,158.05626598465474
Pune,Potato,2016,1305,1923,618,47.35632183908046
Gangapur,Onion,2016,183,801,618,337.7049180327869
Chandrapur-Ganjwad,Bitter Gourd,2014,955,1573,618,64.71204188481676
Ausa,Gram,2015,3508,4126,618,17.616875712656785
Pune-Manjri,Flower,2014,1088,1706,618,56.8014705882353
Kolhapur,Potato,2016,696,1313,617,88.64942528735632
Solapur,Jaggery,2015,1797,2414,617,34.33500278241514
Pune,Beet Root,2015,558,1175,617,110.57347670250896
Chandrapur-Ganjwad,Wal Bhaji,2015,1300,1917,617,47.46153846153846
Majalgaon,Sorgum(Jawar),2016,1303,1920,617,47.35226400613968
Phaltan,BRINJAL,2016,650,1267,617,94.92307692307692
Lonar,Gram,2015,4211,4828,617,14.65210163856566
Dound,Cowpea,2015,5833,6450,617,10.577747299845706
Chandur Bajar,Black Gram,2016,5633,6250,617,10.953310846795668
Rahata,Ginger (Fresh),2016,1550,2167,617,39.806451612903224
Ulhasnagar,Onion,2016,850,1467,617,72.58823529411765
Aurangabad,Bor,2015,1500,2117,617,41.13333333333333
Sangrampur,Green Gram,2016,5083,5700,617,12.138500885303955
Kolhapur,Potato,2015,671,1288,617,91.95230998509687
Palus,Bitter Gourd,2016,1443,2060,617,42.75814275814276
Dondaicha,Pigeon Pea (Tur),2015,4789,5406,617,12.883691793693881
Nashik,Squash Gourd,2016,910,1527,617,67.8021978021978
Manmad,Green Gram,2015,7254,7871,617,8.505652054039151
Kalyan,Rice(Paddy-Hus),2015,2733,3350,617,22.575923893157704
Ahmednagar,Potato,2015,250,867,617,246.8
Nashik-Devlali,Coriander  ,2016,715,1332,617,86.2937062937063
Ahmednagar,Potato,2016,533,1150,617,115.75984990619136
Lasur Station,Sorgum(Jawar),2015,1423,2040,617,43.35910049191848
Shrirampur,Gram,2016,5258,5875,617,11.734499809813617
Ramtek,Spinach,2016,2300,2917,617,26.82608695652174
Nashik,Shepu,2015,708,1325,617,87.14689265536722
Baramati,Sorgum(Jawar),2015,1475,2092,617,41.83050847457627
Akluj,Tomato,2015,1063,1679,616,57.94920037629351
Ratanagari,Ladies Finger,2015,2316,2932,616,26.597582037996546
Beed,Sorgum(Jawar),2015,1610,2226,616,38.26086956521739
Shahapur,Ladies Finger,2016,2179,2795,616,28.269848554382744
Sailu,Green Gram,2016,4197,4813,616,14.67715034548487
Phaltan,Bajri,2016,1617,2233,616,38.095238095238095
Nandura,Pigeon Pea (Tur),2014,4406,5022,616,13.980935088515661
Nagpur,Soybean,2014,2817,3433,616,21.867234646787363
Solapur,Green Peas (Dry),2014,3538,4154,616,17.410966647823628
Mumbai,Bitter Gourd,2014,2328,2944,616,26.460481099656356
Pune-Manjri,Flower,2014,892,1508,616,69.05829596412556
Shevgaon,Gram,2016,6046,6662,616,10.188554416142905
Nagpur,Gram,2016,3771,4387,616,16.335189604879343
Kada,Wheat(Husked),2014,1407,2023,616,43.78109452736319
Khamgaon,Cotton,2016,4817,5433,616,12.78804235001038
Amarawati-Fruit And Vegetables,Lemon,2016,1613,2229,616,38.18970861748295
Mumbai,Ridge Gourd,2014,2368,2984,616,26.013513513513512
Osmanabad,Gram,2015,3331,3947,616,18.49294506154308
Satara,Brinjal,2015,812,1428,616,75.86206896551724
Karanja,Black Gram,2015,5217,5833,616,11.807552233084149
Loha,Turmeric,2014,5134,5750,616,11.998441760810284
Lasur Station,Pigeon Pea (Tur),2015,5045,5661,616,12.210109018830526
Nashik,Potato,2014,1942,2558,616,31.71987641606591
Kej,Pigeon Pea (Tur),2016,6884,7500,616,8.94828588030215
Latur,Green Gram,2015,6838,7454,616,9.008482012284293
Satara,Ladies Finger,2015,1288,1904,616,47.82608695652174
Devala,Onion,2016,301,917,616,204.65116279069767
Ambad(Vadi Godri),Sorgum(Jawar),2015,1385,2001,616,44.47653429602888
Majalgaon,Soybean,2016,3051,3667,616,20.190101606030808
Kolhapur,Potato,2015,638,1254,616,96.55172413793103
Akluj,Bor,2015,716,1332,616,86.03351955307262
Latur-Murud,Soybean,2016,3108,3724,616,19.81981981981982
Junnar (Alephata),Onion,2015,895,1510,615,68.71508379888269
Kamthi,Onion,2016,614,1229,615,100.1628664495114
Aurangabad,Brinjal,2015,1250,1865,615,49.2
Ratanagari,Tomato,2015,552,1167,615,111.41304347826087
Anajngaon Surji,Black Gram,2015,7125,7740,615,8.631578947368421
Kalvan,Wheat(Husked),2015,1324,1939,615,46.45015105740181
Arvi,Soybean,2015,3082,3697,615,19.954574951330304
Mumbai,Green-Peas,2015,2731,3346,615,22.519223727572317
Shegaon,Soybean,2016,3156,3771,615,19.486692015209126
Paithan,Pigeon Pea (Tur),2016,7636,8251,615,8.053954950235726
Pusad,Gram,2014,2188,2803,615,28.107861060329068
Parbhani,Green Gram,2015,7001,7616,615,8.78445936294815
Lonar,Black Gram,2016,6588,7203,615,9.335154826958105
Sonpeth,Gram,2016,5022,5637,615,12.246117084826762
Kalamb (Os),Coriander (Dry),2016,6490,7105,615,9.476117103235747
Ramtek,Onion,2015,3000,3615,615,20.5
Nashik,Kanda Pat,2016,650,1265,615,94.61538461538461
Pune-Manjri,Flower,2015,650,1265,615,94.61538461538461
Majalgaon,Bajri,2016,1432,2047,615,42.94692737430167
Karanja,Pigeon Pea (Tur),2015,6896,7511,615,8.918213457076567
Amarawati,Ginger (Fresh),2016,2705,3320,615,22.735674676524955
Mumbai,Melon,2015,1685,2300,615,36.49851632047478
Manchar,Wal Papdi,2015,2100,2715,615,29.285714285714285
Kolhapur,Water Melon,2016,210,825,615,292.85714285714283
Kurdwadi-Modnimb,Onion,2016,111,726,615,554.0540540540541
Kopargaon,Soybean,2016,3032,3647,615,20.28364116094987
Solapur,Banana,2014,525,1140,615,117.14285714285714
Nampur,Onion,2016,400,1015,615,153.75
Varora,Soybean,2015,3020,3635,615,20.364238410596027
Dound,Sorgum(Jawar),2016,1855,2470,615,33.15363881401617
Jalgaon,Brinjal,2015,711,1326,615,86.49789029535864
Shrirampur,Ladies Finger,2015,2250,2865,615,27.333333333333332
Lasur Station,Gram,2014,2114,2729,615,29.091769157994325
Katol,Gram,2016,5111,5726,615,12.03287027978869
Pune-Moshi,Ghevda,2016,1996,2611,615,30.811623246492985
Ramtek,Cluster Bean,2016,2414,3029,615,25.476387738193868
Nashik,Cabbage,2016,639,1254,615,96.24413145539906
Ausa,Pigeon Pea (Tur),2015,6554,7169,615,9.38358254501068
Gevrai,Sorgum(Jawar),2015,1185,1800,615,51.89873417721519
Shahapur,Ghosali(Bhaji),2015,1980,2595,615,31.060606060606062
Mehkar,Soybean,2015,3263,3878,615,18.847686178363467
Kamthi,Spinach,2015,607,1221,614,101.15321252059309
Aurangabad,Mango(Raw),2015,1229,1843,614,49.959316517493896
Shahapur,Bitter Gourd,2015,3329,3943,614,18.443977170321418
Patan,Green Chilli,2014,2295,2909,614,26.753812636165577
Lasalgaon,Wheat(Husked),2016,1554,2168,614,39.51093951093951
Baramati,Soybean,2015,3001,3615,614,20.459846717760747
Satara,Bitter Gourd,2014,1977,2591,614,31.057157309054123
Jalgaon,Potato,2016,1157,1771,614,53.06828003457217
Mangalwedha,Wheat(Husked),2016,1759,2373,614,34.90619670267197
Mumbai,Cluster Bean,2015,2929,3543,614,20.96278593376579
Kolhapur-Laxmipuri,Gram,2015,3500,4114,614,17.542857142857144
Chandur Bajar,Soybean,2016,3060,3674,614,20.065359477124183
Risod,Gram,2016,6045,6659,614,10.157154673283706
Aurangabad,Cluster Bean,2014,2619,3233,614,23.444062619320352
Nagpur,Gram,2014,2247,2861,614,27.325322652425456
Barshi,Cabbage,2016,872,1486,614,70.41284403669725
Pune,Wal Bhaji,2015,2077,2691,614,29.56186807896004
Karad,Cluster Bean,2015,2100,2714,614,29.238095238095237
Akluj,Cabbage,2016,938,1552,614,65.45842217484008
Lasur Station,Pigeon Pea (Tur),2016,5725,6339,614,10.724890829694322
Bhokar,Gram,2014,3013,3627,614,20.37836043810156
Murbad,Ghosali(Bhaji),2016,3243,3857,614,18.93308664816528
Katol,Soybean,2015,3156,3770,614,19.455006337135615
Aurangabad,Chavli (Shenga ),2016,2229,2843,614,27.545984746523104
Nashik,Cabbage,2014,592,1206,614,103.71621621621621
Amarawati,Ginger (Fresh),2016,2595,3209,614,23.660886319845858
Jalkot,Black Gram,2015,7776,8390,614,7.8960905349794235
Loha,Black Gram,2015,7854,8468,614,7.817672523554877
Satara,CLUSTER BEAN,2016,3000,3614,614,20.466666666666665
Chalisgaon,Pigeon Pea (Tur),2016,7000,7614,614,8.771428571428572
Lonand,Wheat(Husked),2016,1500,2114,614,40.93333333333333
Umared,Cotton,2015,3650,4264,614,16.82191780821918
Karad,Ginger (Fresh),2015,2255,2868,613,27.184035476718403
Karad,Ghevda,2015,1800,2413,613,34.05555555555556
Barshi,Onion,2015,1297,1910,613,47.26291441788743
Tasgaon,BLACK GRAM,2016,5350,5963,613,11.457943925233645
Majalgaon,Sorgum(Jawar),2016,1354,1967,613,45.27326440177253
Akole,Paddy-Unhusked,2016,1500,2113,613,40.86666666666667
Ahmednagar,Gram,2015,4318,4931,613,14.196387216303844
Nandurbar,Wheat(Husked),2015,1324,1937,613,46.299093655589125
Karanja,Green Gram,2014,6432,7045,613,9.53047263681592
Chandur Bajar,Soybean,2016,3375,3988,613,18.16296296296296
Ambad(Vadi Godri),Sorgum(Jawar),2016,1551,2164,613,39.52288845905867
Pusad,Ground Nut Pods (Dry),2016,5487,6100,613,11.17186076180062
Gadhinglaj,Jaggery,2015,1794,2407,613,34.16945373467112
Lonand,Sorgum(Jawar),2015,1600,2213,613,38.3125
Mantha,Wheat(Husked),2015,1450,2063,613,42.275862068965516
Sangrampur,Green Gram,2015,4700,5313,613,13.042553191489361
Pune-Moshi,Ginger (Fresh),2016,2047,2660,613,29.946262823644357
Shirala,Soybean,2014,2620,3233,613,23.396946564885496
Lonar,Gram,2016,6367,6980,613,9.627768179676456
Lonand,Onion,2016,400,1013,613,153.25
Aurangabad,Chikoo,2015,780,1393,613,78.58974358974359
Umared,Wheat(Husked),2015,1475,2088,613,41.559322033898304
Mumbai,Split Lentil,2016,5433,6046,613,11.282900791459598
Barshi-Vairag,Soybean,2014,2650,3263,613,23.132075471698112
Jalna,Soybean,2015,3100,3713,613,19.774193548387096
Varora,Gram,2015,3789,4401,612,16.152019002375297
Pune-Moshi,Chavli (Shenga ),2016,2038,2650,612,30.029440628066734
Kolhapur,FLOWER,2016,250,862,612,244.8
Balapur,Pigeon Pea (Tur),2015,4413,5025,612,13.868116927260367
Karad,Green Chilli,2016,2873,3485,612,21.301775147928993
Phaltan,PAVTTA,2016,2463,3075,612,24.84774665042631
Pune-Manjri,Lemon,2016,0,612,612,inf
Shirpur,Chillies(Red),2016,2606,3218,612,23.48426707597851
Rahuri,Cabbage,2016,138,750,612,443.4782608695652
Arvi,Soybean,2014,2803,3415,612,21.833749554049234
Dhule,Wheat(Husked),2015,1099,1711,612,55.686988171064606
Nandurbar,Ground Nut Pods (Dry),2015,2594,3206,612,23.5929067077872
Nandura,Black Gram,2014,4752,5364,612,12.878787878787879
Karad,SHEVGA,2016,3192,3804,612,19.172932330827066
Pune,Cucumber,2016,540,1152,612,113.33333333333333
Solapur,Banana,2014,467,1079,612,131.0492505353319
Rahata,Capsicum,2016,2442,3054,612,25.061425061425062
Akole,Gram,2015,3338,3950,612,18.334331935290592
Tumsar,Rice(Paddy-Hus),2016,2790,3402,612,21.93548387096774
Patan,Ginger (Fresh),2016,2059,2671,612,29.723166585721223
Khamgaon,Gram,2015,2956,3568,612,20.70365358592693
Karad,Chikoo,2015,1780,2392,612,34.38202247191011
Sailu,Green Gram,2016,4482,5094,612,13.654618473895582
Vai,Ridge Gourd,2016,2563,3175,612,23.87826765509169
Pathardi,Wheat(Husked),2016,1538,2150,612,39.79193758127438
Gevrai,Sorgum(Jawar),2015,1615,2227,612,37.89473684210526
Indapur-Bhigwan,Bajri,2016,1463,2075,612,41.83185235816815
Murum,Black Gram,2016,6459,7071,612,9.475150952159778
Akkolkot,Pigeon Pea (Tur),2016,9029,9641,612,6.778159264591871
Junnar (Narayangaon),Tomato,2016,316,928,612,193.67088607594937
Nira-Saswad,Bajri,2016,1520,2131,611,40.19736842105263
Majalgaon,Gram,2015,3815,4426,611,16.01572739187418
Nandura,Gram,2015,3619,4230,611,16.883116883116884
Chandrapur-Ganjwad,Brinjal,2015,500,1111,611,122.2
Aurangabad,Onion,2016,133,744,611,459.3984962406015
Vaijapur,Onion,2016,222,833,611,275.22522522522524
Dondaicha,Ground Nut Pods (Dry),2015,4244,4855,611,14.39679547596607
Ratanagari,Bitter Gourd,2014,2889,3500,611,21.149186569747318
Shrirampur,Tomato,2016,2972,3583,611,20.558546433378197
Karad,Pavata,2015,1889,2500,611,32.34515616728428
Kannad,Pigeon Pea (Tur),2016,7300,7911,611,8.36986301369863
Shahapur,Capsicum,2016,1167,1778,611,52.35646958011996
Lasalgaon-Vinchur,Gram,2016,3972,4583,611,15.382678751258812
Rahata,Ground Nut Pods (Dry),2016,3556,4167,611,17.1822272215973
Chandvad,Cucumber,2016,428,1039,611,142.7570093457944
Shrirampur,Custard Apple,2016,1667,2278,611,36.65266946610678
Kurdwadi-Modnimb,Gram,2016,3675,4286,611,16.625850340136054
Nira-Saswad,Wheat(Husked),2016,1625,2235,610,37.53846153846154
Phaltan,Wheat(Husked),2014,1570,2180,610,38.853503184713375
Sindi,Gram,2016,5055,5665,610,12.067260138476756
Sangrampur,Soybean,2014,2533,3143,610,24.082116067903673
Chandur Bajar,Gram,2014,2233,2843,610,27.317510076130766
Kalamb (Os),WHEAT(HUSKED),2016,2106,2716,610,28.96486229819563
Jalgaon,Lemon,2015,920,1530,610,66.30434782608695
Gevrai,Pigeon Pea (Tur),2014,3863,4473,610,15.7908361377168
Dhamangaon-Rly,Pigeon Pea (Tur),2016,5728,6338,610,10.649441340782124
Nashik,Wal Papdi,2015,460,1070,610,132.6086956521739
Lasalgaon,Soybean,2015,2841,3451,610,21.471312917986623
Sangali,Wheat(Unhusked),2014,3750,4360,610,16.266666666666666
Vadgaon Peth,GREEN CHILLI,2016,960,1570,610,63.541666666666664
Kalamb (Os),Wheat(Husked),2015,1352,1962,610,45.11834319526627
Chandrapur-Ganjwad,Bitter Gourd,2014,1340,1950,610,45.52238805970149
Nashik,Shahale ,2016,1858,2468,610,32.83100107642626
Deglur,Green Gram,2016,4300,4910,610,14.186046511627907
Sangali,Lentil,2016,5950,6560,610,10.252100840336135
Vai,Ginger (Fresh),2015,3577,4187,610,17.053396701146212
Manora,Pigeon Pea (Tur),2014,4490,5100,610,13.585746102449889
Amarawati-Fruit And Vegetables,Papai,2016,1220,1830,610,50.0
Ratanagari,Carrot,2015,1750,2360,610,34.857142857142854
Nilanga,Pigeon Pea (Tur),2016,8350,8960,610,7.3053892215568865
Aurangabad,GINGER (FRESH),2016,1045,1655,610,58.3732057416268
Chandur Bajar,Pigeon Pea (Tur),2016,7775,8385,610,7.845659163987138
Pune,Squash Gourd,2014,490,1100,610,124.48979591836735
Shahada,Green Gram,2015,5883,6493,610,10.3688594254632
Jalgaon,Flower,2016,2159,2768,609,28.207503473830478
Shahapur,Bitter Gourd,2015,2164,2773,609,28.142329020332717
Satara,Capsicum,2014,2652,3261,609,22.963800904977376
Karad,Squash Gourd,2016,3081,3690,609,19.76630963972736
Shahapur,Brinjal,2016,2682,3291,609,22.706935123042506
Mumbai,Curry Leaves,2015,1304,1913,609,46.70245398773006
Ahmedpur,Pigeon Pea (Tur),2016,6144,6753,609,9.912109375
Mangalwedha,TOMATO,2016,171,780,609,356.140350877193
Majalgaon,Bajri,2014,1060,1669,609,57.45283018867924
Vadgaon Peth,Brinjal,2015,655,1264,609,92.97709923664122
Satara,Cluster Bean,2016,1718,2327,609,35.44819557625146
Satara,Ladies Finger,2015,1743,2352,609,34.93975903614458
Nilanga,Gram,2015,3724,4333,609,16.353383458646615
Chikhali,Pigeon Pea (Tur),2015,4834,5443,609,12.598262308647083
Aurangabad,Mango(Raw),2016,2882,3491,609,21.13115891741846
Khamgaon,Gram,2016,3917,4526,609,15.547612969109013
Hingoli,Pigeon Pea (Tur),2014,4360,4969,609,13.96788990825688
Chakur,Pigeon Pea (Tur),2016,8114,8723,609,7.5055459699285185
Chandrapur-Ganjwad,Tomato,2015,583,1192,609,104.45969125214408
Jalna,Gram,2016,5724,6333,609,10.639412997903564
Babhulgaon,Gram,2016,5003,5612,609,12.172696382170697
Jalgaon,Wal Papdi,2016,1055,1664,609,57.725118483412324
Pandharkawada,Pigeon Pea (Tur),2015,4778,5387,609,12.745918794474676
Satara,Pavtta,2014,2739,3348,609,22.234392113910186
Ahmedpur,Paddy-Unhusked,2015,801,1410,609,76.02996254681648
Satara,Pavtta,2016,3348,3957,609,18.189964157706093
Lasalgaon,Bajri,2016,1461,2070,609,41.68377823408624
Kalamb (Os),Wheat(Husked),2014,1339,1947,608,45.40702016430172
Kopargaon,Gram,2015,3214,3822,608,18.91723708774113
Murtizapur,Pigeon Pea (Tur),2016,8458,9066,608,7.188460628990305
Nagpur,Coriander  ,2016,2938,3546,608,20.694349897889722
Navapur,Green Chilli,2016,4821,5429,608,12.611491391827421
Patan,Ginger (Fresh),2016,2300,2908,608,26.434782608695652
Katol,Gram,2016,4705,5313,608,12.922422954303933
Yeola,Gram,2015,3606,4214,608,16.860787576261785
Aurangabad,Ladies Finger,2016,2092,2700,608,29.063097514340345
Chandrapur-Ganjwad,Flower,2014,515,1123,608,118.05825242718447
Lasur Station,Wheat(Husked),2016,1524,2132,608,39.89501312335958
Pathardi,Wheat(Husked),2016,1623,2231,608,37.4614910659273
Mumbai,Curry Leaves,2014,1228,1836,608,49.5114006514658
Karad,Bitter Gourd,2016,3673,4281,608,16.553226245575825
Akola,PIGEON PEA (TUR),2016,5329,5937,608,11.40927003190092
Dondaicha,Pigeon Pea (Tur),2016,6527,7135,608,9.31515244369542
Nandura,Green Gram,2016,4515,5123,608,13.466223698781839
Hinganghat,Gram,2015,3775,4383,608,16.105960264900663
Mumbai-Fruit Market,MOSAMBI,2016,1304,1912,608,46.625766871165645
Satara,Carrot,2015,1107,1714,607,54.83288166214995
Mumbai,Green Chilli,2016,6662,7269,607,9.111377964575203
Vai,Green Chilli,2015,3000,3607,607,20.233333333333334
Karanja,Pigeon Pea (Tur),2015,6646,7253,607,9.133313271140535
Pune-Manjri,Onion,2015,680,1287,607,89.26470588235294
Lonar,Black Gram,2015,6269,6876,607,9.682565002392726
Parner,Onion,2016,308,915,607,197.07792207792207
Jalgaon,Jaggery,2015,2204,2811,607,27.540834845735027
Chandur Rly.,Pigeon Pea (Tur),2016,7624,8231,607,7.961699895068206
Shegaon,Thymol/Lovage,2016,13413,14020,607,4.525460374263774
Osmanabad,Sorgum(Jawar),2015,1291,1898,607,47.01781564678544
Aarni,Soybean,2016,3067,3674,607,19.791327029670686
Aarni,Pigeon Pea (Tur),2016,8183,8790,607,7.417817426371746
Anajngaon Surji,Pigeon Pea (Tur),2015,6672,7279,607,9.097721822541967
Pusad,Wheat(Husked),2016,1579,2186,607,38.44205193160228
Chandrapur,Papai,2015,807,1414,607,75.21685254027261
Akluj,Bitter Gourd,2014,1208,1815,607,50.24834437086093
Amarawati,Soybean,2015,2650,3257,607,22.90566037735849
Akola,Gram,2016,7225,7831,606,8.387543252595156
Hinganghat,Soybean,2014,2878,3484,606,21.05628908964559
Akkolkot,Black Gram,2016,7531,8137,606,8.04674014075156
Sangrampur,Soybean,2015,2729,3335,606,22.205936240381092
Pune-Pimpri,Bottle Gourd,2016,1144,1750,606,52.97202797202797
Nandura,GRAM,2016,7664,8270,606,7.907098121085595
Sailu,Sorgum(Jawar),2015,1321,1927,606,45.87433762301287
Lasalgaon,Soybean,2015,2756,3362,606,21.988388969521043
Umarga,Green Gram,2016,3898,4504,606,15.546434068753207
Indapur-Bhigwan,Bajri,2015,1400,2006,606,43.285714285714285
Mumbai,Potato,2016,761,1367,606,79.63206307490144
Akluj,Carrot,2016,567,1173,606,106.87830687830687
Pimpalgaon Basawant,Tomato,2016,299,905,606,202.67558528428094
Osmanabad,Sorgum(Jawar),2016,1542,2148,606,39.29961089494164
Vani,Pigeon Pea (Tur),2016,8083,8689,606,7.497216380056909
Chikhali,Gram,2015,3563,4169,606,17.008139208532135
Umared,Wheat(Husked),2016,1600,2206,606,37.875
Chandrapur-Ganjwad,ONION,2016,1165,1771,606,52.01716738197425
Kej,Wheat(Husked),2015,1885,2491,606,32.148541114058354
Manchar,Flower,2016,900,1505,605,67.22222222222223
Malkapur,Gram,2016,5070,5675,605,11.93293885601578
Jalgaon,Coriander (Dry),2014,10710,11315,605,5.648926237161532
Devala,Pigeon Pea (Tur),2016,6190,6795,605,9.773828756058158
Ramtek,Pigeon Pea (Tur),2016,7495,8100,605,8.072048032021348
Khed,Cabbage,2016,521,1126,605,116.12284069097889
Rajura,Cotton,2015,3347,3952,605,18.075888855691666
Shrirampur,Green Chilli,2016,2395,3000,605,25.260960334029228
Pune,Lemon,2015,95,700,605,636.8421052631579
Amarawati,Ground Nut Pods (Dry),2016,4107,4712,605,14.730947163379597
Shrirampur,Tomato,2015,1316,1921,605,45.972644376899694
Kalyan,Green-Peas,2016,4725,5330,605,12.804232804232804
Shrirampur,Ladies Finger,2016,2184,2789,605,27.7014652014652
Sailu,Pigeon Pea (Tur),2016,8068,8673,605,7.498760535448686
Lasur Station,Sorgum(Jawar),2015,1372,1977,605,44.096209912536445
Nira-Saswad,Wheat(Husked),2016,1590,2195,605,38.0503144654088
Sailu,Pigeon Pea (Tur),2016,7280,7885,605,8.31043956043956
Jalgaon,Potato,2016,853,1458,605,70.926143024619
Ratanagari,Tomato,2015,1280,1885,605,47.265625
Satara,Bitter Gourd,2015,3316,3921,605,18.24487334137515
Nagpur,Papai,2015,533,1138,605,113.50844277673546
Aurangabad,Capsicum,2014,2033,2638,605,29.758976881455975
Deglur,Black Gram,2014,5184,5789,605,11.670524691358025
Lasur Station,Green Gram,2014,6651,7256,605,9.096376484739137
Shrirampur,Mango(Raw),2016,1875,2479,604,32.21333333333333
Chandrapur-Ganjwad,Onion,2016,564,1168,604,107.09219858156028
Aarni,Pigeon Pea (Tur),2015,4723,5327,604,12.7884818970993
Dound,Gram,2016,5945,6549,604,10.159798149705635
Shirur,Tamarind,2016,2464,3068,604,24.51298701298701
Umarga,Pigeon Pea (Tur),2014,4000,4604,604,15.1
Hinganghat,Pigeon Pea (Tur),2014,4483,5087,604,13.473120678117333
Shrirampur,Green Chilli,2014,3604,4208,604,16.759156492785795
Aurangabad,Onion,2016,265,869,604,227.9245283018868
Nagpur,Capsicum,2016,4971,5575,604,12.150472741903037
Amarawati-Fruit And Vegetables,Coriander  ,2016,3463,4067,604,17.441524689575512
Kolhapur-Laxmipuri,Split Black Gram,2016,14550,15154,604,4.151202749140894
Kalyan,Papai,2015,1305,1909,604,46.28352490421456
Bhokardan,Gram,2016,3509,4113,604,17.212881162724422
Kolhapur-Laxmipuri,GR.NUT KERNELS,2016,8128,8732,604,7.431102362204724
Latur-Murud,Gram,2016,5121,5725,604,11.794571372778755
Pandharkawada,Soybean,2014,2596,3200,604,23.266563944530045
Umarga,Gram,2016,3787,4391,604,15.949300237655136
Mumbai,Papai,2015,604,1208,604,100.0
Nashik-Devlali,Shepu,2016,328,932,604,184.14634146341464
Lonand,Sorgum(Jawar),2015,1550,2154,604,38.96774193548387
Washim,BLACK GRAM,2016,6282,6885,603,9.598853868194842
Vasai,WHEAT(HUSKED),2016,1890,2493,603,31.904761904761905
Sangli-Phale Bhajipalam,Papai,2016,219,822,603,275.3424657534247
Manora,Pigeon Pea (Tur),2016,7753,8356,603,7.777634464078421
Umari,Pigeon Pea (Tur),2016,7443,8046,603,8.101571946795646
Hanegaon,SOYBEAN,2016,2134,2737,603,28.25679475164011
Nandgaon,Pigeon Pea (Tur),2016,6575,7178,603,9.171102661596958
Kurdwadi,Sorgum(Jawar),2015,1454,2057,603,41.47180192572215
Nashik,Tomato,2016,518,1121,603,116.40926640926641
Amarawati,Onion,2016,268,871,603,225.0
Lasalgaon,Onion,2016,274,877,603,220.07299270072994
Ambejogai,Gram,2016,4728,5331,603,12.753807106598984
Akola,Black Gram,2015,5171,5774,603,11.661187391220267
Pune-Moshi,Ghevda,2016,2569,3172,603,23.47216815881666
Washim,Black Gram,2015,8289,8891,602,7.26263723006394
Dhule,Cowpea,2016,3425,4027,602,17.576642335766422
Satana,WHEAT(HUSKED),2016,1673,2275,602,35.98326359832636
Khed-Chakan,Cucumber,2016,1396,1998,602,43.12320916905444
Malegaon,Green Gram,2015,7362,7964,602,8.17712578103776
Umarga,Soybean,2014,2776,3378,602,21.685878962536023
Yeotmal,Pigeon Pea (Tur),2015,8048,8650,602,7.480119284294235
Pune,Gr.Nut Kernels,2016,8075,8677,602,7.455108359133127
Devala,Green Gram,2016,5232,5834,602,11.50611620795107
Akola,Pigeon Pea (Tur),2014,4728,5330,602,12.732656514382402
Manchar,ONION,2016,371,973,602,162.26415094339623
Gevrai,Green Gram,2015,6922,7524,602,8.696908407974574
Nilanga,Black Gram,2015,8320,8922,602,7.235576923076923
Karanja,Pigeon Pea (Tur),2015,6034,6636,602,9.976798143851509
Pune,Onion,2016,524,1126,602,114.8854961832061
Mangrulpeer,Gram,2015,3315,3917,602,18.159879336349924
Mangrulpeer,Wheat(Husked),2016,1425,2027,602,42.24561403508772
Anajngaon Surji,Pigeon Pea (Tur),2016,7663,8265,602,7.855931097481404
Anajngaon Surji,Pigeon Pea (Tur),2016,5638,6240,602,10.67754522880454
Latur-Murud,Soybean,2015,3193,3794,601,18.822424052615094
Chikhali,Gram,2016,3738,4339,601,16.07811663991439
Junnar (Alephata),Onion,2016,492,1093,601,122.15447154471545
Nashik,Flower,2015,430,1031,601,139.7674418604651
Kej,WHEAT(HUSKED),2016,1400,2001,601,42.92857142857143
Nira-Saswad,Bajri,2016,1627,2228,601,36.93915181315304
Yeola,Gram,2014,2046,2647,601,29.374389051808407
Mangrulpeer,Soybean,2015,2976,3577,601,20.19489247311828
Nashik,Squash Gourd,2015,266,867,601,225.93984962406014
Mangalwedha,Pigeon Pea (Tur),2015,4474,5075,601,13.433169423334823
Gangapur,Onion,2016,200,801,601,300.5
Mehkar,Black Gram,2016,11900,12501,601,5.050420168067227
Ramtek,Pigeon Pea (Tur),2016,7414,8015,601,8.10628540598867
Shirpur,Sorgum(Jawar),2016,1332,1933,601,45.12012012012012
Barshi-Vairag,Sorgum(Jawar),2016,1740,2341,601,34.54022988505747
Manmad,Green Gram,2016,6800,7401,601,8.838235294117647
Ghoti,Tomato,2016,1135,1736,601,52.951541850220266
Lonar,Gram,2016,7015,7616,601,8.56735566642908
Akkolkot,Wheat(Husked),2015,1400,2001,601,42.92857142857143
Pachora,Green Gram,2016,4026,4627,601,14.92796820665673
Loha,Turmeric,2015,6900,7501,601,8.710144927536232
Kej,Gram,2016,4534,5135,601,13.25540361711513
Nampur,Onion,2016,333,934,601,180.48048048048048
Indapur-Bhigwan,CORIANDER (DRY),2016,6000,6600,600,10.0
Osmanabad,Shevga,2016,2000,2600,600,30.0
Karad,Squash Gourd,2016,3642,4242,600,16.474464579901152
Mumbai,Split Gram,2014,3572,4172,600,16.7973124300112
Sengaon,TURMERIC,2016,6700,7300,600,8.955223880597014
Akluj,Ground Nut Pods (Dry),2016,3000,3600,600,20.0
Pune,Gram,2015,5290,5890,600,11.342155009451796
Mumbai,Cluster Bean,2015,3000,3600,600,20.0
Indapur-Bhigwan,Horse Gram,2015,1500,2100,600,40.0
Kolhapur-Laxmipuri,Wheat(Husked),2016,2277,2877,600,26.350461133069828
Kamthi,Potato,2016,696,1296,600,86.20689655172414
Koregaon,Onion,2015,3200,3800,600,18.75
Sillod-Bharadi,Black Gram,2016,7500,8100,600,8.0
Bhivandi,Wheat(Husked),2014,1467,2067,600,40.899795501022496
Vasai,Tomato,2016,1000,1600,600,60.0
Palus,Bitter Gourd,2016,2533,3133,600,23.68732727990525
Pune-Pimpri,Ladies Finger,2016,3221,3821,600,18.627755355479664
Akole,Bajri,2016,1433,2033,600,41.8702023726448
Kamthi,Raddish,2016,422,1022,600,142.18009478672985
Jalgaon Jamod-Aasalgaon,Gram,2016,5900,6500,600,10.169491525423728
Lasalgaon,Wheat(Husked),2016,1565,2165,600,38.33865814696485
Sindi,Soybean,2015,3030,3630,600,19.801980198019802
Mantha,Pigeon Pea (Tur),2015,6500,7100,600,9.23076923076923
Kolhapur-Laxmipuri,Spilt Pigeon Pea,2016,11800,12400,600,5.084745762711864
Pandharpur,Potato,2016,500,1100,600,120.0
Balapur,Gram,2016,4990,5590,600,12.024048096192384
Shirpur,Onion,2016,200,800,600,300.0
Anajngaon Surji,Pigeon Pea (Tur),2015,7400,8000,600,8.108108108108109
Solapur,Flower,2015,360,960,600,166.66666666666666
Karad,Tomato,2016,2019,2619,600,29.71768202080238
Karad,Sweet Potato,2016,1080,1680,600,55.55555555555556
Palus,Bottle Gourd,2016,900,1500,600,66.66666666666667
Osmanabad,Sorgum(Jawar),2016,1619,2219,600,37.059913526868435
Pune,Dhemse,2014,1000,1600,600,60.0
Jalgaon,Tomato,2015,1026,1626,600,58.47953216374269
Kolhapur-Malkapur,Cabbage,2016,514,1114,600,116.73151750972762
Shevgaon,Gram,2015,3767,4367,600,15.927794000530927
Nagpur,Coriander (Dry),2015,7300,7900,600,8.219178082191782
Bhor,Rice(Paddy-Hus),2016,3533,4133,600,16.982734220209455
Nagpur,Sorgum(Jawar),2016,1600,2200,600,37.5
Akluj,Banana,2016,560,1160,600,107.14285714285714
Vadgaon Peth,Bitter Gourd,2015,1575,2175,600,38.095238095238095
Bhivandi,Potato,2015,1000,1600,600,60.0
Jalgaon Jamod-Aasalgaon,Green Gram,2015,5250,5850,600,11.428571428571429
Ghoti,Ladies Finger,2016,1760,2360,600,34.09090909090909
Indapur (Nimgaon Ketki),Sorgum(Jawar),2016,1600,2200,600,37.5
Bhiwapur,Gram,2015,3000,3600,600,20.0
Shrirampur,Pigeon Pea (Tur),2016,6180,6780,600,9.70873786407767
Jalgaon Jamod,Pigeon Pea (Tur),2015,3950,4550,600,15.189873417721518
Mumbai,Lentil,2014,5027,5627,600,11.935548040580864
Bhivandi,Rice(Paddy-Hus),2015,2323,2923,600,25.82866982350409
Amalner,Green Gram,2014,7900,8500,600,7.594936708860759
Akluj,Wheat(Unhusked),2015,2800,3400,600,21.428571428571427
Kamthi,Kanda Pat,2016,400,1000,600,150.0
Jalna,Safflower,2015,3050,3650,600,19.672131147540984
Nagpur,Sorgum(Jawar),2016,1600,2200,600,37.5
Partur,Pigeon Pea (Tur),2015,5465,6065,600,10.978956999085087
Shrirampur,Capsicum,2015,1500,2100,600,40.0
Jalgaon,Chikoo,2015,1200,1800,600,50.0
Manchar,Ghevda,2015,3005,3605,600,19.966722129783694
Mumbai,Custard Apple,2014,3100,3700,600,19.35483870967742
Shrigonda,LEMON,2016,1900,2500,600,31.57894736842105
Shrirampur,MOSAMBI,2016,2200,2800,600,27.272727272727273
Patan,Ghevda,2016,2475,3075,600,24.242424242424242
Bhokardan-Pimpalgaon Renu,BLACK GRAM,2016,5000,5600,600,12.0
Gangapur,Soybean,2016,3300,3900,600,18.181818181818183
Achalpur,Lentil,2016,4600,5200,600,13.043478260869565
Shahapur,Ladies Finger,2016,1544,2144,600,38.86010362694301
Satara,Onion,2015,944,1544,600,63.559322033898304
Jalgaon Jamod,Gram,2015,3267,3867,600,18.365472910927455
Tumsar,Gram,2015,3954,4554,600,15.174506828528072
Vadgaon Peth,Bottle Gourd,2016,850,1450,600,70.58823529411765
Jalgaon Jamod,Black Gram,2016,5300,5900,600,11.320754716981131
Baramati,Bajri,2016,1700,2300,600,35.294117647058826
Kolhapur-Laxmipuri,SPILT PIGEON PEA,2016,10733,11333,600,5.590235721606261
Shahapur,Ridge Gourd,2016,2775,3375,600,21.62162162162162
Jalgaon Jamod,Ground Nut Pods (Dry),2015,3600,4200,600,16.666666666666668
Nanded,Pigeon Pea (Tur),2016,7917,8517,600,7.578628268283441
Kamthi,Squash Gourd,2016,1060,1660,600,56.60377358490566
Mumbai,Cluster Bean,2015,2500,3100,600,24.0
Indapur-Bhigwan,Bajri,2015,1251,1851,600,47.961630695443645
Manchar,Maize(Corn.),2014,200,800,600,300.0
Karad,Green Chilli,2015,2714,3314,600,22.10759027266028
Manchar,Ladies Finger,2015,1600,2200,600,37.5
Lasalgaon,Black Gram,2016,8401,9001,600,7.142006903940007
Akole,Bhagar/Vari,2014,2000,2600,600,30.0
Varora,Soybean,2016,3307,3907,600,18.143332325370427
Akole,Bhagar/Vari,2014,2000,2600,600,30.0
Akluj,Banana,2015,200,800,600,300.0
Pandharpur,Potato,2015,850,1450,600,70.58823529411765
Rahata,Bor,2015,1750,2350,600,34.285714285714285
Aurangabad,Coriander  ,2015,300,900,600,200.0
Karad,Cluster Bean,2014,2667,3267,600,22.49718785151856
Manchar,Onion,2015,1700,2300,600,35.294117647058826
Aurangabad,Chavli (Shenga ),2015,2013,2613,600,29.806259314456035
Nira,Bajri,2015,1500,2100,600,40.0
Nira,Bajri,2015,1500,2100,600,40.0
Aurangabad,Chavli (Shenga ),2015,1165,1765,600,51.502145922746784
Aurangabad,Math (Bhaji),2016,600,1200,600,100.0
Khed-Chakan,Coriander  ,2016,400,1000,600,150.0
Pune,Potato,2015,674,1274,600,89.02077151335311
Manchar,Flower,2014,100,700,600,600.0
Beed,Sesamum,2015,8700,9300,600,6.896551724137931
Khed-Chakan,Chavli (Shenga ),2016,992,1592,600,60.483870967741936
Shahapur,Ridge Gourd,2014,2667,3267,600,22.49718785151856
Vasai,Tomato,2014,1600,2200,600,37.5
Vasai,Sorgum(Jawar),2014,1600,2200,600,37.5
Akole,Bhagar/Vari,2014,2000,2600,600,30.0
Pune-Manjri,Spinach,2016,900,1500,600,66.66666666666667
Pune-Moshi,Ghevda,2016,5400,6000,600,11.11111111111111
Kolhapur,Snake Gourd,2016,854,1454,600,70.2576112412178
Akluj,Green-Peas,2014,1200,1800,600,50.0
Shahapur,Bitter Gourd,2014,2330,2930,600,25.751072961373392
Nira,Wheat(Husked),2015,1600,2200,600,37.5
Aurangabad,Guava,2015,1000,1600,600,60.0
Pusad,Wheat(Husked),2016,1486,2086,600,40.376850605652756
Solapur,Green Peas (Dry),2015,3100,3700,600,19.35483870967742
Nira,Wheat(Husked),2015,1575,2175,600,38.095238095238095
Kille Dharur,Tamarind,2015,3000,3600,600,20.0
Kolhapur,Potato,2016,1212,1812,600,49.504950495049506
Jalgaon,Methi (Bhaji),2015,605,1205,600,99.17355371900827
Jalgaon,Coriander (Dry),2016,7600,8200,600,7.894736842105263
Nira,Wheat(Husked),2015,1600,2200,600,37.5
Karad,Capsicum,2015,2300,2900,600,26.08695652173913
Akluj,Tomato,2014,939,1539,600,63.89776357827476
Nira,Sorgum(Jawar),2015,1600,2200,600,37.5
Vasai,Potato,2014,1600,2200,600,37.5
Akluj,Water Melon,2014,680,1280,600,88.23529411764706
Pathardi,Gram,2014,2150,2750,600,27.906976744186046
Rahata,Bottle Gourd,2015,923,1523,600,65.00541711809318
Koregaon,Sorgum(Jawar),2016,1600,2200,600,37.5
Patan,Cucumber,2016,1500,2100,600,40.0
Karad,Ridge Gourd,2016,3600,4200,600,16.666666666666668
Karad,Onion,2015,1543,2143,600,38.8852883992223
Shahapur,Ladies Finger,2015,2113,2713,600,28.39564600094652
Tumsar,Linseed,2014,3000,3600,600,20.0
Patan,Bitter Gourd,2016,3100,3700,600,19.35483870967742
Kolhapur-Laxmipuri,Cowpea,2016,5769,6369,600,10.400416016640666
Pune-Manjri,Green-Peas,2016,2250,2850,600,26.666666666666668
Atpadi,Cotton,2014,4200,4800,600,14.285714285714286
Akkolkot,Wheat(Unhusked),2015,2200,2800,600,27.272727272727273
Jalgaon,Orange,2016,736,1336,600,81.52173913043478
Osmanabad,Ladies Finger,2016,650,1250,600,92.3076923076923
Karad,Green-Peas,2016,2128,2728,600,28.195488721804512
Pune-Manjri,Chavli (Pala),2015,567,1167,600,105.82010582010582
Paranda,Sorgum(Jawar),2016,1550,2150,600,38.70967741935484
Jalgaon Jamod-Aasalgaon,Soybean,2016,3057,3657,600,19.627085377821395
Pune-Manjri,Shepu,2016,504,1104,600,119.04761904761905
Jalgaon,Beet Root,2014,1400,2000,600,42.857142857142854
Akole,Soybean,2016,3000,3600,600,20.0
Shahapur,Bitter Gourd,2016,4188,4788,600,14.326647564469914
Rahata,Sweet Potato,2015,3000,3600,600,20.0
Manwat,Soybean,2015,3185,3785,600,18.838304552590266
Parner,Onion,2016,150,750,600,400.0
Khamgaon,Sesamum,2016,5450,6050,600,11.009174311926605
Paranda,Sorgum(Jawar),2015,1632,2232,600,36.76470588235294
Khamgaon,Lemon,2016,133,733,600,451.1278195488722
Vadgaon Peth,Cucumber,2015,650,1250,600,92.3076923076923
Ausa,Ground Nut Pods (Dry),2015,4201,4801,600,14.282313734825042
Pune-Manjri,Kanda Pat,2016,900,1500,600,66.66666666666667
Amalner,Cotton,2015,4000,4600,600,15.0
Aurangabad,Tamarind,2014,1200,1800,600,50.0
Karad,Pavata,2015,2900,3500,600,20.689655172413794
Karad,Pavtta,2015,1900,2500,600,31.57894736842105
Vasai,Sorgum(Jawar),2015,1600,2200,600,37.5
Khed-Chakan,Bottle Gourd,2016,1177,1777,600,50.97706032285472
Jalkot,Soybean,2015,2800,3400,600,21.428571428571427
Nira-Saswad,Wheat(Husked),2016,1638,2238,600,36.63003663003663
Manchar,Beet Root,2016,600,1200,600,100.0
Ulhasnagar,Bajri,2016,1955,2555,600,30.690537084398976
Karad,Ridge Gourd,2015,1750,2350,600,34.285714285714285
Aurangabad,Sweet Potato,2016,1250,1850,600,48.0
Morshi,Ground Nut Pods (Dry),2016,3000,3600,600,20.0
Pune-Manjri,Lemon,2016,0,600,600,inf
Pune-Manjri,Lemon,2016,0,600,600,inf
Barshi,Shepu,2016,400,1000,600,150.0
Mangaon(Bhadav),Nagali,2016,1400,2000,600,42.857142857142854
Aurangabad,Lemon,2014,1460,2060,600,41.0958904109589
Akole,Paddy-Unhusked,2015,1467,2067,600,40.899795501022496
Hadgaon-Tamsa,Gram,2016,7200,7800,600,8.333333333333334
Shrirampur,Garlic,2015,2400,3000,600,25.0
Akkolkot,Wheat(Unhusked),2015,3301,3901,600,18.176310209027566
Manchar,Beet Root,2016,774,1374,600,77.51937984496124
Karad,Ridge Gourd,2015,1600,2200,600,37.5
Junnar (Alephata),Potato,2015,500,1100,600,120.0
Pune-Manjri,Chavli (Pala),2016,865,1465,600,69.36416184971098
Chandrapur-Ganjwad,Ladies Finger,2016,1060,1660,600,56.60377358490566
Junnar (Narayangaon),Tomato,2015,1450,2050,600,41.37931034482759
Chandrapur-Ganjwad,Chavli (Shenga ),2015,1000,1600,600,60.0
Sangamner,Gram,2014,1950,2550,600,30.76923076923077
Kalvan,Ground Nut Pods (Dry),2016,3100,3700,600,19.35483870967742
Chandrapur-Ganjwad,Brinjal,2015,500,1100,600,120.0
Kalyan,Sesamum,2015,5700,6300,600,10.526315789473685
Vadgaon Peth,CARROT,2016,700,1300,600,85.71428571428571
Kada,Green Gram,2015,6929,7529,600,8.659258190215038
Manchar,Tomato,2016,300,900,600,200.0
Ratanagari,Bitter Gourd,2015,3100,3700,600,19.35483870967742
Buldhana,Pigeon Pea (Tur),2015,5333,5933,600,11.250703168948059
Chandrapur-Ganjwad,Ladies Finger,2016,1200,1800,600,50.0
Ahmednagar,Jaggery,2015,2300,2900,600,26.08695652173913
Buldhana,Sorgum(Jawar),2015,1200,1800,600,50.0
Phaltan,Wheat(Husked),2015,1450,2050,600,41.37931034482759
Kalyan,Indian Bean,2016,7600,8200,600,7.894736842105263
Mumbai,French Bean,2016,2800,3400,600,21.428571428571427
Junnar-Otur,Potato,2016,583,1183,600,102.91595197255575
Umarkhed,Pigeon Pea (Tur),2015,4900,5500,600,12.244897959183673
Junnar-Otur,Carrot,2016,800,1400,600,75.0
Chalisgaon,Gram,2015,2267,2867,600,26.46669607410675
Ratanagari,Bitter Gourd,2015,2450,3050,600,24.489795918367346
Ahmednagar,Jaggery,2016,2950,3550,600,20.338983050847457
Deglur,Black Gram,2016,8100,8700,600,7.407407407407407
Chandrapur-Ganjwad,Spinach,2016,540,1140,600,111.11111111111111
Jamkhed,Coriander (Dry),2014,9100,9700,600,6.593406593406593
Junnar (Alephata),Potato,2014,1325,1925,600,45.283018867924525
Chandrapur-Ganjwad,Capsicum,2015,1475,2075,600,40.67796610169491
Murbad,GHOSALI(BHAJI),2016,2060,2660,600,29.12621359223301
Satara,Cluster Bean,2014,3917,4517,600,15.317845289762573
Umarkhed-Danki,Ground Nut Pods (Dry),2014,3400,4000,600,17.647058823529413
Vai,Pavtta,2016,3600,4200,600,16.666666666666668
Mumbai,Split Gram,2015,3891,4491,600,15.420200462606013
Chandrapur-Ganjwad,Ladies Finger,2014,1300,1900,600,46.15384615384615
Nashik,Ground Nut Pods (Dry),2016,2800,3400,600,21.428571428571427
Nashik,Flower,2014,534,1134,600,112.35955056179775
Dhule,Brinjal,2016,800,1400,600,75.0
Shrirampur,Ginger (Fresh),2016,1400,2000,600,42.857142857142854
Kalyan,Onion,2015,4100,4700,600,14.634146341463415
Kalyan,Chikoo,2016,2000,2600,600,30.0
Kalyan,Onion,2015,800,1400,600,75.0
Ratanagari,Bottle Gourd,2015,1200,1800,600,50.0
Mumbai,Ridge Gourd,2015,1857,2457,600,32.31017770597738
Sangali,Horse Gram,2016,3200,3800,600,18.75
Nandurbar,Ground Nut Pods (Dry),2016,2450,3050,600,24.489795918367346
Vai,Ridge Gourd,2016,2100,2700,600,28.571428571428573
Kalyan,Papai,2016,1731,2331,600,34.66204506065858
Junnar-Otur,Small Gourd,2016,950,1550,600,63.1578947368421
Kalvan,Green Gram,2016,4300,4900,600,13.953488372093023
Chandrapur,Onion,2015,1233,1833,600,48.661800486618006
Buldhana,Black Gram,2015,7200,7800,600,8.333333333333334
Junnar-Otur,Bitter Gourd,2016,200,800,600,300.0
Malegaon (Washim),Gram,2016,6700,7300,600,8.955223880597014
Pune-Manjri,Coriander  ,2016,450,1050,600,133.33333333333334
Pune-Manjri,Lemon,2015,0,600,600,inf
Vai,Pavata,2015,4100,4700,600,14.634146341463415
Mumbai,Spilt Gerrn Gram,2016,7665,8265,600,7.8277886497064575
Sangrampur,Black Gram,2014,4700,5300,600,12.76595744680851
Nagpur,Coriander (Dry),2014,9650,10250,600,6.217616580310881
Mumbai,French Bean,2016,2000,2600,600,30.0
Junnar-Otur,Bottle Gourd,2016,600,1200,600,100.0
Sangli-Phale Bhajipalam,Potato,2015,700,1300,600,85.71428571428571
Ahmednagar,Potato,2016,767,1367,600,78.22685788787484
Daryapur,Soybean,2014,2500,3100,600,24.0
Kalyan,Green Chilli,2016,4500,5100,600,13.333333333333334
Sangrampur-Varvatbakal,Green Gram,2016,5000,5600,600,12.0
Manchar,Ghosali(Bhaji),2016,1000,1600,600,60.0
Umari,Pigeon Pea (Tur),2016,8266,8866,600,7.2586498911202515
Junnar-Otur,Cabbage,2015,100,700,600,600.0
Kalyan,Lemon,2016,3120,3720,600,19.23076923076923
Murbad,Tomato,2016,1800,2400,600,33.333333333333336
Malegaon,Sorgum(Jawar),2014,1772,2372,600,33.86004514672686
Chandrapur-Ganjwad,Bitter Gourd,2015,1400,2000,600,42.857142857142854
Tiwasa,Pigeon Pea (Tur),2016,7800,8400,600,7.6923076923076925
Chandrapur-Ganjwad,Squash Gourd,2015,1000,1600,600,60.0
Ahmednagar,Carrot,2016,400,1000,600,150.0
Pune-Pimpri,CUCUMBER,2016,1646,2246,600,36.452004860267316
Satana,Onion,2015,805,1405,600,74.53416149068323
Murbad,Tomato,2016,2200,2800,600,27.272727272727273
Manchar,Shevga,2016,500,1100,600,120.0
Chandrapur-Ganjwad,Bitter Gourd,2015,1333,1933,600,45.0112528132033
Nashik,Shahale ,2015,1767,2367,600,33.95585738539898
Vai,Green Chilli,2014,2267,2867,600,26.46669607410675
Shrirampur,Shevga,2015,1350,1950,600,44.44444444444444
Nagpur,Mango(Raw),2016,3329,3929,600,18.023430459597478
Mumbai,Split Gram,2015,3717,4317,600,16.142050040355127
Chandrapur-Ganjwad,Spinach,2015,1400,2000,600,42.857142857142854
Jalgaon,Papai,2014,1300,1900,600,46.15384615384615
Mumbai,Split Gram,2015,3809,4409,600,15.752165922814386
Chalisgaon,Black Gram,2015,4850,5450,600,12.371134020618557
Ahmednagar,Sorgum(Jawar),2015,1600,2200,600,37.5
Pune-Pimpri,Green Gram,2016,7400,8000,600,8.108108108108109
Pune,Sweet Potato,2016,1550,2150,600,38.70967741935484
Chandrapur,Cucumber,2016,900,1500,600,66.66666666666667
Nashik,Flower,2015,528,1128,600,113.63636363636364
Kamthi,Bottle Gourd,2015,729,1329,600,82.3045267489712
Chandrapur,Dhemse,2015,1000,1600,600,60.0
Kalyan,Gram,2015,3200,3800,600,18.75
Sangrampur,Black Gram,2015,5000,5600,600,12.0
Ramtek,Bottle Gourd,2015,1960,2560,600,30.612244897959183
Kalyan,CURRY LEAVES,2016,2314,2914,600,25.92912705272256
Satara,Sweet Potato,2014,900,1500,600,66.66666666666667
Vai,Green-Peas,2015,3050,3650,600,19.672131147540984
Ramtek,Kharbuj,2016,1400,2000,600,42.857142857142854
Ahmednagar,Cabbage,2015,667,1267,600,89.95502248875562
Ramtek,Kand,2016,1000,1600,600,60.0
Ahmednagar,Ground Nut Pods (Dry),2015,3750,4350,600,16.0
Pune-Manjri,Rajgira,2015,300,900,600,200.0
Ramtek,Chavli (Shenga ),2016,1791,2391,600,33.50083752093802
Tasgaon,Black Gram,2014,3900,4500,600,15.384615384615385
Chandrapur-Ganjwad,Dhemse,2015,1000,1600,600,60.0
Chandrapur,Chavli (Shenga ),2015,1000,1600,600,60.0
Satara,Bottle Gourd,2015,1192,1792,600,50.33557046979866
Ahmednagar,Maize(Corn.),2016,400,1000,600,150.0
Ramtek,Pavtta,2015,2900,3500,600,20.689655172413794
Chandrapur,Capsicum,2015,1000,1600,600,60.0
Kurdwadi-Modnimb,Gram,2015,3161,3760,599,18.949699462195507
Dudhani,Gram,2016,4129,4728,599,14.507144587067087
Indapur-Bhigwan,Ground Nut Pods (Dry),2015,2876,3475,599,20.827538247566064
Satana,Gram,2014,2150,2749,599,27.86046511627907
Katol,Pigeon Pea (Tur),2015,6067,6666,599,9.873083896489204
Latur,Gram,2015,4012,4611,599,14.930209371884347
Shahada,Sorgum(Jawar),2016,1323,1922,599,45.27588813303099
Lasalgaon,SOYBEAN,2016,2246,2845,599,26.669634906500445
Barshi,Gram,2016,3864,4463,599,15.50207039337474
Loha,Wheat(Husked),2016,1502,2101,599,39.880159786950735
Beed,Gram,2016,6315,6914,599,9.48535233570863
Malegaon,Onion,2016,219,818,599,273.5159817351598
Nira,Jaggery,2016,3609,4208,599,16.59739540038792
Lasalgaon-Vinchur,Gram,2016,4831,5429,598,12.378389567377354
Nandura,Gram,2015,3525,4123,598,16.9645390070922
Pathari,Bajri,2016,1789,2387,598,33.42649524874231
Barshi,Capsicum,2016,1718,2316,598,34.80791618160652
Malegaon,Onion,2016,204,802,598,293.1372549019608
Nashik,Shahale ,2016,1810,2408,598,33.03867403314917
Parner,Onion,2016,296,894,598,202.02702702702703
Khamgaon,Green Gram,2016,4355,4953,598,13.73134328358209
Kolhapur,Cabbage,2015,285,883,598,209.82456140350877
Yeola,Onion,2016,344,942,598,173.8372093023256
Lasalgaon,Sorgum(Jawar),2016,1262,1860,598,47.385103011093506
Solapur,Potato,2015,613,1211,598,97.55301794453507
Gevrai,Gram,2016,6078,6676,598,9.838762750904904
Baramati,Onion,2016,200,798,598,299.0
Devani,Pigeon Pea (Tur),2016,8902,9500,598,6.717591552460122
Lonar,Black Gram,2014,4358,4956,598,13.72189077558513
Osmanabad,Cabbage,2015,982,1580,598,60.89613034623218
Latur,Pigeon Pea (Tur),2015,6337,6935,598,9.436641944137605
Sinner,SOYBEAN,2016,2176,2774,598,27.481617647058822
Kalamnuri,Pigeon Pea (Tur),2016,7489,8087,598,7.985044732274002
Solapur,Wheat(Husked),2016,2024,2622,598,29.545454545454547
Pune-Moshi,Flower,2016,1075,1672,597,55.53488372093023
Osmanabad,Gram,2016,5671,6268,597,10.527243872332923
Arvi,Soybean,2015,3114,3711,597,19.171483622350674
Jintur,Pigeon Pea (Tur),2016,7158,7755,597,8.340318524727577
Mangalwedha,Gram,2016,4414,5011,597,13.525147258722248
Barshi,Kharbuj,2016,603,1200,597,99.0049751243781
Kada,Tamarind,2015,3375,3972,597,17.68888888888889
Karanja,Wheat(Husked),2016,1626,2223,597,36.715867158671585
Shirpur,Chillies(Red),2015,1965,2562,597,30.38167938931298
Chandvad,Bitter Gourd,2016,817,1414,597,73.07221542227663
Chandvad,Tomato,2016,346,943,597,172.54335260115607
Umared,Wheat(Husked),2016,1600,2197,597,37.3125
Pathardi,Wheat(Husked),2016,1616,2213,597,36.943069306930695
Aarni,Pigeon Pea (Tur),2015,8333,8930,597,7.164286571462858
Taloda,Pigeon Pea (Tur),2015,4940,5537,597,12.085020242914979
Sindi (Selu),Pigeon Pea (Tur),2016,5814,6411,597,10.268317853457173
Shirpur,Sorgum(Jawar),2016,1355,1952,597,44.05904059040591
Ahmedpur,Green Gram,2016,4310,4907,597,13.851508120649651
Hadgaon-Tamsa,Gram,2016,4343,4940,597,13.74625834676491
Mehkar,Pigeon Pea (Tur),2016,5916,6513,597,10.09127789046653
Babhulgaon,Soybean,2015,3183,3780,597,18.75589066918002
Jalna,Gram,2014,2195,2792,597,27.198177676537586
Raver,Gram,2015,3693,4290,597,16.165718927701057
Chandvad,Tomato,2016,280,877,597,213.21428571428572
Mohol,Wheat(Husked),2014,1422,2019,597,41.983122362869196
Lasalgaon-Niphad,GREEN GRAM,2016,3970,4567,597,15.037783375314861
Hinganghat,Cotton,2016,4116,4712,596,14.480077745383868
Vai,Green Chilli,2015,3245,3841,596,18.366718027734976
Mangalwedha,Sorgum(Jawar),2016,1634,2230,596,36.4749082007344
Osmanabad,Sorgum(Jawar),2014,1540,2136,596,38.701298701298704
Satana,Pigeon Pea (Tur),2016,6935,7531,596,8.59408795962509
Kamthi,Bottle Gourd,2016,486,1082,596,122.63374485596708
Mumbai,Capsicum,2016,4313,4909,596,13.818687688383955
Daryapur,Soybean,2016,3089,3685,596,19.294269990288118
Solapur,Potato,2015,480,1076,596,124.16666666666667
Chandrapur-Ganjwad,Flower,2015,377,973,596,158.09018567639257
Beed,Sorgum(Jawar),2015,1670,2266,596,35.68862275449102
Aurangabad,Onion,2016,205,801,596,290.7317073170732
Kalmeshwar,Cotton,2016,4221,4817,596,14.11987680644397
Manchar,Beet Root,2016,880,1476,596,67.72727272727273
Jalgaon,Black Gram,2016,6529,7125,596,9.128503599326084
Lonand,Gram,2016,4388,4984,596,13.582497721057429
Kolhapur,Bottle Gourd,2015,304,900,596,196.05263157894737
Phaltan,Bajri,2016,1275,1871,596,46.745098039215684
Aurangabad,Onion,2016,170,766,596,350.5882352941176
Karad,Onion,2016,1284,1880,596,46.41744548286604
Kolhapur,Cabbage,2016,652,1248,596,91.41104294478528
Kolhapur-Laxmipuri,Wheat(Husked),2016,2300,2896,596,25.91304347826087
Shrirampur,Brinjal,2016,1152,1748,596,51.736111111111114
Karanja,Green Gram,2015,7509,8105,596,7.937142096151285
Akkolkot,Pigeon Pea (Tur),2016,8746,9342,596,6.814543791447519
Sangrampur-Varvatbakal,Green Gram,2016,5009,5605,596,11.898582551407467
Pune,Bottle Gourd,2015,485,1081,596,122.88659793814433
Dudhani,Green Gram,2016,4261,4857,596,13.987326918563717
Khed-Chakan,Farshi,2016,1067,1663,596,55.85754451733833
Shrirampur,Ladies Finger,2016,1692,2288,596,35.22458628841608
Satara,Bitter Gourd,2015,3058,3654,596,19.48986265533028
Washim,Pigeon Pea (Tur),2015,6579,7174,595,9.043927648578812
Shahapur,Ladies Finger,2015,3157,3752,595,18.8470066518847
Karanja,Black Gram,2015,5535,6130,595,10.749774164408311
Lasur Station,Black Gram,2016,5843,6438,595,10.1831251069656
Pathardi,Wheat(Husked),2015,1547,2142,595,38.46153846153846
Akluj,Ground Nut Pods (Dry),2015,2542,3137,595,23.406766325727773
Shahapur,Ridge Gourd,2015,2755,3350,595,21.59709618874773
Akkolkot,Green Gram,2016,4481,5076,595,13.278286096853382
Satara,Green Chilli,2015,3022,3617,595,19.68894771674388
Mangalwedha,Tomato,2016,207,802,595,287.43961352657004
Dudhani,Gram,2015,3566,4161,595,16.685361749859787
Ratanagari,Ladies Finger,2015,3643,4238,595,16.332692835575074
Washim,Green Gram,2015,7479,8074,595,7.95560903864153
Baramati,Maize,2016,1400,1995,595,42.5
Mumbai,Cluster Bean,2016,3676,4271,595,16.1860718171926
Kopargaon,Green Gram,2014,6840,7435,595,8.698830409356725
Shahapur,Chavli (Shenga ),2016,1940,2535,595,30.670103092783506
Shrirampur,Ladies Finger,2015,1288,1883,595,46.19565217391305
Pune-Pimpri,Bitter Gourd,2015,2780,3375,595,21.402877697841728
Akole,Tomato,2014,272,867,595,218.75
Aurangabad,Orange,2015,795,1390,595,74.84276729559748
Kopargaon,Onion,2016,108,703,595,550.925925925926
Nashik-Devlali,Shepu,2016,1621,2216,595,36.705737199259715
Vai,Green Chilli,2015,2881,3476,595,20.652551197500866
Kopargaon,Onion,2016,250,845,595,238.0
Chandvad,TOMATO,2016,299,894,595,198.99665551839465
Jalgaon,Wal Papdi,2015,1076,1671,595,55.29739776951673
Anajngaon Surji,Gram,2016,6190,6785,595,9.612277867528272
Arvi,Soybean,2015,3064,3659,595,19.419060052219322
Manora,Gram,2015,3922,4517,595,15.170831208567058
Ratanagari,Cabbage,2015,996,1591,595,59.738955823293175
Ratanagari,Bitter Gourd,2015,1625,2219,594,36.55384615384615
Manchar,Shepu,2016,587,1181,594,101.19250425894379
Aurangabad,Ginger (Fresh),2016,1119,1713,594,53.083109919571044
Mangrulpeer,Wheat(Husked),2015,1206,1800,594,49.25373134328358
Yeotmal,Pigeon Pea (Tur),2016,5786,6380,594,10.26615969581749
Manwat,Pigeon Pea (Tur),2015,7672,8266,594,7.742440041710115
Junnar,Onion,2014,1275,1869,594,46.588235294117645
Pune,Gram,2016,8935,9529,594,6.648013430330162
Pathari,Wheat(Husked),2016,1768,2362,594,33.5972850678733
Aurangabad,Wal Bhaji,2016,1630,2224,594,36.441717791411044
Majalgaon,Cotton,2016,4100,4694,594,14.487804878048781
Latur,Pigeon Pea (Tur),2015,5646,6240,594,10.520722635494154
Dudhani,Green Gram,2016,4535,5129,594,13.098125689084895
Shirpur,Onion,2016,125,719,594,475.2
Pune-Manjri,Spinach,2015,319,913,594,186.20689655172413
Malegaon,Onion,2016,224,818,594,265.17857142857144
Lonand,Gram,2016,3550,4144,594,16.732394366197184
Phaltan,Bajri,2015,1294,1888,594,45.904173106646056
Chalisgaon,Pigeon Pea (Tur),2015,5117,5711,594,11.608364275942936
Satara,Pavtta,2014,2194,2788,594,27.07383773928897
Ratanagari,Brinjal,2015,1453,2047,594,40.88093599449415
Baramati,Onion,2016,200,794,594,297.0
Dhamangaon-Rly,Ground Nut Pods (Dry),2016,5086,5680,594,11.679119150609516
Kalyan,Cluster Bean,2015,2659,3253,594,22.339225272658894
Shirpur,Ground Nut Pods (Dry),2016,4384,4977,593,13.526459854014599
Bhivandi,Wheat(Husked),2016,1838,2431,593,32.26332970620239
Chandrapur-Ganjwad,Flower,2015,380,973,593,156.05263157894737
Hinganghat,Soybean,2015,3016,3609,593,19.661803713527853
Sangali,Wheat(Unhusked),2014,3985,4578,593,14.880803011292347
Jintur,Sorgum(Jawar),2015,1110,1703,593,53.42342342342342
Arvi,Soybean,2014,2743,3336,593,21.61866569449508
Kada,Green Gram,2016,4357,4950,593,13.610282304337847
Chikhali,GREEN GRAM,2016,4203,4796,593,14.108969783487984
Pune,Sweet Potato,2016,1157,1750,593,51.25324114088159
Aurangabad,Bottle Gourd,2016,900,1493,593,65.88888888888889
Lonar,Green Gram,2015,6323,6916,593,9.37845959196584
Pathardi,Wheat(Husked),2015,1536,2129,593,38.606770833333336
Shahapur,Chavli (Shenga ),2015,1467,2060,593,40.42263122017723
Jalgaon,Flower,2016,763,1356,593,77.71952817824378
Baramati,Soybean,2016,3020,3613,593,19.635761589403973
Morshi,Gram,2015,4263,4856,593,13.910391742904059
Sinner,Sorgum(Jawar),2015,977,1570,593,60.696008188331625
Akola,Ground Nut Pods (Dry),2016,4819,5412,593,12.305457563809918
Gevrai,Pigeon Pea (Tur),2016,7031,7623,592,8.419854928175225
Junnar-Otur,Cucumber,2016,423,1015,592,139.95271867612294
Karanja,Ground Nut Pods (Dry),2014,3395,3987,592,17.43740795287187
Gevrai,Pigeon Pea (Tur),2016,6848,7440,592,8.644859813084112
Jalgaon,Brinjal,2015,745,1337,592,79.46308724832215
Phaltan,Wheat(Husked),2016,1617,2209,592,36.61100803957947
Barshi,Capsicum,2015,800,1392,592,74.0
Tumsar,Rice(Paddy-Hus),2016,2798,3390,592,21.15796997855611
Kalmeshwar,Soybean,2015,3097,3689,592,19.11527284468841
Dondaicha,Ground Nut Pods (Dry),2015,4884,5476,592,12.121212121212121
Rahata,Tomato,2015,485,1077,592,122.0618556701031
Savner,Pigeon Pea (Tur),2015,6462,7054,592,9.161250386877128
Nira-Saswad,Bajri,2016,1513,2105,592,39.12756113681428
Ratanagari,Cucumber,2016,1062,1654,592,55.74387947269303
Satara,Cucumber,2015,1024,1616,592,57.8125
Pune,Squash Gourd,2014,525,1117,592,112.76190476190476
Pune-Manjri,Bottle Gourd,2015,583,1175,592,101.54373927958834
Nashik-Devlali,Chavli (Pala),2016,800,1392,592,74.0
Solapur,Cabbage,2016,420,1012,592,140.95238095238096
Ulhasnagar,Bajri,2016,1585,2177,592,37.35015772870663
Kalvan,Onion,2016,290,882,592,204.13793103448276
Vasai,Potato,2015,956,1548,592,61.92468619246862
Chandvad,Tomato,2016,434,1026,592,136.40552995391704
Mangalwedha,Tomato,2016,176,768,592,336.3636363636364
Kolhapur-Laxmipuri,Green Gram,2016,7078,7670,592,8.363944617123481
Nampur,Gram,2016,3348,3940,592,17.682198327359618
Mumbai,Bitter Gourd,2015,3452,4043,591,17.120509849362687
Shrirampur,Tomato,2014,1386,1977,591,42.64069264069264
Karad,Green Chilli,2014,1973,2564,591,29.95438418651799
Satara,Capsicum,2015,2227,2818,591,26.537943421643465
Karad,Pavata,2016,2414,3005,591,24.48218724109362
Vadgaon Peth,Tomato,2016,461,1052,591,128.19956616052062
Pune,Tamarind,2015,3900,4491,591,15.153846153846153
Osmanabad,Sorgum(Jawar),2015,1584,2175,591,37.31060606060606
Ahmednagar,Potato,2015,545,1136,591,108.44036697247707
Vadgaon Peth,Ridge Gourd,2015,886,1477,591,66.70428893905192
Vadgaon Peth,Ladies Finger,2015,745,1336,591,79.32885906040268
Kamthi,Onion,2016,426,1017,591,138.73239436619718
Satara,Carrot,2015,1182,1773,591,50.0
Aurangabad,Papai,2015,1409,2000,591,41.944641589779984
Shirpur,Sorgum(Jawar),2015,1198,1789,591,49.3322203672788
Ambad(Vadi Godri),Green Gram,2016,4543,5134,591,13.009024873431652
Gevrai,Wheat(Husked),2016,1516,2107,591,38.98416886543536
Aurangabad,Ladies Finger,2016,1623,2214,591,36.41404805914972
Pune,Cabbage,2016,513,1104,591,115.2046783625731
Jalgaon,Cucumber,2015,784,1375,591,75.38265306122449
Chandrapur-Ganjwad,Brinjal,2016,948,1538,590,62.23628691983122
Shirur,Gram,2016,4601,5191,590,12.823299282764616
Junnar,Potato,2015,840,1430,590,70.23809523809524
Pandharpur,Cabbage,2015,450,1040,590,131.11111111111111
Baramati,Sorgum(Jawar),2014,1800,2390,590,32.77777777777778
Kalyan,Cluster Bean,2016,2929,3519,590,20.1433936497098
Sindi,Gram,2016,5543,6133,590,10.644055565578206
Gevrai,SORGUM(JAWAR),2016,1902,2492,590,31.019978969505782
Sinner,Sorgum(Jawar),2016,1278,1868,590,46.165884194053206
Parli-Vaijnath,Pigeon Pea (Tur),2015,7950,8540,590,7.421383647798742
Vaijapur,Onion,2016,182,772,590,324.1758241758242
Pune-Moshi,Tomato,2016,769,1359,590,76.72301690507152
Akluj,Onion,2016,395,985,590,149.36708860759492
Pune,Beet Root,2015,580,1170,590,101.72413793103448
Jalgaon,Brinjal,2015,765,1355,590,77.12418300653594
Pune-Pimpri,Bitter Gourd,2015,2470,3060,590,23.88663967611336
Satara,Pavtta,2015,1585,2175,590,37.22397476340694
Akluj,Potato,2015,840,1430,590,70.23809523809524
Mumbai-Fruit Market,Guava,2016,1010,1600,590,58.415841584158414
Manmad,Gram,2015,3854,4444,590,15.308770108977685
Vai,Ladies Finger,2016,2955,3545,590,19.96615905245347
Mumbai,Squash Gourd,2016,1660,2250,590,35.54216867469879
Aarni,Green Gram,2015,6880,7470,590,8.575581395348838
Shahapur,Chavli (Shenga ),2015,1143,1733,590,51.61854768153981
Mumbai,Sweet Potato,2016,1000,1590,590,59.0
Ahmednagar,Potato,2015,560,1150,590,105.35714285714286
Barshi,Coriander  ,2016,510,1100,590,115.68627450980392
Arvi,Soybean,2015,2950,3540,590,20.0
Pune,Lentil,2015,6150,6740,590,9.59349593495935
Nandura,Green Gram,2015,6891,7481,590,8.561892323320272
Bhivandi,Other Vegetables,2015,1262,1852,590,46.75118858954041
Solapur,Potato,2015,543,1132,589,108.47145488029466
Savner,Pigeon Pea (Tur),2015,8136,8725,589,7.239429695181908
Aurangabad,Bitter Gourd,2015,2872,3461,589,20.508356545961004
Jalgaon,Tomato,2015,1300,1889,589,45.30769230769231
Junnar (Alephata),Onion,2016,692,1281,589,85.11560693641619
Amalner,Gram,2016,3738,4327,589,15.75708935259497
Indapur-Bhigwan,Ground Nut Pods (Dry),2015,2925,3514,589,20.136752136752136
Kalmeshwar,Coriander  ,2016,5834,6423,589,10.095989029825162
Dudhani,Sorgum(Jawar),2015,1156,1745,589,50.951557093425606
Kille Dharur,Sesamum,2016,6095,6684,589,9.663658736669401
Babhulgaon,Pigeon Pea (Tur),2016,5919,6508,589,9.951005237371177
Pune-Pimpri,Cucumber,2016,1775,2364,589,33.183098591549296
Lasalgaon,Onion,2016,340,929,589,173.23529411764707
Ulhasnagar,ONION,2016,511,1100,589,115.2641878669276
Kurdwadi-Modnimb,Wheat(Husked),2015,1528,2117,589,38.547120418848166
Karad,Ladies Finger,2015,2150,2739,589,27.3953488372093
Nagpur,Soybean,2015,3154,3743,589,18.674698795180724
Mumbai,Sweet Potato,2014,1274,1863,589,46.23233908948195
Lasur Station,Gram,2015,3687,4276,589,15.975047464062923
Dound,Sorgum(Jawar),2016,1621,2210,589,36.33559531153609
Pusad,Green Gram,2016,4506,5095,589,13.071460275188638
Jalgaon,Cucumber,2015,967,1556,589,60.9100310237849
Kada,Wheat(Husked),2016,1675,2264,589,35.16417910447761
Mehkar,Sorgum(Jawar),2014,1097,1685,588,53.600729261622604
Nandura,Soybean,2016,3072,3660,588,19.140625
Kolhapur,Snake Gourd,2015,792,1380,588,74.24242424242425
Lonand,Sorgum(Jawar),2015,1600,2188,588,36.75
Malkapur,Soybean,2015,3274,3862,588,17.95968234575443
Satara,Ladies Finger,2015,1183,1771,588,49.70414201183432
Nashik,Onion,2016,159,747,588,369.811320754717
Osmanabad,SOYBEAN,2016,2175,2763,588,27.03448275862069
Indapur,Bajri,2016,1250,1838,588,47.04
Karanja,Pigeon Pea (Tur),2015,5408,5996,588,10.872781065088757
Solapur,Sorgum(Jawar),2014,1762,2350,588,33.37116912599319
Narkhed,Orange,2016,1313,1901,588,44.78293983244478
Mangalwedha,Bitter Gourd,2015,4000,4588,588,14.7
Nira-Saswad,Sorgum(Jawar),2016,1593,2181,588,36.911487758945384
Shahada,Pigeon Pea (Tur),2015,4833,5421,588,12.166356300434513
Partur,Pigeon Pea (Tur),2016,7365,7953,588,7.9837067209775965
Aurangabad,Ladies Finger,2016,1372,1960,588,42.857142857142854
Ausa,Wheat(Husked),2015,1519,2107,588,38.70967741935484
Nashik,Potato,2014,1850,2438,588,31.783783783783782
Shrirampur,Bitter Gourd,2016,3353,3941,588,17.53653444676409
Alibag,Coconut,2016,2385,2973,588,24.654088050314467
Balapur,Gram,2016,5800,6388,588,10.137931034482758
Karad,Cluster Bean,2016,3100,3688,588,18.967741935483872
Mumbai,Capsicum,2016,5127,5715,588,11.468695143358689
Satara,Onion,2014,1456,2044,588,40.38461538461539
Karad,Ridge Gourd,2014,2025,2613,588,29.037037037037038
Akluj,Chikoo,2015,1525,2113,588,38.557377049180324
Dudhani,Sorgum(Jawar),2015,1341,1929,588,43.84787472035794
Khamgaon,Green Gram,2016,5109,5697,588,11.509101585437463
Malkapur,Soybean,2016,3401,3989,588,17.28903263745957
Udgir,Green Gram,2014,6861,7449,588,8.570179274158287
Karad,Green Chilli,2016,2816,3404,588,20.880681818181817
Satara,Brinjal,2015,1135,1723,588,51.80616740088106
Malkapur,Soybean,2016,3139,3727,588,18.732080280344057
Devani,SOYBEAN,2016,2294,2882,588,25.632083696599825
Nashik,Shahale ,2014,1738,2325,587,33.77445339470656
Shegaon,Black Gram,2014,4142,4729,587,14.17189763399324
Khed-Chakan,Cluster Bean,2015,4244,4831,587,13.83129123468426
Nampur,Onion,2016,264,851,587,222.34848484848484
Parbhani,Pigeon Pea (Tur),2015,6094,6681,587,9.632425336396455
Chandrapur-Ganjwad,Tomato,2016,477,1064,587,123.06079664570231
Chalisgaon,Gram,2016,4885,5472,587,12.016376663254862
Pune,Wheat(Husked),2015,2290,2877,587,25.633187772925766
Kolhapur-Laxmipuri,Lentil,2015,5513,6100,587,10.647560311989842
Nashik,Shepu,2016,580,1167,587,101.20689655172414
Kada,Wheat(Husked),2016,1613,2200,587,36.39181649101054
Gevrai,Pigeon Pea (Tur),2016,5865,6452,587,10.008525149190111
Jalgaon,Lemon,2014,1248,1835,587,47.03525641025641
Nira-Saswad,Sorgum(Jawar),2016,1651,2238,587,35.5542095699576
Murtizapur,Gram,2015,4311,4898,587,13.616330317791695
Aurangabad,Chavli (Shenga ),2014,1895,2482,587,30.976253298153033
Washim,Green Gram,2016,5300,5887,587,11.075471698113208
Pune,Tamarind,2016,5519,6106,587,10.635984779851423
Varud-Rajura Bazar,Soybean,2015,3100,3687,587,18.93548387096774
Pune-Pimpri,Bitter Gourd,2016,3980,4567,587,14.748743718592964
Shahapur,Ghosali(Bhaji),2015,1174,1761,587,50.0
Mumbai,French Bean,2016,1493,2080,587,39.31681178834561
Kamthi,Pumpkin,2016,587,1174,587,100.0
Murum,Green Gram,2015,7311,7898,587,8.02899740117631
Pune,Sweet Potato,2015,933,1520,587,62.91532690246517
Sailu,Soybean,2016,2178,2765,587,26.951331496786043
Satara,Onion,2015,1138,1725,587,51.5817223198594
Mumbai-Fruit Market,Chikoo,2016,1165,1752,587,50.3862660944206
Mumbai,Sweet Potato,2016,1000,1587,587,58.7
Amarawati,Chikoo,2015,1913,2500,587,30.68478829064297
Akola,Gram,2015,3746,4333,587,15.670048051254671
Jalna-Badnapur,Pigeon Pea (Tur),2016,8247,8834,587,7.1177397841639385
Indapur-Bhigwan,Bajri,2016,1545,2132,587,37.993527508090615
Nagpur,Ground Nut Pods (Dry),2015,3326,3913,587,17.648827420324714
Malkapur,Onion,2014,1041,1627,586,56.292026897214214
Aurangabad,Bitter Gourd,2014,1490,2076,586,39.328859060402685
Satana,Green Gram,2014,7371,7957,586,7.950074616741284
Washim,Pigeon Pea (Tur),2016,8133,8719,586,7.205213328415099
Barshi-Vairag,Gram,2016,6136,6722,586,9.55019556714472
Jalgaon,Cluster Bean,2015,909,1495,586,64.46644664466447
Khed-Chakan,CARROT,2016,1000,1586,586,58.6
Hingoli,Pigeon Pea (Tur),2014,4459,5045,586,13.141960080735592
Patan,Cluster Bean,2016,3321,3907,586,17.645287563986752
Sailu,Gram,2015,4004,4590,586,14.635364635364635
Akot,Green Gram,2016,4254,4840,586,13.77527033380348
Raver,Gram,2016,7018,7604,586,8.34995725277857
Solapur,Banana,2015,434,1020,586,135.02304147465438
Khed-Chakan,Ladies Finger,2016,1970,2556,586,29.746192893401016
Karmala,Ground Nut Pods (Dry),2016,5095,5681,586,11.501472031403337
Nashik,Shepu,2015,714,1300,586,82.07282913165267
Vai,Pavata,2016,4143,4729,586,14.144339850349988
Pimpalgaon (B)-Saykheda,Onion,2016,231,817,586,253.67965367965368
Parli-Vaijnath,Green Gram,2015,7011,7597,586,8.358294109256882
Jalkot,Green Gram,2014,5341,5927,586,10.971728140797604
Bhandara,Other Cereals,2016,3400,3986,586,17.235294117647058
Malkapur,Soybean,2016,3463,4049,586,16.921744152468957
Karad,Shevga,2016,2491,3077,586,23.524688879967883
Karad,Ginger (Fresh),2015,1950,2536,586,30.05128205128205
Pune-Pimpri,Brinjal,2016,1976,2562,586,29.655870445344128
Nandura,Gram,2015,3272,3858,586,17.90953545232274
Sangali,Wheat(Unhusked),2016,3417,4003,586,17.149546385718466
Umrane,Onion,2016,338,924,586,173.37278106508876
Kamthi,Cabbage,2014,757,1343,586,77.4108322324967
Akot,Sunflower,2015,2722,3307,585,21.491550330639235
Pune-Moshi,Green Chilli,2016,1000,1585,585,58.5
Hinganghat,Soybean,2015,2800,3385,585,20.892857142857142
Kalyan,Shevga,2015,2486,3071,585,23.531777956556716
Kalyan,Shevga,2015,3386,3971,585,17.277023036030716
Barshi,Pigeon Pea (Tur),2015,7762,8347,585,7.5367173408915225
Dondaicha-Sindkheda,Black Gram,2016,7615,8200,585,7.682206172028891
Indapur,Onion,2016,107,692,585,546.7289719626168
Ratanagari,Tomato,2016,668,1253,585,87.57485029940119
Chopda,Sesamum,2016,5234,5819,585,11.176920137562094
Karad,Cluster Bean,2015,2429,3014,585,24.083985179086042
Sangrampur-Varvatbakal,Soybean,2016,2830,3415,585,20.671378091872793
Risod,Pigeon Pea (Tur),2016,6109,6694,585,9.576035357669014
Kada (Ashti),Green Gram,2016,4186,4771,585,13.975155279503106
Shrirampur,Ladies Finger,2015,1725,2310,585,33.91304347826087
Khamgaon,Lemon,2015,208,793,585,281.25
Pune,Lemon,2015,103,688,585,567.9611650485436
Chikhali,SOYBEAN,2016,2280,2865,585,25.657894736842106
Pandharpur,Coriander  ,2014,195,780,585,300.0
Nashik,Cabbage,2015,609,1194,585,96.05911330049261
Aheri,Maize,2015,615,1200,585,95.1219512195122
Lasalgaon,TOMATO,2016,100,685,585,585.0
Varora,Gram,2015,3427,4012,585,17.07032389845346
Yeotmal,Soybean,2016,2462,3047,585,23.761169780666126
Ahmednagar,Jaggery,2016,3053,3638,585,19.161480510972815
Vadgaon Peth,Flower,2015,530,1115,585,110.37735849056604
Ausa,Green Gram,2015,6982,7567,585,8.378688054998568
Vai,Green Chilli,2015,2629,3214,585,22.251806770635223
Murum,Black Gram,2014,4501,5086,585,12.99711175294379
Aurangabad,Bitter Gourd,2015,2115,2700,585,27.659574468085108
Kolhapur,Flower,2016,228,813,585,256.57894736842104
Karad,Green Chilli,2015,2583,3167,584,22.609368950832366
Palus,Ginger (Fresh),2016,2333,2917,584,25.032147449635662
Pune-Moshi,Small Gourd,2016,2083,2667,584,28.036485837734038
Khed-Chakan,Shevga,2016,1608,2192,584,36.318407960199
Satara,Carrot,2014,1958,2542,584,29.82635342185904
Nagpur,Potato,2016,600,1184,584,97.33333333333333
Shahapur,Chavli (Shenga ),2014,1833,2417,584,31.860338243316967
Nashik,Shepu,2015,333,917,584,175.37537537537537
Arvi,Soybean,2014,2861,3445,584,20.412443201677736
Sengaon,GRAM,2016,7233,7817,584,8.074104797456103
Jalkot,Green Gram,2015,6617,7201,584,8.825751851292127
Chikhali,Green Gram,2016,3623,4207,584,16.11923820038642
Kalyan,Ghevda,2016,4083,4667,584,14.303208425177566
Osmanabad,Wheat(Husked),2015,1561,2145,584,37.41191543882127
Mumbai,Curry Leaves,2014,1456,2040,584,40.10989010989011
Shrirampur,Tomato,2015,1479,2063,584,39.48613928329953
Beed,Sorgum(Jawar),2015,1634,2218,584,35.74051407588739
Barshi,Wheat(Husked),2016,1622,2206,584,36.004932182490755
Shahapur,Chavli (Shenga ),2015,1458,2042,584,40.054869684499316
Kalyan,Flower,2016,1424,2008,584,41.01123595505618
Shrigonda,Sorgum(Jawar),2015,1611,2195,584,36.250775915580384
Umared,Green Gram,2016,5958,6542,584,9.801946962067808
Hingoli,TURMERIC,2016,7526,8110,584,7.759766144034016
Satara,Carrot,2016,1208,1792,584,48.34437086092715
Shrirampur,BOR,2016,1583,2167,584,36.89197725837018
Vai,Pavtta,2016,3333,3917,584,17.52175217521752
Ratanagari,Tomato,2016,684,1268,584,85.38011695906432
Lonand,Bajri,2015,1317,1901,584,44.34320425208808
Pune,Potato,2015,560,1144,584,104.28571428571429
Pandharpur,Cabbage,2015,509,1093,584,114.73477406679764
Sailu,Gram,2015,3362,3946,584,17.37061273051755
Pimpalgaon (B)-Saykheda,Onion,2016,241,825,584,242.32365145228215
Jalgaon,Cabbage,2016,1004,1588,584,58.167330677290835
Ghansawangi,Pigeon Pea (Tur),2016,7883,8467,584,7.4083470759863
Patan,Ginger (Fresh),2015,2850,3434,584,20.49122807017544
Mumbai,Melon,2015,1180,1764,584,49.49152542372882
Indapur,Ground Nut Pods (Dry),2016,5017,5600,583,11.620490332868249
Satana,Onion,2016,225,808,583,259.1111111111111
Jalgaon,ONION,2016,343,926,583,169.97084548104957
Dound,Gram,2016,6343,6926,583,9.191234431656945
Shrirampur,Chikoo,2014,1750,2333,583,33.31428571428572
Patan,Ladies Finger,2016,2175,2758,583,26.804597701149426
Aurangabad,Green-Peas,2015,1500,2083,583,38.86666666666667
Bhokar,Pigeon Pea (Tur),2015,5327,5910,583,10.944246292472311
Varora,Gram,2016,6167,6750,583,9.453543051726934
Raver,Gram,2016,4562,5145,583,12.779482683033757
Kalyan,Ghevda,2016,3800,4383,583,15.342105263157896
Rahata,Ginger (Fresh),2016,3167,3750,583,18.40858856962425
Kurdwadi,Pigeon Pea (Tur),2015,4497,5080,583,12.964198354458528
Ambad(Vadi Godri),BAJRI,2016,1165,1748,583,50.042918454935624
Mumbai,Ridge Gourd,2015,1750,2333,583,33.31428571428572
Kalyan,Ladies Finger,2016,2663,3246,583,21.892602328201278
Nashik-Devlali,Kanda Pat,2016,916,1499,583,63.646288209606986
Sangli-Phale Bhajipalam,Papai,2016,208,791,583,280.28846153846155
Shrirampur,Garlic,2014,2417,3000,583,24.12081092263136
Amalner,Coriander (Dry),2016,7837,8420,583,7.439071073114712
Solapur,WHEAT(HUSKED),2016,2226,2809,583,26.19047619047619
Chandrapur,Soybean,2015,3269,3852,583,17.834200061180788
Shirur,Gram,2015,3365,3948,583,17.325408618127785
Mahagaon,Gram,2016,5017,5600,583,11.620490332868249
Kalyan,Ghevda,2015,3117,3700,583,18.703881937760666
Shrirampur,Capsicum,2016,1813,2396,583,32.15664644236073
Akluj,Ladies Finger,2015,989,1572,583,58.94843276036401
Jalgaon Jamod-Aasalgaon,Green Gram,2014,6667,7250,583,8.744562771861407
Lasur Station,Sorgum(Jawar),2014,1160,1743,583,50.258620689655174
Parola,Gram,2016,3217,3800,583,18.12247435498912
Sangamner,Tomato,2015,382,965,583,152.61780104712042
Mumbai,Melon,2014,1788,2371,583,32.60626398210291
Shahapur,Cluster Bean,2015,3867,4450,583,15.076286527023532
Karad,Shevga,2016,3271,3854,583,17.823295628248243
Dound,Bajri,2016,1252,1835,583,46.56549520766773
Pune-Moshi,Ginger (Fresh),2016,2614,3197,583,22.302983932670237
Satara,Ghevda,2015,2750,3333,583,21.2
Manmad,Gram,2015,4203,4786,583,13.871044492029503
Patan,Tomato,2016,1428,2011,583,40.826330532212886
Karad,Capsicum,2015,2000,2583,583,29.15
Ratanagari,Bitter Gourd,2016,2000,2583,583,29.15
Chandrapur-Ganjwad,Capsicum,2015,700,1283,583,83.28571428571429
Kalyan,Shevga,2016,3417,4000,583,17.061750073163594
Shrirampur,Mosambi,2016,2417,3000,583,24.12081092263136
Jalna,Bajri,2015,1246,1828,582,46.70947030497592
Ausa,Pigeon Pea (Tur),2016,5735,6317,582,10.14821272885789
Pune,Green Gram,2015,7991,8573,582,7.283193592791891
Gevrai,Wheat(Husked),2015,1369,1951,582,42.512783053323595
Murtizapur,Black Gram,2015,5175,5757,582,11.246376811594203
Amarawati,Green Gram,2015,6847,7429,582,8.500073024682342
Dound,Bajri,2016,1700,2282,582,34.23529411764706
Patan,Ladies Finger,2016,3159,3741,582,18.42355175688509
Khed-Chakan,Carrot,2016,1245,1827,582,46.74698795180723
Akot,GREEN GRAM,2016,4177,4759,582,13.933445056260474
Dhule,Onion,2016,177,759,582,328.8135593220339
Nandgaon,Gram,2014,1996,2578,582,29.158316633266534
Ralegaon,Pigeon Pea (Tur),2016,8007,8589,582,7.268639940052454
Kej,Green Gram,2015,6601,7183,582,8.816845932434479
Mumbai-Fruit Market,Mosambi,2016,1722,2304,582,33.79790940766551
Vai,Ladies Finger,2015,3382,3964,582,17.20875221762271
Gangapur,Pigeon Pea (Tur),2015,7697,8279,582,7.561387553592309
Pusad,Pigeon Pea (Tur),2016,8383,8965,582,6.942621973040677
Dhule,Wheat(Husked),2016,1502,2084,582,38.74833555259654
Patan,Green Chilli,2015,1209,1791,582,48.13895781637717
Nagpur,Potato,2015,616,1197,581,94.31818181818181
Kolhapur-Laxmipuri,Wheat(Husked),2016,2340,2921,581,24.82905982905983
Satara,Brinjal,2015,1243,1824,581,46.74175382139984
Mumbai-Onion And Potato Mkt,Potato,2016,1240,1821,581,46.854838709677416
Pandharkawada,Pigeon Pea (Tur),2016,7021,7602,581,8.275174476570289
Ramtek,Potato,2016,1120,1701,581,51.875
Chalisgaon,Gram,2015,2617,3198,581,22.200993504012228
Indapur-Bhigwan,Wheat(Husked),2014,1450,2031,581,40.06896551724138
Aurangabad,Ladies Finger,2015,1841,2422,581,31.55893536121673
Junnar,Potato,2016,688,1269,581,84.44767441860465
Lasur Station,Gram,2015,2422,3003,581,23.98843930635838
Katol,Pigeon Pea (Tur),2015,5117,5698,581,11.354309165526676
Karanja,PIGEON PEA (TUR),2016,5392,5973,581,10.775222551928783
Lasalgaon,Pigeon Pea (Tur),2016,7463,8044,581,7.785073026932869
Sangali,Wheat(Unhusked),2014,3763,4344,581,15.439808663300559
Ahmednagar,Ground Nut Pods (Dry),2015,2683,3264,581,21.654863958255685
Ambejogai,Pigeon Pea (Tur),2015,5004,5585,581,11.610711430855316
Dhamangaon-Rly,Gram,2016,5690,6271,581,10.210896309314586
Kopargaon,Gram,2014,2087,2668,581,27.83900335409679
Chalisgaon,Gram,2015,3340,3920,580,17.365269461077844
Dudhani,BAJRI,2016,1250,1830,580,46.4
Ahmednagar,Capsicum,2016,690,1270,580,84.05797101449275
Varud-Rajura Bazar,Green Chilli,2014,2490,3070,580,23.29317269076305
Nagpur,Sorgum(Jawar),2016,1580,2160,580,36.70886075949367
Patur,Gram,2015,3770,4350,580,15.384615384615385
Pathardi,Sorgum(Jawar),2014,1540,2120,580,37.66233766233766
Kolhapur,Tomato,2015,188,768,580,308.51063829787233
Lonar,GRAM,2016,8140,8720,580,7.125307125307125
Pune,Gr.Nut Kernels,2015,7185,7765,580,8.072372999304106
Khamgaon,Soybean,2015,3253,3833,580,17.829695665539504
Nandgaon Khandeshwar,Pigeon Pea (Tur),2015,6691,7271,580,8.66836048423255
Sinner,WHEAT(HUSKED),2016,1781,2361,580,32.565974171813586
Yeotmal,Gram,2015,3979,4559,580,14.576526765518974
Pune-Moshi,Cucumber,2016,815,1395,580,71.16564417177914
Vai,Ginger (Fresh),2016,2843,3423,580,20.400984875131904
Ambad(Vadi Godri),Gram,2015,2767,3347,580,20.961329960245752
Rahata,Brinjal,2015,600,1180,580,96.66666666666667
Gevrai,SOYBEAN,2016,2076,2656,580,27.9383429672447
Kurdwadi,Onion,2016,144,724,580,402.77777777777777
Yeola,ONION,2016,214,794,580,271.02803738317755
Satara,Green Chilli,2015,3260,3840,580,17.791411042944784
Mumbai-Fruit Market,Water Melon,2016,1162,1742,580,49.91394148020654
Umared,Gram,2015,3900,4480,580,14.871794871794872
Pathari,Green Gram,2016,4487,5067,580,12.926231334967685
Murtizapur,Pigeon Pea (Tur),2015,8995,9575,580,6.448026681489717
Chikhali,Gram,2016,3771,4351,580,15.380535666931848
Pune-Moshi,Ground Nut Pods (Dry),2016,3448,4028,580,16.82134570765661
Lasalgaon,Pigeon Pea (Tur),2015,4800,5380,580,12.083333333333334
Ulhasnagar,Potato,2016,928,1508,580,62.5
Karad,Onion,2014,760,1340,580,76.3157894736842
Nandgaon Khandeshwar,SOYBEAN,2016,2244,2824,580,25.846702317290553
Shahapur,Ghosali(Bhaji),2014,1320,1900,580,43.93939393939394
Karad,Banana,2014,1673,2253,580,34.6682606096832
Patan,Ginger (Fresh),2016,2743,3323,580,21.14473204520598
Shahapur,Ladies Finger,2015,1463,2043,580,39.644565960355436
Loha,Wheat(Husked),2015,1463,2043,580,39.644565960355436
Shegaon,Soybean,2015,3180,3760,580,18.238993710691823
Nandgaon,Onion,2016,170,750,580,341.1764705882353
Aurangabad,Bitter Gourd,2015,1284,1864,580,45.17133956386293
Karad,Ghevda,2016,2088,2668,580,27.77777777777778
Karad,Capsicum,2014,3000,3580,580,19.333333333333332
Kolhapur,Potato,2015,663,1242,579,87.33031674208145
Pachora,Pigeon Pea (Tur),2016,7601,8180,579,7.617418760689383
Achalpur,Soybean,2014,2700,3279,579,21.444444444444443
Pusad,Soybean,2016,3368,3947,579,17.19121140142518
Shahapur,Cluster Bean,2015,2964,3543,579,19.534412955465587
Kej,Green Gram,2015,8040,8619,579,7.201492537313433
Kalyan,Green Chilli,2015,2046,2625,579,28.299120234604107
Indapur,Sorgum(Jawar),2016,1751,2330,579,33.06681896059395
Beed,Sorgum(Jawar),2014,1691,2270,579,34.2400946185689
Katol,Cotton,2016,3900,4479,579,14.846153846153847
Shrirampur,Lemon,2015,1105,1684,579,52.39819004524887
Yeotmal,Gram,2016,4726,5305,579,12.251375370292001
Khed-Chakan,Cucumber,2016,2242,2821,579,25.825156110615524
Kalmeshwar,Soybean,2015,3004,3583,579,19.274300932090547
Malegaon (Washim),Pigeon Pea (Tur),2016,8457,9036,579,6.846399432422845
Chandrapur-Ganjwad,Flower,2016,917,1496,579,63.14067611777536
Ghoti,Brinjal,2015,1311,1890,579,44.16475972540046
Babhulgaon,Soybean,2015,2992,3571,579,19.351604278074866
Lasalgaon-Niphad,Soybean,2016,3215,3793,578,17.97822706065319
Jalgaon,Tomato,2015,936,1514,578,61.75213675213675
Khamgaon,Black Gram,2015,5127,5705,578,11.273649307587283
Aurangabad,Chavli (Shenga ),2015,2333,2911,578,24.774967852550365
Shirpur,Matki,2015,6585,7163,578,8.777524677296887
Karad,Cucumber,2016,1270,1848,578,45.511811023622045
Ambejogai,Gram,2015,3998,4576,578,14.457228614307153
Rahata,Flower,2016,893,1471,578,64.72564389697648
Chandrapur-Ganjwad,Capsicum,2015,1029,1607,578,56.17103984450923
Mohol,Black Gram,2016,6200,6778,578,9.32258064516129
Morshi,Green Chilli,2014,2438,3016,578,23.707957342083674
Kalyan,Chikoo,2015,2011,2589,578,28.741919443063153
Nagpur,Gram,2015,2667,3245,578,21.672290963629546
Jalgaon Jamod-Aasalgaon,Green Gram,2016,4433,5011,578,13.03857432889691
Khamgaon,Gram,2015,2953,3531,578,19.57331527260413
Nandurbar,Shepa,2016,4586,5164,578,12.603576101177497
Vai,Pavata,2015,3389,3967,578,17.05517851873709
Vai,Green Chilli,2014,2252,2830,578,25.66607460035524
Barshi,BRINJAL,2016,1044,1622,578,55.3639846743295
Ausa,Pigeon Pea (Tur),2015,5465,6043,578,10.576395242451968
Akluj,Carrot,2015,744,1322,578,77.68817204301075
Ashti-Karanja,Soybean,2016,3146,3724,578,18.372536554354735
Umared,Coriander (Dry),2015,8333,8911,578,6.936277451098044
Shahapur,Ladies Finger,2015,1174,1752,578,49.23339011925042
Satara,Carrot,2016,1035,1613,578,55.84541062801932
Ratanagari,Cucumber,2015,803,1381,578,71.98007471980075
Vai,Pavata,2016,3511,4089,578,16.462546283110225
Jalgaon,Orange,2015,731,1308,577,78.9329685362517
Mumbai,Melon,2015,1181,1758,577,48.85690093141405
Manchar,Ghevda,2015,2319,2896,577,24.88141440275981
Raver,Gram,2015,3555,4132,577,16.230661040787624
Aurangabad,Bitter Gourd,2015,1700,2277,577,33.94117647058823
Satara,Green Chilli,2015,2981,3558,577,19.35592083193559
Mangalwedha,Sorgum(Jawar),2015,1809,2386,577,31.89607517965727
Kalamb (Os),Gram,2014,2150,2727,577,26.837209302325583
Shrirampur,Gram,2016,6635,7212,577,8.696307460437076
Khed-Chakan,Ladies Finger,2016,1777,2354,577,32.47045582442318
Karad,Bitter Gourd,2015,2256,2833,577,25.576241134751772
Murbad,Brinjal,2016,2088,2665,577,27.634099616858236
Rahata,Cucumber,2016,1885,2462,577,30.610079575596817
Kalyan,ORANGE,2016,2267,2844,577,25.45213939126599
Kalmeshwar,Pigeon Pea (Tur),2015,5683,6260,577,10.153088157663205
Satara,Brinjal,2015,992,1569,577,58.16532258064516
Yeola,Onion,2016,180,757,577,320.55555555555554
Chalisgaon,Green Gram,2016,4042,4619,577,14.275111331024245
Shrirampur,Mosambi,2014,1500,2077,577,38.46666666666667
Chimur,Pigeon Pea (Tur),2016,7790,8367,577,7.406931964056483
Gevrai,Gram,2015,3522,4099,577,16.38273708120386
Umarga,Gram,2015,3902,4479,577,14.78728856996412
Savner,Ground Nut Pods (Dry),2016,3383,3959,576,17.026308010641444
Karanja,GREEN GRAM,2016,4117,4693,576,13.990769978139422
Satara,Green Chilli,2015,2312,2888,576,24.913494809688583
Kolhapur-Laxmipuri,Wheat(Husked),2015,2324,2900,576,24.78485370051635
Karad,Chikoo,2016,1796,2372,576,32.071269487750556
Aurangabad,CLUSTER BEAN,2016,1876,2452,576,30.70362473347548
Dondaicha,Green Gram,2015,5450,6026,576,10.568807339449542
Aurad Shahajani,Pigeon Pea (Tur),2015,9015,9591,576,6.389351081530782
Chopda,Sesamum,2016,5711,6287,576,10.085799334617406
Karad,Cluster Bean,2016,3144,3720,576,18.3206106870229
Baramati,Sorgum(Jawar),2015,1675,2251,576,34.38805970149254
Sangali,GREEN GRAM,2016,5418,5994,576,10.631229235880399
Aurangabad,Bitter Gourd,2015,1859,2435,576,30.984400215169448
Gevrai,Sorgum(Jawar),2016,1708,2284,576,33.723653395784545
Jalgaon,Tomato,2015,824,1400,576,69.90291262135922
Dound,Sorgum(Jawar),2016,1828,2404,576,31.50984682713348
Lasalgaon,Wheat(Husked),2016,1609,2185,576,35.798632691112495
Parbhani,Green Gram,2015,7388,7964,576,7.796426637791012
Ausa,Paddy-Unhusked,2014,850,1426,576,67.76470588235294
Indapur,Sorgum(Jawar),2016,1875,2451,576,30.72
Mumbai,Flower,2014,1560,2136,576,36.92307692307692
Jintur-Bori,Gram,2015,2902,3478,576,19.848380427291524
Nandurbar,Green Gram,2016,4510,5086,576,12.771618625277162
Solapur,Guava,2014,851,1426,575,67.56756756756756
Shrirampur,Ginger (Fresh),2015,2217,2792,575,25.93594948128101
Phaltan,Bajri,2015,1250,1825,575,46.0
Akluj,Bor,2015,663,1238,575,86.72699849170438
Balapur,Pigeon Pea (Tur),2016,5525,6100,575,10.407239819004525
Yawal,Ground Nut Pods (Dry),2016,4713,5288,575,12.2002970507108
Amarawati,Chikoo,2016,1245,1820,575,46.18473895582329
Solapur,Potato,2015,461,1036,575,124.72885032537961
Gevrai,Pigeon Pea (Tur),2015,5071,5646,575,11.338986393216327
Aarni,Ground Nut Pods (Dry),2016,4800,5375,575,11.979166666666666
Karad,Potato,2015,1625,2200,575,35.38461538461539
Pune,LENTIL,2016,5891,6466,575,9.760651841792566
Vadgaon Peth,Snake Gourd,2015,675,1250,575,85.18518518518519
Aurangabad,Guava,2015,1217,1792,575,47.24732949876746
Hinganghat,Soybean,2015,2800,3375,575,20.535714285714285
Sangali,Castor Seed,2014,2800,3375,575,20.535714285714285
Akhadabalapur,Turmeric,2015,6375,6950,575,9.019607843137255
Parshiwani,Pigeon Pea (Tur),2016,7050,7625,575,8.156028368794326
Ratanagari,Flower,2015,2000,2575,575,28.75
Karad,Potato,2014,1683,2258,575,34.165181224004755
Pathardi,Pigeon Pea (Tur),2015,4875,5450,575,11.794871794871796
Ambad(Vadi Godri),Wheat(Husked),2016,1525,2100,575,37.704918032786885
Nandura,Gram,2016,5042,5617,575,11.40420468068227
Lohara,Pigeon Pea (Tur),2016,7375,7950,575,7.796610169491525
Rahuri-Vambori,Soybean,2016,2651,3226,575,21.689928328932478
Shahapur,Chavli (Shenga ),2016,1813,2388,575,31.715388858246
Shahapur,Bitter Gourd,2016,4350,4925,575,13.218390804597702
Sonpeth,Sorgum(Jawar),2015,1550,2125,575,37.096774193548384
Yeola,Green Gram,2014,7566,8141,575,7.599788527623579
Khamgaon,Green Gram,2016,5835,6410,575,9.85432733504713
Junnar-Otur,Cabbage,2016,519,1094,575,110.78998073217727
Mumbai,Ginger (Dry),2015,2725,3300,575,21.10091743119266
Satara,Potato,2015,1075,1650,575,53.48837209302326
Lonand,Sorgum(Jawar),2016,1650,2225,575,34.84848484848485
Akole,Wheat(Husked),2015,1425,2000,575,40.35087719298246
Dhule,Onion,2016,232,807,575,247.8448275862069
Loha,Wheat(Husked),2015,1242,1817,575,46.2962962962963
Jalgaon,Onion,2016,337,912,575,170.62314540059347
Ahmednagar,Bottle Gourd,2016,138,713,575,416.6666666666667
Ghoti,Brinjal,2016,2243,2818,575,25.63530985287561
Akole,Wheat(Husked),2015,1450,2025,575,39.6551724137931
Chalisgaon,Gram,2014,2000,2575,575,28.75
Phaltan,Bajri,2016,1275,1850,575,45.09803921568628
Kalyan,Apple,2016,1300,1875,575,44.23076923076923
Lasur Station,Pigeon Pea (Tur),2016,7035,7610,575,8.173418621179815
Akole,Soybean,2015,3000,3575,575,19.166666666666668
Rahata,Tomato,2015,575,1150,575,100.0
Shahapur,Bitter Gourd,2015,3695,4270,575,15.561569688768607
Jamkhed,Gram,2016,3725,4300,575,15.436241610738255
Khed,Flower,2016,550,1125,575,104.54545454545455
Indapur-Bhigwan,Ground Nut Pods (Dry),2015,3988,4563,575,14.418254764292879
Rahuri-Vambori,Green Gram,2014,5625,6200,575,10.222222222222221
Manchar,Beet Root,2015,900,1475,575,63.888888888888886
Pathardi,Wheat(Husked),2015,1500,2075,575,38.333333333333336
Rahata,Cucumber,2015,663,1238,575,86.72699849170438
Nira-Saswad,Rice(Paddy-Hus),2016,2813,3388,575,20.440810522573766
Pandharkawada,Pigeon Pea (Tur),2016,7189,7764,575,7.99833078314091
Kej,Coriander (Dry),2014,6550,7125,575,8.778625954198473
Indapur-Bhigwan,Gram,2015,2575,3150,575,22.33009708737864
Shahapur,Chavli (Shenga ),2014,1000,1575,575,57.5
Jalgaon,Lemon,2015,908,1483,575,63.32599118942731
Majalgaon,Bajri,2015,1393,1967,574,41.20603015075377
Indapur-Bhigwan,Bajri,2015,1301,1875,574,44.11990776325903
Pulgaon,Pigeon Pea (Tur),2015,6005,6579,574,9.558701082431307
Kalyan,Ridge Gourd,2015,3121,3695,574,18.391541172701057
Phaltan,Bajri,2016,1410,1984,574,40.709219858156025
Sonpeth,Pigeon Pea (Tur),2014,4276,4850,574,13.42376052385407
Sangamner,Flower,2015,618,1192,574,92.88025889967638
Baramati,Soybean,2015,3200,3774,574,17.9375
Shirur,Tamarind,2016,2371,2945,574,24.209194432728808
Latur,Wheat(Husked),2015,1590,2164,574,36.100628930817614
Khed-Chakan,Green-Peas,2016,2441,3015,574,23.51495288816059
Dudhani,Pigeon Pea (Tur),2015,6873,7447,574,8.351520442310491
Lonar,SORGUM(JAWAR),2016,1701,2275,574,33.74485596707819
Mumbai,Ginger (Dry),2015,3643,4217,574,15.756244853143015
Nira,Jaggery,2016,3738,4312,574,15.355805243445692
Shegaon,Soybean,2015,3200,3774,574,17.9375
Aurangabad,Bor,2015,807,1381,574,71.1276332094176
Naigaon,SOYBEAN,2016,2161,2735,574,26.561776955113373
Shahapur,Cucumber,2015,1287,1861,574,44.5998445998446
Pune,Gram,2016,8300,8874,574,6.9156626506024095
Akluj,Potato,2016,1121,1695,574,51.2042818911686
Risod,PIGEON PEA (TUR),2016,5526,6100,574,10.387260224393774
Kille Dharur,Sorgum(Jawar),2014,1828,2402,574,31.400437636761488
Shahapur,Brinjal,2015,1165,1739,574,49.27038626609442
Pune,Cabbage,2016,565,1138,573,101.41592920353982
Devala,Gram,2014,3094,3667,573,18.51971557853911
Washim,Pigeon Pea (Tur),2016,7906,8479,573,7.247660005059449
Khed-Chakan,Cabbage,2016,1729,2302,573,33.14054366685946
Shahapur,Cluster Bean,2016,4367,4940,573,13.121135791160981
Pune,Flower,2016,610,1183,573,93.93442622950819
Pune,Gram,2016,5227,5800,573,10.962311077099674
Umared,Gram,2015,3713,4286,573,15.43226501481282
Nagpur,Mosambi,2015,971,1544,573,59.011328527291454
Hingoli,Gram,2016,7588,8161,573,7.551396942540854
Mumbai,Chikoo,2015,945,1518,573,60.63492063492063
Manmad,Green Gram,2016,4798,5371,573,11.942476031679867
Kalyan,Mango,2015,2318,2891,573,24.71958584987058
Aurangabad,LEMON,2016,1246,1819,573,45.987158908507226
Varora,Soybean,2015,3310,3883,573,17.31117824773414
Paithan,Soybean,2015,3168,3741,573,18.08712121212121
Washim,Pigeon Pea (Tur),2015,4944,5517,573,11.589805825242719
Jalna,Green Gram,2016,4013,4586,573,14.278594567655121
Varud-Rajura Bazar,Green Chilli,2015,2154,2727,573,26.601671309192202
Mumbai,Split Gram,2015,3635,4208,573,15.763411279229711
Aurangabad,Bitter Gourd,2016,2818,3391,573,20.33356990773598
Pune-Manjri,Shepu,2015,660,1233,573,86.81818181818181
Pune,Black Gram,2014,4558,5131,573,12.57130320315928
Aurangabad,Flower,2014,1150,1723,573,49.82608695652174
Aurangabad,Lemon,2015,795,1368,573,72.0754716981132
Aurangabad,Orange,2015,627,1200,573,91.38755980861244
Pune,Pumpkin,2015,794,1367,573,72.1662468513854
Karad,Ladies Finger,2014,1836,2409,573,31.209150326797385
Dound,Wheat(Husked),2016,1610,2183,573,35.590062111801245
Ghoti,Brinjal,2014,2215,2788,573,25.869074492099323
Daryapur,Soybean,2016,3115,3688,573,18.39486356340289
Khed-Chakan,SWEET POTATO,2016,857,1429,572,66.74445740956826
Solapur,Green Peas (Dry),2016,3303,3875,572,17.317590069633667
Satara,Green Chilli,2016,3592,4164,572,15.924276169265033
Umared,Coriander (Dry),2016,6266,6838,572,9.12863070539419
Manora,Pigeon Pea (Tur),2016,6521,7093,572,8.771660788222665
Tumsar,Black Gram,2015,4650,5222,572,12.301075268817204
Amarawati-Fruit And Vegetables,Mosambi,2016,1414,1986,572,40.452616690240454
Jalgaon,Green Gram,2015,7311,7883,572,7.823827109834496
Jalgaon,Maize(Corn.),2016,821,1393,572,69.67113276492083
Mumbai,Green Chilli,2015,2353,2925,572,24.30939226519337
Amarawati,Lemon,2016,1721,2293,572,33.23649041255084
Satara,Pavtta,2015,3333,3905,572,17.16171617161716
Ahmednagar,Maize(Corn.),2016,414,986,572,138.16425120772948
Satana,Onion,2016,273,845,572,209.52380952380952
Sangali,Gram,2015,3604,4176,572,15.871254162042176
Telhara,Black Gram,2015,7569,8141,572,7.557140969745013
Hingoli-Kanegaon Naka,Wheat(Husked),2016,1560,2132,572,36.666666666666664
Chalisgaon,Ground Nut Pods (Dry),2015,3794,4366,572,15.076436478650502
Rahata,Bor,2016,1214,1786,572,47.1169686985173
Sillod,Pigeon Pea (Tur),2016,7428,8000,572,7.700592353257943
Akola,Gram,2015,3739,4311,572,15.298208077025944
Rahata,Shevga,2015,1714,2286,572,33.37222870478413
Sangali,Wheat(Unhusked),2015,4057,4629,572,14.099087996056198
Aurangabad,Orange,2015,924,1496,572,61.904761904761905
Mumbai-Fruit Market,Orange,2016,1656,2228,572,34.54106280193237
Satara,Bitter Gourd,2015,3476,4048,572,16.455696202531644
Patan,Ladies Finger,2014,2714,3286,572,21.075902726602802
Jintur,Sorgum(Jawar),2016,1289,1860,571,44.29790535298681
Shrirampur,Ground Nut Pods (Dry),2015,2500,3071,571,22.84
Kada (Ashti),Sorgum(Jawar),2016,1620,2191,571,35.24691358024691
Chandvad,Onion,2016,186,757,571,306.98924731182797
Chandrapur-Ganjwad,Flower,2016,658,1229,571,86.77811550151975
Shahapur,Ghosali(Bhaji),2016,2067,2638,571,27.624576681180454
Kalyan,Cluster Bean,2016,2082,2653,571,27.425552353506244
Aurangabad,Green Chilli,2016,2281,2852,571,25.03288031565103
Karad,Ginger (Fresh),2015,2429,3000,571,23.507616303005353
Karad,Ridge Gourd,2014,1700,2271,571,33.588235294117645
Satara,Ginger (Fresh),2015,2586,3157,571,22.08043310131477
Varud,Orange,2016,500,1071,571,114.2
Shahapur,Ghosali(Bhaji),2015,1104,1675,571,51.721014492753625
Satara,Cabbage,2016,1929,2500,571,29.60082944530845
Manmad,Horse Gram,2016,3801,4372,571,15.022362536174692
Satara,Capsicum,2015,2881,3452,571,19.819507115584866
Babhulgaon,Pigeon Pea (Tur),2016,8238,8809,571,6.931294003398883
Kalyan,Cluster Bean,2015,2486,3057,571,22.968624296057925
Lasalgaon,WHEAT(HUSKED),2016,1790,2361,571,31.899441340782122
Dhamangaon-Rly,Pigeon Pea (Tur),2016,7759,8330,571,7.359195772651115
Umared,Wheat(Husked),2015,1500,2071,571,38.06666666666667
Ahmedpur,Pigeon Pea (Tur),2015,8603,9174,571,6.637219574567012
Jalgaon,Sorgum(Jawar),2016,1564,2135,571,36.508951406649615
Rahuri-Vambori,Gram,2015,3433,4004,571,16.63268278473638
Mumbai,Papai,2015,533,1104,571,107.12945590994372
Karad,Capsicum,2016,2919,3490,571,19.56149366221309
Bhokar,Turmeric,2015,8364,8935,571,6.826877092300335
Anajngaon Surji,Soybean,2015,3229,3800,571,17.683493341591824
Pune-Manjri,Tomato,2016,610,1181,571,93.60655737704919
Indapur-Bhigwan,Bajri,2016,1613,2184,571,35.39987600743955
Junnar (Alephata),Onion,2015,969,1540,571,58.92672858617131
Pune,Wal Bhaji,2015,1941,2512,571,29.417825862957237
Satara,Cucumber,2016,1433,2004,571,39.84647592463364
Rahata,Brinjal,2016,1292,1862,570,44.11764705882353
Pune-Manjri,Tomato,2015,615,1185,570,92.6829268292683
Satara,Capsicum,2015,1522,2092,570,37.450722733245726
Rahata,Cucumber,2015,740,1310,570,77.02702702702703
Karad,Banana,2015,780,1350,570,73.07692307692308
Dindori,Onion,2016,800,1370,570,71.25
Manchar,Beet Root,2016,483,1053,570,118.01242236024845
Deulgaon Raja,Sorgum(Jawar),2016,1600,2170,570,35.625
Pusad,Ground Nut Pods (Dry),2015,5300,5870,570,10.754716981132075
Pune-Pimpri,Cucumber,2015,1480,2050,570,38.513513513513516
Solapur,Apple,2015,570,1140,570,100.0
Lonand,Wheat(Husked),2016,1530,2100,570,37.254901960784316
Ausa,Tamarind,2015,3241,3811,570,17.587164455414996
Aurangabad,Tomato,2015,785,1355,570,72.61146496815287
Pathari,Pigeon Pea (Tur),2015,4958,5528,570,11.496571198063736
Pathardi,Wheat(Husked),2016,1563,2133,570,36.468330134357004
Hingoli,Black Gram,2014,3290,3860,570,17.325227963525837
Sakri,Gram,2015,3374,3944,570,16.893894487255483
Rahata,Brinjal,2016,920,1490,570,61.95652173913044
Sakri,Onion,2016,180,750,570,316.6666666666667
Shrirampur,Bitter Gourd,2015,1600,2170,570,35.625
Partur,Gram,2014,2043,2613,570,27.90014684287812
Ratanagari,Tomato,2015,730,1300,570,78.08219178082192
Baramati,Wheat(Husked),2016,1633,2203,570,34.90508266993264
Rahata,Brinjal,2015,1020,1590,570,55.88235294117647
Ambejogai,Soybean,2016,2437,3007,570,23.389413212966762
Kamthi,Pumpkin,2015,690,1260,570,82.6086956521739
Anajngaon Surji,Gram,2016,7269,7839,570,7.841518778373916
Amarawati,Bor,2015,1420,1990,570,40.140845070422536
Barshi,Turmeric,2016,6400,6970,570,8.90625
Khed-Chakan,Cucumber,2016,1938,2508,570,29.41176470588235
Vai,Cucumber,2016,2075,2645,570,27.46987951807229
Karad,Bitter Gourd,2016,2915,3485,570,19.554030874785592
Beed,Sorgum(Jawar),2015,1630,2200,570,34.969325153374236
Pune-Moshi,Bitter Gourd,2016,1717,2287,570,33.1974373907979
Chandur Bajar,Soybean,2015,3033,3602,569,18.76030333003627
Kolhapur-Laxmipuri,Spilt Gerrn Gram,2016,8612,9181,569,6.607059916395727
Nashik,Tomato,2016,560,1129,569,101.60714285714286
Ahmedpur,Pigeon Pea (Tur),2016,5850,6419,569,9.726495726495726
Aurangabad,Awala,2014,594,1163,569,95.79124579124579
Udgir,Gram,2015,3816,4385,569,14.91090146750524
Ambejogai,Gram,2014,2015,2584,569,28.23821339950372
Babhulgaon,Gram,2016,5673,6242,569,10.029966508020447
Nagpur,Papai,2015,647,1216,569,87.94435857805254
Rahuri-Vambori,Green Gram,2016,4447,5016,569,12.795142792894087
Pune,Gr.Nut Kernels,2014,6504,7073,569,8.748462484624847
Kurdwadi,Onion,2016,120,689,569,474.1666666666667
Mumbai,Papai,2015,519,1088,569,109.63391136801542
Karad,Tomato,2014,1369,1938,569,41.56318480642805
Amarawati,Chikoo,2016,1431,2000,569,39.762403913347306
Shahada,Wheat(Husked),2015,1282,1851,569,44.38377535101404
Mumbai,Bitter Gourd,2015,2688,3256,568,21.13095238095238
Pulgaon,Cotton,2015,3972,4540,568,14.300100704934541
Chandrapur-Ganjwad,Brinjal,2016,1060,1628,568,53.58490566037736
Satara,Flower,2015,832,1400,568,68.26923076923077
Dound,Wheat(Husked),2015,1575,2143,568,36.06349206349206
Akluj,Cabbage,2016,932,1500,568,60.94420600858369
Barshi,Green Chilli,2016,918,1486,568,61.87363834422658
Dindori-Vani,Onion,2016,775,1343,568,73.29032258064517
Vadgaon Peth,Tomato,2016,537,1105,568,105.77281191806331
Nampur,GROUND NUT PODS (DRY),2016,2452,3020,568,23.164763458401303
Taloda,Sorgum(Jawar),2015,1507,2075,568,37.69077637690776
Kalyan,Potato,2016,976,1544,568,58.19672131147541
Jalgaon,Cucumber,2016,650,1218,568,87.38461538461539
Pune-Manjri,CHAVLI (PALA),2016,606,1174,568,93.72937293729373
Kopargaon,Soybean,2015,3213,3781,568,17.678182384064737
Ramtek,Brinjal,2016,1891,2459,568,30.037017451084083
Mehkar,Soybean,2016,2563,3131,568,22.1615294576668
Solapur,Potato,2015,600,1168,568,94.66666666666667
Nandura,Soybean,2015,3243,3811,568,17.51464693185322
Dudhani,Green Gram,2016,4437,5004,567,12.778904665314402
Palus,GREEN CHILLI,2016,1200,1767,567,47.25
Vai,Pavtta,2015,4833,5400,567,11.731843575418994
Shrirampur,Orange,2015,1500,2067,567,37.8
Mumbai,Curry Leaves,2015,1370,1937,567,41.386861313868614
Jalgaon,Melon,2016,1000,1567,567,56.7
Karad,Ghevda,2015,2111,2678,567,26.859308384651825
Amarawati,Ginger (Fresh),2014,3058,3625,567,18.54153041203401
Kej,Soybean,2015,3153,3720,567,17.982873453853472
Akola,Green Gram,2015,7100,7667,567,7.985915492957746
Baramati,Ground Nut Pods (Dry),2015,2600,3167,567,21.807692307692307
Chandrapur-Ganjwad,CHAVLI (PALA),2016,1133,1700,567,50.0441306266549
Vadgaon Peth,Cucumber,2015,600,1167,567,94.5
Vadgaon Peth,Cluster Bean,2015,833,1400,567,68.0672268907563
Pune-Pimpri,Ladies Finger,2015,2600,3167,567,21.807692307692307
Chandrapur-Ganjwad,Spinach,2015,933,1500,567,60.77170418006431
Shahada,Gram,2014,2469,3036,567,22.96476306196841
Shahapur,Brinjal,2015,1000,1567,567,56.7
Shahapur,Capsicum,2015,1222,1789,567,46.39934533551555
Paranda,Pigeon Pea (Tur),2016,5300,5867,567,10.69811320754717
Ratanagari,Flower,2015,1350,1917,567,42.0
Malegaon (Washim),Green Gram,2015,6900,7467,567,8.217391304347826
Chandrapur-Ganjwad,Brinjal,2014,608,1175,567,93.25657894736842
Murbad,Ghosali(Bhaji),2016,3833,4400,567,14.792590660057396
Bhivandi,Rice(Paddy-Hus),2015,2250,2817,567,25.2
Jalgaon,Shevga,2016,1061,1628,567,53.44015080113101
Manchar,Shepu,2014,322,889,567,176.08695652173913
Phaltan,Wheat(Husked),2015,1467,2034,567,38.65030674846626
Aurangabad,Shevga,2015,1195,1762,567,47.44769874476987
Kalyan,Flower,2015,958,1525,567,59.18580375782881
Indapur,Black Gram,2016,10767,11334,567,5.266090833101142
Patan,Ghevda,2015,2333,2900,567,24.30347192456065
Ahmednagar,Tomato,2016,157,724,567,361.14649681528664
Deglur,Black Gram,2016,9133,9700,567,6.208255775758239
Mohol,Pigeon Pea (Tur),2014,3801,4368,567,14.917127071823204
Nagpur,Chavli (Pala),2016,1733,2300,567,32.71783035199077
Indapur-Bhigwan,Green Peas (Dry),2015,1933,2500,567,29.332643559234352
Sillod-Bharadi,GRAM,2016,6933,7500,567,8.178277801817394
Patan,Bitter Gourd,2015,1833,2400,567,30.9328968903437
Latur-Murud,Soybean,2015,3220,3787,567,17.608695652173914
Katol,Gram,2015,3876,4443,567,14.628482972136222
Ramtek,Lemon,2015,1083,1650,567,52.35457063711911
Aurangabad,Sweet Potato,2016,1533,2100,567,36.986301369863014
Shahapur,Cucumber,2014,1000,1567,567,56.7
Jalgaon,Custard Apple,2015,2500,3067,567,22.68
Solapur,Pigeon Pea (Tur),2016,7370,7937,567,7.693351424694709
Himayatnagar,Gram,2015,3500,4067,567,16.2
Paranda,Green Gram,2016,3950,4517,567,14.354430379746836
Khed-Chakan,Walvad,2016,1607,2174,567,35.28313627878033
Kille Dharur,Wheat(Husked),2015,1574,2141,567,36.02287166454892
Patan,CLUSTER BEAN,2016,2750,3317,567,20.618181818181817
Mumbai,Spilt Gerrn Gram,2016,6508,7075,567,8.712354025814383
Pune-Manjri,Shepu,2015,300,867,567,189.0
Aurangabad,Cucumber,2014,1381,1948,567,41.057204923968136
Ahmednagar,Gram,2015,4328,4894,566,13.077634011090574
Ramtek,Ground Nut Pods (Dry),2016,2767,3333,566,20.455366823274304
Chandvad,Onion,2016,232,798,566,243.9655172413793
Mohol,Sorgum(Jawar),2014,1546,2112,566,36.61060802069858
Pune,Sorgum(Jawar),2015,2434,3000,566,23.25390304026294
Malegaon,Sorgum(Jawar),2016,1570,2136,566,36.05095541401274
Pune-Pimpri,GHOSALI(BHAJI),2016,1934,2500,566,29.26577042399173
Nira-Saswad,Wheat(Husked),2016,1609,2175,566,35.17712865133623
Manmad,Onion,2016,300,866,566,188.66666666666666
Karad,Ginger (Fresh),2016,2093,2659,566,27.042522694696608
Pune-Moshi,Walvad,2016,2017,2583,566,28.061477441745165
Gevrai,Sorgum(Jawar),2014,1460,2026,566,38.76712328767123
Umarkhed-Danki,Pigeon Pea (Tur),2015,8067,8633,566,7.016238998388497
Satara,Potato,2014,2156,2722,566,26.25231910946197
Vaijapur,Wheat(Husked),2015,1426,1992,566,39.691444600280505
Pune,Gr.Nut Kernels,2016,8779,9345,566,6.447203553935528
Kalyan,Curry Leaves,2016,2067,2633,566,27.38268021286889
Vai,Ridge Gourd,2015,2767,3333,566,20.455366823274304
Pune,Mula Shenga,2015,1167,1733,566,48.50042844901457
Patan,Ghevda,2014,2142,2708,566,26.42390289449113
Nandura,Sesamum,2016,4796,5362,566,11.801501251042536
Kalamb (Os),Wheat(Husked),2016,1958,2524,566,28.907048008171603
Jalgaon Jamod-Aasalgaon,Pigeon Pea (Tur),2014,4267,4833,566,13.2645887040075
Kurdwadi,Sorgum(Jawar),2016,1456,2022,566,38.87362637362637
Pune,Tomato,2016,404,970,566,140.0990099009901
Pune,Tomato,2016,396,962,566,142.92929292929293
Kej,Wheat(Husked),2015,1845,2411,566,30.67750677506775
Kada (Ashti),Sorgum(Jawar),2014,2167,2733,566,26.119058606368252
Kalyan,Capsicum,2015,2617,3183,566,21.62781811234238
Anajngaon Surji,Pigeon Pea (Tur),2015,8556,9122,566,6.615240766713417
Dound,Green Gram,2015,7684,8250,566,7.365955231650182
Kalyan,Onion,2015,1742,2308,566,32.49138920780712
Jalgaon Jamod-Aasalgaon,Black Gram,2014,4617,5183,566,12.259042668399394
Shahapur,Brinjal,2016,2167,2733,566,26.119058606368252
Malegaon,Bajri,2016,1463,2029,566,38.687628161312375
Nashik,Flower,2016,687,1253,566,82.38719068413391
Malegaon,Ground Nut Pods (Dry),2015,4050,4616,566,13.975308641975309
Yeola,Gram,2016,6113,6679,566,9.2589563225912
Ramtek,Onion,2016,1141,1707,566,49.60560911481157
Akluj,Tomato,2016,864,1429,565,65.39351851851852
Tumsar,Jaggery,2015,2291,2856,565,24.66171977302488
Mantha,Black Gram,2016,6040,6605,565,9.35430463576159
Aurangabad,Green Chilli,2016,2839,3404,565,19.90137372314195
Hinganghat,Gram,2015,2463,3028,565,22.93950466910272
Solapur,Tomato,2016,187,752,565,302.13903743315507
Jintur,Pigeon Pea (Tur),2016,7500,8065,565,7.533333333333333
Buldhana,Wheat(Husked),2015,1420,1985,565,39.7887323943662
Shegaon,Green Gram,2016,4537,5102,565,12.45316288296231
Pune,Arvi,2016,2325,2890,565,24.301075268817204
Nagpur,Brinjal,2015,712,1277,565,79.35393258426966
Lasur Station,Wheat(Husked),2015,1311,1876,565,43.09687261632342
Lonand,Onion,2016,171,736,565,330.4093567251462
Umarga,Gram,2015,3533,4098,565,15.99207472403057
Vasai,Potato,2015,939,1504,565,60.170394036208734
Indapur-Bhigwan,Bajri,2015,1325,1890,565,42.64150943396226
Nandurbar,Gram,2014,2177,2742,565,25.953146531924666
Shegaon,Gram,2015,3287,3852,565,17.18892607240645
Karad,Banana,2015,814,1379,565,69.41031941031942
Dhamangaon-Rly,Gram,2016,5807,6372,565,9.729636645427933
Koregaon,Potato,2015,625,1190,565,90.4
Satara,Pavtta,2015,3353,3918,565,16.850581568744406
Satara,Pavtta,2015,2300,2865,565,24.565217391304348
Mumbai,Melon,2015,1450,2015,565,38.96551724137931
Pusad,Black Gram,2015,7978,8543,565,7.081975432439208
Pathari,Pigeon Pea (Tur),2015,5760,6325,565,9.809027777777779
Patan,Tomato,2016,2029,2593,564,27.79694430754066
Mohol,Gram,2016,5686,6250,564,9.919099542736546
Pune,Green Gram,2015,7300,7864,564,7.726027397260274
Nagpur,Gram,2014,2348,2912,564,24.020442930153322
Kalamb (Os),Black Gram,2014,5008,5572,564,11.261980830670927
Mohol,Gram,2016,5440,6004,564,10.367647058823529
Pune,Sweet Potato,2016,1086,1650,564,51.93370165745856
Khed-Chakan,Shevga,2016,1688,2252,564,33.41232227488152
Jalgaon,Wal Papdi,2014,1618,2182,564,34.857849196538936
Pune-Pimpri,Brinjal,2016,2250,2814,564,25.066666666666666
Solapur,Potato,2015,571,1135,564,98.77408056042032
Mangalwedha,Sorgum(Jawar),2016,1650,2214,564,34.18181818181818
Shegaon,Gram,2015,3917,4481,564,14.39877457237682
Ambad(Vadi Godri),Sorgum(Jawar),2015,1150,1714,564,49.04347826086956
Sailu,Sorgum(Jawar),2015,1083,1647,564,52.0775623268698
Shrirampur,Mango(Raw),2016,1458,2021,563,38.61454046639232
Karad,Green-Peas,2016,2879,3442,563,19.555401180965614
Chandrapur-Ganjwad,Capsicum,2016,650,1213,563,86.61538461538461
Karad,Green Chilli,2015,2125,2688,563,26.49411764705882
Kille Dharur,Soybean,2016,3275,3838,563,17.19083969465649
Majalgaon,Sorgum(Jawar),2016,1431,1994,563,39.343116701607265
Indapur-Bhigwan,Bajri,2016,1350,1913,563,41.7037037037037
Purna,Sorgum(Jawar),2016,1381,1944,563,40.76755973931933
Karanja,Ground Nut Pods (Dry),2015,5020,5583,563,11.215139442231076
Latur,SOYBEAN,2016,2429,2992,563,23.17826265953067
Anajngaon Surji,WHEAT(HUSKED),2016,1550,2113,563,36.32258064516129
Akole,Soybean,2016,3000,3563,563,18.766666666666666
Karad,Cluster Bean,2016,2200,2763,563,25.59090909090909
Karad,Cluster Bean,2016,2421,2984,563,23.25485336637753
Partur,Green Gram,2015,6576,7139,563,8.561435523114355
Kopargaon,Onion,2016,328,891,563,171.64634146341464
Shahada,Green Gram,2015,8140,8703,563,6.916461916461916
Palghar(Bevur),Rice(Paddy-Hus),2016,2422,2985,563,23.245251857968622
Nandurbar,Gram,2015,3642,4205,563,15.458539264140581
Jalgaon,Tomato,2015,764,1327,563,73.69109947643979
Mantha,Sorgum(Jawar),2015,1165,1728,563,48.32618025751073
Vadgaon Peth,Tomato,2015,564,1127,563,99.822695035461
Varora,Soybean,2015,2842,3405,563,19.80999296270232
Koregaon,Onion,2016,200,763,563,281.5
Rahata,Shevga,2015,1500,2063,563,37.53333333333333
Rahata,Capsicum,2015,1125,1688,563,50.044444444444444
Karad,Bitter Gourd,2014,2100,2663,563,26.80952380952381
Gevrai,Pigeon Pea (Tur),2015,5007,5570,563,11.244258038745755
Balapur,Gram,2016,3650,4213,563,15.424657534246576
Mantha,Wheat(Husked),2015,1300,1863,563,43.30769230769231
Satara,Flower,2016,1450,2013,563,38.827586206896555
Manmad,Gram,2015,3757,4320,563,14.985360660101145
Nandurbar,Wheat(Husked),2015,1442,2005,563,39.04299583911234
Ashti-Karanja,Soybean,2015,3114,3677,563,18.079640333975593
Kopargaon,Gram,2016,3884,4447,563,14.49536560247168
Sinner,Potato,2016,525,1088,563,107.23809523809524
Purna,Pigeon Pea (Tur),2016,7789,8352,563,7.228142251893696
Khamgaon,Lemon,2015,345,908,563,163.18840579710144
Lonand,Onion,2016,188,751,563,299.468085106383
Ratanagari,Bitter Gourd,2015,3125,3688,563,18.016
Karad,Bitter Gourd,2015,2500,3063,563,22.52
Khamgaon,Lemon,2015,125,688,563,450.4
Sangali,Green Gram,2016,5385,5947,562,10.436397400185701
Junnar,Onion,2016,567,1129,562,99.11816578483246
Gevrai,Wheat(Husked),2015,1360,1922,562,41.3235294117647
Satana,Bajri,2016,1520,2082,562,36.973684210526315
Pune,PUMPKIN,2016,724,1286,562,77.62430939226519
Akola,Gram,2016,4105,4667,562,13.69062119366626
Pachora,Gram,2016,6743,7305,562,8.334569182856296
Vai,Ridge Gourd,2015,2563,3125,562,21.927428794381584
Nashik,Ladies Finger,2016,1061,1623,562,52.9688972667295
Kamthi,Chavli (Pala),2015,624,1186,562,90.06410256410257
Nashik,Shahale ,2015,1513,2075,562,37.14474553866491
Washim,Pigeon Pea (Tur),2015,6688,7250,562,8.40311004784689
Chandur Rly.,Pigeon Pea (Tur),2015,5578,6140,562,10.07529580494801
Khed-Chakan,Ladies Finger,2016,1688,2250,562,33.29383886255924
Aurangabad,Wal Bhaji,2016,1217,1779,562,46.17912900575185
Babhulgaon,Gram,2016,4641,5203,562,12.109459168282697
Pune-Pimpri,Brinjal,2016,2552,3114,562,22.021943573667713
Murum,Pigeon Pea (Tur),2015,6075,6637,562,9.251028806584362
Shrirampur,Bitter Gourd,2014,2263,2825,562,24.83429076447194
Pusad,Soybean,2015,3236,3798,562,17.367119901112485
Khamgaon,Lemon,2016,333,895,562,168.76876876876878
Kolhapur-Laxmipuri,Split Gram,2016,8273,8835,562,6.793182642330472
Satara,Capsicum,2015,2192,2754,562,25.638686131386862
Majalgaon,Gram,2014,1719,2281,562,32.6934264107039
Shahapur,Ladies Finger,2015,2019,2581,562,27.835562159484894
Solapur,Wheat(Husked),2016,2102,2664,562,26.736441484300666
Shegaon,Thymol/Lovage,2015,8638,9200,562,6.506135679555452
Kalyan,Bor,2016,1763,2325,562,31.877481565513328
Patan,Ginger (Fresh),2016,2105,2666,561,26.65083135391924
Dindori-Vani,Onion,2014,1253,1814,561,44.772545889864325
Ahmednagar,Green Gram,2015,7508,8069,561,7.472029834842834
Tumsar,Rice(Paddy-Hus),2015,2823,3384,561,19.872476089266737
Devala,Cowpea,2014,2106,2667,561,26.63817663817664
Aurad Shahajani,SOYBEAN,2016,2339,2900,561,23.984608807182557
Dound,Wheat(Husked),2015,1413,1974,561,39.70276008492569
Chopda,Pigeon Pea (Tur),2015,4622,5183,561,12.137602769363912
Patan,Ginger (Fresh),2015,2242,2803,561,25.022301516503124
Mumbai-Fruit Market,Papai,2016,1657,2218,561,33.85636692818346
Sangali,Gram,2016,4130,4691,561,13.583535108958838
Nashik,Carrot,2016,1267,1828,561,44.277821625887924
Murtizapur,Green Gram,2015,8371,8932,561,6.701708278580814
Devala,Gram,2015,3064,3625,561,18.30939947780679
Pachora,Soybean,2015,3150,3711,561,17.80952380952381
Paranda,Sorgum(Jawar),2016,1711,2272,561,32.787843366452364
Sinner,Pigeon Pea (Tur),2015,3895,4456,561,14.403080872913993
Umari,Pigeon Pea (Tur),2016,8088,8649,561,6.936201780415431
Pune,Gr.Nut Kernels,2015,8562,9123,561,6.552207428170988
Khamgaon,Lemon,2016,147,708,561,381.6326530612245
Jalgaon,Flower,2016,1267,1828,561,44.277821625887924
Pune-Pimpri,Ridge Gourd,2014,2881,3442,561,19.472405414786532
Tasgaon,GRAM,2016,7455,8016,561,7.525150905432596
Karanja,Gram,2015,3399,3960,561,16.50485436893204
Murtizapur,GREEN GRAM,2016,4217,4778,561,13.30329618211999
Jalna-Badnapur,Gram,2014,2400,2961,561,23.375
Kopargaon,Soybean,2015,3065,3626,561,18.303425774877653
Anajngaon Surji,Pigeon Pea (Tur),2016,7644,8205,561,7.339089481946624
Pune,Sorgum(Jawar),2015,2255,2816,561,24.878048780487806
Jintur,Wheat(Husked),2015,1441,2001,560,38.8619014573213
Kopargaon,Sorgum(Jawar),2016,1411,1971,560,39.68816442239547
Kamthi,Spinach,2016,497,1057,560,112.67605633802818
Nandura,Soybean,2015,3272,3832,560,17.114914425427873
Nashik,Bottle Gourd,2016,557,1117,560,100.53859964093357
Jalgaon Jamod-Aasalgaon,Black Gram,2014,4520,5080,560,12.389380530973451
Akola,Green Gram,2016,5060,5620,560,11.067193675889328
Solapur,Jaggery,2016,2349,2909,560,23.839931885908896
Murbad,Capsicum,2016,4470,5030,560,12.527964205816556
Solapur,Cabbage,2015,500,1060,560,112.0
Manmad,Capsicum,2016,250,810,560,224.0
Dound,Bajri,2016,1509,2069,560,37.11066931742876
Satara,Cluster Bean,2016,1608,2168,560,34.82587064676617
Vai,Ginger (Fresh),2015,2944,3504,560,19.02173913043478
Jalgaon Jamod-Aasalgaon,Pigeon Pea (Tur),2015,4900,5460,560,11.428571428571429
Akola,SORGUM(JAWAR),2016,1283,1843,560,43.64770070148091
Karad,Ginger (Fresh),2016,2336,2896,560,23.972602739726028
Nandura,Green Gram,2016,4308,4868,560,12.999071494893222
Daryapur,Pigeon Pea (Tur),2014,4600,5160,560,12.173913043478262
Umared,Wheat(Husked),2015,1500,2060,560,37.333333333333336
Pathardi,Wheat(Husked),2015,1584,2144,560,35.35353535353536
Satara,Pavtta,2015,2000,2560,560,28.0
Solapur,Tomato,2015,104,664,560,538.4615384615385
Sangali,Green Peas (Dry),2016,2547,3107,560,21.98665096191598
Rahata,Bottle Gourd,2016,1554,2114,560,36.03603603603604
Vadgaon Peth,Brinjal,2015,420,980,560,133.33333333333334
Dudhani,Pigeon Pea (Tur),2016,5304,5864,560,10.558069381598793
Jalna,Bajri,2015,1054,1614,560,53.13092979127135
Partur,Green Gram,2014,6863,7423,560,8.159696925542766
Vai,Pavata,2016,3100,3660,560,18.06451612903226
Kurdwadi,Sorgum(Jawar),2016,1769,2329,560,31.656302996042964
Chalisgaon,Cabbage,2016,1525,2085,560,36.721311475409834
Nagpur,Coriander  ,2015,3840,4400,560,14.583333333333334
Katol,Gram,2016,3666,4226,560,15.275504637206765
Rahata,Walvad,2016,1960,2520,560,28.571428571428573
Umared,Wheat(Husked),2015,1500,2060,560,37.333333333333336
Kada,Black Gram,2014,4281,4841,560,13.081055828077552
Samudrapur,Soybean,2016,3049,3609,560,18.366677599212856
Aurad Shahajani,GREEN GRAM,2016,4200,4760,560,13.333333333333334
Kamthi,CUCUMBER,2016,865,1425,560,64.73988439306359
Pune-Pimpri,Cluster Bean,2016,4240,4800,560,13.20754716981132
Junnar,Potato,2016,500,1060,560,112.0
Karad,Potato,2014,1620,2180,560,34.5679012345679
Lonar,Pigeon Pea (Tur),2014,4175,4735,560,13.41317365269461
Kalamb (Os),Green Gram,2014,7493,8053,560,7.4736420659282
Pune-Moshi,Carrot,2016,1560,2120,560,35.8974358974359
Loha,Wheat(Husked),2015,1462,2021,559,38.23529411764706
Bhokar,Turmeric,2015,6355,6914,559,8.79622344610543
Osmanabad,Onion,2016,657,1216,559,85.08371385083714
Kurdwadi-Modnimb,Gram,2016,3645,4204,559,15.336076817558299
Aurangabad,Cluster Bean,2014,2986,3545,559,18.720696584058942
Ausa,Pigeon Pea (Tur),2015,5333,5892,559,10.481905119069943
Khamgaon,Soybean,2016,2722,3281,559,20.536370315944158
Ausa,Pigeon Pea (Tur),2015,8808,9367,559,6.346503178928247
Pune,ARVI,2016,2459,3018,559,22.732818218788125
Kurdwadi-Modnimb,Wheat(Husked),2015,1323,1882,559,42.252456538170826
Vai,Ridge Gourd,2015,3088,3647,559,18.102331606217618
Jalna,Gram,2015,3877,4436,559,14.418364714985813
Manmad,BAJRI,2016,1416,1975,559,39.4774011299435
Karad,Tomato,2015,1108,1667,559,50.45126353790614
Beed,Gram,2016,4855,5414,559,11.513903192584964
Aurangabad,CHAVLI (SHENGA ),2016,1968,2527,559,28.40447154471545
Karad,Tomato,2016,1641,2200,559,34.064594759293115
Washim,Green Gram,2016,4358,4917,559,12.826984855438274
Khed-Chakan,Ladies Finger,2015,2269,2828,559,24.636403702071398
Dudhani,Sorgum(Jawar),2014,1228,1787,559,45.52117263843648
Lasalgaon,Onion,2016,483,1041,558,115.527950310559
Amarawati,Pigeon Pea (Tur),2016,8713,9271,558,6.40422357396993
Kada,Wheat(Husked),2016,1652,2210,558,33.7772397094431
Pune-Moshi,Ladies Finger,2016,1404,1962,558,39.743589743589745
Mantha,Wheat(Husked),2015,1420,1978,558,39.29577464788732
Pune-Pimpri,Ghevda,2016,2721,3279,558,20.507166482910694
Kamthi,Flower,2015,742,1300,558,75.2021563342318
Kinwat,Green Gram,2016,4667,5225,558,11.956288836511678
Gangapur,Wheat(Husked),2015,1344,1902,558,41.517857142857146
Akot,Soybean,2016,3265,3823,558,17.090352220520675
Satara,Cluster Bean,2015,4750,5308,558,11.74736842105263
Alibag,Coconut,2016,2500,3058,558,22.32
Karad,Ginger (Fresh),2016,2038,2596,558,27.379784102060842
Ahmednagar,Black Gram,2016,6321,6879,558,8.827717133364974
Barshi,Pigeon Pea (Tur),2015,5023,5581,558,11.1088990643042
Shahapur,Cluster Bean,2015,1967,2525,558,28.36807320793086
Rahata,Ladies Finger,2015,3242,3800,558,17.211597779148672
Dound,Gram,2015,3911,4469,558,14.2674507798517
Pandharpur,Sorgum(Jawar),2014,1990,2548,558,28.040201005025125
Kalyan,Capsicum,2016,3374,3932,558,16.538233550681685
Kolhapur,Cabbage,2015,360,918,558,155.0
Sangli-Phale Bhajipalam,Potato,2016,1073,1631,558,52.00372786579683
Shirpur,Sorgum(Jawar),2016,1511,2069,558,36.929185969556585
Kej,Pigeon Pea (Tur),2015,4695,5253,558,11.884984025559106
Shahapur,Capsicum,2016,1071,1629,558,52.10084033613445
Ahmedpur,Gram,2016,3673,4231,558,15.191941192485707
Dudhani,Wheat(Husked),2015,1382,1940,558,40.37626628075253
Malegaon,Sorgum(Jawar),2015,1930,2488,558,28.911917098445596
Shrirampur,Tomato,2015,1288,1846,558,43.32298136645963
Karad,Onion,2015,1043,1600,557,53.40364333652924
Baramati,Jaggery,2016,2912,3469,557,19.127747252747252
Pune-Moshi,WALVAD,2016,1532,2089,557,36.35770234986945
Akot,Ground Nut Pods (Dry),2015,4952,5509,557,11.247980613893377
Chandrapur,Chikoo,2015,1500,2057,557,37.13333333333333
Akluj,Tomato,2016,806,1363,557,69.10669975186104
Pathardi,Wheat(Husked),2016,1693,2250,557,32.900177200236264
Gevrai,Green Gram,2016,4505,5062,557,12.364039955604884
Chandrapur-Ganjwad,Flower,2015,507,1064,557,109.86193293885601
Amarawati,Soybean,2016,3088,3645,557,18.037564766839377
Chandrapur-Ganjwad,Math (Bhaji),2015,743,1300,557,74.96635262449529
Partur,Pigeon Pea (Tur),2016,7157,7714,557,7.782590470867682
Katol,Gram,2015,3414,3971,557,16.31517281780902
Kalyan,Rice(Paddy-Hus),2015,2486,3043,557,22.40547063555913
Pune,Arvi,2014,1614,2171,557,34.51053283767038
Karad,Cabbage,2016,1186,1743,557,46.964586846543
Amarawati,Coriander  ,2016,4000,4557,557,13.925
Akot,Green Gram,2015,6742,7299,557,8.261643429249482
Ausa,Wheat(Husked),2014,1455,2012,557,38.281786941580755
Aurangabad,Tomato,2014,804,1361,557,69.27860696517413
Nagpur,Soybean,2015,3089,3646,557,18.03172547750081
Nilanga,Black Gram,2014,4856,5413,557,11.470345963756177
Patan,Green Chilli,2015,2000,2557,557,27.85
Kille Dharur,Bajri,2015,1337,1894,557,41.660433807030664
Amarawati,Math (Bhaji),2016,3929,4486,557,14.176635276151693
Kalyan,Cluster Bean,2015,2326,2883,557,23.946689595872744
Kamthi,Brinjal,2016,460,1017,557,121.08695652173913
Junnar,Onion,2015,743,1300,557,74.96635262449529
Pune,Pumpkin,2015,1124,1681,557,49.555160142348754
Risod,Green Gram,2015,8259,8816,557,6.744157888364208
Solapur,Gram,2016,5770,6327,557,9.653379549393414
Shrirampur,Wheat(Husked),2016,1519,2076,557,36.66886109282423
Osmanabad,Cabbage,2015,670,1227,557,83.13432835820896
Buldhana,Gram,2016,7243,7800,557,7.6901836255695155
Osmanabad,Wheat(Husked),2016,1727,2284,557,32.2524609148813
Dhule,Gram,2014,2171,2727,556,25.61031782588669
Mumbai,Split Lentil,2015,6548,7104,556,8.491142333536958
Devala,Onion,2016,250,806,556,222.4
Katol,Soybean,2016,3024,3580,556,18.386243386243386
Kolhapur-Laxmipuri,Green Gram,2014,7188,7744,556,7.7351140790205895
Amarawati,Soybean,2016,3300,3856,556,16.848484848484848
Amarawati,Sesamum,2016,5346,5902,556,10.400299289188178
Kolhapur,Potato,2015,608,1164,556,91.44736842105263
Akluj,Tomato,2016,824,1380,556,67.47572815533981
Nandura,Pigeon Pea (Tur),2016,8373,8929,556,6.640391735339783
Akole,Bajri,2016,1444,2000,556,38.50415512465374
Jalgaon,Lemon,2015,1311,1867,556,42.41037376048818
Rahuri-Vambori,Wheat(Husked),2015,1280,1836,556,43.4375
Majalgaon,Sorgum(Jawar),2016,1361,1917,556,40.85231447465099
Karanja,Pigeon Pea (Tur),2016,6086,6642,556,9.1357213276372
Jintur,Green Gram,2015,6357,6913,556,8.746263960987887
Karanja,Pigeon Pea (Tur),2015,5551,6107,556,10.016213294901819
Mangalwedha,Wheat(Husked),2014,1391,1947,556,39.97124370956146
Mumbai,Water Melon,2015,804,1360,556,69.1542288557214
Kopargaon,Green Gram,2016,4545,5101,556,12.233223322332233
Mantha,Black Gram,2016,5542,6098,556,10.032479249368459
Akluj,Banana,2014,300,856,556,185.33333333333334
Junnar-Otur,Capsicum,2016,778,1334,556,71.46529562982005
Shrirampur,Wheat(Husked),2015,1370,1926,556,40.583941605839414
Daryapur,Gram,2015,3907,4463,556,14.230867673406706
Jalgaon,Maize(Corn.),2016,850,1406,556,65.41176470588235
Pune-Pimpri,Brinjal,2015,2665,3220,555,20.825515947467167
Loha,Wheat(Husked),2016,1570,2125,555,35.35031847133758
Satara,Ladies Finger,2014,3352,3907,555,16.557279236276848
Dhule,Maize,2016,843,1398,555,65.83629893238434
Manchar,Brinjal,2015,3125,3680,555,17.76
Akluj,BRINJAL,2016,840,1395,555,66.07142857142857
Vai,Green Chilli,2016,3689,4244,555,15.044727568446733
Pune,Lentil,2015,7118,7673,555,7.797134026411913
Shrirampur,Tamarind,2015,1500,2055,555,37.0
Morshi,Gram,2016,7622,8177,555,7.281553398058253
Khed (Shel Pimpalgaon),Brinjal,2016,2007,2562,555,27.65321375186846
Yeola,Onion,2016,246,801,555,225.609756097561
Bhivandi,Other Vegetables,2015,1258,1813,555,44.11764705882353
Kurdwadi,Onion,2016,115,670,555,482.60869565217394
Achalpur,Gram,2016,6245,6800,555,8.8871096877502
Rahuri-Vambori,Gram,2016,6027,6582,555,9.208561473369835
Akluj,Tomato,2015,867,1422,555,64.01384083044982
Majalgaon,Pigeon Pea (Tur),2016,6208,6763,555,8.94007731958763
Ulhasnagar,Potato,2016,889,1444,555,62.429696287964006
Satara,Shevga,2015,2541,3096,555,21.841794569067297
Ratanagari,Flower,2015,2028,2583,555,27.366863905325445
Hadgaon,Gram,2016,4417,4972,555,12.56508942721304
Ahmednagar,Sorgum(Jawar),2016,1723,2278,555,32.21125943122461
Junnar (Alephata),Onion,2016,314,869,555,176.7515923566879
Nandura,Black Gram,2015,4747,5302,555,11.691594691384031
Chandur Bajar,Pigeon Pea (Tur),2016,7729,8284,555,7.1807478328373655
Shirpur,Gram,2014,2381,2936,555,23.309533809323813
Samudrapur,Soybean,2016,3209,3764,555,17.295107510127767
Risod,Pigeon Pea (Tur),2015,4925,5480,555,11.269035532994923
Shrirampur,Wheat(Husked),2015,1441,1996,555,38.51492019430951
Pune,Potato,2016,817,1372,555,67.93145654834761
Karad,Squash Gourd,2015,2075,2630,555,26.746987951807228
Latur-Murud,Soybean,2015,3136,3691,555,17.697704081632654
Nandura,Pigeon Pea (Tur),2014,4361,4916,555,12.726438890162807
Amarawati-Fruit And Vegetables,CHIKOO,2016,1565,2120,555,35.46325878594249
Satara,Ladies Finger,2015,2950,3505,555,18.8135593220339
Mumbai,Carrot,2014,1630,2185,555,34.04907975460123
Rahata,Cluster Bean,2016,4889,5444,555,11.352014726938025
Taloda,Black Gram,2015,3289,3844,555,16.874429917908177
Jamkhed,Soybean,2016,3002,3557,555,18.48767488341106
Jalgaon,Flower,2015,1028,1583,555,53.988326848249024
Nandgaon,Maize,2016,910,1464,554,60.879120879120876
Gevrai,Wheat(Husked),2016,1741,2295,554,31.820792647903502
Dhule,Matki,2016,6474,7028,554,8.557306147667594
Chandrapur-Ganjwad,Onion,2014,1573,2127,554,35.21932612841704
Akot,Gram,2015,3687,4241,554,15.025766205587198
Varora,Gram,2016,6065,6619,554,9.134377576257213
Nagpur,Math (Bhaji),2015,2815,3369,554,19.680284191829486
Kalmeshwar,Cotton,2015,3792,4346,554,14.609704641350211
Mumbai,Ladies Finger,2015,2115,2669,554,26.19385342789598
Lasalgaon-Vinchur,Gram,2016,3794,4348,554,14.602003162888773
Aurangabad,Flower,2015,1415,1969,554,39.15194346289753
Patan,Ginger (Fresh),2015,2373,2927,554,23.345975558364938
Lonar,Gram,2015,4053,4607,554,13.668887244016778
Umarga,Pigeon Pea (Tur),2015,8771,9325,554,6.316269524569605
Nandura,Pigeon Pea (Tur),2015,4568,5122,554,12.12784588441331
Ashti-Karanja,Soybean,2016,3083,3637,554,17.969510217320792
Manchar,Shepu,2014,442,996,554,125.3393665158371
Indapur (Nimgaon Ketki),Sorgum(Jawar),2016,1721,2275,554,32.19058686809994
Jintur-Bori,Soybean,2015,3098,3652,554,17.88250484183344
Mumbai,Squash Gourd,2016,4173,4727,554,13.275820752456266
Dondaicha,Gram,2016,6344,6898,554,8.73266078184111
Shegaon,Soybean,2015,3285,3839,554,16.864535768645357
Mumbai,Flower,2016,615,1169,554,90.08130081300813
Junnar (Alephata),Onion,2015,1213,1767,554,45.67188788128607
Aurangabad,Green Chilli,2015,2464,3018,554,22.483766233766232
Khamgaon,Cotton,2016,4100,4654,554,13.512195121951219
Chopda,Gram,2015,3322,3876,554,16.676700782661047
Shahapur,Chavli (Shenga ),2015,1964,2518,554,28.207739307535643
Hinganghat,Soybean,2015,2800,3354,554,19.785714285714285
Pune-Moshi,Ginger (Fresh),2016,2875,3429,554,19.269565217391303
Mehkar,Pigeon Pea (Tur),2016,6238,6792,554,8.881051619108689
Jalgaon,Shevga,2016,988,1541,553,55.97165991902834
Chandrapur-Ganjwad,Brinjal,2015,558,1111,553,99.10394265232975
Barshi,Capsicum,2015,682,1235,553,81.08504398826979
Pathari,Pigeon Pea (Tur),2015,4897,5450,553,11.292628139677353
Kolhapur-Laxmipuri,Gr.Nut Kernels,2015,8057,8610,553,6.86359687228497
Pune,Beet Root,2015,547,1100,553,101.09689213893967
Barshi-Vairag,Sorgum(Jawar),2015,1748,2301,553,31.63615560640732
Jalna,Banana,2014,389,942,553,142.15938303341903
Baramati,Onion,2016,217,770,553,254.83870967741936
Malkapur,Gram,2015,3701,4254,553,14.941907592542556
Telhara,Soybean,2015,3075,3628,553,17.983739837398375
Pune-Pimpri,Brinjal,2015,1300,1853,553,42.53846153846154
Nampur,Onion,2016,456,1009,553,121.2719298245614
Nira-Saswad,Bajri,2015,1517,2070,553,36.45352669742913
Mehkar,Black Gram,2016,6427,6980,553,8.604325501789326
Karanja,Gram,2015,3606,4159,553,15.335551858014421
Beed,Gram,2015,4051,4604,553,13.650950382621575
Nampur,Pigeon Pea (Tur),2016,5605,6158,553,9.866190900981266
Lonand,Onion,2016,264,817,553,209.46969696969697
Pusad,Sesamum,2016,5701,6254,553,9.700052622346957
Amalner,Sorgum(Jawar),2016,1581,2134,553,34.97786211258697
Amarawati-Fruit And Vegetables,Ginger (Fresh),2016,2057,2610,553,26.883811375789985
Ramtek,Spinach,2015,1519,2071,552,36.33969716919026
Junnar-Otur,Onion,2016,473,1025,552,116.70190274841438
Satara,Flower,2016,1261,1813,552,43.77478191911182
Hingoli,Pigeon Pea (Tur),2016,6191,6743,552,8.916168631884995
Latur,Gram,2016,4433,4985,552,12.45206406496729
Devala,Pigeon Pea (Tur),2015,4625,5177,552,11.935135135135136
Pune,Onion,2016,540,1092,552,102.22222222222223
Dound,Wheat(Husked),2016,1566,2118,552,35.24904214559387
Raver,Gram,2015,2542,3094,552,21.71518489378442
Aurangabad,Ladies Finger,2015,1712,2264,552,32.242990654205606
Mangrulpeer,Gram,2014,1997,2549,552,27.641462193289936
Akluj,ONION,2016,331,883,552,166.76737160120845
Jalgaon,Papai,2015,681,1233,552,81.05726872246696
Shrirampur,Brinjal,2015,1356,1908,552,40.70796460176991
Parola,GREEN GRAM,2016,3901,4453,552,14.150217892847987
Dhule,Onion,2016,133,685,552,415.0375939849624
Mumbai,Shevga,2016,1632,2184,552,33.8235294117647
Chandrapur,Banana,2016,1008,1560,552,54.76190476190476
Karad,Green Chilli,2015,1705,2257,552,32.375366568914956
Lasalgaon-Vinchur,Soybean,2015,2874,3426,552,19.206680584551147
Nagpur,Dhemse,2015,1652,2204,552,33.41404358353511
Vai,Green Chilli,2015,2057,2609,552,26.835196888672826
Pune,Potato,2016,883,1435,552,62.51415628539071
Manchar,Cabbage,2016,593,1144,551,92.91736930860034
Katol,Pigeon Pea (Tur),2015,4916,5467,551,11.208299430431245
Ahmedpur,Pigeon Pea (Tur),2016,8343,8894,551,6.6043389667985135
Varora,Soybean,2016,3060,3611,551,18.00653594771242
Bhokar,Sesamum,2015,6650,7201,551,8.285714285714286
Mangalwedha,Pigeon Pea (Tur),2016,6250,6801,551,8.816
Aurangabad,Onion,2016,166,717,551,331.9277108433735
Chikhali,Wheat(Husked),2016,1453,2004,551,37.921541637990366
Manmad,Gram,2014,2220,2771,551,24.81981981981982
Mehkar,PIGEON PEA (TUR),2016,5050,5601,551,10.910891089108912
Arvi,Pigeon Pea (Tur),2016,8664,9215,551,6.359649122807017
Latur,Gram,2014,2370,2921,551,23.248945147679326
Khamgaon,Gram,2016,3845,4396,551,14.330299089726918
Hinganghat,Soybean,2016,3039,3590,551,18.130964132938466
Vadgaon Peth,Tomato,2015,727,1278,551,75.79092159559835
Khamgaon,Green Gram,2015,7328,7879,551,7.51910480349345
Latur-Murud,Soybean,2015,3000,3551,551,18.366666666666667
Barshi,Tomato,2016,516,1067,551,106.78294573643412
Jawala-Bajar,Pigeon Pea (Tur),2015,6900,7450,550,7.971014492753623
Dhule,Chillies(Red),2014,3400,3950,550,16.176470588235293
Chandrapur-Ganjwad,Chavli (Shenga ),2014,1450,2000,550,37.93103448275862
Akkalkuwa,Sorgum(Jawar),2015,1200,1750,550,45.833333333333336
Dondaicha,Matki,2016,5560,6110,550,9.892086330935252
Rahata,Cluster Bean,2015,2350,2900,550,23.404255319148938
Vani,Pigeon Pea (Tur),2015,4632,5182,550,11.87392055267703
Indapur-Bhigwan,Gram,2016,3863,4413,550,14.237639140564328
Karad,Shevga,2014,2500,3050,550,22.0
Kalyan,Cluster Bean,2014,1750,2300,550,31.428571428571427
Indapur-Bhigwan,Wheat(Husked),2016,1667,2217,550,32.99340131973605
Baramati,Pigeon Pea (Tur),2016,5950,6500,550,9.243697478991596
Anajngaon Surji,Sorgum(Jawar),2016,986,1536,550,55.78093306288032
Lasur Station,Onion,2016,100,650,550,550.0
Karad,Sweet Potato,2014,1000,1550,550,55.0
Kalyan,Chillies(Red),2016,1000,1550,550,55.0
Aarni,Pigeon Pea (Tur),2016,4800,5350,550,11.458333333333334
Akluj,Bor,2014,1371,1921,550,40.116703136396794
Ratanagari,Bottle Gourd,2015,800,1350,550,68.75
Nashik-Devlali,CHAVLI (PALA),2016,350,900,550,157.14285714285714
Rahata,Ladies Finger,2015,3950,4500,550,13.924050632911392
Mumbai-Fruit Market,Pitch,2016,6450,7000,550,8.527131782945736
Manchar,Chavli (Shenga ),2016,650,1200,550,84.61538461538461
Shahapur,Ladies Finger,2016,2767,3317,550,19.877123238164078
Ahmednagar,Tomato,2015,717,1267,550,76.70850767085076
Ratanagari,Bottle Gourd,2015,575,1125,550,95.65217391304348
Amarawati,Chikoo,2015,1700,2250,550,32.35294117647059
Mumbai,Flower,2016,596,1146,550,92.28187919463087
Paranda,Onion,2016,83,633,550,662.6506024096385
Phaltan,Green Gram,2016,4850,5400,550,11.34020618556701
Jalgaon,Green Gram,2015,6933,7483,550,7.933073705466609
Rahata,Capsicum,2014,2300,2850,550,23.91304347826087
Nira-Saswad,Bajri,2015,1538,2088,550,35.76072821846554
Ahmednagar,Cucumber,2015,883,1433,550,62.287655719139295
Chopda,SUNFLOWER,2016,2401,2951,550,22.907122032486463
Dhule,Cowpea,2016,3288,3838,550,16.727493917274938
Karad,Pavtta,2016,1750,2300,550,31.428571428571427
Vadgaon Peth,Sweet Potato,2014,950,1500,550,57.89473684210526
Biloli,Green Gram,2016,4350,4900,550,12.64367816091954
Khed-Chakan,Ladies Finger,2016,2922,3472,550,18.822724161533195
Kalyan,Bottle Gourd,2014,850,1400,550,64.70588235294117
Karad,Capsicum,2015,900,1450,550,61.111111111111114
Nandura,Soybean,2016,3061,3611,550,17.96798431885005
Indapur,Green Gram,2016,4150,4700,550,13.25301204819277
Mantha,Sorgum(Jawar),2015,1150,1700,550,47.82608695652174
Sinner,Ground Nut Pods (Dry),2014,3775,4325,550,14.56953642384106
Manchar,Ground Nut Pods (Dry),2015,3100,3650,550,17.741935483870968
Shrirampur,Tamarind,2016,2450,3000,550,22.448979591836736
Aurangabad,Ladies Finger,2016,2615,3165,550,21.032504780114724
Nagpur,Papai,2015,700,1250,550,78.57142857142857
Kolhapur-Malkapur,Cluster Bean,2016,464,1014,550,118.53448275862068
Lasalgaon,Onion,2016,393,943,550,139.94910941475828
Pune,Green Gram,2016,7572,8122,550,7.263602746962493
Sangli-Phale Bhajipalam,Papai,2016,203,753,550,270.935960591133
Chandrapur-Ganjwad,Pumpkin,2016,550,1100,550,100.0
Pune,Arvi,2015,1468,2018,550,37.46594005449591
Rahuri-Vambori,Matki,2015,9670,10220,550,5.687693898655636
Shrirampur,Bitter Gourd,2014,1771,2321,550,31.055900621118013
Washim,Black Gram,2016,8350,8900,550,6.586826347305389
Karad,Capsicum,2015,1950,2500,550,28.205128205128204
Ramtek,Dhemse,2016,1950,2500,550,28.205128205128204
Dondaicha,Matki,2016,5956,6506,550,9.234385493619879
Pune-Pimpri,Fenugreek,2016,650,1200,550,84.61538461538461
Nanded,Pigeon Pea (Tur),2015,7200,7750,550,7.638888888888889
Kada,Green Gram,2015,7501,8051,550,7.332355685908546
Osmanabad,Bottle Gourd,2016,1075,1625,550,51.16279069767442
Malkapur,Sesamum,2014,8350,8900,550,6.586826347305389
Shrigonda,Tomato,2016,3450,4000,550,15.942028985507246
Kada,Gram,2014,2156,2706,550,25.510204081632654
Aurangabad,Chikoo,2016,1150,1700,550,47.82608695652174
Nira,Sorgum(Jawar),2015,1600,2150,550,34.375
Indapur-Bhigwan,Pigeon Pea (Tur),2015,4200,4750,550,13.095238095238095
Akot,Gram,2015,3897,4447,550,14.113420579933281
Nandurbar,Wheat(Husked),2015,1401,1951,550,39.25767309064953
Jawala-Bajar,Pigeon Pea (Tur),2015,5975,6525,550,9.205020920502092
Satara,Ghevda,2015,2163,2713,550,25.42764678687009
Chandrapur-Ganjwad,SMALL GOURD,2016,650,1200,550,84.61538461538461
Dhamangaon-Rly,SOYBEAN,2016,2281,2831,550,24.112231477422185
Dound,Green Gram,2015,6100,6650,550,9.01639344262295
Manchar,Potato,2016,400,950,550,137.5
Manchar,Bottle Gourd,2015,1025,1575,550,53.65853658536585
Kalyan,Jaggery,2015,2750,3300,550,20.0
Pulgaon,Soybean,2015,3309,3859,550,16.62133575098217
Mantha,Wheat(Husked),2016,1500,2050,550,36.666666666666664
Lonand,Gram,2016,4975,5525,550,11.055276381909549
Tasgaon,Black Gram,2016,5100,5650,550,10.784313725490197
Nampur,Gram,2016,4541,5091,550,12.111869632239594
Akluj,Ladies Finger,2016,715,1265,550,76.92307692307692
Shrirampur,Garlic,2014,2225,2775,550,24.719101123595507
Sangali,Castor Seed,2014,2800,3350,550,19.642857142857142
Ramtek,Mango,2016,1500,2050,550,36.666666666666664
Shahapur,Ridge Gourd,2015,4000,4550,550,13.75
Jamkhed,Black Gram,2015,9150,9700,550,6.0109289617486334
Vai,Sweet Potato,2015,1875,2425,550,29.333333333333332
Junnar-Otur,Onion,2015,2700,3250,550,20.37037037037037
Kalyan,Banana,2015,3850,4400,550,14.285714285714286
Kalyan,Papai,2016,1783,2333,550,30.846887268648345
Taloda,Gram,2016,4115,4665,550,13.365735115431349
Sindi,Soybean,2016,3058,3608,550,17.985611510791365
Rahuri,Potato,2015,617,1167,550,89.14100486223663
Malkapur,Black Gram,2016,9469,10019,550,5.8084275002640195
Akole,Gram,2015,3300,3850,550,16.666666666666668
Bhokardan,Gram,2016,7000,7550,550,7.857142857142857
Umarkhed-Danki,Pigeon Pea (Tur),2015,4950,5500,550,11.11111111111111
Patan,Capsicum,2016,950,1500,550,57.89473684210526
Phaltan,Pavtta,2016,3650,4200,550,15.068493150684931
Shrirampur,Pomegranate,2014,4250,4800,550,12.941176470588236
Lonar,Black Gram,2015,5967,6517,550,9.217362158538629
Shahapur,Cucumber,2016,1250,1800,550,44.0
Bhivandi,Onion,2015,1563,2113,550,35.18873960332694
Junnar,Potato,2016,1033,1583,550,53.24298160696999
Sangali,Soybean,2016,2950,3500,550,18.64406779661017
Loha,Green Gram,2015,7101,7651,550,7.745387973524855
Vai,Pavata,2014,3750,4300,550,14.666666666666666
Satara,Onion,2016,550,1100,550,100.0
Solapur,Gram,2016,4126,4676,550,13.330101793504605
Savali,Pigeon Pea (Tur),2016,5850,6400,550,9.401709401709402
Ambejogai,Gram,2015,2488,3038,550,22.106109324758844
Pathardi,Gram,2014,2250,2800,550,24.444444444444443
Vai,Ladies Finger,2015,1750,2300,550,31.428571428571427
Vai,Ladies Finger,2015,3350,3900,550,16.417910447761194
Telhara,Black Gram,2015,8915,9465,550,6.169377453729669
Satara,Tomato,2014,764,1314,550,71.98952879581152
Palus,Cabbage,2016,1300,1850,550,42.30769230769231
Achalpur,Mustard,2016,3525,4075,550,15.602836879432624
Vadgaon Peth,Snake Gourd,2015,700,1250,550,78.57142857142857
Ghansawangi,Soybean,2016,3300,3850,550,16.666666666666668
Kille Dharur,GRAM,2016,7267,7817,550,7.568460162377873
Palus,Ladies Finger,2016,1200,1750,550,45.833333333333336
Pune-Pimpri,Raddish,2016,650,1200,550,84.61538461538461
Akhadabalapur,Turmeric,2016,7875,8425,550,6.984126984126984
Umarkhed-Danki,Ground Nut Pods (Dry),2015,4500,5050,550,12.222222222222221
Rahata,Bitter Gourd,2016,1367,1917,550,40.23408924652524
Nashik-Devlali,Tandulja,2016,697,1247,550,78.90961262553802
Nashik,Potato,2015,920,1470,550,59.78260869565217
Pune-Pimpri,Raddish,2016,650,1200,550,84.61538461538461
Anajngaon Surji,Sunflower,2015,2500,3050,550,22.0
Manchar,Chavli (Shenga ),2015,2500,3050,550,22.0
Sangrampur-Varvatbakal,Soybean,2016,2962,3512,550,18.568534773801485
Paranda,Wheat(Husked),2015,1300,1850,550,42.30769230769231
Manchar,Cucumber,2016,1250,1800,550,44.0
Kalyan,Indian Bean,2015,4000,4550,550,13.75
Jalgaon,Melon,2016,1186,1736,550,46.3743676222597
Pathardi,Wheat(Husked),2016,1583,2133,550,34.74415666456096
Umarkhed-Danki,Pigeon Pea (Tur),2015,4700,5250,550,11.702127659574469
Jalgaon,CARROT,2016,1000,1550,550,55.0
Vai,Ginger (Fresh),2015,3308,3858,550,16.626360338573157
Palus,CAPSICUM,2016,1017,1567,550,54.08062930186824
Jalgaon,Coriander (Dry),2015,10500,11050,550,5.238095238095238
Chandrapur-Ganjwad,Tomato,2016,508,1058,550,108.26771653543307
Lonar,Gram,2015,3858,4408,550,14.25609123898393
Karmala,Sunflower,2016,3350,3900,550,16.417910447761194
Katol,Gram,2015,4246,4795,549,12.929816297691945
Junnar (Narayangaon),Tomato,2016,314,863,549,174.84076433121018
Mantha,Wheat(Husked),2015,1433,1982,549,38.311235170969994
Tumsar,Paddy-Unhusked,2016,1750,2299,549,31.37142857142857
Umared,Other Pulses,2015,4580,5129,549,11.986899563318778
Lonar,Pigeon Pea (Tur),2016,7020,7569,549,7.82051282051282
Daryapur,Green Gram,2015,9052,9601,549,6.0649580203269995
Ambad(Vadi Godri),Sorgum(Jawar),2016,1590,2139,549,34.528301886792455
Mangalwedha,Sorgum(Jawar),2015,1484,2033,549,36.99460916442049
Pune,Lemon,2015,105,654,549,522.8571428571429
Rajura,Cotton,2015,3536,4085,549,15.526018099547512
Shirpur,Sorgum(Jawar),2014,1196,1745,549,45.903010033444815
Lonand,Onion,2016,275,824,549,199.63636363636363
Chalisgaon,Sesamum,2016,4451,5000,549,12.334306897326444
Hinganghat,Cotton,2016,4088,4637,549,13.429549902152642
Aurangabad,BITTER GOURD,2016,1136,1684,548,48.23943661971831
Ramtek,Spinach,2015,1862,2410,548,29.430719656283568
Satara,Cluster Bean,2015,1888,2436,548,29.02542372881356
Udgir,Pigeon Pea (Tur),2014,4405,4953,548,12.440408626560727
Ghatanji,Pigeon Pea (Tur),2016,8375,8923,548,6.543283582089552
Mehkar,Gram,2016,3828,4376,548,14.31556948798328
Kamthi,Bottle Gourd,2014,739,1287,548,74.15426251691476
Umrane,Onion,2016,839,1387,548,65.31585220500595
Satara,Capsicum,2015,1744,2292,548,31.422018348623855
Khed (Shel Pimpalgaon),Ladies Finger,2015,1381,1929,548,39.68139029688631
Pune,Green Gram,2016,5869,6417,548,9.33719543363435
Kolhapur,Tomato,2016,177,725,548,309.6045197740113
Kurdwadi-Modnimb,Wheat(Husked),2016,1713,2261,548,31.990659661412725
Karad,POTATO,2016,908,1456,548,60.352422907488986
Yeola,BLACK GRAM,2016,5352,5900,548,10.23916292974589
Vaijapur,Pigeon Pea (Tur),2015,8137,8685,548,6.734668796853877
Shrirampur,Custard Apple,2014,1738,2286,548,31.53049482163406
Chandrapur-Ganjwad,Flower,2015,312,860,548,175.64102564102564
Bhandara,Gram,2016,9364,9912,548,5.852199914566425
Umarga,Gram,2015,3488,4036,548,15.711009174311927
Aurangabad,Cucumber,2016,1490,2038,548,36.77852348993289
Karad,Ladies Finger,2016,2628,3176,548,20.85235920852359
Shirpur,Onion,2016,171,719,548,320.46783625730995
Karad,Ginger (Fresh),2016,2104,2652,548,26.045627376425855
Tumsar,Rice(Paddy-Hus),2016,2855,3403,548,19.194395796847637
Ratanagari,Flower,2015,1690,2238,548,32.42603550295858
Kopargaon,Soybean,2015,3175,3723,548,17.25984251968504
Mumbai-Fruit Market,Chikoo,2016,1162,1710,548,47.16006884681583
Pune,Beet Root,2015,320,868,548,171.25
Jalgaon,Potato,2016,1120,1668,548,48.92857142857143
Pune,Flower,2015,478,1026,548,114.64435146443515
Nagpur,Capsicum,2016,3248,3796,548,16.87192118226601
Dondaicha,Matki,2016,5434,5981,547,10.06624953993375
Pune-Pimpri,Bottle Gourd,2015,924,1471,547,59.1991341991342
Nagpur,Chavli (Shenga ),2016,2183,2730,547,25.05726065048099
Shirpur,Gram,2014,2406,2953,547,22.734829592684953
Akot,Black Gram,2016,5753,6300,547,9.508082739440292
Pune-Pimpri,Brinjal,2015,1810,2357,547,30.22099447513812
Chopda,Gram,2016,5696,6243,547,9.603230337078651
Bhokar,Turmeric,2016,7583,8130,547,7.213503890280892
Karad,Bitter Gourd,2016,2238,2785,547,24.441465594280608
Beed,Sorgum(Jawar),2016,1614,2161,547,33.8909541511772
Narkhed,Cotton,2016,4871,5418,547,11.229726955450626
Pune,Arvi,2015,1566,2113,547,34.92975734355045
Hadgaon,Pigeon Pea (Tur),2016,8529,9076,547,6.413413061320202
Phaltan,Tomato,2016,588,1135,547,93.02721088435374
Ramtek,Capsicum,2016,2140,2687,547,25.560747663551403
Shahapur,Chavli (Shenga ),2015,1088,1635,547,50.275735294117645
Sangali,Soybean,2014,2716,3263,547,20.139911634756995
Jalna,Gram,2014,2221,2767,546,24.583520936515082
Majalgaon,Green Gram,2015,6616,7162,546,8.252720677146312
Junnar (Alephata),Onion,2016,450,996,546,121.33333333333333
Khamgaon,Soybean,2016,3155,3701,546,17.305863708399364
Phaltan,Bajri,2015,1253,1799,546,43.57541899441341
Telhara,Pigeon Pea (Tur),2015,8345,8891,546,6.542840023966447
Aarni,Pigeon Pea (Tur),2016,6313,6859,546,8.648819895453826
Satara,Green Chilli,2015,1214,1760,546,44.97528830313015
Khamgaon,Gram,2014,2183,2729,546,25.0114521300962
Barshi,Bitter Gourd,2016,754,1300,546,72.41379310344827
Ratanagari,Cucumber,2015,1192,1738,546,45.80536912751678
Kolhapur-Laxmipuri,Wheat(Husked),2016,2400,2946,546,22.75
Pune-Pimpri,Green Chilli,2014,3136,3682,546,17.410714285714285
Wardha,Gram,2016,6214,6760,546,8.786610878661088
Kamthi,Raddish,2016,743,1289,546,73.48586810228802
Shrirampur,Ginger (Fresh),2014,3568,4114,546,15.302690582959642
Sinner,Sorgum(Jawar),2015,1072,1618,546,50.93283582089552
Phaltan,CLUSTER BEAN,2016,3818,4364,546,14.3006809848088
Satara,Cucumber,2015,1004,1550,546,54.38247011952191
Jalgaon,Tomato,2016,1127,1673,546,48.4472049689441
Pune,Potato,2015,650,1196,546,84.0
Ramtek,Green Chilli,2016,1518,2064,546,35.96837944664031
Chandur Bajar,Pigeon Pea (Tur),2016,8175,8721,546,6.678899082568807
Nagpur,Potato,2016,546,1092,546,100.0
Jintur-Bori,Pigeon Pea (Tur),2016,7577,8123,546,7.206018213013066
Murtizapur,Soybean,2016,2405,2951,546,22.7027027027027
Pune,Potato,2016,720,1266,546,75.83333333333333
Nagpur,Soybean,2015,3134,3680,546,17.42182514358647
Varora,Soybean,2015,3075,3621,546,17.75609756097561
Amarawati-Fruit And Vegetables,Chikoo,2016,1118,1664,546,48.83720930232558
Chalisgaon,Black Gram,2015,6935,7481,546,7.873107426099495
Shahapur,Bitter Gourd,2016,3446,3992,546,15.844457341845619
Vadgaon Peth,Flower,2015,627,1173,546,87.08133971291866
Karad,Green-Peas,2016,3281,3827,546,16.64126790612618
Aurangabad,Green Chilli,2016,554,1100,546,98.55595667870035
Anajngaon Surji,PIGEON PEA (TUR),2016,4920,5465,545,11.077235772357724
Navapur,Pigeon Pea (Tur),2015,7965,8510,545,6.842435655994978
Kalyan,Cluster Bean,2016,3022,3567,545,18.034414295168762
Mumbai,Papai,2015,541,1086,545,100.73937153419594
Malkapur,Bajri,2016,1135,1680,545,48.01762114537445
Rahata,Garlic,2016,8000,8545,545,6.8125
Kolhapur-Laxmipuri,Split Gram,2015,3844,4389,545,14.177939646201873
Nandurbar,Sorgum(Jawar),2016,1395,1940,545,39.06810035842294
Rahuri-Vambori,Gram,2016,5242,5787,545,10.396795116367798
Pune,Arvi,2016,2600,3145,545,20.96153846153846
Nagpur,Gram,2015,4003,4548,545,13.614788908318761
Kalyan,SHEVGA,2016,3222,3767,545,16.91495965238982
Khamgaon,Soybean,2015,3175,3720,545,17.165354330708663
Dhule,Green Gram,2015,5922,6467,545,9.202971968929416
Hingoli,Wheat(Husked),2015,1424,1969,545,38.27247191011236
Risod,Pigeon Pea (Tur),2015,8393,8938,545,6.4935064935064934
Jintur,Pigeon Pea (Tur),2015,5076,5621,545,10.736800630417651
Jalgaon,Flower,2015,675,1220,545,80.74074074074075
Pune-Manjri,Rajgira,2015,355,900,545,153.5211267605634
Manora,Gram,2015,3475,4020,545,15.683453237410072
Satana,Onion,2016,268,813,545,203.3582089552239
Aurangabad,Brinjal,2015,855,1400,545,63.74269005847953
Khed-Chakan,Carrot,2016,825,1370,545,66.06060606060606
Akluj,Shevga,2016,544,1089,545,100.18382352941177
Kada,Wheat(Husked),2016,1502,2047,545,36.284953395472705
Shrirampur,Bitter Gourd,2015,1864,2409,545,29.238197424892704
Ambad(Vadi Godri),Green Gram,2016,3889,4434,545,14.013885317562355
Umarkhed-Danki,Pigeon Pea (Tur),2016,8044,8589,545,6.775236200895077
Chalisgaon,Bitter Gourd,2016,1409,1954,545,38.679914833215044
Mangrulpeer,Soybean,2014,2762,3306,544,19.695872556118754
Pune,Gr.Nut Kernels,2015,6700,7244,544,8.119402985074627
Pune,Carrot,2015,656,1200,544,82.92682926829268
Sailu,Cotton,2016,4172,4716,544,13.039309683604985
Gangapur,Onion,2016,250,794,544,217.6
Khamgaon,Lemon,2016,231,775,544,235.4978354978355
Kolhapur,Harbara(Pendi),2016,576,1120,544,94.44444444444444
Aurangabad,Capsicum,2015,1180,1724,544,46.101694915254235
Ambejogai,Gram,2015,3777,4321,544,14.402965316388668
Amarawati,Pigeon Pea (Tur),2015,9315,9859,544,5.840042941492217
Sangamner,Tomato,2016,348,892,544,156.32183908045977
Palghar(Bevur),Rice(Paddy-Hus),2016,2534,3078,544,21.468034727703238
Shegaon,Gram,2015,2850,3394,544,19.087719298245613
Amarawati-Fruit And Vegetables,Onion,2016,352,896,544,154.54545454545453
Karad,Ghevda,2016,2843,3387,544,19.134716848399577
Anajngaon Surji,Pigeon Pea (Tur),2016,8506,9050,544,6.395485539619092
Varora,Gram,2016,7017,7561,544,7.752600826564059
Varora,Soybean,2015,2943,3487,544,18.484539585457018
Loha,Pigeon Pea (Tur),2016,8269,8813,544,6.578788245253356
Manmad,Green Gram,2015,6984,7528,544,7.789232531500573
Shahapur,Cluster Bean,2016,3578,4122,544,15.204024594745668
Dhule,Chillies(Red),2015,5856,6400,544,9.289617486338798
Kej,Bajri,2015,1417,1961,544,38.390966831333806
Kalyan,PAPAI,2016,2100,2644,544,25.904761904761905
Umarkhed,Pigeon Pea (Tur),2016,8089,8633,544,6.72518234639634
Nashik,Bitter Gourd,2016,868,1412,544,62.672811059907836
Sailu,Soybean,2015,3192,3736,544,17.04260651629073
Naigaon,GREEN GRAM,2016,4325,4869,544,12.578034682080926
Jintur,Ground Nut Pods (Dry),2015,4544,5088,544,11.971830985915492
Vani,Cotton,2016,3975,4519,544,13.685534591194969
Pune,Bottle Gourd,2015,368,911,543,147.55434782608697
Tumsar,Jaggery,2016,2489,3032,543,21.815990357573323
Gevrai,Gram,2015,3314,3857,543,16.385033192516595
Satara,Capsicum,2016,2457,3000,543,22.1001221001221
Nira,Wheat(Husked),2015,1638,2181,543,33.15018315018315
Shrirampur,Ginger (Fresh),2015,3076,3619,543,17.652795838751626
Jamkhed,Black Gram,2016,6286,6829,543,8.638243716194719
Barshi-Vairag,Sorgum(Jawar),2015,1498,2041,543,36.24833110814419
Kille Dharur,Soybean,2016,3154,3697,543,17.216233354470514
Pandharpur,Cabbage,2014,486,1029,543,111.72839506172839
Ambad(Vadi Godri),Sorgum(Jawar),2015,1172,1715,543,46.33105802047782
Karmala,Gram,2016,3586,4129,543,15.142219743446738
Majalgaon,Bajri,2015,1413,1956,543,38.42887473460722
Shahapur,Shevga,2016,2357,2900,543,23.037759864234197
Dondaicha-Sindkheda,Green Gram,2016,4303,4846,543,12.619102951429236
Akot,Pigeon Pea (Tur),2016,5830,6373,543,9.313893653516296
Arvi,Soybean,2015,2787,3330,543,19.483315392895587
Shahapur,Chavli (Shenga ),2016,2964,3507,543,18.31983805668016
Mauda,Pigeon Pea (Tur),2016,8150,8693,543,6.662576687116564
Mumbai,Papai,2015,519,1062,543,104.6242774566474
Mumbai,Ladies Finger,2015,1796,2339,543,30.233853006681514
Ramtek,Coriander  ,2016,1090,1633,543,49.81651376146789
Aurangabad,Chikoo,2014,1200,1743,543,45.25
Varora,Gram,2015,3278,3821,543,16.56497864551556
Dound,Bajri,2015,1432,1975,543,37.91899441340782
Aurangabad,Guava,2016,1000,1543,543,54.3
Mumbai,Squash Gourd,2015,2163,2706,543,25.104022191400833
Kamthi,Orange,2016,414,957,543,131.15942028985506
Satara,POTATO,2016,757,1300,543,71.73051519154558
Nilanga,Gram,2015,4067,4610,543,13.351364642242439
Phaltan,Wheat(Husked),2014,1558,2100,542,34.78818998716303
Pune-Pimpri,Green Chilli,2015,2448,2990,542,22.140522875816995
Amarawati,Pigeon Pea (Tur),2015,8773,9315,542,6.17804627835404
Pune-Pimpri,Tomato,2015,721,1263,542,75.17337031900139
Manmad,Gram,2015,2480,3022,542,21.85483870967742
Chopda,Ground Nut Pods (Dry),2016,4272,4814,542,12.687265917602996
Ulhasnagar,Potato,2015,1182,1724,542,45.854483925549914
Pandharpur,Banana,2016,625,1167,542,86.72
Paithan,Pigeon Pea (Tur),2016,6863,7405,542,7.8974209529360335
Nagpur,Onion,2015,1071,1613,542,50.60690943043884
Jalna,Pigeon Pea (Tur),2016,6012,6554,542,9.015302727877579
Amalner,Gram,2016,3784,4326,542,14.323467230443974
Satara,Shevga,2016,2479,3021,542,21.863654699475596
Baramati,Sorgum(Jawar),2016,1634,2176,542,33.17013463892289
Ambad(Vadi Godri),SORGUM(JAWAR),2016,2009,2551,542,26.97859631657541
Naigaon,Sesamum,2015,7033,7575,542,7.706526375657614
Barshi,Tamarind,2015,3310,3852,542,16.37462235649547
Nira,Wheat(Husked),2015,1575,2117,542,34.41269841269841
Phaltan,Onion,2016,300,842,542,180.66666666666666
Shrigonda,WHEAT(HUSKED),2016,1558,2100,542,34.78818998716303
Karanja,Wheat(Husked),2016,1596,2138,542,33.959899749373434
Kalmeshwar,Pigeon Pea (Tur),2016,6929,7471,542,7.822196565160918
Pune-Manjri,Flower,2016,771,1313,542,70.29831387808042
Devala,Onion,2016,224,766,542,241.96428571428572
Vasai,Onion,2016,885,1427,542,61.24293785310734
Ghoti,Cucumber,2016,1455,1997,542,37.25085910652921
Dound,WHEAT(HUSKED),2016,1756,2298,542,30.865603644646924
Ratanagari,Green-Peas,2016,2833,3375,542,19.13166254853512
Akot,Soybean,2016,3024,3566,542,17.923280423280424
Lonar,Gram,2016,6003,6545,542,9.028818923871398
Junnar-Otur,Beet Root,2016,460,1002,542,117.82608695652173
Satara,Ladies Finger,2014,3125,3667,542,17.344
Jalgaon,Jaggery,2014,2326,2867,541,23.258813413585553
Navapur,Brinjal,2016,1635,2176,541,33.08868501529052
Pune,Beet Root,2016,532,1073,541,101.69172932330827
Ahmedpur,Green Gram,2016,4171,4712,541,12.970510668904339
Sinner,Sorgum(Jawar),2016,1346,1887,541,40.193164933135215
Dound,Wheat(Husked),2016,1594,2135,541,33.939774153074026
Kamthi,Coriander  ,2015,644,1185,541,84.00621118012423
Anajngaon Surji,Pigeon Pea (Tur),2016,8239,8780,541,6.566330865396286
Barshi,Squash Gourd,2016,985,1526,541,54.923857868020306
Ausa,Green Gram,2014,7662,8203,541,7.060819629339598
Karad,Ladies Finger,2016,2196,2737,541,24.635701275045538
Pandharkawada,Ground Nut Pods (Dry),2015,4160,4701,541,13.004807692307692
Mumbai-Fruit Market,Water Melon,2016,764,1305,541,70.81151832460733
Kolhapur,Cabbage,2015,221,762,541,244.79638009049773
Sangali,Gram,2015,4150,4691,541,13.036144578313253
Pune-Pimpri,Brinjal,2015,1567,2108,541,34.52456924058711
Mumbai,Green Chilli,2015,2874,3415,541,18.82393876130828
Nashik,Potato,2015,691,1232,541,78.29232995658467
Sangrampur,Soybean,2015,2682,3223,541,20.17151379567487
Shirpur,Wheat(Husked),2015,1239,1780,541,43.66424535916061
Kurdwadi-Modnimb,Onion,2016,122,663,541,443.44262295081967
Mohol,Sorgum(Jawar),2015,1568,2109,541,34.50255102040816
Latur,Sunflower,2016,3356,3897,541,16.120381406436234
Ausa,WHEAT(HUSKED),2016,2326,2867,541,23.258813413585553
Sonpeth,Wheat(Husked),2015,1528,2069,541,35.40575916230367
Nagpur,Coriander  ,2016,3104,3644,540,17.396907216494846
Solapur,Sorgum(Jawar),2015,1951,2491,540,27.678113787801127
Shrirampur,Bitter Gourd,2015,1560,2100,540,34.61538461538461
Kalyan,Papai,2016,1987,2527,540,27.176648213387015
Rahata,Gram,2016,4333,4873,540,12.462497115162705
Akot,Gram,2015,4085,4625,540,13.219094247246023
Kalvan,Onion,2016,259,799,540,208.4942084942085
Karad,Green-Peas,2015,3360,3900,540,16.071428571428573
Partur,Gram,2015,3951,4491,540,13.66742596810934
Karad,Ghevda,2016,1944,2484,540,27.77777777777778
Vaijapur,GROUND NUT PODS (DRY),2016,4648,5188,540,11.61790017211704
Pimpalgaon Basawant,Onion,2016,154,694,540,350.64935064935065
Shahapur,Bitter Gourd,2015,3330,3870,540,16.216216216216218
Shahapur,Bitter Gourd,2015,2665,3205,540,20.26266416510319
Varora,Pigeon Pea (Tur),2015,5920,6460,540,9.121621621621621
Kolhapur-Laxmipuri,Lentil,2015,7500,8040,540,7.2
Jintur-Bori,Pigeon Pea (Tur),2016,7010,7550,540,7.703281027104137
Akole,Soybean,2016,3000,3540,540,18.0
Lasur Station,Soybean,2016,2188,2728,540,24.680073126142595
Aurangabad,Ladies Finger,2015,885,1425,540,61.016949152542374
Indapur,Pigeon Pea (Tur),2015,8510,9050,540,6.345475910693302
Jamkhed,Green Gram,2015,6790,7330,540,7.952871870397644
Jalgaon,Green Gram,2015,6860,7400,540,7.871720116618076
Malegaon,Cowpea,2016,2500,3040,540,21.6
Pathardi,Wheat(Husked),2014,1600,2140,540,33.75
Aurangabad,Capsicum,2016,956,1496,540,56.48535564853557
Mumbai,Water Melon,2016,782,1322,540,69.0537084398977
Karad,Chikoo,2016,2020,2560,540,26.73267326732673
Malkapur,Soybean,2016,3108,3648,540,17.374517374517374
Nashik,Green-Peas,2015,2130,2670,540,25.35211267605634
Ahmednagar,Sorgum(Jawar),2015,1560,2100,540,34.61538461538461
Kalyan,Small Gourd,2016,2800,3340,540,19.285714285714285
Tuljapur,Pigeon Pea (Tur),2015,4994,5534,540,10.812975570684822
Mumbai,Split Lentil,2015,7244,7784,540,7.454445057979017
Shahada,Maize,2014,950,1490,540,56.8421052631579
Solapur,Matki,2016,6580,7120,540,8.206686930091186
Paithan,Onion,2016,143,683,540,377.6223776223776
Lonand,Gram,2016,5920,6460,540,9.121621621621621
Jalgaon Jamod,Ground Nut Pods (Dry),2014,3170,3710,540,17.034700315457414
Karanja,Black Gram,2014,4936,5476,540,10.94003241491086
Satara,Pavtta,2016,1940,2480,540,27.835051546391753
Aurangabad,Cucumber,2016,1556,2096,540,34.70437017994858
Samudrapur,Soybean,2015,3179,3719,540,16.98647373387858
Mangalwedha,Gram,2015,3125,3665,540,17.28
Gevrai,Green Gram,2016,4134,4674,540,13.062409288824384
Baramati,Ground Nut Pods (Dry),2014,2800,3340,540,19.285714285714285
Washim,Wheat(Husked),2016,1577,2117,540,34.242232086239696
Nagpur,Math (Bhaji),2014,3132,3672,540,17.24137931034483
Vai,Ladies Finger,2016,3346,3885,539,16.10878661087866
Shrirampur,Shevga,2015,1038,1577,539,51.92678227360308
Satara,Flower,2016,2038,2577,539,26.44749754661433
Satara,Cucumber,2015,1771,2310,539,30.434782608695652
Chandrapur-Ganjwad,Brinjal,2014,838,1377,539,64.31980906921241
Aurangabad,Shevga,2015,1483,2022,539,36.345246122724205
Satara,Tomato,2015,719,1258,539,74.96522948539638
Malegaon,Onion,2016,155,694,539,347.741935483871
Nashik-Devlali,Shepu,2016,530,1069,539,101.69811320754717
Aurangabad,Wal Bhaji,2015,1338,1877,539,40.28400597907324
Korpana,Pigeon Pea (Tur),2016,7815,8354,539,6.896992962252079
Khamgaon,Soybean,2016,3238,3777,539,16.646077825818406
Shirpur,ONION,2016,237,776,539,227.42616033755274
Vani,Pigeon Pea (Tur),2016,7940,8479,539,6.788413098236775
Sangamner,Tomato,2016,559,1098,539,96.4221824686941
Nagpur,Onion,2015,813,1352,539,66.29766297662977
Phaltan,Onion,2016,300,839,539,179.66666666666666
Karad,Bitter Gourd,2016,2309,2848,539,23.343438718059765
Arvi,Cotton,2015,4000,4538,538,13.45
Nagpur,Coriander  ,2014,2950,3488,538,18.23728813559322
Aurangabad,Capsicum,2014,1854,2392,538,29.018338727076593
Anajngaon Surji,Pigeon Pea (Tur),2016,7704,8242,538,6.9833852544132915
Pune-Pimpri,Ghevda,2015,2350,2888,538,22.893617021276597
Baramati,Sorgum(Jawar),2015,1546,2084,538,34.79948253557568
Aurangabad,Flower,2015,1133,1671,538,47.484554280670785
Achalpur,Pigeon Pea (Tur),2014,4467,5005,538,12.043877322587866
Rahata,Capsicum,2015,1904,2442,538,28.256302521008404
Babhulgaon,PIGEON PEA (TUR),2016,5300,5838,538,10.150943396226415
Barshi,Black Gram,2015,7428,7966,538,7.242864835756596
Dound,Wheat(Husked),2015,1408,1946,538,38.21022727272727
Sakri,Pigeon Pea (Tur),2015,6683,7221,538,8.050276821786623
Yeotmal,Gram,2016,5174,5712,538,10.398144568998841
Shahapur,Ghosali(Bhaji),2016,2075,2613,538,25.927710843373493
Mumbai,Water Melon,2016,654,1192,538,82.26299694189602
Telhara,Pigeon Pea (Tur),2015,5526,6064,538,9.735794426348173
Jalgaon,FLOWER,2016,710,1248,538,75.77464788732394
Karad,Squash Gourd,2016,2577,3115,538,20.876988746604578
Solapur,Jaggery,2016,2625,3163,538,20.495238095238093
Vai,Ginger (Fresh),2015,2885,3423,538,18.648180242634314
Chandrapur-Ganjwad,Brinjal,2016,762,1300,538,70.60367454068242
Parli-Vaijnath,Pigeon Pea (Tur),2015,5440,5978,538,9.889705882352942
Vadgaon Peth,Tomato,2016,443,981,538,121.44469525959369
Patan,Bitter Gourd,2015,2000,2538,538,26.9
Pune-Pimpri,Bottle Gourd,2014,1786,2324,538,30.123180291153414
Shahapur,Cluster Bean,2016,4000,4538,538,13.45
Karad,Shevga,2015,3250,3788,538,16.553846153846155
Chandrapur-Ganjwad,Flower,2015,300,838,538,179.33333333333334
Amarawati,Mosambi,2015,1375,1913,538,39.127272727272725
Bhivandi,Other Vegetables,2015,1153,1691,538,46.66088464874241
Kada,Wheat(Husked),2016,1675,2213,538,32.11940298507463
Kille Dharur,Bajri,2015,1380,1918,538,38.98550724637681
Akola,Pigeon Pea (Tur),2016,5845,6383,538,9.204448246364414
Shahada,Pigeon Pea (Tur),2015,3563,4101,538,15.09963513892787
Patan,Brinjal,2014,1859,2397,538,28.94029047875202
Bhokar,Green Gram,2016,4827,5365,538,11.145639113320904
Jalgaon,Flower,2015,1088,1625,537,49.356617647058826
Rahata,Tomato,2015,436,973,537,123.1651376146789
Daryapur,Soybean,2016,3009,3546,537,17.846460618145564
Akluj,Ground Nut Pods (Dry),2015,3538,4075,537,15.17806670435274
Shirpur,Sunflower,2015,4676,5213,537,11.484174508126603
Pune,Wheat(Husked),2015,2134,2671,537,25.164011246485472
Umrane,Onion,2016,420,957,537,127.85714285714286
Shahapur,Cluster Bean,2015,1594,2131,537,33.68883312421581
Mangrulpeer,Soybean,2015,2910,3447,537,18.45360824742268
Shrirampur,Cluster Bean,2015,1238,1775,537,43.376413570274636
Solapur,Wheat(Husked),2016,2212,2749,537,24.276672694394215
Nandura,Pigeon Pea (Tur),2016,7900,8437,537,6.7974683544303796
Khamgaon,Soybean,2016,3497,4034,537,15.356019445238775
Lonar,Pigeon Pea (Tur),2015,6669,7206,537,8.052181736392262
Malkapur,Gram,2014,2172,2709,537,24.723756906077348
Karad,Ladies Finger,2016,2152,2689,537,24.95353159851301
Kopargaon,Soybean,2016,3319,3856,537,16.179572160289243
Nandura,Soybean,2016,3130,3667,537,17.156549520766774
Khamgaon,Lemon,2015,130,667,537,413.0769230769231
Mangrulpeer,Soybean,2016,2911,3448,537,18.44726897973205
Karad,Capsicum,2014,1218,1755,537,44.08866995073892
Nagpur,Soybean,2014,2824,3361,537,19.01558073654391
Sillod,Pigeon Pea (Tur),2016,6340,6877,537,8.470031545741325
Nilanga,Gram,2016,5390,5927,537,9.962894248608535
Amarawati,Chikoo,2016,1188,1725,537,45.2020202020202
Lonar,Pigeon Pea (Tur),2014,4488,5025,537,11.96524064171123
Patan,Brinjal,2014,2474,3011,537,21.705739692805174
Chikhali,Soybean,2015,2899,3436,537,18.523628837530183
Lasalgaon,Soybean,2015,2980,3517,537,18.02013422818792
Malegaon,Onion,2016,284,821,537,189.08450704225353
Daryapur,Soybean,2016,2759,3296,537,19.46357375860819
Pusad,Sesamum,2015,5843,6380,537,9.19048434023618
Sangamner,Tomato,2016,387,924,537,138.75968992248062
Chandur Bajar,Soybean,2014,2851,3388,537,18.835496317081727
Lasur Station,Sorgum(Jawar),2016,1673,2209,536,32.03825463239689
Pune,Gr.Nut Kernels,2015,6764,7300,536,7.924305144884683
Satara,Bitter Gourd,2014,3020,3556,536,17.748344370860927
Aurangabad,Guava,2014,1064,1600,536,50.37593984962406
Beed,Pigeon Pea (Tur),2016,7900,8436,536,6.784810126582278
Kada,Wheat(Husked),2014,1406,1942,536,38.12233285917497
Nandurbar,Chillies(Red),2014,1820,2356,536,29.45054945054945
Nagpur,Papai,2015,650,1186,536,82.46153846153847
Nagpur,Green Chilli,2016,3748,4284,536,14.300960512273212
Morshi,Pigeon Pea (Tur),2016,8238,8774,536,6.506433600388444
Vai,Cucumber,2016,1982,2518,536,27.043390514631685
Mantha,Pigeon Pea (Tur),2015,5364,5900,536,9.99254287844892
Aarni,Pigeon Pea (Tur),2016,7980,8516,536,6.716791979949875
Majalgaon,Bajri,2016,1302,1838,536,41.16743471582181
Vai,Ginger (Fresh),2015,2875,3411,536,18.643478260869564
Murum,Pigeon Pea (Tur),2015,5124,5660,536,10.460577673692427
Karad,Squash Gourd,2016,2568,3104,536,20.87227414330218
Khed (Shel Pimpalgaon),Ladies Finger,2015,1000,1536,536,53.6
Ambejogai,Green Gram,2014,5925,6461,536,9.046413502109704
Pune,Wal Bhaji,2015,2011,2547,536,26.653406265539534
Beed,Green Gram,2015,7354,7890,536,7.288550448735382
Murtizapur,Black Gram,2014,3959,4495,536,13.538772417277091
Arvi,Soybean,2015,2728,3264,536,19.64809384164223
Shrirampur,Papai,2016,1500,2036,536,35.733333333333334
Nashik,Raddish,2016,1059,1595,536,50.6137865911237
Umared,Cotton,2016,3983,4518,535,13.432086367060005
Mantha,Wheat(Husked),2015,1500,2035,535,35.666666666666664
Pune,Beet Root,2014,435,970,535,122.98850574712644
Karad,Squash Gourd,2016,2079,2614,535,25.733525733525735
Aurangabad,Wal Bhaji,2015,1426,1961,535,37.51753155680225
Satara,Bitter Gourd,2015,2674,3209,535,20.0074794315632
Nashik-Devlali,CORIANDER ,2016,527,1062,535,101.5180265654649
Mumbai,Green Chilli,2015,2400,2935,535,22.291666666666668
Nandgaon,Gram,2014,1812,2347,535,29.525386313465784
Ashti (Jalna),Soybean,2015,2956,3491,535,18.098782138024358
Nagpur,Ginger (Fresh),2015,2394,2929,535,22.347535505430244
Mauda,Pigeon Pea (Tur),2016,7388,7923,535,7.241472658364916
Mangalwedha,Wheat(Husked),2015,1421,1956,535,37.64954257565095
Aurangabad,Cucumber,2015,887,1422,535,60.31567080045096
Lohara,Gram,2016,3666,4201,535,14.593562465902892
Mangrulpeer,Pigeon Pea (Tur),2014,4325,4860,535,12.369942196531792
Pandharpur,Cabbage,2015,348,883,535,153.73563218390805
Jintur,Pigeon Pea (Tur),2015,5127,5662,535,10.434952213770236
Lasalgaon,Onion,2016,239,774,535,223.84937238493723
Lasur Station,Sorgum(Jawar),2015,1268,1803,535,42.19242902208202
Amarawati-Fruit And Vegetables,Chikoo,2016,1259,1793,534,42.414614773629864
Aurangabad,SQUASH GOURD,2016,1433,1967,534,37.264480111653874
Jalgaon,Potato,2015,742,1276,534,71.96765498652292
Chikhali,Wheat(Husked),2015,910,1444,534,58.68131868131868
Koregaon,Cowpea,2015,3433,3967,534,15.554908243518788
Vai,Green Chilli,2016,3504,4038,534,15.23972602739726
Vadgaon Peth,Capsicum,2015,1222,1756,534,43.69885433715221
Indapur,Green Gram,2015,5283,5817,534,10.107893242475866
Washim,Sorgum(Jawar),2015,1204,1738,534,44.352159468438536
Lasalgaon,Wheat(Husked),2015,1575,2109,534,33.904761904761905
Aarni,Ground Nut Pods (Dry),2016,5625,6159,534,9.493333333333334
Phaltan,Wheat(Husked),2016,1533,2067,534,34.833659491193735
Mumbai,Water Melon,2015,1554,2088,534,34.36293436293436
Jalgaon,Melon,2016,933,1467,534,57.234726688102896
Khamgaon,GREEN GRAM,2016,4292,4826,534,12.44175209692451
Majalgaon,Bajri,2014,1173,1707,534,45.52429667519181
Lasalgaon-Niphad,Soybean,2016,3395,3929,534,15.72901325478645
Khed-Chakan,Green Chilli,2016,960,1494,534,55.625
Akluj,Bor,2014,1183,1717,534,45.13947590870668
Chandvad,Onion,2016,264,798,534,202.27272727272728
Baramati,Jaggery,2015,1994,2528,534,26.78034102306921
Karad,Capsicum,2015,1783,2317,534,29.949523275378574
Nandurbar,BAJRI,2016,1287,1821,534,41.49184149184149
Aurangabad,Cluster Bean,2015,1996,2530,534,26.753507014028056
Mumbai,Onion,2015,1908,2442,534,27.9874213836478
Atpadi,Sorgum(Jawar),2016,1733,2267,534,30.813618003462203
Kurdwadi,Wheat(Husked),2015,1369,1903,534,39.00657414170928
Gevrai,Gram,2015,4258,4792,534,12.541099107562236
Kamthi,Cucumber,2016,507,1041,534,105.32544378698225
Nagpur,Soybean,2015,2847,3381,534,18.75658587987355
Kalvan,Green Gram,2016,4867,5401,534,10.971851243065544
Ambad(Vadi Godri),Soybean,2015,2976,3510,534,17.943548387096776
Amarawati,Sesamum,2015,7483,8017,534,7.136175330749699
Wardha,Pigeon Pea (Tur),2015,6083,6617,534,8.778563208942955
Shegaon,Pigeon Pea (Tur),2015,7678,8212,534,6.954936181297213
Malegaon,Bajri,2016,1514,2048,534,35.270805812417436
Sonpeth,Cotton,2016,3933,4467,534,13.577421815408085
Kalyan,Bitter Gourd,2016,4583,5117,534,11.65175649138119
Atpadi,Cotton,2014,4100,4633,533,13.0
Chandur Bajar,Soybean,2015,3360,3893,533,15.863095238095237
Vai,Ginger (Fresh),2015,3307,3840,533,16.11732688237073
Shegaon,Soybean,2016,3135,3668,533,17.00159489633174
Osmanabad,Gram,2015,3634,4167,533,14.667033571821683
Ghansawangi,Green Gram,2015,6967,7500,533,7.650351657815415
Phaltan,Wheat(Husked),2015,1400,1933,533,38.07142857142857
Pune-Manjri,Cabbage,2015,856,1389,533,62.26635514018692
Sangali,Soybean,2015,3250,3783,533,16.4
Kille Dharur,Wheat(Husked),2015,1744,2277,533,30.56192660550459
Aurangabad,Shevga,2016,2417,2950,533,22.052130740587504
Jalgaon,Tomato,2014,861,1394,533,61.904761904761905
Katol,MOSAMBI,2016,3000,3533,533,17.766666666666666
Mohol,Sorgum(Jawar),2016,1745,2278,533,30.544412607449857
Mumbai,JAGGERY,2016,3612,4145,533,14.756367663344408
Chalisgaon,Pigeon Pea (Tur),2016,7325,7858,533,7.276450511945392
Patan,Ladies Finger,2016,2525,3058,533,21.10891089108911
Anajngaon Surji,Soybean,2015,3165,3698,533,16.84044233807267
Lasalgaon,Onion,2016,115,648,533,463.4782608695652
Khamgaon,SOYBEAN,2016,2368,2901,533,22.508445945945947
Murtizapur,Black Gram,2015,8313,8846,533,6.411644412366173
Khamgaon,Lemon,2016,150,683,533,355.3333333333333
Akole,Bajri,2016,1467,2000,533,36.33265167007498
Rahuri,BOTTLE GOURD,2016,100,633,533,533.0
Kolhapur,Potato,2015,700,1233,533,76.14285714285714
Ambejogai,Gram,2016,6171,6704,533,8.63717387781559
Manchar,Brinjal,2015,1600,2133,533,33.3125
Shirpur,Sesamum,2016,3667,4200,533,14.535042268884647
Gevrai,Sorgum(Jawar),2016,1733,2266,533,30.75591459896134
Lasalgaon,Black Gram,2014,4088,4621,533,13.03816046966732
Shrirampur,LADIES FINGER,2016,1310,1843,533,40.68702290076336
Kolhapur-Laxmipuri,Split Gram,2014,3487,4020,533,15.285345569257242
Satara,Onion,2015,2078,2611,533,25.649663137632338
Jamkhed,WHEAT(HUSKED),2016,1867,2400,533,28.548473486877345
Achalpur,Sesamum,2015,6867,7400,533,7.761759137905927
Navapur,Flower,2016,1092,1625,533,48.80952380952381
Amarawati-Fruit And Vegetables,Orange,2016,2000,2533,533,26.65
Varud-Rajura Bazar,GRAM,2016,8700,9233,533,6.126436781609195
Akole,Wheat(Husked),2015,1467,2000,533,36.33265167007498
Solapur,Green Peas (Dry),2015,3389,3922,533,15.727353201534376
Nagpur,Green Chilli,2016,3075,3608,533,17.333333333333332
Karad,Brinjal,2015,700,1233,533,76.14285714285714
Vai,Ladies Finger,2016,1825,2358,533,29.205479452054796
Telhara,Pigeon Pea (Tur),2016,7979,8512,533,6.680035092116807
Aurangabad,Guava,2015,1500,2033,533,35.53333333333333
Loha,Pigeon Pea (Tur),2016,8425,8958,533,6.326409495548962
Jalgaon Jamod,Gram,2015,2817,3350,533,18.920837770678027
Baramati,Bajri,2016,1518,2050,532,35.046113306982875
Sillod,Maize,2016,1334,1866,532,39.88005997001499
Satara,Ladies Finger,2015,1152,1684,532,46.18055555555556
Chandur Bajar,SOYBEAN,2016,2430,2962,532,21.893004115226336
Kalyan,Small Gourd,2015,2387,2919,532,22.287390029325515
Akluj,Onion,2015,789,1321,532,67.42712294043092
Pusad,Wheat(Husked),2014,1462,1994,532,36.388508891928865
Pune,Pumpkin,2016,1776,2308,532,29.954954954954953
Akluj,Water Melon,2016,606,1138,532,87.7887788778878
Buldhana,Sorgum(Jawar),2015,1185,1717,532,44.89451476793249
Shegaon,Gram,2016,4662,5194,532,11.411411411411411
Nagpur,Capsicum,2016,4296,4828,532,12.383612662942271
Pune-Manjri,Onion,2016,250,782,532,212.8
Mohol,Gram,2016,4513,5045,532,11.788167516064702
Karad,Ladies Finger,2016,2216,2748,532,24.0072202166065
Indapur-Bhigwan,Bajri,2015,1300,1832,532,40.92307692307692
Karad,Pavata,2016,2024,2556,532,26.284584980237153
Morshi,Green Chilli,2014,2550,3082,532,20.862745098039216
Nagpur,Ground Nut Pods (Dry),2015,3784,4316,532,14.059196617336152
Mohol,Sorgum(Jawar),2016,1703,2235,532,31.238990017615972
Kurdwadi,Onion,2016,136,668,532,391.1764705882353
Mumbai,SPILT GERRN GRAM,2016,6136,6668,532,8.670143415906129
Karad,Capsicum,2016,2104,2636,532,25.285171102661597
Pune-Manjri,Tomato,2015,728,1260,532,73.07692307692308
Hingoli,Pigeon Pea (Tur),2016,8600,9132,532,6.186046511627907
Chandvad,Onion,2016,350,882,532,152.0
Kolhapur-Malkapur,Tomato,2016,131,663,532,406.10687022900765
Jalgaon,Amla,2014,1200,1732,532,44.333333333333336
Babhulgaon,Soybean,2015,3279,3811,532,16.22445867642574
Ahmednagar,Sorgum(Jawar),2016,1656,2188,532,32.1256038647343
Akluj,Tomato,2016,626,1158,532,84.98402555910543
Pune-Pimpri,Tomato,2016,1547,2079,532,34.38914027149321
Kalyan,Orange,2015,1318,1850,532,40.36418816388468
Khed-Chakan,Green Chilli,2016,868,1400,532,61.29032258064516
Nira,Jaggery,2016,3761,4293,532,14.145174155809626
Zarijamini,Pigeon Pea (Tur),2016,6740,7272,532,7.893175074183977
Shirpur,Gram,2015,3499,4031,532,15.204344098313804
Achalpur,Pigeon Pea (Tur),2015,7020,7552,532,7.578347578347579
Anajngaon Surji,Pigeon Pea (Tur),2015,4768,5300,532,11.157718120805368
Pune,Cabbage,2015,582,1114,532,91.40893470790378
Akluj,Brinjal,2015,689,1221,532,77.2133526850508
Karad,Ginger (Fresh),2016,1808,2340,532,29.424778761061948
Varud-Rajura Bazar,Pigeon Pea (Tur),2016,8192,8723,531,6.48193359375
Nandurbar,Wheat(Husked),2016,1524,2055,531,34.84251968503937
Udgir,Black Gram,2016,8214,8745,531,6.464572680788897
Kalyan,Capsicum,2016,5623,6154,531,9.443357638271385
Satara,Bottle Gourd,2016,674,1205,531,78.78338278931751
Mumbai-Fruit Market,Pineapple,2016,1231,1762,531,43.13566206336312
Ausa,Ground Nut Pods (Dry),2014,3134,3665,531,16.94320357370772
Kej,Gram,2015,4207,4738,531,12.621820774898978
Barshi,Green Chilli,2016,500,1031,531,106.2
Balapur,Soybean,2015,3250,3781,531,16.338461538461537
Pusad,Soybean,2015,3247,3778,531,16.353557129658146
Ratanagari,Brinjal,2015,702,1233,531,75.64102564102564
Pimpalgaon (B)-Saykheda,Onion,2016,149,680,531,356.3758389261745
Lonand,Onion,2016,280,811,531,189.64285714285714
Nagpur,Ladies Finger,2015,2165,2696,531,24.526558891454965
Latur,Soybean,2014,3127,3658,531,16.9811320754717
Nashik,Shahale ,2016,1765,2296,531,30.084985835694052
Pathardi,Wheat(Husked),2016,1669,2200,531,31.815458358298383
Chopda,SOYBEAN,2016,2261,2792,531,23.485183547103052
Daryapur,Green Gram,2016,5567,6098,531,9.53835099694629
Akkolkot,Pigeon Pea (Tur),2016,8115,8646,531,6.543438077634011
Nagpur,Coriander  ,2015,1515,2046,531,35.04950495049505
Pune-Pimpri,Squash Gourd,2016,4125,4656,531,12.872727272727273
Lasalgaon,Wheat(Husked),2015,1599,2130,531,33.208255159474675
Varora,Soybean,2015,3035,3566,531,17.495881383855025
Chandur Rly.,Soybean,2015,3183,3714,531,16.682375117813383
Partur,Pigeon Pea (Tur),2015,7399,7930,531,7.176645492634139
Nagpur,Papai,2014,715,1246,531,74.26573426573427
Loha,Wheat(Husked),2016,1748,2279,531,30.377574370709382
Kalyan,Ghevda,2015,3891,4422,531,13.646877409406322
Nagpur,Coriander  ,2015,3381,3912,531,15.705412599822537
Amarawati,Mosambi,2014,1700,2231,531,31.235294117647058
Amalner,Green Gram,2016,4323,4853,530,12.26000462641684
Dhule,Wheat(Husked),2016,1493,2023,530,35.49899531145345
Mumbai,Green-Peas,2015,2987,3517,530,17.74355540676264
Jalgaon,Brinjal,2016,593,1123,530,89.3760539629005
Karanja,Pigeon Pea (Tur),2016,8424,8954,530,6.2915479582146245
Kalyan,Small Gourd,2015,2255,2785,530,23.503325942350333
Sangali,Soybean,2015,3013,3543,530,17.59044142051112
Akhadabalapur,Pigeon Pea (Tur),2016,7340,7870,530,7.220708446866485
Shrirampur,Gram,2014,2288,2818,530,23.164335664335663
Savner,Ground Nut Pods (Dry),2015,4090,4620,530,12.95843520782396
Chandrapur-Ganjwad,Spinach,2014,910,1440,530,58.24175824175824
Aurangabad,Cluster Bean,2015,1209,1739,530,43.837882547559964
Buldhana,Green Gram,2014,6260,6790,530,8.466453674121405
Taloda,Wheat(Husked),2015,1179,1709,530,44.95335029686175
Lonand,Bajri,2016,1630,2160,530,32.515337423312886
Ratanagari,Tomato,2014,655,1185,530,80.91603053435115
Shahapur,Bitter Gourd,2015,1770,2300,530,29.943502824858758
Bhivandi,Potato,2015,1185,1715,530,44.72573839662447
Barshi,Gram,2014,2241,2771,530,23.650156180276664
Pune-Moshi,BITTER GOURD,2016,1440,1970,530,36.80555555555556
Parola,Green Gram,2015,6670,7200,530,7.946026986506746
Kamthi,Cucumber,2016,822,1352,530,64.47688564476886
Chandrapur-Ganjwad,Flower,2014,490,1020,530,108.16326530612245
Junnar-Otur,BEET ROOT,2016,420,950,530,126.19047619047619
Dondaicha,Matki,2015,7098,7628,530,7.466892082276698
Murbad,Bitter Gourd,2016,4635,5165,530,11.434735706580367
Pimpalgaon Basawant,Onion,2016,391,921,530,135.54987212276214
Pune-Manjri,Shepu,2015,741,1271,530,71.52496626180837
Manora,Pigeon Pea (Tur),2015,6727,7257,530,7.87869778504534
Mumbai,Split Gram,2014,3500,4030,530,15.142857142857142
Karad,Ridge Gourd,2015,1620,2150,530,32.71604938271605
Pune-Moshi,Green Chilli,2016,1030,1560,530,51.45631067961165
Nira-Saswad,Bajri,2015,1580,2110,530,33.54430379746835
Aurangabad,Wal Bhaji,2016,1635,2165,530,32.415902140672785
Khamgaon,Ground Nut Pods (Dry),2014,3030,3560,530,17.49174917491749
Rahata,Cucumber,2016,1040,1570,530,50.96153846153846
Nira-Saswad,Bajri,2016,1550,2080,530,34.193548387096776
Sangali,Gram,2016,7360,7890,530,7.201086956521739
Shrirampur,Ladies Finger,2014,1833,2363,530,28.914348063284233
Aurangabad,Bitter Gourd,2014,848,1378,530,62.5
Amalner,Onion,2016,185,715,530,286.4864864864865
Lasur Station,Pigeon Pea (Tur),2016,7084,7614,530,7.481648785996612
Dhule,Wheat(Husked),2015,1474,2004,530,35.95658073270013
Sinner,Rice(Paddy-Hus),2014,901,1431,530,58.8235294117647
Satara,Carrot,2015,1960,2490,530,27.040816326530614
Vadgaon Peth,Carrot,2016,830,1360,530,63.855421686746986
Mumbai,Grapes,2014,2757,3287,530,19.22379397896264
Satara,Capsicum,2015,1140,1670,530,46.49122807017544
Bhokar,Cotton,2015,3619,4148,529,14.617297596021
Parli-Vaijnath,Pigeon Pea (Tur),2014,3961,4490,529,13.35521332996718
Ausa,Pigeon Pea (Tur),2015,5042,5571,529,10.491868306227687
Karad,Cluster Bean,2016,2671,3200,529,19.805316360913515
Amarawati,Papai,2015,857,1386,529,61.7269544924154
Kej,Sorgum(Jawar),2015,1796,2325,529,29.4543429844098
Kalyan,Mosambi,2016,2964,3493,529,17.847503373819162
Kolhapur-Laxmipuri,Split Black Gram,2016,14881,15410,529,3.554868624420402
Kopargaon,Sorgum(Jawar),2016,1445,1974,529,36.608996539792386
Yeotmal,Gram,2015,3952,4481,529,13.385627530364372
Mumbai,Melon,2015,1846,2375,529,28.656554712892742
Chandrapur-Ganjwad,Green Chilli,2016,538,1067,529,98.3271375464684
Parbhani,Green Gram,2015,8228,8757,529,6.4292659212445304
Kurdwadi,Onion,2016,160,689,529,330.625
Rahata,Bottle Gourd,2016,979,1508,529,54.03472931562819
Kurdwadi,Onion,2016,120,649,529,440.8333333333333
Malkapur,Gram,2014,2102,2631,529,25.16650808753568
Shegaon,Green Gram,2016,4479,5008,529,11.810672025005582
Rahata,Capsicum,2015,1400,1929,529,37.785714285714285
Mantha,Green Gram,2014,6668,7197,529,7.933413317336533
Lasalgaon,Bajri,2016,1564,2093,529,33.8235294117647
Sailu,Sorgum(Jawar),2015,1144,1673,529,46.24125874125874
Bhokar,Pigeon Pea (Tur),2016,8486,9015,529,6.233796841857177
Karad,Cucumber,2014,1100,1629,529,48.09090909090909
Mumbai,Brinjal,2015,821,1350,529,64.43361753958587
Karad,Ridge Gourd,2015,1964,2493,529,26.934826883910386
Latur,Sunflower,2014,2910,3439,529,18.1786941580756
Washim,Green Gram,2016,5065,5594,529,10.444225074037512
Kamthi,Tomato,2015,650,1179,529,81.38461538461539
Arvi,Gram,2016,4705,5234,529,11.243358129649309
Osmanabad,Soybean,2015,3290,3819,529,16.0790273556231
Mangrulpeer,Gram,2016,4716,5245,529,11.21713316369805
Kille Dharur,Sorgum(Jawar),2014,1867,2396,529,28.33422603106588
Shrirampur,Custard Apple,2014,1500,2029,529,35.266666666666666
Yeola,Gram,2016,3750,4279,529,14.106666666666667
Yeotmal,Black Gram,2016,5846,6375,529,9.04892234006158
Mangrulpeer,Wheat(Husked),2015,1241,1769,528,42.546333601933924
Anajngaon Surji,Soybean,2016,2938,3466,528,17.9714091218516
Yeotmal,Ground Nut Pods (Dry),2015,4528,5056,528,11.66077738515901
Pune-Moshi,Pavtta,2016,2841,3369,528,18.585005279831044
Osmanabad,Cabbage,2016,2218,2746,528,23.80522993688007
Khamgaon,Black Gram,2014,5174,5702,528,10.204870506378045
Dound,Sorgum(Jawar),2015,1802,2330,528,29.3007769145394
Gevrai,Pigeon Pea (Tur),2015,7782,8310,528,6.784888203546646
Chandvad,Onion,2016,333,861,528,158.55855855855856
Basmat,Ground Nut Pods (Dry),2015,5100,5628,528,10.352941176470589
Ratanagari,Ladies Finger,2015,2694,3222,528,19.599109131403118
Mangrulpeer,Soybean,2015,3186,3714,528,16.572504708097927
Deglur,Green Gram,2014,6346,6874,528,8.320201701859439
Murbad,Capsicum,2016,2543,3071,528,20.762878489972472
Pune,Gram,2016,4927,5455,528,10.716460320681957
Karad,Ginger (Fresh),2016,1948,2476,528,27.104722792607802
Loha,Turmeric,2014,4629,5157,528,11.406351263771873
Mumbai,Bottle Gourd,2014,2304,2832,528,22.916666666666668
Kalyan,Tomato,2016,3410,3938,528,15.483870967741936
Lasalgaon,Sorgum(Jawar),2016,1174,1702,528,44.97444633730835
Mangalwedha,Wheat(Husked),2015,1511,2039,528,34.94374586366644
Digras,Pigeon Pea (Tur),2015,9080,9608,528,5.814977973568282
Aurangabad,Flower,2014,1804,2332,528,29.26829268292683
Hadgaon-Tamsa,Pigeon Pea (Tur),2016,8178,8706,528,6.456346294937638
Sindi,Gram,2016,4713,5241,528,11.203055378739656
Pune-Manjri,Rajgira,2015,106,634,528,498.1132075471698
Satara,Tomato,2015,796,1324,528,66.33165829145729
Jalgaon,Cabbage,2015,728,1256,528,72.52747252747253
Kalyan,Cluster Bean,2015,2148,2676,528,24.58100558659218
Pusad,Spilt Pigeon Pea,2016,8823,9350,527,5.973025048169557
Ahmednagar,Gram,2016,6369,6896,527,8.274454388444026
Khed-Chakan,Cucumber,2016,1223,1750,527,43.09076042518397
Samudrapur,Pigeon Pea (Tur),2015,4967,5494,527,10.610026172740085
Baramati,Wheat(Husked),2015,1632,2159,527,32.291666666666664
Rahata,Capsicum,2015,1385,1912,527,38.05054151624549
Rahata,Carrot,2016,1273,1800,527,41.39827179890023
Solapur,Pigeon Pea (Tur),2016,8270,8797,527,6.372430471584039
Ahmednagar,Gram,2016,5906,6433,527,8.923129021334237
Yeotmal,Ground Nut Pods (Dry),2016,5168,5695,527,10.197368421052632
Kalyan,Orange,2016,2964,3491,527,17.780026990553306
Rahata,Capsicum,2015,1917,2444,527,27.490871152842985
Sangali,Bajri,2015,1300,1827,527,40.53846153846154
Shahapur,Ladies Finger,2015,2073,2600,527,25.42209358417752
Nashik,Shahale ,2014,1738,2265,527,30.322209436133488
Karad,Squash Gourd,2016,2100,2627,527,25.095238095238095
Latur,Sorgum(Jawar),2016,1794,2321,527,29.375696767001116
Washim,Gram,2016,8909,9436,527,5.9153664833314625
Dhule,Cowpea,2015,3468,3995,527,15.196078431372548
Nashik,Bottle Gourd,2015,533,1060,527,98.87429643527204
Babhulgaon,Gram,2015,3633,4160,527,14.505917974126067
Shegaon,GREEN GRAM,2016,4442,4969,527,11.864025213867627
Kille Dharur,Sorgum(Jawar),2015,1936,2463,527,27.22107438016529
Naigaon,Green Gram,2015,8269,8796,527,6.3732011125891885
Rahata,Cucumber,2015,609,1136,527,86.5353037766831
Pune-Moshi,Pavtta,2016,1844,2370,526,28.524945770065077
Vai,Ladies Finger,2016,2687,3213,526,19.575735020468926
Nandura,Black Gram,2014,4646,5172,526,11.321566939302626
Kalmeshwar,Soybean,2014,2784,3310,526,18.89367816091954
Sakri,Gram,2016,3975,4501,526,13.232704402515724
Risod,Pigeon Pea (Tur),2015,6745,7271,526,7.798369162342476
Manmad,Onion,2016,339,865,526,155.1622418879056
Vai,Ginger (Fresh),2015,3326,3852,526,15.81479254359591
Yeotmal,Gram,2015,4004,4530,526,13.136863136863138
Karad,Capsicum,2016,2752,3278,526,19.113372093023255
Lasur Station,Wheat(Husked),2016,1510,2036,526,34.83443708609271
Vai,Ladies Finger,2014,2348,2874,526,22.402044293015333
Chandrapur,Banana,2016,517,1043,526,101.74081237911025
Katol,Gram,2015,3971,4497,526,13.246033744648702
Daryapur,Soybean,2014,2723,3249,526,19.316929856775616
Chandrapur,Pigeon Pea (Tur),2015,6180,6706,526,8.511326860841423
Shrirampur,Ginger (Fresh),2015,3474,4000,526,15.14104778353483
Varud-Rajura Bazar,Green Chilli,2014,676,1202,526,77.81065088757397
Mumbai,Water Melon,2015,959,1485,526,54.848800834202294
Mumbai,Water Melon,2016,864,1390,526,60.879629629629626
Nira,Bajri,2015,1525,2051,526,34.49180327868852
Nagpur,POTATO,2016,526,1052,526,100.0
Sailu,Gram,2016,8934,9460,526,5.88762032684128
Patan,Ginger (Fresh),2016,1567,2093,526,33.56732610082961
Khamgaon,Gram,2015,3725,4251,526,14.120805369127517
Aurangabad,Cucumber,2015,770,1296,526,68.31168831168831
Chandrapur-Ganjwad,Flower,2016,474,1000,526,110.9704641350211
Varora,SOYBEAN,2016,2317,2843,526,22.701769529564093
Kille Dharur,Bajri,2016,1393,1919,526,37.76022972002872
Kalyan,Capsicum,2015,2649,3175,526,19.856549641374105
Nashik-Devlali,SHEPU,2016,733,1259,526,71.75989085948159
Anajngaon Surji,SORGUM(JAWAR),2016,1088,1613,525,48.25367647058823
Chandrapur-Ganjwad,Dhemse,2016,1150,1675,525,45.65217391304348
Murbad,CABBAGE,2016,1680,2205,525,31.25
Mahagaon,Cotton,2016,4088,4613,525,12.842465753424657
Sillod-Bharadi,Gram,2014,2975,3500,525,17.647058823529413
Indapur (Nimgaon Ketki),Gram,2016,2775,3300,525,18.91891891891892
Mumbai,Tomato,2016,3435,3960,525,15.283842794759826
Akole,Wheat(Husked),2015,1450,1975,525,36.206896551724135
Pusad,Sesamum,2015,7025,7550,525,7.473309608540926
Kopargaon,Green Gram,2014,6734,7259,525,7.796257796257796
Wardha,Pigeon Pea (Tur),2016,7638,8163,525,6.873527101335428
Akluj,WATER MELON,2016,475,1000,525,110.52631578947368
Lonand,WHEAT(HUSKED),2016,1663,2188,525,31.569452796151534
Jalgaon,Papai,2016,800,1325,525,65.625
Satara,Bitter Gourd,2015,2600,3125,525,20.192307692307693
Shirpur,Chillies(Red),2016,9263,9788,525,5.667710245060995
Balapur,Pigeon Pea (Tur),2016,8150,8675,525,6.441717791411043
Phaltan,Wheat(Husked),2014,1525,2050,525,34.42622950819672
Dondaicha,Green Gram,2015,7022,7547,525,7.476502420962689
Nagpur,Jambhul,2016,2050,2575,525,25.609756097560975
Nagpur,Pigeon Pea (Tur),2014,4000,4525,525,13.125
Vadgaon Peth,Bottle Gourd,2015,550,1075,525,95.45454545454545
Ghansawangi,Pigeon Pea (Tur),2016,8263,8788,525,6.3536245915527045
Balapur,Wheat(Husked),2016,1425,1950,525,36.8421052631579
Nagpur,Bottle Gourd,2016,583,1108,525,90.05145797598628
Rahata,Bottle Gourd,2016,1655,2180,525,31.72205438066465
Mumbai,Capsicum,2015,1419,1944,525,36.99788583509514
Osmanabad,Sorgum(Jawar),2015,1215,1740,525,43.20987654320987
Akole,Bajri,2015,1375,1900,525,38.18181818181818
Shrirampur,Cluster Bean,2015,1575,2100,525,33.333333333333336
Jalgaon,Bitter Gourd,2016,3225,3750,525,16.27906976744186
Shirur,Green Gram,2015,7145,7670,525,7.3477956613016095
Rahata,Capsicum,2016,1080,1605,525,48.611111111111114
Kalyan,Chillies(Red),2016,2500,3025,525,21.0
Mumbai,Chikoo,2015,1192,1717,525,44.04362416107382
Umared,Other Pulses,2015,6278,6803,525,8.362535839439312
Ratanagari,Cucumber,2014,900,1425,525,58.333333333333336
Pune,Squash Gourd,2015,580,1105,525,90.51724137931035
Lonar,Black Gram,2015,5575,6100,525,9.417040358744394
Buldhana,Wheat(Husked),2015,1450,1975,525,36.206896551724135
Kalamb (Os),Pigeon Pea (Tur),2016,7476,8001,525,7.022471910112359
Aurangabad,Cucumber,2015,645,1170,525,81.3953488372093
Kalamb (Os),Wheat(Husked),2015,1385,1910,525,37.90613718411552
Amarawati,Mosambi,2015,1725,2250,525,30.434782608695652
Nira,Wheat(Husked),2015,1650,2175,525,31.818181818181817
Ahmednagar,Tomato,2016,350,875,525,150.0
Sangamner,Wheat(Husked),2015,1525,2050,525,34.42622950819672
Koregaon,Potato,2015,1050,1575,525,50.0
Ghoti,Ladies Finger,2016,1375,1900,525,38.18181818181818
Sindkhed Raja,Black Gram,2016,5900,6425,525,8.898305084745763
Ambad(Vadi Godri),Sorgum(Jawar),2015,1231,1756,525,42.64825345247766
Umarkhed-Danki,Soybean,2015,3000,3525,525,17.5
Patan,Bitter Gourd,2015,1650,2175,525,31.818181818181817
Chandrapur-Ganjwad,Flower,2015,425,950,525,123.52941176470588
Tumsar,Rice(Paddy-Hus),2015,2650,3175,525,19.81132075471698
Morshi,Pigeon Pea (Tur),2015,5438,5963,525,9.65428466347922
Kolhapur-Malkapur,Flower,2016,175,700,525,300.0
Akole,Soybean,2015,3250,3775,525,16.153846153846153
Shrirampur,Pigeon Pea (Tur),2016,6588,7113,525,7.969034608378871
Akole,Paddy-Unhusked,2015,1425,1950,525,36.8421052631579
Akole,Paddy-Unhusked,2015,1475,2000,525,35.59322033898305
Akluj,Bor,2015,950,1475,525,55.26315789473684
Paranda,Onion,2016,62,587,525,846.7741935483871
Sangali,Chillies(Red),2014,8675,9200,525,6.051873198847262
Ghoti,Bitter Gourd,2015,1150,1675,525,45.65217391304348
Patan,Tomato,2016,1438,1963,525,36.50904033379694
Buldhana,Gram,2015,4250,4775,525,12.352941176470589
Karad,Pavata,2015,1650,2175,525,31.818181818181817
Pusad,GRAM,2016,7425,7950,525,7.070707070707071
Khed-Chakan,Coriander  ,2016,550,1075,525,95.45454545454545
Varud-Rajura Bazar,Gram,2015,5158,5683,525,10.178363706863125
Akole,Soybean,2016,3200,3725,525,16.40625
Dound,Gram,2015,3728,4253,525,14.082618025751072
Amarawati,Green Gram,2016,5538,6062,524,9.461899602744673
Jalgaon,Cluster Bean,2016,2900,3424,524,18.06896551724138
Shegaon,Black Gram,2015,5248,5772,524,9.984756097560975
Baramati,Bajri,2015,1493,2017,524,35.09711989283322
Umarga,Gram,2015,3766,4290,524,13.913967073818375
Shahapur,Ladies Finger,2016,2136,2660,524,24.53183520599251
Jalna-Badnapur,Green Gram,2016,4536,5060,524,11.552028218694886
Hinganghat,Gram,2016,3789,4313,524,13.82950646608604
Sindi,Soybean,2016,3139,3663,524,16.693214399490284
Solapur,Banana,2015,444,968,524,118.01801801801801
Shrirampur,Green Chilli,2015,2190,2714,524,23.926940639269407
Shrirampur,Green Chilli,2015,1619,2143,524,32.3656578134651
Achalpur,Pigeon Pea (Tur),2016,7793,8317,524,6.723983061722058
Patan,Brinjal,2016,2229,2753,524,23.50829968595783
Kamthi,GREEN CHILLI,2016,714,1238,524,73.38935574229691
Aurangabad,Ladies Finger,2015,1162,1686,524,45.09466437177281
Karad,Shevga,2016,1828,2352,524,28.665207877461707
Pune-Pimpri,Tomato,2014,1886,2410,524,27.783669141039237
Amarawati,Ginger (Fresh),2016,2394,2918,524,21.888053467000834
Karad,Potato,2016,760,1284,524,68.94736842105263
Lasur Station,Wheat(Husked),2016,1648,2172,524,31.796116504854368
Sinner,Green Gram,2015,7707,8231,524,6.799013883482548
Kurdwadi,Sorgum(Jawar),2015,1827,2351,524,28.680897646414888
Nandurbar,Cluster Bean,2015,3975,4499,524,13.182389937106919
Wardha,Soybean,2016,2454,2978,524,21.352893235533823
Pune-Moshi,CARROT,2016,1117,1640,523,46.821844225604295
Wardha,Pigeon Pea (Tur),2015,8569,9092,523,6.103395962189287
Nashik-Devlali,Raddish,2016,1277,1800,523,40.95536413469068
Baramati,Sunflower,2015,3075,3598,523,17.008130081300813
Latur-Murud,Pigeon Pea (Tur),2016,7044,7567,523,7.4247586598523565
Aurangabad,Ladies Finger,2014,1548,2071,523,33.78552971576227
Mumbai,Green Chilli,2015,2208,2731,523,23.68659420289855
Shrirampur,Ginger (Fresh),2014,3977,4500,523,13.150616042242897
Satara,Pavtta,2015,1642,2165,523,31.851400730816078
Aurangabad,Cucumber,2016,1370,1893,523,38.175182481751825
Pune-Manjri,Tomato,2016,831,1354,523,62.93622141997593
Karad,Brinjal,2016,1465,1988,523,35.69965870307167
Risod,Gram,2015,3228,3751,523,16.20198265179678
Chalisgaon,Sunflower,2016,2830,3353,523,18.480565371024735
Mangalwedha,Gram,2015,3550,4073,523,14.732394366197184
Nagpur,Soybean,2015,3386,3909,523,15.44595392793857
Gangakhed,Cotton,2016,4100,4623,523,12.75609756097561
Phaltan,Tomato,2016,625,1148,523,83.68
Karad,Capsicum,2016,1869,2392,523,27.982878544676296
Phaltan,Bajri,2015,1250,1773,523,41.84
Dindori-Vani,Onion,2014,1155,1678,523,45.28138528138528
Kada,Sorgum(Jawar),2015,1535,2058,523,34.071661237785015
Rahata,Cucumber,2016,1791,2314,523,29.201563372417645
Satara,Capsicum,2015,1932,2455,523,27.0703933747412
Karanja,Gram,2015,3127,3650,523,16.725295810681164
Ratanagari,Brinjal,2015,923,1446,523,56.66305525460455
Malegaon,Sorgum(Jawar),2014,1798,2321,523,29.087875417130146
Mumbai,Capsicum,2016,2531,3054,523,20.663769261161598
Jalna,Bajri,2015,1289,1812,523,40.57408844065167
Dudhani,Gram,2016,4211,4734,523,12.419852766563762
Kopargaon,Green Gram,2016,4866,5389,523,10.748047677764077
Osmanabad,Carrot,2016,666,1188,522,78.37837837837837
Kolhapur-Laxmipuri,Split Black Gram,2016,16504,17026,522,3.162869607367911
Daryapur,Green Gram,2016,6656,7178,522,7.842548076923077
Mumbai,Melon,2014,1217,1739,522,42.892358258011505
Shahapur,Cluster Bean,2016,4089,4611,522,12.76595744680851
Pune,Green Gram,2016,5476,5998,522,9.532505478451425
Pune-Pimpri,Ghosali(Bhaji),2016,2639,3161,522,19.78021978021978
Karad,Tomato,2015,756,1278,522,69.04761904761905
Nagpur,Gram,2016,4811,5333,522,10.850135107046352
Shrirampur,Gram,2016,3683,4205,522,14.173228346456693
Mumbai,Shevga,2015,2478,3000,522,21.065375302663437
Hinganghat,Soybean,2014,2793,3315,522,18.689581095596132
Paithan,Sorgum(Jawar),2014,1616,2138,522,32.301980198019805
Aurangabad,Ladies Finger,2016,815,1337,522,64.04907975460122
Barshi,Pigeon Pea (Tur),2016,5550,6072,522,9.405405405405405
Kada (Ashti),Sorgum(Jawar),2015,1578,2100,522,33.07984790874525
Manchar,WALVAD,2016,440,962,522,118.63636363636364
Gangapur,Gram,2015,4111,4633,522,12.697640476769642
Kalamb (Os),Sorgum(Jawar),2015,1609,2131,522,32.442510876320696
Aarni,Soybean,2016,3233,3755,522,16.145994432415712
Khed (Shel Pimpalgaon),Cluster Bean,2014,1412,1934,522,36.96883852691218
Buldhana,Pigeon Pea (Tur),2016,8067,8589,522,6.470806991446635
Karad,Ladies Finger,2015,2422,2944,522,21.552436003303054
Karad,Ladies Finger,2015,1564,2086,522,33.37595907928389
Patan,Pavtta,2015,1856,2378,522,28.125
Nashik-Devlali,Chavli (Pala),2016,446,968,522,117.04035874439462
Latur,Gram,2015,3501,4023,522,14.910025706940875
Risod,Pigeon Pea (Tur),2015,8039,8561,522,6.4933449434009205
Vita,LADIES FINGER,2016,1117,1638,521,46.64279319606088
Pusad,Pigeon Pea (Tur),2016,8478,8999,521,6.1453172918141075
Shirpur,BAJRI,2016,1093,1614,521,47.66697163769442
Solapur,Wheat(Husked),2016,2108,2629,521,24.71537001897533
Shahapur,Ghosali(Bhaji),2016,2825,3346,521,18.442477876106196
Mumbai,Ladies Finger,2015,2831,3352,521,18.403391027905332
Chandrapur-Ganjwad,Onion,2015,926,1447,521,56.26349892008639
Kurdwadi-Modnimb,Wheat(Husked),2015,1466,1987,521,35.53888130968622
Amalner,Black Gram,2014,4309,4830,521,12.090972383383615
Ausa,Green Gram,2014,7027,7548,521,7.414259285612637
Pusad,Gram,2015,3488,4009,521,14.936926605504587
Nashik,Cabbage,2015,623,1144,521,83.62760834670947
Dound,Bajri,2016,1679,2200,521,31.03037522334723
Satana,Wheat(Husked),2016,1498,2019,521,34.77970627503338
Lonar,Gram,2015,3001,3522,521,17.36087970676441
Tumsar,Jaggery,2016,3590,4111,521,14.512534818941504
Pune,Wheat(Husked),2015,2237,2758,521,23.29012069736254
Karad,Ghevda,2016,2936,3457,521,17.745231607629428
Gevrai,Sorgum(Jawar),2016,1532,2053,521,34.007832898172325
Kalamb (Os),Gram,2015,4092,4613,521,12.732160312805474
Patur,Wheat(Husked),2015,1236,1757,521,42.15210355987055
Kamthi,ONION,2016,486,1007,521,107.20164609053498
Pune-Pimpri,Bottle Gourd,2016,1679,2200,521,31.03037522334723
Shrirampur,Cucumber,2016,1354,1875,521,38.47858197932053
Murtizapur,Pigeon Pea (Tur),2016,5457,5978,521,9.547370350009162
Nashik,Shahale ,2016,1945,2466,521,26.786632390745503
Sonpeth,Soybean,2015,3151,3672,521,16.534433513170423
Rahuri-Vambori,Sorgum(Jawar),2016,1436,1957,521,36.28133704735376
Umarga,Gram,2014,2057,2578,521,25.328147788040837
Umared,Gram,2015,3400,3921,521,15.323529411764707
Manmad,Onion,2016,294,815,521,177.2108843537415
Babhulgaon,Gram,2016,3711,4231,520,14.01239558070601
Balapur,Wheat(Husked),2016,1420,1940,520,36.61971830985915
Nagpur,Chavli (Shenga ),2016,1554,2074,520,33.46203346203346
Aurangabad,Cabbage,2016,1815,2335,520,28.650137741046834
Shrirampur,Ginger (Fresh),2015,2692,3212,520,19.316493313521544
Kalamb (Os),Green Gram,2016,4468,4988,520,11.638316920322293
Hinganghat,Gram,2014,2268,2788,520,22.92768959435626
Manora,Pigeon Pea (Tur),2014,4610,5130,520,11.279826464208243
Patan,Bitter Gourd,2015,2180,2700,520,23.853211009174313
Manmad,Onion,2016,202,722,520,257.4257425742574
Khed (Shel Pimpalgaon),Bottle Gourd,2014,602,1122,520,86.37873754152824
Nira-Saswad,Rice(Paddy-Hus),2016,2960,3480,520,17.56756756756757
Mumbai,Onion,2015,1176,1696,520,44.21768707482993
Kalyan,Chikoo,2016,1435,1955,520,36.23693379790941
Chandrapur,Pigeon Pea (Tur),2015,5050,5570,520,10.297029702970297
Kamthi,Onion,2016,375,895,520,138.66666666666666
Mohol,Pigeon Pea (Tur),2014,3280,3800,520,15.853658536585366
Karad,Snake Gourd,2014,2060,2580,520,25.24271844660194
Karad,Brinjal,2016,1528,2048,520,34.031413612565444
Kurdwadi-Modnimb,Maize,2016,1481,2001,520,35.11141120864281
Buldhana-Dhad,Green Gram,2016,4480,5000,520,11.607142857142858
Satara,Green Chilli,2015,1125,1645,520,46.22222222222222
Aurangabad,Capsicum,2015,1676,2196,520,31.026252983293556
Bhokardan-Pimpalgaon Renu,Green Gram,2015,6720,7240,520,7.738095238095238
Hingoli,Gram,2016,6119,6639,520,8.498120607942475
Murtizapur,Gram,2015,3636,4156,520,14.3014301430143
Patur,Black Gram,2016,6380,6900,520,8.150470219435737
Baramati,Jaggery,2016,2923,3443,520,17.789941840574752
Chandur Bajar,Soybean,2015,2900,3420,520,17.93103448275862
Hingoli,Pigeon Pea (Tur),2016,8548,9068,520,6.083294337856809
Patan,Cabbage,2016,2260,2780,520,23.008849557522122
Murbad,Ghevda,2016,3920,4440,520,13.26530612244898
Karad,Ladies Finger,2016,2168,2688,520,23.985239852398525
Anajngaon Surji,GREEN GRAM,2016,3950,4470,520,13.164556962025317
Kalvan,Ground Nut Pods (Dry),2016,3980,4500,520,13.06532663316583
Karad,Bitter Gourd,2015,1900,2420,520,27.36842105263158
Karad,Flower,2016,1092,1612,520,47.61904761904762
Shahapur,Capsicum,2016,1560,2080,520,33.333333333333336
Aurangabad,Tomato,2016,800,1320,520,65.0
Sonpeth,SOYBEAN,2016,2176,2696,520,23.897058823529413
Karad,Ginger (Fresh),2015,2740,3260,520,18.978102189781023
Kada,Gram,2016,5967,6486,519,8.697838109602815
Jalna,PIGEON PEA (TUR),2016,4878,5397,519,10.63960639606396
Karanja,Gram,2015,3854,4373,519,13.4665282823041
Chimur,Pigeon Pea (Tur),2016,6741,7260,519,7.69915442812639
Khed-Chakan,Capsicum,2016,1514,2033,519,34.28005284015852
Aurangabad,LADIES FINGER,2016,1954,2473,519,26.56090071647902
Akole,Bajri,2016,1456,1975,519,35.645604395604394
Shrirampur,Ladies Finger,2016,1176,1695,519,44.13265306122449
Shrirampur,Green Chilli,2015,2327,2846,519,22.303394929093255
Partur,Pigeon Pea (Tur),2016,8230,8749,519,6.306196840826246
Babhulgaon,Soybean,2014,2686,3205,519,19.32241250930752
Anajngaon Surji,Soybean,2016,3029,3548,519,17.1343677781446
Nagpur,Green Chilli,2015,1646,2165,519,31.530984204131226
Gevrai,Pigeon Pea (Tur),2014,4129,4648,519,12.56962945023008
Yeola,Gram,2015,3941,4460,519,13.169246384166454
Indapur (Nimgaon Ketki),Wheat(Husked),2016,1599,2118,519,32.4577861163227
Pachora,Green Gram,2015,6916,7435,519,7.504337767495662
Solapur,Jaggery,2015,2111,2630,519,24.585504500236855
Dondaicha,WHEAT(HUSKED),2016,1689,2208,519,30.72824156305506
Shrirampur,Capsicum,2014,1657,2176,519,31.32166566083283
Shrirampur,Capsicum,2015,1250,1769,519,41.52
Majalgaon,Wheat(Husked),2015,1293,1812,519,40.13921113689095
Shrirampur,Ginger (Fresh),2016,1981,2500,519,26.198889449772842
Dhule,Wheat(Husked),2016,1430,1949,519,36.29370629370629
Barshi,Wheat(Husked),2015,1422,1941,519,36.49789029535865
Aurangabad,Capsicum,2016,1255,1773,518,41.27490039840637
Chopda,Soybean,2016,2353,2871,518,22.014449638759032
Risod,Gram,2016,5246,5764,518,9.874189858940145
Shrirampur,Water Melon,2015,1091,1609,518,47.47937671860678
Kalamb (Os),Sorgum(Jawar),2015,1438,1956,518,36.02225312934632
Shahapur,Cucumber,2015,1000,1518,518,51.8
Jamkhed,Pigeon Pea (Tur),2016,7674,8192,518,6.7500651550690645
Karad,Ghevda,2016,2773,3291,518,18.68012982329607
Sangali,Soybean,2014,2910,3428,518,17.80068728522337
Amarawati,Soybean,2016,2396,2914,518,21.619365609348915
Kalyan,Carrot,2016,3259,3777,518,15.894446149125498
Khed-Chakan,Bitter Gourd,2015,2887,3405,518,17.942500865950812
Nandura,Pigeon Pea (Tur),2014,4506,5024,518,11.495783399911229
Hingoli,Green Gram,2015,6002,6520,518,8.630456514495169
Kada (Ashti),Sorgum(Jawar),2016,1638,2156,518,31.623931623931625
Pune,Squash Gourd,2015,452,970,518,114.60176991150442
Aurangabad,Guava,2015,1118,1636,518,46.33273703041145
Nagpur,Coriander  ,2016,1373,1891,518,37.72760378732702
Khamgaon,Soybean,2016,3324,3842,518,15.583634175691937
Shrirampur,Brinjal,2016,1204,1722,518,43.02325581395349
Ramtek,Chavli (Shenga ),2016,1700,2218,518,30.470588235294116
Sangamner,Tomato,2015,500,1017,517,103.4
Jalgaon,Cucumber,2016,1224,1741,517,42.23856209150327
Chandur Bajar,Soybean,2014,2894,3411,517,17.864547339322737
Kalyan,Lemon,2015,2183,2700,517,23.683005038937242
Manmad,Onion,2016,378,895,517,136.7724867724868
Shahapur,Cucumber,2015,1183,1700,517,43.70245139475909
Paranda,Sorgum(Jawar),2015,1450,1967,517,35.6551724137931
Solapur,Banana,2016,475,992,517,108.84210526315789
Buldhana,Wheat(Husked),2014,1250,1767,517,41.36
Nashik,Melon,2016,650,1167,517,79.53846153846153
Malegaon,Bajri,2016,1339,1856,517,38.61090365944735
Dhamangaon-Rly,Soybean,2014,2884,3401,517,17.926490984743413
Nandurbar,Bajri,2014,1009,1526,517,51.238850346878095
Pune-Pimpri,Ghevda,2016,2083,2600,517,24.81997119539126
Balapur,Soybean,2015,3046,3563,517,16.973079448456993
Akole,Paddy-Unhusked,2016,1500,2017,517,34.46666666666667
Nagpur,Ladies Finger,2015,1621,2138,517,31.89389265885256
Rahata,Cucumber,2016,1483,2000,517,34.86176668914363
Bhokardan,Black Gram,2016,6000,6517,517,8.616666666666667
Kalyan,Green Chilli,2016,3159,3676,517,16.36593858816081
Akole,Bajri,2016,1483,2000,517,34.86176668914363
Pune-Pimpri,Ghevda,2015,2600,3117,517,19.884615384615383
Ausa,Tamarind,2015,3723,4240,517,13.886650550631211
Shegaon,Green Gram,2015,7010,7527,517,7.375178316690442
Navapur,Tomato,2016,902,1419,517,57.31707317073171
Karad,Capsicum,2015,1625,2142,517,31.815384615384616
Aarni,Black Gram,2016,6050,6567,517,8.545454545454545
Nandurbar,Pigeon Pea (Tur),2016,6834,7351,517,7.565115598478197
Aarni,Pigeon Pea (Tur),2016,8300,8817,517,6.228915662650603
Katol,Gram,2015,2705,3222,517,19.11275415896488
Nagpur,Potato,2015,550,1067,517,94.0
Pune,Sorgum(Jawar),2015,2346,2863,517,22.03751065643649
Pune,Gram,2016,5962,6479,517,8.671586715867159
Lonar,Pigeon Pea (Tur),2015,6783,7300,517,7.621996166887808
Nagpur,Ladies Finger,2016,2471,2988,517,20.922703358963982
Yeotmal,Gram,2015,3958,4475,517,13.062152602324407
Manmad,Onion,2016,406,923,517,127.33990147783251
Hadgaon-Tamsa,Gram,2016,4483,5000,517,11.532455944679901
Kolhapur,Potato,2016,975,1492,517,53.02564102564103
Jintur,Green Gram,2015,6425,6942,517,8.04669260700389
Nashik-Devlali,Coriander  ,2016,1115,1632,517,46.36771300448431
Nira-Saswad,Rice(Paddy-Hus),2015,2850,3367,517,18.140350877192983
Amarawati-Fruit And Vegetables,ONION,2016,992,1508,516,52.016129032258064
Shahapur,Capsicum,2016,1217,1733,516,42.39934264585045
Satara,Bitter Gourd,2014,2800,3316,516,18.428571428571427
Nandura,Black Gram,2015,6396,6912,516,8.067542213883677
Sindkhed Raja,Wheat(Husked),2016,1467,1983,516,35.173824130879346
Vai,Brinjal,2014,2206,2722,516,23.390752493200363
Nagpur,Coriander  ,2016,2308,2824,516,22.357019064124785
Kalyan,Black Gram,2016,12317,12833,516,4.189331817812779
Sangrampur-Varvatbakal,Pigeon Pea (Tur),2016,5391,5907,516,9.571508069003896
Pune,CAPSICUM,2016,668,1184,516,77.24550898203593
Pusad,Bajri,2015,1285,1801,516,40.1556420233463
Devala,Gram,2016,3890,4406,516,13.264781491002571
Solapur,Wheat(Husked),2016,2095,2611,516,24.630071599045348
Aurangabad,Cabbage,2016,1563,2079,516,33.01343570057582
Shahapur,Ridge Gourd,2015,2167,2683,516,23.811721273650207
Varud,Orange,2015,612,1128,516,84.31372549019608
Jintur-Bori,Pigeon Pea (Tur),2016,7741,8257,516,6.665805451492055
Mumbai,Shevga,2015,1832,2348,516,28.16593886462882
Katol,Gram,2014,2263,2779,516,22.801590808661068
Amarawati-Fruit And Vegetables,Onion,2016,367,883,516,140.59945504087193
Daryapur,Pigeon Pea (Tur),2015,4467,4983,516,11.55137676292814
Jalgaon,Squash Gourd,2015,568,1084,516,90.84507042253522
Raver,Wheat(Husked),2015,963,1479,516,53.58255451713396
Taloda,Green Gram,2015,5833,6349,516,8.846219783987657
Katol,Ground Nut Pods (Dry),2016,4198,4714,516,12.291567413053835
Yeotmal,Cotton,2016,4252,4768,516,12.13546566321731
Karad,Snake Gourd,2016,2538,3054,516,20.33096926713948
Kalmeshwar,Soybean,2015,3207,3723,516,16.089803554724043
Satara,Tomato,2016,1076,1592,516,47.95539033457249
Patan,Ladies Finger,2016,2446,2962,516,21.095666394112836
Sinner,Onion,2016,52,568,516,992.3076923076923
Yeola,Onion,2016,285,801,516,181.05263157894737
Sindi (Selu),Pigeon Pea (Tur),2015,4850,5365,515,10.618556701030927
Solapur,Sorgum(Jawar),2014,1906,2421,515,27.0199370409234
Beed,Sorgum(Jawar),2016,1605,2120,515,32.087227414330215
Kopargaon,Sorgum(Jawar),2014,1260,1775,515,40.87301587301587
Solapur,Banana,2016,307,822,515,167.75244299674267
Aurangabad,Flower,2016,1004,1519,515,51.29482071713147
Varud,SOYBEAN,2016,2421,2936,515,21.27220156959934
Chandrapur-Ganjwad,Capsicum,2015,1171,1686,515,43.97950469684031
Kalyan,Ridge Gourd,2016,2375,2890,515,21.68421052631579
Solapur,Jaggery,2016,2338,2853,515,22.02737382378101
Kolhapur-Laxmipuri,Split Gram,2016,11971,12486,515,4.302063319689249
Karanja,Pigeon Pea (Tur),2015,6964,7479,515,7.395175186674325
Ahmedpur,Ground Nut Pods (Dry),2015,4675,5190,515,11.016042780748663
Satara,Capsicum,2015,2452,2967,515,21.00326264274062
Sindi,Pigeon Pea (Tur),2015,4523,5038,515,11.38624806544329
Pune,Arvi,2014,1914,2429,515,26.90700104493208
Amarawati-Fruit And Vegetables,Onion,2016,771,1286,515,66.79636835278859
Nandura,Soybean,2016,3292,3807,515,15.643985419198057
Shegaon,Pigeon Pea (Tur),2016,5350,5865,515,9.626168224299066
Rahata,Bottle Gourd,2016,1231,1746,515,41.835905767668564
Khed-Chakan,Chavli (Shenga ),2016,1773,2288,515,29.046813310772702
Karanja,Gram,2015,3807,4322,515,13.527712109272393
Parli-Vaijnath,Pigeon Pea (Tur),2015,4641,5156,515,11.096746390864038
Digras,Gram,2016,6317,6832,515,8.152604084217192
Manchar,Shepu,2015,293,807,514,175.42662116040955
Solapur,Gram,2015,4074,4588,514,12.616593028964163
Kamthi,Brinjal,2015,557,1071,514,92.28007181328546
Lasalgaon-Vinchur,Wheat(Husked),2015,1241,1755,514,41.41821112006446
Kamthi,Tomato,2014,632,1146,514,81.32911392405063
Malkapur,Gram,2016,3729,4243,514,13.783856261732367
Sangrampur,Gram,2015,2242,2756,514,22.925958965209634
Kalvan,Onion,2016,125,639,514,411.2
Phaltan,Maize,2016,1770,2284,514,29.03954802259887
Murtizapur,Gram,2015,3036,3550,514,16.930171277997363
Shirpur,Gram,2015,3137,3651,514,16.38508128785464
Karanja,Pigeon Pea (Tur),2015,6854,7368,514,7.4992704989786985
Jalgaon,Melon,2015,757,1271,514,67.89960369881109
Dhule,Wheat(Husked),2016,1479,1993,514,34.75321162947938
Jalgaon,Papai,2015,873,1387,514,58.87743413516609
Morshi,Soybean,2015,3169,3683,514,16.219627642789522
Kolhapur-Laxmipuri,Wheat(Husked),2015,2371,2885,514,21.678616617460985
Wardha,Gram,2015,4167,4681,514,12.335013198944084
Jintur,Black Gram,2014,4848,5362,514,10.602310231023102
Shirpur,Gram,2015,4476,4990,514,11.483467381590707
Lasur Station,Green Gram,2016,4373,4887,514,11.75394466041619
Aurangabad,Cluster Bean,2015,1481,1995,514,34.70627954085078
Sangli-Phale Bhajipalam,Papai,2016,222,736,514,231.53153153153153
Wardha,Pigeon Pea (Tur),2016,5468,5982,514,9.400146305779078
Shirpur,Black Gram,2014,4990,5504,514,10.30060120240481
Partur,Pigeon Pea (Tur),2016,7925,8439,514,6.485804416403785
Pune,Snake Gourd,2016,1000,1514,514,51.4
Sangali,Jaggery,2016,3511,4025,514,14.63970378809456
Arvi,Cotton,2015,4000,4514,514,12.85
Jalgaon,Cucumber,2016,559,1073,514,91.94991055456171
Taloda,Pigeon Pea (Tur),2016,6673,7187,514,7.7026824516709125
Karad,Cluster Bean,2015,2586,3100,514,19.876256767208044
Karad,Cluster Bean,2015,1857,2371,514,27.679052234787292
Devala,Gram,2015,2957,3471,514,17.382482245519107
Anajngaon Surji,Gram,2015,4133,4646,513,12.412291313815631
Shirpur,Onion,2016,146,659,513,351.36986301369865
Varora,Soybean,2016,3212,3725,513,15.971357409713574
Pathardi,Bajri,2016,1276,1789,513,40.20376175548589
Pune-Moshi,Flower,2016,830,1343,513,61.80722891566265
Shegaon,Green Gram,2015,6853,7366,513,7.4857726543119805
Satara,Cucumber,2014,752,1265,513,68.21808510638297
Rahata,Ladies Finger,2015,1325,1838,513,38.716981132075475
Wardha,Gram,2016,7491,8004,513,6.848217861433721
Hinganghat,Soybean,2016,2962,3475,513,17.319378798109387
Shrirampur,Tomato,2014,1505,2018,513,34.08637873754153
Sangli-Phale Bhajipalam,Papai,2015,257,770,513,199.61089494163423
Kej,Bajri,2016,1351,1864,513,37.97187268689859
Baramati,Sunflower,2015,2700,3213,513,19.0
Chopda,Green Gram,2016,4052,4565,513,12.660414610069102
Mantha,Green Gram,2015,6225,6738,513,8.240963855421686
Nampur,Onion,2016,329,842,513,155.92705167173253
Jalgaon,Cucumber,2015,708,1221,513,72.45762711864407
Jalna,Soybean,2016,3143,3656,513,16.32198536430162
Lasalgaon-Vinchur,Gram,2016,6617,7130,513,7.752758047453529
Aurangabad,Chikoo,2015,1150,1663,513,44.608695652173914
Amalner,Soybean,2015,2744,3257,513,18.69533527696793
Manchar,Maize(Corn.),2016,625,1138,513,82.08
Katol,Gram,2014,2154,2667,513,23.81615598885794
Aurangabad,Cluster Bean,2015,1596,2109,513,32.142857142857146
Kalmeshwar,Cotton,2016,4575,5088,513,11.21311475409836
Baramati,BAJRI,2016,1581,2094,513,32.44781783681214
Sangli-Phale Bhajipalam,Potato,2016,1290,1803,513,39.76744186046512
Aurangabad,Green-Peas,2014,2204,2717,513,23.275862068965516
Malkapur,Onion,2015,525,1038,513,97.71428571428571
Tuljapur,Pigeon Pea (Tur),2016,8236,8749,513,6.228751821272462
Umari,Sorgum(Jawar),2015,1483,1996,513,34.59204315576534
Lasalgaon,Gram,2014,2315,2828,513,22.159827213822894
Khed-Chakan,Cabbage,2016,1631,2144,513,31.453096259963214
Ahmedpur,Sorgum(Jawar),2016,1305,1818,513,39.310344827586206
Pune-Pimpri,Green Chilli,2016,1325,1838,513,38.716981132075475
Chopda,Pigeon Pea (Tur),2015,4370,4883,513,11.73913043478261
Chandur Bajar,Soybean,2015,2960,3473,513,17.33108108108108
Mumbai,Cluster Bean,2016,2647,3160,513,19.38043067623725
Khed-Chakan,Tomato,2016,667,1179,512,76.7616191904048
Khed (Shel Pimpalgaon),Cluster Bean,2016,2141,2653,512,23.914058851004203
Pune,Flower,2015,308,820,512,166.23376623376623
Baramati,Wheat(Husked),2015,1526,2038,512,33.551769331585845
Khed-Chakan,Potato,2016,638,1150,512,80.25078369905957
Shrirampur,Chikoo,2016,1368,1880,512,37.42690058479532
Katol,Gram,2015,2655,3167,512,19.284369114877588
Karanja,Soybean,2016,3215,3727,512,15.925349922239503
Chandrapur-Ganjwad,Onion,2016,567,1079,512,90.29982363315696
Mumbai-Fruit Market,Papai,2016,844,1356,512,60.66350710900474
Khed-Chakan,CUCUMBER,2016,1060,1572,512,48.301886792452834
Satara,Cucumber,2014,1452,1964,512,35.26170798898072
Katol,Pigeon Pea (Tur),2015,4480,4992,512,11.428571428571429
Murtizapur,PIGEON PEA (TUR),2016,5283,5795,512,9.691463183797085
Osmanabad,Sorgum(Jawar),2015,1779,2291,512,28.780213603147835
Shahapur,Ladies Finger,2016,1363,1875,512,37.56419662509171
Kamthi,Bottle Gourd,2015,664,1176,512,77.10843373493977
Vasai,Wheat(Husked),2016,1839,2351,512,27.841218053289833
Lonand,Wheat(Husked),2016,1538,2050,512,33.28998699609883
Kamthi,CHAVLI (SHENGA ),2016,565,1077,512,90.61946902654867
Khamgaon,Gram,2015,2572,3084,512,19.906687402799378
Pune,Arvi,2016,2344,2856,512,21.843003412969285
Pune,Beet Root,2016,412,924,512,124.27184466019418
Kalyan,Jaggery,2016,4188,4700,512,12.225405921680993
Kamthi,RADDISH,2016,481,993,512,106.44490644490645
Karad,Ladies Finger,2016,1512,2024,512,33.86243386243386
Gevrai,Wheat(Husked),2015,1221,1733,512,41.93284193284193
Dound,Bajri,2016,1565,2077,512,32.715654952076676
Sangali,Bajri,2015,1309,1821,512,39.113827349121465
Khed-Chakan,Flower,2016,1292,1804,512,39.628482972136226
Karad,Pavata,2016,2913,3425,512,17.57638173704085
Junnar-Otur,Onion,2015,1338,1850,512,38.2660687593423
Umared,Wheat(Husked),2015,1513,2025,512,33.84005287508262
Nandurbar,Sorgum(Jawar),2014,1235,1747,512,41.45748987854251
Kalyan,Guava,2016,2129,2641,512,24.048849224988256
Katol,Gram,2016,3640,4152,512,14.065934065934066
Nandura,Gram,2015,2387,2899,512,21.449518223711774
Jalgaon,Potato,2014,2024,2536,512,25.296442687747035
Ghoti,Ladies Finger,2016,1488,2000,512,34.40860215053763
Loha,Green Gram,2016,5601,6113,512,9.141224781289056
Mandhal,Soybean,2014,2812,3324,512,18.207681365576104
Chalisgaon,Soybean,2016,2945,3457,512,17.38539898132428
Bhivandi,Potato,2015,2063,2575,512,24.81822588463403
Solapur,Wheat(Husked),2016,2123,2635,512,24.116815826660385
Khed-Chakan,ONION,2016,438,950,512,116.89497716894977
Karad,Ladies Finger,2016,1589,2100,511,32.158590308370044
Aarni,Gram,2015,3840,4351,511,13.307291666666666
Nashik-Devlali,Kanda Pat,2016,666,1177,511,76.72672672672672
Indapur-Bhigwan,Jaggery,2016,2900,3411,511,17.620689655172413
Kalyan,Ridge Gourd,2016,3541,4052,511,14.430951708556904
Solapur,Carrot,2016,1500,2011,511,34.06666666666667
Murtizapur,Green Gram,2015,7497,8008,511,6.816059757236228
Barshi,Wheat(Husked),2015,1500,2011,511,34.06666666666667
Tumsar,Pigeon Pea (Tur),2016,7511,8022,511,6.803355079217148
Shahapur,Ghosali(Bhaji),2015,1889,2400,511,27.051349920592905
Phaltan,Wheat(Husked),2015,1585,2096,511,32.2397476340694
Karad,Capsicum,2014,1233,1744,511,41.443633414436334
Mangrulpeer,Wheat(Husked),2015,1122,1633,511,45.54367201426025
Loha,PIGEON PEA (TUR),2016,5200,5711,511,9.826923076923077
Vai,Bottle Gourd,2016,1656,2167,511,30.857487922705314
Ausa,Green Gram,2015,6938,7449,511,7.365234938022485
Kurdwadi-Modnimb,Onion,2016,184,695,511,277.7173913043478
Akola,Wheat(Husked),2016,2083,2594,511,24.531925108017283
Kamthi,Tomato,2015,559,1070,511,91.41323792486583
Loha,Black Gram,2015,8200,8711,511,6.2317073170731705
Vai,Brinjal,2016,2193,2704,511,23.30141358869129
Amarawati,Orange,2015,1428,1939,511,35.78431372549019
Mumbai,Potato,2016,1015,1526,511,50.3448275862069
Barshi,Capsicum,2015,467,978,511,109.42184154175588
Kurdwadi-Modnimb,Wheat(Husked),2015,1336,1847,511,38.24850299401198
Ausa,Ground Nut Pods (Dry),2015,4001,4512,511,12.77180704823794
Telhara,Gram,2015,3827,4338,511,13.352495427227593
Anajngaon Surji,Gram,2016,4850,5361,511,10.536082474226804
Jintur,Green Gram,2014,7237,7748,511,7.06093685228686
Aurangabad,Brinjal,2015,1111,1622,511,45.994599459945995
Pune,Snake Gourd,2015,784,1295,511,65.17857142857143
Nagpur,Math (Bhaji),2015,2731,3242,511,18.711094837056024
Karad,Ghevda,2015,2378,2889,511,21.48864592094197
Shahapur,Cucumber,2015,1233,1744,511,41.443633414436334
Jamkhed,Soybean,2016,3050,3561,511,16.75409836065574
Pathardi,Wheat(Husked),2015,1564,2075,511,32.672634271099746
Telhara,Green Gram,2015,7000,7511,511,7.3
Dhule,WHEAT(HUSKED),2016,1785,2296,511,28.627450980392158
Mumbai,Arvi,2016,1556,2067,511,32.840616966580974
Pune-Pimpri,Brinjal,2016,1295,1805,510,39.38223938223938
Dondaicha,Gram,2015,3714,4224,510,13.731825525040387
Mumbai,Potato,2016,900,1410,510,56.666666666666664
Kolhapur,WATER MELON,2016,165,675,510,309.09090909090907
Dound,Green Gram,2015,7100,7610,510,7.183098591549296
Dhule,Wheat(Husked),2015,1287,1797,510,39.62703962703963
Pune-Pimpri,Brinjal,2016,3815,4325,510,13.368283093053735
Samudrapur,Pigeon Pea (Tur),2015,6100,6610,510,8.360655737704919
Indapur,Green Gram,2016,6361,6871,510,8.017607294450558
Navapur,Flower,2015,1116,1626,510,45.69892473118279
Patan,Ladies Finger,2016,2145,2655,510,23.776223776223777
Chikhali,Soybean,2015,3324,3834,510,15.342960288808664
Satana,Wheat(Husked),2016,1599,2109,510,31.894934333958723
Malkapur,Black Gram,2015,5483,5993,510,9.30147729345249
Baramati,Wheat(Husked),2016,1623,2133,510,31.423290203327173
Koregaon,Green Gram,2015,7070,7580,510,7.2135785007072135
Kille Dharur,Gram,2015,3817,4327,510,13.361278490961489
Aurad Shahajani,Gram,2016,7097,7607,510,7.1861349866140625
Katol,ORANGE,2016,1660,2170,510,30.72289156626506
Dound,Wheat(Husked),2016,1585,2095,510,32.17665615141956
Koregaon,Onion,2015,1790,2300,510,28.491620111731844
Pune-Manjri,Cabbage,2014,932,1442,510,54.72103004291846
Kolhapur-Laxmipuri,Split Gram,2016,10057,10567,510,5.071094759868748
Akkolkot,Wheat(Unhusked),2015,2801,3311,510,18.20778293466619
Amalner,Ground Nut Pods (Dry),2016,5134,5644,510,9.933774834437086
Sengaon,Turmeric,2016,7886,8396,510,6.467156987065686
Kalyan,Green-Peas,2016,3737,4247,510,13.647310677013648
Junnar,Onion,2016,480,990,510,106.25
Bhivandi,WHEAT(HUSKED),2016,1670,2180,510,30.538922155688624
Kurdwadi,Sorgum(Jawar),2015,1648,2158,510,30.946601941747574
Satara,Potato,2015,780,1290,510,65.38461538461539
Kurdwadi,Gram,2015,3040,3550,510,16.776315789473685
Savner,Pigeon Pea (Tur),2016,7573,8083,510,6.7344513402878645
Lasalgaon-Vinchur,Sorgum(Jawar),2015,1151,1661,510,44.30929626411816
Kamthi,Bottle Gourd,2015,725,1235,510,70.34482758620689
Nandgaon Khandeshwar,Soybean,2015,3205,3715,510,15.912636505460219
Dhamangaon-Rly,Pigeon Pea (Tur),2015,6600,7110,510,7.7272727272727275
Chalisgaon,Bajri,2016,1390,1900,510,36.69064748201439
Risod,Black Gram,2016,6491,7001,510,7.857032814666462
Sinner,Bajri,2016,1209,1719,510,42.18362282878412
Hingoli,Sorgum(Jawar),2014,1080,1590,510,47.22222222222222
Tasgaon,Tamarind,2016,6995,7505,510,7.290922087205146
Bhokar,Cotton,2016,3950,4459,509,12.886075949367088
Shrirampur,Chikoo,2016,1130,1639,509,45.04424778761062
Aurangabad,Chavli (Shenga ),2015,1400,1909,509,36.357142857142854
Kamthi,Spinach,2015,565,1074,509,90.08849557522124
Sangali,GREEN PEAS (DRY),2016,2541,3050,509,20.031483667847304
Patan,Brinjal,2016,1858,2367,509,27.395048439181917
Hadgaon,Pigeon Pea (Tur),2016,8208,8717,509,6.201267056530215
Mangalwedha,Tomato,2016,168,677,509,302.9761904761905
Ausa,Gram,2016,5131,5640,509,9.920093549015787
Mumbai,Green Chilli,2016,5362,5871,509,9.49272659455427
Mumbai,Chikoo,2015,1014,1523,509,50.19723865877712
Mumbai,Jaggery,2016,3665,4174,509,13.8881309686221
Junnar,Potato,2015,483,992,509,105.38302277432712
Shegaon,Soybean,2015,3085,3594,509,16.499189627228525
Nagpur,Papai,2015,550,1059,509,92.54545454545455
Kolhapur-Laxmipuri,Gr.Nut Kernels,2016,9609,10118,509,5.297117285877823
Rahata,Green Peas (Dry),2015,2055,2564,509,24.768856447688563
Shirur,Tamarind,2016,2353,2862,509,21.631959201019974
Parola,Gram,2016,4384,4893,509,11.610401459854014
Malegaon,Sorgum(Jawar),2015,1883,2392,509,27.03133297928837
Chandur Bajar,Soybean,2015,2814,3323,509,18.088130774697937
Dhamangaon-Rly,Soybean,2015,3272,3781,509,15.556234718826406
Shrirampur,CAPSICUM,2016,1024,1533,509,49.70703125
Karad,Bitter Gourd,2014,1483,1992,509,34.322319622387056
Sangali,Bajri,2014,1316,1825,509,38.67781155015197
Gevrai,Soybean,2015,3242,3751,509,15.700185070943862
Akluj,Tomato,2014,835,1344,509,60.958083832335326
Partur,Pigeon Pea (Tur),2016,6132,6641,509,8.300717547292889
Chandrapur,Soybean,2015,3263,3772,509,15.599141893962612
Shrirampur,Capsicum,2014,2432,2941,509,20.929276315789473
Shrirampur,Capsicum,2014,2008,2517,509,25.34860557768924
Baramati,Bajri,2015,1554,2063,509,32.75418275418276
Pune,Carrot,2016,629,1138,509,80.9220985691574
Karad,Bitter Gourd,2015,1968,2477,509,25.86382113821138
Katol,Orange,2015,1325,1834,509,38.41509433962264
Kille Dharur,Bajri,2015,1296,1805,509,39.27469135802469
Akluj,Bitter Gourd,2016,705,1214,509,72.19858156028369
Ausa,Green Gram,2016,4292,4801,509,11.859273066169617
Pune,Flower,2016,474,983,509,107.38396624472574
Nira-Saswad,Bajri,2016,1575,2084,509,32.317460317460316
Jintur,Pigeon Pea (Tur),2015,4701,5210,509,10.827483514145927
Mumbai,Melon,2015,1854,2362,508,27.400215749730314
Mumbai,Split Lentil,2016,5896,6404,508,8.616010854816825
Karad,Capsicum,2016,1512,2020,508,33.597883597883595
Jalgaon,Green Gram,2014,5700,6208,508,8.912280701754385
Nagpur,Potato,2016,564,1072,508,90.0709219858156
Nandura,Green Gram,2015,6725,7233,508,7.553903345724907
Rajura,Cotton,2015,3401,3909,508,14.936783299029697
Nandura,Green Gram,2015,6684,7192,508,7.600239377618193
Aurangabad,Chavli (Shenga ),2015,1313,1821,508,38.69002284843869
Dhamangaon-Rly,Gram,2016,4819,5327,508,10.541606142353185
Yeotmal,Soybean,2015,3223,3731,508,15.761712690040335
Ahmednagar,Sorgum(Jawar),2015,1674,2182,508,30.34647550776583
Shrirampur,Capsicum,2015,1938,2446,508,26.212590299277604
Chopda,Gram,2016,4838,5346,508,10.500206696982223
Shahada,Wheat(Husked),2015,1342,1850,508,37.85394932935917
Pune,Potato,2015,752,1260,508,67.55319148936171
Lonand,Wheat(Husked),2015,1450,1958,508,35.03448275862069
Vai,Ginger (Fresh),2015,2946,3454,508,17.243720298710116
Murbad,Bitter Gourd,2016,1418,1926,508,35.82510578279267
Karad,Bitter Gourd,2015,2192,2700,508,23.175182481751825
Shrirampur,Sorgum(Jawar),2014,1803,2311,508,28.17526344980588
Nandgaon,Onion,2016,308,816,508,164.93506493506493
Aurangabad,Ladies Finger,2016,1344,1852,508,37.79761904761905
Akluj,Banana,2016,420,928,508,120.95238095238095
Pune-Pimpri,Bottle Gourd,2014,1396,1904,508,36.38968481375358
Hadgaon,Gram,2016,4454,4962,508,11.405478221823081
Shrirampur,Lemon,2015,1238,1746,508,41.033925686591274
Shegaon,Black Gram,2014,5057,5565,508,10.04548151077714
Dhule,Bajri,2014,1004,1512,508,50.59760956175299
Nashik-Devlali,Raddish,2016,1177,1685,508,43.16057774001699
Karad,Squash Gourd,2016,1915,2423,508,26.527415143603132
Malkapur,Green Gram,2016,5592,6100,508,9.084406294706724
Amarawati-Fruit And Vegetables,Onion,2016,246,754,508,206.5040650406504
Ahmednagar,Carrot,2016,1877,2385,508,27.064464571124134
Nandurbar,WHEAT(HUSKED),2016,1606,2114,508,31.63138231631382
Osmanabad,ONION,2016,602,1110,508,84.38538205980066
Karad,Ginger (Fresh),2016,1170,1678,508,43.41880341880342
Sonpeth,Pigeon Pea (Tur),2016,5986,6494,508,8.486468426328099
Akole,PADDY-UNHUSKED,2016,1505,2013,508,33.754152823920265
Chandur Bajar,Soybean,2014,2728,3236,508,18.621700879765395
Shrirampur,Pigeon Pea (Tur),2016,7092,7600,508,7.1630005640157925
Satara,Capsicum,2015,1595,2102,507,31.786833855799372
Yeotmal,Gram,2016,7050,7557,507,7.191489361702128
Arvi,Pigeon Pea (Tur),2015,4554,5061,507,11.133069828722002
Washim,Green Gram,2014,5433,5940,507,9.331860850358918
Tumsar,Green Gram,2016,5038,5545,507,10.063517268757444
Pune-Pimpri,Lentil,2016,5514,6021,507,9.194776931447226
Pune,Wheat(Husked),2015,2191,2698,507,23.140118667275217
Kamthi,Cabbage,2016,407,914,507,124.57002457002457
Kamthi,Cabbage,2016,650,1157,507,78.0
Indapur,Green Gram,2015,5629,6136,507,9.006928406466512
Varud-Rajura Bazar,Green Chilli,2014,2550,3057,507,19.88235294117647
Sangrampur,Soybean,2015,2673,3180,507,18.967452300785634
Jalgaon,Bor,2016,1429,1936,507,35.47935619314206
Patan,Brinjal,2015,1364,1871,507,37.17008797653959
Gevrai,Gram,2015,2744,3251,507,18.47667638483965
Manchar,Beet Root,2015,1279,1786,507,39.64034401876466
Umarga,Wheat(Husked),2015,1498,2005,507,33.845126835781045
Pune-Moshi,Walvad,2016,2114,2621,507,23.982970671712394
Nagpur,Spinach,2015,1835,2342,507,27.629427792915532
Kada,Wheat(Husked),2015,1481,1988,507,34.23362592842674
Chandrapur-Ganjwad,Tomato,2014,452,959,507,112.16814159292035
Jamkhed,Black Gram,2015,8393,8900,507,6.040748242583105
Kada,Sorgum(Jawar),2015,1502,2009,507,33.75499334221038
Akluj,Onion,2015,862,1369,507,58.816705336426914
Katol,Pigeon Pea (Tur),2015,6141,6647,506,8.239700374531836
Kej,Bajri,2016,1336,1842,506,37.874251497005986
Kalvan,Ground Nut Pods (Dry),2015,3388,3894,506,14.935064935064934
Shahapur,Ladies Finger,2014,3019,3525,506,16.760516727393178
Umrane,Onion,2016,520,1026,506,97.3076923076923
Sindi,Gram,2015,3749,4255,506,13.496932515337424
Baramati,Sorgum(Jawar),2015,1784,2290,506,28.36322869955157
Mangalwedha,Gram,2015,3415,3921,506,14.816983894582723
Dudhani,Gram,2015,3311,3817,506,15.282392026578073
Partur,Green Gram,2016,3991,4497,506,12.678526685041343
Morshi,Pigeon Pea (Tur),2015,8586,9092,506,5.893314698346145
Kada (Ashti),Gram,2015,3484,3990,506,14.52353616532721
Bhokar,Green Gram,2016,4625,5131,506,10.94054054054054
Satana,Bajri,2014,1147,1653,506,44.11508282476024
Bhandara,Gram,2014,2232,2738,506,22.670250896057347
Kamthi,Chavli (Pala),2016,507,1013,506,99.80276134122288
Jalgaon,Melon,2016,738,1244,506,68.56368563685636
Samudrapur,Cotton,2016,4020,4526,506,12.587064676616915
Nilanga,Gram,2016,3936,4442,506,12.855691056910569
Nandura,Soybean,2016,3305,3811,506,15.310136157337368
Beed,Pigeon Pea (Tur),2015,5561,6067,506,9.099082898759216
Kalyan,Shevga,2016,2918,3424,506,17.340644276901987
Lasalgaon,Onion,2016,360,865,505,140.27777777777777
Latur-Murud,Wheat(Husked),2016,1409,1914,505,35.84102200141945
Purna,Sorgum(Jawar),2016,1421,1926,505,35.53835327234342
Manora,Soybean,2014,2933,3438,505,17.217865666553017
Pune,Tamarind,2016,5555,6060,505,9.090909090909092
Koregaon,Onion,2016,200,705,505,252.5
Akluj,Cabbage,2016,795,1300,505,63.522012578616355
Ahmednagar,Cabbage,2016,190,695,505,265.7894736842105
Akola,Soybean,2016,3280,3785,505,15.396341463414634
Jintur,Soybean,2015,3200,3705,505,15.78125
Phaltan,Onion,2016,300,805,505,168.33333333333334
Shirpur,Sorgum(Jawar),2015,1245,1750,505,40.562248995983936
Beed,Wheat(Husked),2016,1701,2206,505,29.688418577307466
Nandurbar,Rice(Paddy-Hus),2015,2739,3244,505,18.437385907265426
Aarni,Pigeon Pea (Tur),2016,6104,6609,505,8.273263433813893
Chikhali,Wheat(Husked),2016,1444,1949,505,34.97229916897507
Sindi,Gram,2015,3956,4461,505,12.765419615773508
Nandgaon,Onion,2016,231,736,505,218.6147186147186
Nampur,Gram,2016,5121,5626,505,9.861355204061706
Barshi,Turmeric,2015,6492,6997,505,7.778804682686383
Pandharpur,Tomato,2016,158,663,505,319.62025316455697
Aurangabad,Wal Bhaji,2014,1945,2450,505,25.96401028277635
Pune,Flower,2015,463,968,505,109.07127429805615
Malegaon,Onion,2016,231,736,505,218.6147186147186
Nandurbar,Sorgum(Jawar),2015,1405,1910,505,35.94306049822064
Sinner,Sorgum(Jawar),2014,1360,1865,505,37.13235294117647
Shegaon,Black Gram,2015,5124,5629,505,9.855581576893051
Latur-Murud,Wheat(Husked),2015,1738,2243,505,29.05638665132336
Mumbai,Melon,2015,1536,2041,505,32.877604166666664
Mangalwedha,Tomato,2016,140,645,505,360.7142857142857
Washim-Ansing,Black Gram,2016,6792,7297,505,7.435217903415784
Ner Parasopant,Black Gram,2015,9373,9878,505,5.387816067427718
Barshi,Wheat(Husked),2015,1452,1957,505,34.77961432506887
Kada (Ashti),Sorgum(Jawar),2015,1541,2046,505,32.770927968851396
Ahmednagar,Gram,2015,4400,4905,505,11.477272727272727
Majalgaon,SORGUM(JAWAR),2016,1719,2223,504,29.319371727748692
Vai,Green Chilli,2015,1868,2372,504,26.980728051391864
Washim,Gram,2016,4157,4661,504,12.124127976906422
Jalna-Badnapur,COTTON,2016,4524,5028,504,11.140583554376658
Karad,Chikoo,2016,1777,2281,504,28.362408553742263
Barshi,Onion,2016,141,645,504,357.4468085106383
Karad,Ladies Finger,2016,1508,2012,504,33.42175066312998
Paranda,Onion,2016,70,574,504,720.0
Umared,Soybean,2015,3200,3704,504,15.75
Kada,Green Gram,2016,4600,5104,504,10.956521739130435
Pune-Pimpri,Walvad,2016,3143,3647,504,16.035634743875278
Chalisgaon,Wheat(Husked),2016,1497,2001,504,33.66733466933868
Pune-Manjri,Onion,2016,163,667,504,309.20245398773005
Karad,Potato,2016,1122,1626,504,44.919786096256686
Nandurbar,Bajri,2014,1030,1534,504,48.932038834951456
Shegaon,Gram,2015,4111,4615,504,12.259790805156896
Malkapur,GREEN GRAM,2016,4367,4871,504,11.5411037325395
Nagpur,Bottle Gourd,2016,696,1200,504,72.41379310344827
Vai,Ginger (Fresh),2016,3157,3661,504,15.964523281596453
Solapur,Gram,2016,3998,4502,504,12.606303151575787
Pune,Cabbage,2015,412,916,504,122.33009708737865
Khamgaon,Soybean,2016,3417,3921,504,14.749780509218613
Aurangabad,Flower,2016,987,1491,504,51.06382978723404
Sangali,Gram,2016,6805,7309,504,7.406318883174136
Kolhapur-Laxmipuri,Spilt Gerrn Gram,2016,9763,10267,504,5.162347639045375
Kalamb (Os),Pigeon Pea (Tur),2016,5445,5949,504,9.256198347107437
Rahata,CAPSICUM,2016,605,1109,504,83.30578512396694
Pimpalgaon Basawant,Onion,2016,353,857,504,142.77620396600565
Chandvad,Cucumber,2016,272,776,504,185.2941176470588
Telhara,Pigeon Pea (Tur),2016,7514,8018,504,6.707479371839233
Akola,Wheat(Husked),2015,1376,1880,504,36.627906976744185
Mumbai-Onion And Potato Mkt,Potato,2016,1214,1718,504,41.5156507413509
Shrirampur,Capsicum,2015,2396,2900,504,21.035058430717864
Devala,Onion,2016,828,1332,504,60.869565217391305
Nashik,Green Chilli,2016,1150,1654,504,43.82608695652174
Ahmednagar,Sorgum(Jawar),2015,1625,2129,504,31.015384615384615
Chandur Bajar,PIGEON PEA (TUR),2016,5252,5756,504,9.596344249809597
Nagpur,Bitter Gourd,2015,1673,2177,504,30.1255230125523
Karad,CLUSTER BEAN,2016,2196,2700,504,22.950819672131146
Pune-Moshi,Squash Gourd,2016,1365,1869,504,36.92307692307692
Hingoli,Ground Nut Pods (Dry),2016,5235,5739,504,9.627507163323783
Ashti (Wardha),Cotton,2015,3636,4139,503,13.833883388338833
Akola,Soybean,2016,3364,3867,503,14.95243757431629
Lasalgaon,Wheat(Husked),2015,1431,1934,503,35.150244584206845
Ratanagari,Coriander  ,2016,760,1263,503,66.1842105263158
Tumsar,Rice(Paddy-Hus),2015,2541,3044,503,19.795356158992522
Dhule,Wheat(Husked),2016,1540,2043,503,32.66233766233766
Murtizapur,Gram,2016,6243,6746,503,8.057023866730738
Tumsar,Rice(Paddy-Hus),2015,2864,3367,503,17.562849162011172
Pachora,Soybean,2016,3096,3599,503,16.246770025839794
Katol,Ground Nut Pods (Dry),2015,3579,4082,503,14.054205085219335
Dound,GRAM,2016,7715,8218,503,6.519766688269605
Babhulgaon,Soybean,2014,2857,3360,503,17.6058802940147
Shegaon,Pigeon Pea (Tur),2015,4505,5008,503,11.165371809100998
Jintur,Pigeon Pea (Tur),2014,3571,4074,503,14.08569028283394
Vai,Ginger (Fresh),2015,3267,3770,503,15.39638812366085
Hinganghat,Gram,2014,2158,2661,503,23.308619091751623
Sangali,Bajri,2014,1295,1798,503,38.84169884169884
Shrigonda,Sorgum(Jawar),2016,1641,2144,503,30.65204143814747
Washim-Ansing,Gram,2016,6003,6506,503,8.379143761452607
Dhule,Black Gram,2015,8038,8541,503,6.257775566061209
Khed-Chakan,Farshi,2015,3431,3934,503,14.660448848732148
Arvi,Pigeon Pea (Tur),2016,7600,8103,503,6.618421052631579
Pune,Cucumber,2016,385,888,503,130.64935064935065
Shrigonda,Lemon,2016,3212,3715,503,15.660024906600249
Pulgaon,Pigeon Pea (Tur),2015,6550,7053,503,7.679389312977099
Dound,Gram,2016,6166,6668,502,8.141420694129096
Shrirampur,Sorgum(Jawar),2015,1362,1864,502,36.8575624082232
Mumbai,Green Chilli,2016,3938,4440,502,12.747587607922803
Sinner,Bajri,2016,1485,1987,502,33.804713804713806
Varora,Soybean,2016,3031,3533,502,16.562190696139886
Mangrulpeer,Soybean,2015,2866,3368,502,17.51570132588974
Mumbai,Water Melon,2015,669,1171,502,75.0373692077728
Bhivandi,Rice(Paddy-Hus),2015,1599,2101,502,31.39462163852408
Bhokar,Pigeon Pea (Tur),2016,8358,8860,502,6.006221584111032
Satana,Bajri,2016,1563,2065,502,32.11772232885477
Shrirampur,Wheat(Husked),2016,1513,2015,502,33.17911434236616
Sangali,Gram,2015,3973,4475,502,12.635288195318399
Nanded,Ground Nut Pods (Dry),2015,4769,5271,502,10.526315789473685
Alibag,Coconut,2016,1603,2105,502,31.316281971303805
Dhule,Matki,2014,5279,5781,502,9.509376775904528
Lonand,Onion,2016,313,815,502,160.38338658146964
Jalna,Bajri,2014,1108,1610,502,45.30685920577617
Lasalgaon,Horse Gram,2016,2500,3001,501,20.04
Ambad(Vadi Godri),Maize,2016,1850,2351,501,27.08108108108108
Lasalgaon,Ground Nut Pods (Dry),2016,5100,5601,501,9.823529411764707
Pathardi,Wheat(Husked),2014,1621,2122,501,30.906847624922886
Chopda,Pigeon Pea (Tur),2015,6700,7201,501,7.477611940298507
Jintur,Gram,2015,3299,3800,501,15.186420127311306
Sinner,Green Gram,2014,6146,6647,501,8.151643345265214
Pathardi,Black Gram,2016,6533,7034,501,7.66875861013317
Ausa,PIGEON PEA (TUR),2016,4500,5001,501,11.133333333333333
Shegaon,Green Gram,2015,7439,7940,501,6.734776179594031
Chandur Bajar,Gram,2015,2600,3101,501,19.26923076923077
Yeotmal,Pigeon Pea (Tur),2014,4345,4846,501,11.530494821634061
Chandur Bajar,Soybean,2015,2771,3272,501,18.080115481775533
Pune,Wheat(Husked),2015,2194,2695,501,22.835004557885142
Kej,Bajri,2015,1308,1809,501,38.30275229357798
Baramati,Gram,2014,2000,2501,501,25.05
Dudhani,Sorgum(Jawar),2014,985,1486,501,50.86294416243655
Khamgaon,LEMON,2016,188,689,501,266.48936170212767
Junnar-Otur,ONION,2016,629,1130,501,79.65023847376789
Baramati,Gram,2014,2300,2801,501,21.782608695652176
Kalamb (Yawatmal),Gram,2016,5033,5533,500,9.934432743890325
Rahata,Garlic,2015,2692,3192,500,18.573551263001487
Aurangabad,Sweet Potato,2015,1000,1500,500,50.0
Aurangabad,Kharbuj,2015,1750,2250,500,28.571428571428573
Aurangabad,Sweet Potato,2015,1000,1500,500,50.0
Hingoli,Pigeon Pea (Tur),2014,4205,4705,500,11.890606420927467
Ahmednagar,Bottle Gourd,2015,500,1000,500,100.0
Vai,Sweet Potato,2016,1500,2000,500,33.333333333333336
Sangamner,Flower,2015,500,1000,500,100.0
Vai,Small Gourd,2016,1500,2000,500,33.333333333333336
Jalgaon,Chikoo,2016,1133,1633,500,44.1306266548985
Vai,SPINACH,2016,1000,1500,500,50.0
Nagpur,Fenugreek,2016,3000,3500,500,16.666666666666668
Nagpur,Ambat Chuka,2016,1000,1500,500,50.0
Sangamner,Flower,2015,1000,1500,500,50.0
Aurangabad,Sweet Potato,2015,2000,2500,500,25.0
Ramtek,Green Peas (Dry),2016,1567,2067,500,31.90810465858328
Aurangabad,Kharbuj,2015,1500,2000,500,33.333333333333336
Mumbai-Fruit Market,Mango,2016,3000,3500,500,16.666666666666668
Hingna,Pigeon Pea (Tur),2016,7600,8100,500,6.578947368421052
Nashik,Methi (Bhaji),2015,217,717,500,230.4147465437788
Kamthi,Brinjal,2015,593,1093,500,84.31703204047217
Sailu,Pigeon Pea (Tur),2016,7734,8234,500,6.464959917248513
Ahmednagar,Tomato,2015,500,1000,500,100.0
Raver,Gram,2015,3179,3679,500,15.728216420257942
Manora,Green Gram,2016,5200,5700,500,9.615384615384615
Nagpur,Chavli (Pala),2016,1000,1500,500,50.0
Dhule,Green Chilli,2016,3300,3800,500,15.151515151515152
Dhule,Cucumber,2016,1500,2000,500,33.333333333333336
Patan,Ghevda,2014,2000,2500,500,25.0
Vai,Pavata,2015,2400,2900,500,20.833333333333332
Tasgaon,Gram,2016,7000,7500,500,7.142857142857143
Vai,Pavata,2015,3000,3500,500,16.666666666666668
Vai,Pavata,2015,3100,3600,500,16.129032258064516
Shrirampur,Capsicum,2014,1523,2023,500,32.829940906106366
Ahmednagar,BOTTLE GOURD,2016,225,725,500,222.22222222222223
Patan,Bitter Gourd,2014,2500,3000,500,20.0
Patan,Bitter Gourd,2014,2500,3000,500,20.0
Shrirampur,Chikoo,2014,1500,2000,500,33.333333333333336
Ahmednagar,Soybean,2015,2900,3400,500,17.24137931034483
Indapur,Onion,2016,108,608,500,462.962962962963
Patan,Bitter Gourd,2015,2500,3000,500,20.0
Rahata,Bor,2014,2000,2500,500,25.0
Shrirampur,Brinjal,2015,1000,1500,500,50.0
Manora,Green Gram,2015,5075,5575,500,9.852216748768473
Manora,Ground Nut Pods (Dry),2015,5000,5500,500,10.0
Patan,Bitter Gourd,2015,2000,2500,500,25.0
Vadgaon Peth,Ginger (Fresh),2016,2500,3000,500,20.0
Shrirampur,Chikoo,2014,1500,2000,500,33.333333333333336
Rahata,Brinjal,2014,1377,1877,500,36.31082062454612
Koregaon,Green Gram,2015,6500,7000,500,7.6923076923076925
Koregaon,Green Gram,2015,6000,6500,500,8.333333333333334
Tasgaon,Gram,2016,5200,5700,500,9.615384615384615
Amarawati,Orange,2015,1000,1500,500,50.0
Patan,Pavtta,2014,2500,3000,500,20.0
Pune-Moshi,GINGER (FRESH),2016,1820,2320,500,27.47252747252747
Dhule,Bitter Gourd,2016,3000,3500,500,16.666666666666668
Ahmednagar,Bajri,2016,1550,2050,500,32.25806451612903
Indapur-Bhigwan,Pigeon Pea (Tur),2016,5050,5550,500,9.900990099009901
Rahata,Shevga,2014,2857,3357,500,17.50087504375219
Shrigonda,Sorgum(Jawar),2016,1833,2333,500,27.277686852154936
Rahata,Potato,2014,2000,2500,500,25.0
Shrirampur,Capsicum,2015,2000,2500,500,25.0
Shrirampur,Capsicum,2015,1200,1700,500,41.666666666666664
Parshiwani,Pigeon Pea (Tur),2016,6860,7360,500,7.288629737609329
Shrigonda,Pigeon Pea (Tur),2016,6460,6960,500,7.739938080495356
Vai,Pavtta,2015,3500,4000,500,14.285714285714286
Shrirampur,Capsicum,2015,1500,2000,500,33.333333333333336
Vai,Pavtta,2015,3500,4000,500,14.285714285714286
Amarawati,Ginger (Fresh),2016,2833,3333,500,17.649135192375574
Amarawati,Green Chilli,2016,4313,4813,500,11.592858798979828
Vai,Ridge Gourd,2015,3350,3850,500,14.925373134328359
Nagpur,Sorgum(Jawar),2016,1500,2000,500,33.333333333333336
Jalgaon,Green-Peas,2015,2700,3200,500,18.51851851851852
Shrirampur,Capsicum,2015,1658,2158,500,30.156815440289506
Ahmednagar,Bottle Gourd,2016,333,833,500,150.15015015015015
Pune,Dhemse,2015,1000,1500,500,50.0
Pune-Moshi,Chavli (Pala),2016,2000,2500,500,25.0
Rahata,Garlic,2014,2455,2955,500,20.36659877800407
Mantha,Green Gram,2015,6750,7250,500,7.407407407407407
Pune-Pimpri,Cluster Bean,2015,3833,4333,500,13.044612575006523
Indapur,Chillies(Red),2016,9000,9500,500,5.555555555555555
Shrirampur,GUAVA,2016,1500,2000,500,33.333333333333336
Pathardi,Gram,2015,3800,4300,500,13.157894736842104
Mantha,BLACK GRAM,2016,5475,5975,500,9.132420091324201
Sillod,Green Gram,2015,8000,8500,500,6.25
Aarni,Pigeon Pea (Tur),2015,6500,7000,500,7.6923076923076925
Amarawati,Bor,2016,1600,2100,500,31.25
Partur,Green Gram,2015,6825,7325,500,7.326007326007326
Pathardi,Green Gram,2015,6750,7250,500,7.407407407407407
Nagpur,Sorgum(Jawar),2016,1500,2000,500,33.333333333333336
Pune-Pimpri,Arvi,2016,2500,3000,500,20.0
Koregaon,Turmeric,2015,6000,6500,500,8.333333333333334
Koregaon,Sorgum(Jawar),2016,1600,2100,500,31.25
Vai,Ridge Gourd,2015,3375,3875,500,14.814814814814815
Patan,Cluster Bean,2016,3000,3500,500,16.666666666666668
Solapur,Guava,2016,1000,1500,500,50.0
Junnar (Narayangaon),Shepu,2016,201,701,500,248.75621890547265
Patan,Cluster Bean,2016,3250,3750,500,15.384615384615385
Shrirampur,Shevga,2014,2000,2500,500,25.0
Shrirampur,Shevga,2014,1625,2125,500,30.76923076923077
Patan,Cluster Bean,2016,3000,3500,500,16.666666666666668
Amalner,SESAMUM,2016,4275,4775,500,11.695906432748538
Patan,Cucumber,2016,1000,1500,500,50.0
Amalner,Sesamum,2016,5717,6217,500,8.745845723281441
Ulhasnagar,Onion,2016,944,1444,500,52.96610169491525
Patan,Capsicum,2016,3000,3500,500,16.666666666666668
Manchar,Wal Papdi,2016,2500,3000,500,20.0
Pune-Moshi,Ground Nut Pods (Dry),2016,3625,4125,500,13.793103448275861
Shrirampur,Bor,2015,1500,2000,500,33.333333333333336
Junnar,Potato,2016,1500,2000,500,33.333333333333336
Patan,Cucumber,2016,1500,2000,500,33.333333333333336
Amarawati,Awala,2014,3000,3500,500,16.666666666666668
Shrirampur,Water Melon,2014,1000,1500,500,50.0
Junnar (Alephata),POTATO,2016,350,850,500,142.85714285714286
Shrirampur,Ginger (Fresh),2016,1478,1978,500,33.82949932341001
Shrirampur,Ginger (Fresh),2016,2868,3368,500,17.433751743375176
Shrirampur,Bitter Gourd,2015,2500,3000,500,20.0
Raver,Green Gram,2015,5350,5850,500,9.345794392523365
Patan,Ghevda,2016,3000,3500,500,16.666666666666668
Shrirampur,Ginger (Fresh),2016,1614,2114,500,30.97893432465923
Patan,LADIES FINGER,2016,2417,2917,500,20.68680182043856
Shrirampur,Bitter Gourd,2015,3500,4000,500,14.285714285714286
Patan,GHEVDA,2016,2500,3000,500,20.0
Junnar (Narayangaon),Coriander  ,2016,350,850,500,142.85714285714286
Amalner,Green Gram,2016,5925,6425,500,8.438818565400844
Shrirampur,Sweet Potato,2014,2000,2500,500,25.0
Patan,Green Peas (Dry),2016,2500,3000,500,20.0
Junnar-Otur,Farshi,2015,1500,2000,500,33.333333333333336
Ratanagari,Onion,2016,1500,2000,500,33.333333333333336
Alibag,Rice(Paddy-Hus),2016,3500,4000,500,14.285714285714286
Patan,Cluster Bean,2015,2000,2500,500,25.0
Kurdwadi,Lemon,2015,100,600,500,500.0
Patan,Ghevda,2015,2000,2500,500,25.0
Patan,Flower,2015,981,1481,500,50.9683995922528
Solapur,Guava,2016,2000,2500,500,25.0
Shrirampur,Ground Nut Pods (Dry),2014,3500,4000,500,14.285714285714286
Shrirampur,Green Chilli,2014,2250,2750,500,22.22222222222222
Jalgaon,Chikoo,2015,1300,1800,500,38.46153846153846
Patan,Ghevda,2015,3000,3500,500,16.666666666666668
Patan,Cluster Bean,2015,3000,3500,500,16.666666666666668
Vai,Ladies Finger,2015,3500,4000,500,14.285714285714286
Vadgaon Peth,GHEVDA,2016,800,1300,500,62.5
Patan,Cluster Bean,2015,2125,2625,500,23.529411764705884
Dhule,Spinach,2016,1500,2000,500,33.333333333333336
Amarawati,Ground Nut Pods (Dry),2015,3986,4486,500,12.54390366281987
Patan,Squash Gourd,2016,3500,4000,500,14.285714285714286
Murud,Rice(Paddy-Hus),2016,2500,3000,500,20.0
Kurdwadi,Lemon,2016,100,600,500,500.0
Shrirampur,Sweet Potato,2016,1750,2250,500,28.571428571428573
Patan,Bitter Gourd,2016,3100,3600,500,16.129032258064516
Indapur-Bhigwan,Green Peas (Dry),2015,1400,1900,500,35.714285714285715
Kurdwadi,GRAM,2016,5450,5950,500,9.174311926605505
Vai,Green Chilli,2015,2667,3167,500,18.747656542932134
Junnar-Otur,Bottle Gourd,2016,700,1200,500,71.42857142857143
Patan,Ladies Finger,2015,3250,3750,500,15.384615384615385
Patan,Green Peas (Dry),2015,3000,3500,500,16.666666666666668
Jalgaon,Carrot,2015,859,1359,500,58.20721769499418
Ahmednagar,Pigeon Pea (Tur),2015,5500,6000,500,9.090909090909092
Patan,Pavtta,2016,3500,4000,500,14.285714285714286
Vadgaon Peth,Cucumber,2016,750,1250,500,66.66666666666667
Shrirampur,Sweet Potato,2016,1500,2000,500,33.333333333333336
Shrirampur,Sweet Potato,2016,1250,1750,500,40.0
Aarni,Pigeon Pea (Tur),2014,4300,4800,500,11.627906976744185
Vai,Ridge Gourd,2015,2500,3000,500,20.0
Vai,Ridge Gourd,2015,2318,2818,500,21.570319240724764
Aurangabad,Grapes,2015,3000,3500,500,16.666666666666668
Nashik,Carrot,2015,600,1100,500,83.33333333333333
Manchar,Shevga,2016,2000,2500,500,25.0
Ahmednagar,Maize(Corn.),2016,1000,1500,500,50.0
Sillod-Bharadi,Gram,2016,5400,5900,500,9.25925925925926
Sangli-Phale Bhajipalam,Papai,2016,219,719,500,228.31050228310502
Kolhapur,Wood Apple,2015,2000,2500,500,25.0
Vai,Cabbage,2016,2063,2563,500,24.236548715462916
Vai,Coriander  ,2016,1500,2000,500,33.333333333333336
Akole,Wheat(Husked),2015,1475,1975,500,33.898305084745765
Ramtek,Guava,2015,1500,2000,500,33.333333333333336
Ahmednagar,Matki,2016,7000,7500,500,7.142857142857143
Arvi,Pigeon Pea (Tur),2015,6800,7300,500,7.352941176470588
Shirpur,Sunflower,2015,2550,3050,500,19.607843137254903
Kalamb (Os),Sorgum(Jawar),2015,1591,2091,500,31.426775612822123
Pune-Pimpri,Bitter Gourd,2015,3417,3917,500,14.63271875914545
Panvel,Bitter Gourd,2015,3375,3875,500,14.814814814814815
Akole,Wheat(Husked),2015,1460,1960,500,34.24657534246575
Vadgaon Peth,Cucumber,2015,660,1160,500,75.75757575757575
Ramtek,Mango,2015,1500,2000,500,33.333333333333336
Umarkhed-Danki,Gram,2014,2600,3100,500,19.23076923076923
Ratanagari,French Bean,2016,3000,3500,500,16.666666666666668
Sillod-Bharadi,Black Gram,2016,5625,6125,500,8.88888888888889
Akole,Gram,2016,3300,3800,500,15.151515151515152
Akole,Bajri,2016,1460,1960,500,34.24657534246575
Umarkhed-Danki,Soybean,2014,3000,3500,500,16.666666666666668
Murbad,Bitter Gourd,2016,4600,5100,500,10.869565217391305
Akole,Wheat(Husked),2015,1475,1975,500,33.898305084745765
Kolhapur,Carrot,2016,1500,2000,500,33.333333333333336
Sillod-Bharadi,GREEN GRAM,2016,4200,4700,500,11.904761904761905
Anajngaon Surji,Black Gram,2016,7000,7500,500,7.142857142857143
Akole,BAJRI,2016,1450,1950,500,34.48275862068966
Pune-Pimpri,Ghevda,2015,2784,3284,500,17.95977011494253
Anajngaon Surji,Wheat(Husked),2016,1463,1963,500,34.17634996582365
Ashti (Wardha),Soybean,2016,3000,3500,500,16.666666666666668
Vai,French Bean,2016,2500,3000,500,20.0
Murbad,Bottle Gourd,2016,2500,3000,500,20.0
Umarkhed-Danki,Gram,2015,3680,4180,500,13.58695652173913
Aurangabad,Bitter Gourd,2015,3250,3750,500,15.384615384615385
Vai,Leafy Vegetable,2016,2000,2500,500,25.0
Vai,MATH (BHAJI),2016,1500,2000,500,33.333333333333336
Ramtek,Chavli (Shenga ),2015,1582,2082,500,31.605562579013906
Ahmednagar,Potato,2016,845,1345,500,59.171597633136095
Ratanagari,Carrot,2016,1500,2000,500,33.333333333333336
Vai,Pavata,2016,2250,2750,500,22.22222222222222
Solapur,Shepu,2016,800,1300,500,62.5
Vai,Pavtta,2016,2917,3417,500,17.14089818306479
Murum,Gram,2016,8900,9400,500,5.617977528089888
Kinwat,Gram,2016,6500,7000,500,7.6923076923076925
Aurangabad,Flower,2015,1033,1533,500,48.4027105517909
Rahata,Cluster Bean,2015,2250,2750,500,22.22222222222222
Vai,Ridge Gourd,2016,3250,3750,500,15.384615384615385
Ratanagari,Carrot,2016,2500,3000,500,20.0
Aurangabad,Wal Bhaji,2014,1275,1775,500,39.21568627450981
Ratanagari,Cluster Bean,2016,1500,2000,500,33.333333333333336
Vai,Green-Peas,2016,3500,4000,500,14.285714285714286
Pandharpur,LEMON,2016,500,1000,500,100.0
Akole,Soybean,2015,3000,3500,500,16.666666666666668
Ahmednagar,Cowpea,2015,5000,5500,500,10.0
Lasalgaon-Vinchur,Gram,2015,3951,4451,500,12.655024044545685
Ramtek,Cucumber,2015,1000,1500,500,50.0
Solapur,Ground Nut Pods (Dry),2014,3125,3625,500,16.0
Aurangabad,Chavli (Shenga ),2014,2500,3000,500,20.0
Ramtek,Cluster Bean,2015,1500,2000,500,33.333333333333336
Aurangabad,Guava,2014,1292,1792,500,38.69969040247678
Akole,Bajri,2015,1300,1800,500,38.46153846153846
Ahmednagar,Carrot,2015,500,1000,500,100.0
Akole,Bajri,2015,1350,1850,500,37.03703703703704
Jalgaon,Bitter Gourd,2016,2983,3483,500,16.761649346295677
Jintur,Gram,2016,7000,7500,500,7.142857142857143
Murbad,Bottle Gourd,2016,3000,3500,500,16.666666666666668
Akole,Paddy-Unhusked,2016,1475,1975,500,33.898305084745765
Amarawati,Linseed,2016,5500,6000,500,9.090909090909092
Amarawati-Fruit And Vegetables,Capsicum,2016,4833,5333,500,10.345541071798054
Shrirampur,Chikoo,2015,1000,1500,500,50.0
Kada,HORSE GRAM,2016,1676,2176,500,29.832935560859188
Amarawati-Fruit And Vegetables,Bitter Gourd,2016,3500,4000,500,14.285714285714286
Majalgaon,Wheat(Husked),2016,1667,2167,500,29.99400119976005
Ahmednagar,Carrot,2016,900,1400,500,55.55555555555556
Amarawati-Fruit And Vegetables,Bor,2016,1625,2125,500,30.76923076923077
Amarawati-Fruit And Vegetables,Chavli (Shenga ),2016,2000,2500,500,25.0
Vai,Tomato,2015,2646,3146,500,18.89644746787604
Nagpur,CUSTARD APPLE,2016,1167,1667,500,42.84490145672665
Ramtek,Cluster Bean,2016,1500,2000,500,33.333333333333336
Kolhapur-Laxmipuri,Split Black Gram,2015,8500,9000,500,5.882352941176471
Amarawati-Fruit And Vegetables,Cluster Bean,2016,4000,4500,500,12.5
Nagpur,Wal Bhaji,2016,3167,3667,500,15.787811809283234
Umarkhed,Soybean,2015,3000,3500,500,16.666666666666668
Shrirampur,Chikoo,2015,1500,2000,500,33.333333333333336
Shrirampur,Chikoo,2015,1000,1500,500,50.0
Murbad,Tomato,2016,2500,3000,500,20.0
Manchar,Wal Papdi,2015,2500,3000,500,20.0
Murtizapur,Pigeon Pea (Tur),2015,6814,7314,500,7.33783387144115
Kolhapur-Laxmipuri,Spilt Pigeon Pea,2016,11700,12200,500,4.273504273504273
Vai,Shevga,2015,2500,3000,500,20.0
Vai,Shevga,2015,3500,4000,500,14.285714285714286
Shrirampur,Squash Gourd,2016,3500,4000,500,14.285714285714286
Dhule,Cowpea,2015,3481,3981,500,14.363688595231256
Ulhasnagar,BAJRI,2016,1585,2085,500,31.545741324921135
Shrirampur,Chikoo,2015,1000,1500,500,50.0
Amarawati,Naspatti ,2016,2000,2500,500,25.0
Amarawati,Onion,2016,655,1155,500,76.33587786259542
Shrirampur,Chikoo,2015,1738,2238,500,28.768699654775602
Shrirampur,Chikoo,2015,1313,1813,500,38.08073115003808
Amarawati,Papai,2016,1400,1900,500,35.714285714285715
Vai,Snake Gourd,2015,1500,2000,500,33.333333333333336
Kada,Soybean,2016,3000,3500,500,16.666666666666668
Amarawati-Fruit And Vegetables,Ginger (Fresh),2016,2500,3000,500,20.0
Akole,Paddy-Unhusked,2016,1500,2000,500,33.333333333333336
Nagpur,Bitter Gourd,2016,2333,2833,500,21.43163309044149
Murbad,Capsicum,2016,4000,4500,500,12.5
Pune,Pumpkin,2015,1421,1921,500,35.186488388458834
Ambejogai,Pigeon Pea (Tur),2015,6700,7200,500,7.462686567164179
Ambejogai,Sesamum,2015,6500,7000,500,7.6923076923076925
Dondaicha,Ground Nut Pods (Dry),2015,4306,4806,500,11.61170459823502
Sillod-Bharadi,BLACK GRAM,2016,4500,5000,500,11.11111111111111
Akole,Soybean,2016,3300,3800,500,15.151515151515152
Ahmednagar,Green Peas (Dry),2016,9500,10000,500,5.2631578947368425
Umarkhed,Soybean,2014,3000,3500,500,16.666666666666668
Umarkhed,Pigeon Pea (Tur),2014,3800,4300,500,13.157894736842104
Manchar,Carrot,2015,2500,3000,500,20.0
Paranda,Black Gram,2016,6100,6600,500,8.19672131147541
Akole,Paddy-Unhusked,2016,1500,2000,500,33.333333333333336
Akole,Paddy-Unhusked,2016,1500,2000,500,33.333333333333336
Pune,Potato,2015,574,1074,500,87.10801393728222
Jalgaon,Papai,2015,860,1360,500,58.13953488372093
Amarawati-Fruit And Vegetables,Green Chilli,2016,4000,4500,500,12.5
Kada (Ashti),GREEN GRAM,2016,4200,4700,500,11.904761904761905
Kolhapur-Laxmipuri,Cowpea,2015,5500,6000,500,9.090909090909092
Kolhapur-Laxmipuri,Spilt Pigeon Pea,2014,6000,6500,500,8.333333333333334
Pune,Lentil,2015,7057,7557,500,7.085163667280714
Pune,Parwar,2014,2750,3250,500,18.181818181818183
Kolhapur-Laxmipuri,Green Gram,2014,7300,7800,500,6.8493150684931505
Kolhapur-Laxmipuri,Green Gram,2014,5500,6000,500,9.090909090909092
Tuljapur,Turmeric,2015,6075,6575,500,8.23045267489712
Umarkhed,Gram,2015,3800,4300,500,13.157894736842104
Umarkhed,Pigeon Pea (Tur),2015,5500,6000,500,9.090909090909092
Sillod,Pigeon Pea (Tur),2016,6500,7000,500,7.6923076923076925
Murbad,Ghosali(Bhaji),2016,1600,2100,500,31.25
Manchar,Small Gourd,2016,1500,2000,500,33.333333333333336
Dondaicha,Chillies(Red),2015,2151,2651,500,23.245002324500234
Jalgaon,Orange,2015,700,1200,500,71.42857142857143
Jalgaon,Coriander (Dry),2016,6438,6938,500,7.766387076731904
Mumbai,Jaggery,2016,4074,4574,500,12.272950417280315
Kalyan,Guava,2016,3500,4000,500,14.285714285714286
Nagpur,Sorgum(Jawar),2015,1500,2000,500,33.333333333333336
Nagpur,Ambat Chuka,2015,1000,1500,500,50.0
Solapur,Bor,2016,1100,1600,500,45.45454545454545
Lasur Station,Thymol/Lovage,2015,8500,9000,500,5.882352941176471
Mumbai,Bajri,2014,1500,2000,500,33.333333333333336
Barshi,CORIANDER ,2016,400,900,500,125.0
Mumbai,Chavli (Shenga ),2015,1800,2300,500,27.77777777777778
Nagpur,Sorgum(Jawar),2015,1500,2000,500,33.333333333333336
Mumbai,Chikoo,2015,995,1495,500,50.25125628140704
Nagpur,Coriander (Dry),2015,9000,9500,500,5.555555555555555
Nagpur,Sorgum(Jawar),2015,1500,2000,500,33.333333333333336
Pune,Chikoo,2014,4500,5000,500,11.11111111111111
Nagpur,Sorgum(Jawar),2015,1500,2000,500,33.333333333333336
Varora,Gram,2016,6500,7000,500,7.6923076923076925
Shahapur,Brinjal,2016,1900,2400,500,26.31578947368421
Palus,Green Chilli,2016,1025,1525,500,48.78048780487805
Mumbai,Jaggery,2016,3396,3896,500,14.723203769140165
Vadgaon Peth,Onion,2015,1500,2000,500,33.333333333333336
Nagpur,Coriander (Dry),2015,8500,9000,500,5.882352941176471
Shahapur,Brinjal,2016,1750,2250,500,28.571428571428573
Rahata,Small Gourd,2016,2500,3000,500,20.0
Kalyan,Ghevda,2015,2722,3222,500,18.368846436443793
Pune-Moshi,WAL BHAJI,2016,2000,2500,500,25.0
Akhadabalapur,Turmeric,2015,6000,6500,500,8.333333333333334
Lonar,Green Gram,2015,6500,7000,500,7.6923076923076925
Karad,Sweet Potato,2016,1000,1500,500,50.0
Kalyan,Gr.Nut Kernels,2015,8500,9000,500,5.882352941176471
Kalyan,Gr.Nut Kernels,2015,6500,7000,500,7.6923076923076925
Akluj,Ladies Finger,2015,1392,1892,500,35.91954022988506
Karad,Snake Gourd,2016,3000,3500,500,16.666666666666668
Kalyan,Sorgum(Jawar),2016,2100,2600,500,23.80952380952381
Ratanagari,Carrot,2015,2500,3000,500,20.0
Ghansawangi,Pigeon Pea (Tur),2015,5000,5500,500,10.0
Lonar,Green Gram,2015,6500,7000,500,7.6923076923076925
Chandrapur-Ganjwad,Bitter Gourd,2016,1000,1500,500,50.0
Palus,Flower,2016,533,1033,500,93.80863039399625
Sangali,CORIANDER (DRY),2016,6500,7000,500,7.6923076923076925
Shahapur,Ghosali(Bhaji),2016,2500,3000,500,20.0
Ratanagari,Sweet Potato,2016,1500,2000,500,33.333333333333336
Ratanagari,Ground Nut Pods (Dry),2015,4000,4500,500,12.5
Buldhana,Wheat(Husked),2014,1300,1800,500,38.46153846153846
Shrirampur,Green Chilli,2015,1825,2325,500,27.397260273972602
Nagpur,Coriander (Dry),2015,6071,6571,500,8.23587547356284
Gondpimpri,Gram,2016,4000,4500,500,12.5
Vita,Onion,2014,1200,1700,500,41.666666666666664
Shrirampur,ORANGE,2016,1500,2000,500,33.333333333333336
Shrirampur,Mosambi,2016,2250,2750,500,22.22222222222222
Ghansawangi,Green Gram,2016,4000,4500,500,12.5
Akhadabalapur,Pigeon Pea (Tur),2016,8000,8500,500,6.25
Kalyan,Cluster Bean,2015,4000,4500,500,12.5
Chandrapur-Ganjwad,Spinach,2015,700,1200,500,71.42857142857143
Palus,Flower,2016,2000,2500,500,25.0
Mumbai,Ground Nut Pods (Dry),2016,4500,5000,500,11.11111111111111
Khamgaon,Ground Nut Pods (Dry),2016,4500,5000,500,11.11111111111111
Mahagaon,Pigeon Pea (Tur),2016,7900,8400,500,6.329113924050633
Buldhana,Green Gram,2014,6500,7000,500,7.6923076923076925
Chandrapur-Ganjwad,BITTER GOURD,2016,1000,1500,500,50.0
Ghansawangi,Wheat(Husked),2015,1583,2083,500,31.585596967782692
Nagpur,Coriander (Dry),2015,8500,9000,500,5.882352941176471
Shahapur,Cucumber,2016,1514,2014,500,33.02509907529723
Umared,Wheat(Husked),2016,1586,2086,500,31.525851197982345
Shahapur,Cluster Bean,2016,4125,4625,500,12.121212121212121
Osmanabad,Shevga,2016,500,1000,500,100.0
Ratanagari,Green-Peas,2015,3000,3500,500,16.666666666666668
Jamkhed,Wheat(Husked),2016,1600,2100,500,31.25
Buldhana,Black Gram,2014,4500,5000,500,11.11111111111111
Karad,Ridge Gourd,2016,2000,2500,500,25.0
Akluj,Chikoo,2015,1358,1858,500,36.81885125184094
Barshi,LEMON,2016,1588,2088,500,31.486146095717885
Shahapur,Ridge Gourd,2015,3000,3500,500,16.666666666666668
Solapur,Ghevda,2015,1000,1500,500,50.0
Ratanagari,Bitter Gourd,2015,2667,3167,500,18.747656542932134
Kalyan,Indian Bean,2015,4500,5000,500,11.11111111111111
Chandrapur-Ganjwad,Capsicum,2015,1750,2250,500,28.571428571428573
Chandrapur-Ganjwad,Capsicum,2015,2000,2500,500,25.0
Karad,Ground Nut Pods (Dry),2016,2500,3000,500,20.0
Shrirampur,Mango(Raw),2016,1500,2000,500,33.333333333333336
Ratanagari,Bitter Gourd,2015,2833,3333,500,17.649135192375574
Barshi,Harbara(Bhaji),2016,6000,6500,500,8.333333333333334
Barshi,KHARBUJ,2016,1000,1500,500,50.0
Kalyan,Ladies Finger,2015,3500,4000,500,14.285714285714286
Ratanagari,Grapes,2015,5000,5500,500,10.0
Barshi,LADIES FINGER,2016,1125,1625,500,44.44444444444444
Chalisgaon,Black Gram,2015,5000,5500,500,10.0
Indapur-Bhigwan,Ground Nut Pods (Dry),2015,4225,4725,500,11.834319526627219
Navapur,Flower,2016,2250,2750,500,22.22222222222222
Pune-Manjri,Guava,2016,2500,3000,500,20.0
Shahapur,Mango(Raw),2015,2000,2500,500,25.0
Lonar,Black Gram,2015,5500,6000,500,9.090909090909092
Akhadabalapur,Pigeon Pea (Tur),2016,7438,7938,500,6.7222371605270235
Akluj,Chillies(Red),2015,1500,2000,500,33.333333333333336
Khed (Shel Pimpalgaon),Brinjal,2015,1425,1925,500,35.08771929824562
Kalyan,Mango,2015,4500,5000,500,11.11111111111111
Shrirampur,Ginger (Fresh),2015,3175,3675,500,15.748031496062993
Barshi,Methi (Bhaji),2016,500,1000,500,100.0
Pune-Moshi,Walvad,2016,3250,3750,500,15.384615384615385
Karad,Cluster Bean,2016,2900,3400,500,17.24137931034483
Khed (Shel Pimpalgaon),Cluster Bean,2015,3606,4106,500,13.865779256794232
Karad,Chikoo,2016,1207,1707,500,41.42502071251035
Chopda,Green Gram,2015,5905,6405,500,8.467400508044031
Pandharkawada,Pigeon Pea (Tur),2015,5500,6000,500,9.090909090909092
Chandrapur-Ganjwad,Jack Fruit(Raw),2015,1500,2000,500,33.333333333333336
Kalyan,Green Gram,2015,6600,7100,500,7.575757575757576
Kalyan,Green Chilli,2015,2500,3000,500,20.0
Ghansawangi,Wheat(Husked),2014,1300,1800,500,38.46153846153846
Palus,Ladies Finger,2016,1550,2050,500,32.25806451612903
Barshi,Coriander  ,2016,500,1000,500,100.0
Pune,Curry Leaves,2016,1500,2000,500,33.333333333333336
Satara,Bitter Gourd,2016,3821,4321,500,13.08557969118032
Karad,Pavtta,2016,3000,3500,500,16.666666666666668
Hadgaon,Gram,2015,3800,4300,500,13.157894736842104
Ratanagari,Carrot,2015,1800,2300,500,27.77777777777778
Karad,Pavtta,2016,2667,3167,500,18.747656542932134
Palus,Squash Gourd,2016,2500,3000,500,20.0
Akhadabalapur,Turmeric,2015,7000,7500,500,7.142857142857143
Kalyan,Sorgum(Jawar),2016,1850,2350,500,27.027027027027028
Karad,Pavata,2016,6000,6500,500,8.333333333333334
Pune,Curry Leaves,2016,1500,2000,500,33.333333333333336
Mumbai,Melon,2015,1568,2068,500,31.887755102040817
Osmanabad,Onion,2016,600,1100,500,83.33333333333333
Palus,Tomato,2016,625,1125,500,80.0
Akhadabalapur,Turmeric,2015,5750,6250,500,8.695652173913043
Osmanabad,Math (Bhaji),2016,1050,1550,500,47.61904761904762
Karad,Melon,2016,2000,2500,500,25.0
Kalyan,Green-Peas,2015,5000,5500,500,10.0
Pandharkawada,Gram,2014,1900,2400,500,26.31578947368421
Osmanabad,Lemon,2016,3500,4000,500,14.285714285714286
Umarkhed-Danki,Pigeon Pea (Tur),2015,5500,6000,500,9.090909090909092
Barshi,Ghevda,2016,2069,2569,500,24.16626389560174
Akluj,Ground Nut Pods (Dry),2015,4100,4600,500,12.195121951219512
Chandrapur-Ganjwad,Chavli (Pala),2015,700,1200,500,71.42857142857143
Pune-Manjri,Chavli (Pala),2015,950,1450,500,52.63157894736842
Umared,Soybean,2015,3214,3714,500,15.556938394523957
Palus,Flower,2016,1150,1650,500,43.47826086956522
Pune-Pimpri,Garlic,2016,6000,6500,500,8.333333333333334
Buldhana,Black Gram,2015,7000,7500,500,7.142857142857143
Ratanagari,Shevga,2015,1500,2000,500,33.333333333333336
Nagpur,Coriander (Dry),2015,8500,9000,500,5.882352941176471
Ratanagari,Sweet Potato,2015,1000,1500,500,50.0
Akluj,Lemon,2016,500,1000,500,100.0
Jalgaon Jamod,Gram,2016,4500,5000,500,11.11111111111111
Pune,Dhemse,2014,2500,3000,500,20.0
Ratanagari,Snake Gourd,2015,2000,2500,500,25.0
Chandrapur-Ganjwad,Spinach,2016,1500,2000,500,33.333333333333336
Manchar,Capsicum,2016,1100,1600,500,45.45454545454545
Chandrapur-Ganjwad,Small Gourd,2016,1000,1500,500,50.0
Shrirampur,Shevga,2015,3500,4000,500,14.285714285714286
Ratanagari,Snake Gourd,2015,500,1000,500,100.0
Shrirampur,Potato,2016,1000,1500,500,50.0
Katol,Mosambi,2016,1433,1933,500,34.89183531053733
Akluj,Ghevda,2016,1000,1500,500,50.0
Satara,Ground Nut Pods (Dry),2016,4000,4500,500,12.5
Manchar,Ladies Finger,2016,500,1000,500,100.0
Rahata,Green Chilli,2016,500,1000,500,100.0
Shrirampur,Papai,2016,1400,1900,500,35.714285714285715
Shrirampur,Papai,2016,1000,1500,500,50.0
Kalyan,Brinjal,2014,3000,3500,500,16.666666666666668
Ratanagari,Pavtta,2015,2000,2500,500,25.0
Vadgaon Peth,Bottle Gourd,2015,500,1000,500,100.0
Rahata,Green Peas (Dry),2016,1800,2300,500,27.77777777777778
Rahata,Green Peas (Dry),2016,4000,4500,500,12.5
Achalpur,Sesamum,2015,8000,8500,500,6.25
Ratanagari,Snake Gourd,2014,1000,1500,500,50.0
Barshi,Coriander  ,2015,500,1000,500,100.0
Chandrapur-Ganjwad,Pappaya (Bhaji),2016,1000,1500,500,50.0
Kalyan,Cluster Bean,2014,3250,3750,500,15.384615384615385
Barshi,Coriander  ,2015,300,800,500,166.66666666666666
Ratanagari,Bottle Gourd,2016,2000,2500,500,25.0
Shrirampur,Papai,2015,1000,1500,500,50.0
Vita,Onion,2016,433,933,500,115.47344110854503
Shrirampur,Brinjal,2016,1400,1900,500,35.714285714285715
Wardha,Pigeon Pea (Tur),2016,8226,8726,500,6.078288353999514
Manchar,Maize(Corn.),2016,500,1000,500,100.0
Satara,Potato,2016,900,1400,500,55.55555555555556
Baramati,Gram,2016,5384,5884,500,9.286775631500744
Akluj,SHEPU,2016,1000,1500,500,50.0
Pune-Pimpri,Capsicum,2016,3125,3625,500,16.0
Nashik,Melon,2016,400,900,500,125.0
Nashik,Melon,2016,333,833,500,150.15015015015015
Nagpur,Ground Nut Pods (Dry),2014,3327,3827,500,15.028554253080854
Umarkhed-Danki,Gram,2016,4000,4500,500,12.5
Lasur Station,Wheat(Husked),2016,1527,2027,500,32.74394237066143
Ratanagari,Wal Papdi,2015,2000,2500,500,25.0
Rahata,Capsicum,2016,1000,1500,500,50.0
Ratanagari,Wal Papdi,2015,2000,2500,500,25.0
Ratanagari,Sweet Potato,2016,1000,1500,500,50.0
Pune,Beet Root,2016,418,918,500,119.61722488038278
Satara,Capsicum,2015,2706,3206,500,18.477457501847745
Solapur,Bor,2015,550,1050,500,90.9090909090909
Ghoti,Cucumber,2016,1500,2000,500,33.333333333333336
Mumbai,Cluster Bean,2016,1628,2128,500,30.71253071253071
Buldhana-Dhad,Gram,2016,4500,5000,500,11.11111111111111
Baramati,Sunflower,2015,3201,3701,500,15.620118712902219
Buldhana-Dhad,Gram,2016,5433,5933,500,9.203018590097551
Navapur,Wal Papdi,2016,2615,3115,500,19.120458891013385
Ramtek,Small Gourd,2016,1000,1500,500,50.0
Navapur,Wal Papdi,2016,3682,4182,500,13.579576317218903
Ratanagari,Bottle Gourd,2016,1000,1500,500,50.0
Rahata,GREEN PEAS (DRY),2016,3000,3500,500,16.666666666666668
Sangali,Castor Seed,2014,2800,3300,500,17.857142857142858
Bhokar,Turmeric,2016,6125,6625,500,8.16326530612245
Akluj,CLUSTER BEAN,2016,1000,1500,500,50.0
Mumbai,Custard Apple,2014,3000,3500,500,16.666666666666668
Akluj,CHILLIES(RED),2016,700,1200,500,71.42857142857143
Barshi,Raddish,2015,500,1000,500,100.0
Balapur,Gram,2016,3750,4250,500,13.333333333333334
Jalgaon Jamod-Aasalgaon,Gram,2015,3150,3650,500,15.873015873015873
Barshi,Methi (Bhaji),2015,500,1000,500,100.0
Barshi,Methi (Bhaji),2015,500,1000,500,100.0
Jalgaon Jamod-Aasalgaon,Gram,2015,3950,4450,500,12.658227848101266
Pune-Moshi,Sweet Potato,2016,1275,1775,500,39.21568627450981
Jalgaon Jamod-Aasalgaon,Gram,2015,3780,4280,500,13.227513227513228
Akkalkuwa,Gram,2015,3500,4000,500,14.285714285714286
Mumbai,Bottle Gourd,2016,509,1009,500,98.23182711198429
Chandrapur-Ganjwad,Carrot,2016,1000,1500,500,50.0
Kalyan,Black Gram,2015,8000,8500,500,6.25
Kalyan,Black Gram,2015,6000,6500,500,8.333333333333334
Chandrapur-Ganjwad,Carrot,2016,1000,1500,500,50.0
Barshi,Raddish,2015,500,1000,500,100.0
Buldhana,Gram,2015,2125,2625,500,23.529411764705884
Rahata,Brinjal,2016,1115,1615,500,44.84304932735426
Umared,Wheat(Husked),2015,1500,2000,500,33.333333333333336
Umared,Wheat(Husked),2015,1500,2000,500,33.333333333333336
Jalgaon Jamod-Aasalgaon,Green Gram,2015,9500,10000,500,5.2631578947368425
Sangali,Bajri,2015,1305,1805,500,38.31417624521073
Palus,Capsicum,2016,833,1333,500,60.024009603841534
Chandrapur-Ganjwad,Carrot,2016,500,1000,500,100.0
Gondpimpri,Pigeon Pea (Tur),2015,6500,7000,500,7.6923076923076925
Satara,Capsicum,2016,1079,1579,500,46.33920296570899
Palus,Cucumber,2016,2000,2500,500,25.0
Chandrapur-Ganjwad,Capsicum,2016,1250,1750,500,40.0
Pune-Pimpri,Ginger (Fresh),2015,3500,4000,500,14.285714285714286
Sangali,Castor Seed,2016,2600,3100,500,19.23076923076923
Navapur,Methi (Bhaji),2016,1000,1500,500,50.0
Buldhana,Black Gram,2015,7000,7500,500,7.142857142857143
Patur,Gram,2014,3000,3500,500,16.666666666666668
Sangali,Horse Gram,2016,2500,3000,500,20.0
Kalyan,Bitter Gourd,2015,3500,4000,500,14.285714285714286
Kalyan,Bitter Gourd,2015,3000,3500,500,16.666666666666668
Mumbai,Split Lentil,2014,6207,6707,500,8.055421298533913
Mumbai,Split Lentil,2014,6028,6528,500,8.29462508294625
Buldhana,Sorgum(Jawar),2015,1350,1850,500,37.03703703703704
Mumbai,Split Lentil,2014,6000,6500,500,8.333333333333334
Katol,Pigeon Pea (Tur),2015,8227,8727,500,6.077549532028686
Kalyan,Flower,2014,750,1250,500,66.66666666666667
Akluj,Brinjal,2016,831,1331,500,60.16847172081829
Kamthi,Ambat Chuka,2016,1000,1500,500,50.0
Nira,Bajri,2015,1500,2000,500,33.333333333333336
Ramtek,Tomato,2016,2051,2551,500,24.378352023403217
Ratanagari,Wal Papdi,2016,2750,3250,500,18.181818181818183
Nira,Bajri,2015,1500,2000,500,33.333333333333336
Ratanagari,Wal Papdi,2016,2500,3000,500,20.0
Jalgaon Jamod-Aasalgaon,Pigeon Pea (Tur),2014,4333,4833,500,11.539349180706209
Kalyan,Green Chilli,2014,1700,2200,500,29.41176470588235
Ratanagari,Sweet Potato,2016,2500,3000,500,20.0
Balapur,Wheat(Husked),2016,1350,1850,500,37.03703703703704
Palus,Brinjal,2015,2500,3000,500,20.0
Palus,Flower,2015,1500,2000,500,33.333333333333336
Buldhana,Pigeon Pea (Tur),2015,5250,5750,500,9.523809523809524
Kalyan,Onion,2014,1167,1667,500,42.84490145672665
Sindi,Pigeon Pea (Tur),2016,8000,8500,500,6.25
Chandrapur-Ganjwad,Jack Fruit(Raw),2016,1000,1500,500,50.0
Bhokardan-Pimpalgaon Renu,Green Gram,2015,6500,7000,500,7.6923076923076925
Dound,Green Gram,2016,7700,8200,500,6.4935064935064934
Chandrapur-Ganjwad,Flower,2016,450,950,500,111.11111111111111
Kalyan,Banana,2015,7250,7750,500,6.896551724137931
Karmala,Gram,2016,4800,5300,500,10.416666666666666
Rahata,Bitter Gourd,2016,3636,4136,500,13.751375137513751
Hadgaon,Pigeon Pea (Tur),2016,9300,9800,500,5.376344086021505
Shrirampur,Ground Nut Pods (Dry),2015,4000,4500,500,12.5
Mangalwedha,Pigeon Pea (Tur),2015,8550,9050,500,5.847953216374269
Karad,Pavata,2014,1750,2250,500,28.571428571428573
Aurangabad,Papai,2016,1411,1911,500,35.43586109142452
Aurangabad,Papai,2016,1300,1800,500,38.46153846153846
Satara,Potato,2014,2067,2567,500,24.189646831156264
Osmanabad,Small Gourd,2015,850,1350,500,58.8235294117647
Karad,Green Chilli,2015,3000,3500,500,16.666666666666668
Karad,Green Chilli,2015,2040,2540,500,24.50980392156863
Pune-Manjri,Mango(Raw),2015,1500,2000,500,33.333333333333336
Ralegaon,Soybean,2016,2300,2800,500,21.73913043478261
Khed-Chakan,Carrot,2016,2000,2500,500,25.0
Khed-Chakan,Carrot,2016,1833,2333,500,27.277686852154936
Telhara,Green Gram,2016,4500,5000,500,11.11111111111111
Shrirampur,Wal Papdi,2015,1000,1500,500,50.0
Pune,Arvi,2014,2000,2500,500,25.0
Pune-Pimpri,Ridge Gourd,2016,4500,5000,500,11.11111111111111
Karad,Ginger (Fresh),2015,2375,2875,500,21.05263157894737
Karad,Ginger (Fresh),2015,2458,2958,500,20.34174125305126
Osmanabad,Sweet Potato,2015,1050,1550,500,47.61904761904762
Chandrapur,Snake Gourd,2016,700,1200,500,71.42857142857143
Nagpur,Bitter Gourd,2015,1262,1762,500,39.61965134706814
Nira-Saswad,Pigeon Pea (Tur),2016,5625,6125,500,8.88888888888889
Pandharpur,Coriander  ,2015,200,700,500,250.0
Nagpur,Coriander (Dry),2016,7300,7800,500,6.8493150684931505
Shrirampur,KHARBUJ,2016,1500,2000,500,33.333333333333336
Karad,Bor,2014,1500,2000,500,33.333333333333336
Loha,Turmeric,2014,4600,5100,500,10.869565217391305
Rahata,Green Peas (Dry),2015,3750,4250,500,13.333333333333334
Akluj,Banana,2014,650,1150,500,76.92307692307692
Pune-Pimpri,Potato,2015,700,1200,500,71.42857142857143
Beed,Pigeon Pea (Tur),2016,7283,7783,500,6.865302759851709
Ratanagari,Bottle Gourd,2015,750,1250,500,66.66666666666667
Aurangabad,Ridge Gourd,2016,3750,4250,500,13.333333333333334
Vaijapur,PIGEON PEA (TUR),2016,4100,4600,500,12.195121951219512
Shrirampur,Sweet Potato,2015,1500,2000,500,33.333333333333336
Chandrapur,Bor,2015,500,1000,500,100.0
Chandrapur,Brinjal,2015,800,1300,500,62.5
Nashik-Devlali,Tandulja,2016,100,600,500,500.0
Kalyan,Zendu,2015,2500,3000,500,20.0
Shrirampur,Capsicum,2016,1308,1808,500,38.2262996941896
Barshi-Vairag,Ground Nut Pods (Dry),2015,4275,4775,500,11.695906432748538
Vai,Green-Peas,2014,3000,3500,500,16.666666666666668
Osmanabad,Potato,2015,400,900,500,125.0
Karad,Ladies Finger,2015,2000,2500,500,25.0
Shrirampur,Wal Papdi,2015,1875,2375,500,26.666666666666668
Satara,Ghevda,2015,1750,2250,500,28.571428571428573
Osmanabad,Cucumber,2016,500,1000,500,100.0
Ratanagari,Snake Gourd,2016,1833,2333,500,27.277686852154936
Karad,Ground Nut Pods (Dry),2015,1750,2250,500,28.571428571428573
Jalna,Banana,2015,500,1000,500,100.0
Chandrapur-Ganjwad,Bitter Gourd,2014,1500,2000,500,33.333333333333336
Kalamnuri,Pigeon Pea (Tur),2016,6000,6500,500,8.333333333333334
Kalyan,Chikoo,2016,3000,3500,500,16.666666666666668
Shrirampur,Sweet Potato,2015,1000,1500,500,50.0
Karad,Ghevda,2015,2500,3000,500,20.0
Pune-Pimpri,Ladies Finger,2015,3000,3500,500,16.666666666666668
Rahata,Tomato,2016,500,1000,500,100.0
Chandrapur,Brinjal,2016,1000,1500,500,50.0
Chalisgaon,Castor Seed,2016,3000,3500,500,16.666666666666668
Kalyan,Orange,2016,4000,4500,500,12.5
Karad,Cluster Bean,2015,2800,3300,500,17.857142857142858
Chandrapur,Chavli (Pala),2016,1500,2000,500,33.333333333333336
Karad,Cluster Bean,2015,2117,2617,500,23.618327822390174
Aurangabad,Kharbuj,2016,1500,2000,500,33.333333333333336
Karad,Cluster Bean,2015,1860,2360,500,26.881720430107528
Aurangabad,Guava,2016,1500,2000,500,33.333333333333336
Aurangabad,Ground Nut Pods (Dry),2016,4000,4500,500,12.5
Karad,Capsicum,2015,2000,2500,500,25.0
Akhadabalapur,Turmeric,2015,6000,6500,500,8.333333333333334
Osmanabad,Black Gram,2014,4500,5000,500,11.11111111111111
Barshi-Vairag,Ground Nut Pods (Dry),2016,5159,5659,500,9.691800736576855
Vasai,Bajri,2014,1450,1950,500,34.48275862068966
Loha,Pigeon Pea (Tur),2015,8600,9100,500,5.813953488372093
Karad,Carrot,2015,1500,2000,500,33.333333333333336
Shahapur,Cucumber,2014,1667,2167,500,29.99400119976005
Khed-Chakan,MATH (BHAJI),2016,1300,1800,500,38.46153846153846
Khed-Chakan,Math (Bhaji),2016,500,1000,500,100.0
Kamthi,Leafy Vegetable,2016,3500,4000,500,14.285714285714286
Shrirampur,Green-Peas,2016,2500,3000,500,20.0
Vadgaon Peth,Capsicum,2015,629,1129,500,79.4912559618442
Chandrapur,Pigeon Pea (Tur),2016,7295,7795,500,6.854009595613434
Barshi-Vairag,Sorgum(Jawar),2015,1862,2362,500,26.852846401718583
Karad,Snake Gourd,2014,1000,1500,500,50.0
Kamthi,Green-Peas,2016,3000,3500,500,16.666666666666668
Khed-Chakan,Coriander  ,2016,1000,1500,500,50.0
Karad,Ghevda,2015,2367,2867,500,21.123785382340515
Karad,Ghevda,2015,2500,3000,500,20.0
Jamkhed,Green Gram,2015,5750,6250,500,8.695652173913043
Shrirampur,Lemon,2015,1452,1952,500,34.43526170798898
Vai,Pavata,2014,2500,3000,500,20.0
Nashik,Potato,2015,680,1180,500,73.52941176470588
Udgir,Ground Nut Pods (Dry),2016,9000,9500,500,5.555555555555555
Ratanagari,Carrot,2015,2000,2500,500,25.0
Vadgaon Peth,Bottle Gourd,2014,1150,1650,500,43.47826086956522
Shahapur,Ridge Gourd,2014,2425,2925,500,20.61855670103093
Nagpur,Coriander (Dry),2016,7000,7500,500,7.142857142857143
Nagpur,Green Chilli,2015,2028,2528,500,24.65483234714004
Basmat,Ground Nut Pods (Dry),2014,3800,4300,500,13.157894736842104
Manchar,Brinjal,2016,1500,2000,500,33.333333333333336
Karad,Bitter Gourd,2015,1550,2050,500,32.25806451612903
Chandrapur,Awala,2016,1500,2000,500,33.333333333333336
Pune-Pimpri,Green-Peas,2016,3500,4000,500,14.285714285714286
Satara,Ground Nut Pods (Dry),2015,2500,3000,500,20.0
Kalyan,CUCUMBER,2016,2320,2820,500,21.551724137931036
Shrirampur,Capsicum,2016,1038,1538,500,48.16955684007707
Ratanagari,Bottle Gourd,2015,1000,1500,500,50.0
Ratanagari,Ghevda,2015,2000,2500,500,25.0
Nagpur,Chavli (Shenga ),2015,2000,2500,500,25.0
Yawal,Cotton,2016,4238,4738,500,11.798017932987259
Morshi,Sesamum,2016,5500,6000,500,9.090909090909092
Jamkhed,Coriander (Dry),2016,6500,7000,500,7.6923076923076925
Shahapur,Cluster Bean,2015,3786,4286,500,13.206550449022716
Bhandara,Other Cereals,2015,3350,3850,500,14.925373134328359
Akhadabalapur,Black Gram,2016,6000,6500,500,8.333333333333334
Pune-Pimpri,Ghevda,2016,3194,3694,500,15.654351909830932
Karad,Snake Gourd,2015,1857,2357,500,26.925148088314486
Satara,Ghevda,2014,2500,3000,500,20.0
Aurangabad,Awala,2016,1000,1500,500,50.0
Karad,Snake Gourd,2015,1750,2250,500,28.571428571428573
Jalkot,Pigeon Pea (Tur),2015,9000,9500,500,5.555555555555555
Satara,Ghevda,2014,3813,4313,500,13.113034356150013
Karad,Shevga,2015,1871,2371,500,26.723677177979692
Ratanagari,Bottle Gourd,2014,2000,2500,500,25.0
Ratanagari,Ghevda,2015,3250,3750,500,15.384615384615385
Shahapur,Chavli (Shenga ),2015,1743,2243,500,28.686173264486516
Rahata,Sweet Potato,2016,2000,2500,500,25.0
Solapur,Tomato,2016,146,646,500,342.4657534246575
Nagpur,Wal Bhaji,2015,2770,3270,500,18.050541516245488
Bhadrawati,Soybean,2015,3000,3500,500,16.666666666666668
Satara,Ghevda,2014,2625,3125,500,19.047619047619047
Malegaon (Washim),Pigeon Pea (Tur),2016,7800,8300,500,6.410256410256411
Ratanagari,Cluster Bean,2015,5000,5500,500,10.0
Pune,Shepu,2016,300,800,500,166.66666666666666
Karad,Ridge Gourd,2015,2444,2944,500,20.458265139116204
Shahapur,Cucumber,2015,1500,2000,500,33.333333333333336
Achalpur,Black Gram,2015,8000,8500,500,6.25
Aurangabad,Wal Bhaji,2015,1000,1500,500,50.0
Kalyan,Guava,2016,2663,3163,500,18.77581674802854
Hadgaon,Soybean,2016,3500,4000,500,14.285714285714286
Jamkhed,Green Gram,2016,4900,5400,500,10.204081632653061
Kalyan,Guava,2016,2500,3000,500,20.0
Kalyan,Guava,2016,2720,3220,500,18.38235294117647
Junnar (Alephata),Potato,2015,500,1000,500,100.0
Shahapur,Ghosali(Bhaji),2015,1473,1973,500,33.944331296673454
Mumbai,Split Lentil,2015,6508,7008,500,7.682851874615857
Kalyan,Shevga,2016,1500,2000,500,33.333333333333336
Pathari,Black Gram,2016,6000,6500,500,8.333333333333334
Solapur,Methi (Bhaji),2014,100,600,500,500.0
Nandgaon Khandeshwar,Green Gram,2016,5000,5500,500,10.0
Kalyan,Papai,2015,1288,1788,500,38.81987577639752
Navapur,Green Chilli,2015,1500,2000,500,33.333333333333336
Hadgaon,Wheat(Husked),2016,1500,2000,500,33.333333333333336
Nagpur,Dhemse,2016,2168,2668,500,23.062730627306273
Hadgaon,Wheat(Husked),2016,1500,2000,500,33.333333333333336
Barshi,Pomegranate,2016,3000,3500,500,16.666666666666668
Nira-Saswad,Wheat(Husked),2015,1600,2100,500,31.25
Barshi,SPINACH,2016,500,1000,500,100.0
Jalgaon,Melon,2016,888,1388,500,56.306306306306304
Shrirampur,Capsicum,2016,1543,2043,500,32.40440699935191
Karad,Chikoo,2015,1000,1500,500,50.0
Karad,Pavtta,2015,3000,3500,500,16.666666666666668
Chandrapur,Awala,2015,1500,2000,500,33.333333333333336
Osmanabad,Kharbuj,2015,1100,1600,500,45.45454545454545
Solapur,Apple,2015,300,800,500,166.66666666666666
Vai,Tomato,2014,2090,2590,500,23.923444976076556
Karad,Pavtta,2015,1500,2000,500,33.333333333333336
Pune-Pimpri,Green-Peas,2015,2300,2800,500,21.73913043478261
Karad,Pavtta,2015,1750,2250,500,28.571428571428573
Karad,Pavtta,2015,2000,2500,500,25.0
Kalyan,Shevga,2015,4333,4833,500,11.539349180706209
Pune-Pimpri,Ridge Gourd,2016,5500,6000,500,9.090909090909092
Nagpur,Green-Peas,2015,3500,4000,500,14.285714285714286
Shirpur,Sorgum(Jawar),2014,1329,1829,500,37.62227238525207
Jalgaon,MAIZE(CORN.),2016,900,1400,500,55.55555555555556
Karad,Pavata,2015,1325,1825,500,37.735849056603776
Pune-Pimpri,Spinach,2016,500,1000,500,100.0
Rahata,Sweet Potato,2016,3500,4000,500,14.285714285714286
Karad,Pavata,2015,2833,3333,500,17.649135192375574
Karad,Onion,2015,992,1492,500,50.403225806451616
Hadgaon-Tamsa,Wheat(Husked),2016,1500,2000,500,33.333333333333336
Chandrapur-Ganjwad,Mula Shenga,2014,1000,1500,500,50.0
Shahapur,Capsicum,2015,2000,2500,500,25.0
Rahata,Sweet Potato,2016,2000,2500,500,25.0
Vadgaon Peth,Carrot,2014,1000,1500,500,50.0
Rahata,Ground Nut Pods (Dry),2015,3250,3750,500,15.384615384615385
Osmanabad,Cucumber,2016,1000,1500,500,50.0
Rahata,Ground Nut Pods (Dry),2015,2750,3250,500,18.181818181818183
Shrirampur,Wal Papdi,2015,1000,1500,500,50.0
Karad,Ridge Gourd,2015,3000,3500,500,16.666666666666668
Ratanagari,Ghevda,2015,2000,2500,500,25.0
Kalyan,Ridge Gourd,2016,3500,4000,500,14.285714285714286
Jalgaon,Maize(Corn.),2016,700,1200,500,71.42857142857143
Pune-Pimpri,Ridge Gourd,2016,4000,4500,500,12.5
Kalyan,Sesamum,2015,7750,8250,500,6.451612903225806
Chandrapur,Naspatti ,2014,4429,4929,500,11.289230074508918
Kalyan,Shevga,2015,6000,6500,500,8.333333333333334
Ausa,Coriander (Dry),2014,8615,9115,500,5.803830528148578
Karad,Pavtta,2015,2500,3000,500,20.0
Shrirampur,Sweet Potato,2015,1500,2000,500,33.333333333333336
Mumbai,Spilt Gerrn Gram,2016,6218,6718,500,8.041170794467675
Satara,Sweet Potato,2015,1000,1500,500,50.0
Karad,Pavtta,2015,2250,2750,500,22.22222222222222
Ratanagari,Bottle Gourd,2015,1000,1500,500,50.0
Phaltan,Bitter Gourd,2016,2000,2500,500,25.0
Rahata,Ground Nut Pods (Dry),2015,3750,4250,500,13.333333333333334
Vai,Green Chilli,2014,3750,4250,500,13.333333333333334
Karad,Pavtta,2015,2500,3000,500,20.0
Phaltan,Brinjal,2016,724,1224,500,69.06077348066299
Baramati,Onion,2016,179,678,499,278.7709497206704
Dudhani,Wheat(Husked),2015,1501,2000,499,33.24450366422385
Tumsar,Jaggery,2015,2213,2712,499,22.54857659286037
Lasur Station,Pigeon Pea (Tur),2016,7648,8147,499,6.524581589958159
Lonar,Gram,2016,8784,9283,499,5.680783242258652
Beed,Gram,2015,4431,4930,499,11.261566237869555
Phaltan,Bajri,2015,1250,1749,499,39.92
Umarga,Sesamum,2015,6101,6600,499,8.178987051303064
Latur-Murud,Soybean,2016,3419,3918,499,14.594910792629424
Dhule,Cowpea,2015,3302,3801,499,15.112053301029679
Amalner,Pigeon Pea (Tur),2016,7031,7530,499,7.097141231688238
Gadchiroli,Paddy-Unhusked,2015,1755,2254,499,28.433048433048434
Ramtek,Squash Gourd,2015,1005,1504,499,49.65174129353234
Bhokar,Pigeon Pea (Tur),2014,4212,4711,499,11.84710351377018
Mehkar,Gram,2016,3826,4325,499,13.042341871406169
Manwat,Pigeon Pea (Tur),2016,5001,5500,499,9.978004399120175
Chalisgaon,BAJRI,2016,1176,1675,499,42.43197278911565
Kurdwadi-Modnimb,Wheat(Husked),2015,1578,2077,499,31.622306717363752
Mangrulpeer,Sorgum(Jawar),2015,1051,1550,499,47.47859181731684
Mangalwedha,Sorgum(Jawar),2016,1632,2131,499,30.57598039215686
Amarawati-Fruit And Vegetables,Potato,2016,1482,1981,499,33.67071524966262
Solapur,Sorgum(Jawar),2015,1705,2203,498,29.208211143695014
Zarijamini,SOYBEAN,2016,2228,2726,498,22.351885098743267
Khamgaon,Cotton,2016,4100,4598,498,12.146341463414634
Solapur,Cabbage,2015,390,888,498,127.6923076923077
Dudhani,Wheat(Husked),2015,1476,1974,498,33.739837398373986
Ahmedpur,Black Gram,2016,6216,6714,498,8.011583011583012
Nagpur,Soybean,2016,3155,3653,498,15.78446909667195
Dondaicha,Sorgum(Jawar),2016,1429,1927,498,34.849545136459064
Paithan,Wheat(Husked),2015,1450,1948,498,34.3448275862069
Baramati,Onion,2016,163,661,498,305.52147239263803
Gevrai,Gram,2016,5154,5652,498,9.662398137369033
Aurangabad,Tomato,2016,630,1128,498,79.04761904761905
Kolhapur,Potato,2015,625,1123,498,79.68
Gadhinglaj,Jaggery,2015,2252,2750,498,22.113676731793962
Umared,Soybean,2014,2807,3305,498,17.74136088350552
Ausa,Pigeon Pea (Tur),2015,6678,7176,498,7.457322551662174
Deglur,Green Gram,2015,8146,8644,498,6.113429904247483
Samudrapur,Gram,2015,3175,3673,498,15.68503937007874
Savner,Pigeon Pea (Tur),2015,4434,4932,498,11.231393775372124
Pachora,Soybean,2015,3071,3569,498,16.216216216216218
Kolhapur,Potato,2016,896,1394,498,55.580357142857146
Dound,Wheat(Husked),2016,1588,2085,497,31.297229219143578
Shrirampur,Green Gram,2016,4326,4823,497,11.488673139158577
Mohol,BLACK GRAM,2016,6005,6502,497,8.276436303080766
Kundalwadi,Pigeon Pea (Tur),2016,7387,7884,497,6.728035738459456
Umared,Green Gram,2015,6379,6876,497,7.791189841667973
Barshi,Wheat(Husked),2016,1694,2191,497,29.33884297520661
Lonand,Wheat(Husked),2015,1500,1997,497,33.13333333333333
Kopargaon,Gram,2014,2106,2603,497,23.599240265906932
Pulgaon,Cotton,2016,4141,4638,497,12.001931900507124
Majalgaon,Sorgum(Jawar),2016,1308,1805,497,37.99694189602447
Yeotmal,Gram,2016,3762,4259,497,13.211057947900054
Lasalgaon-Niphad,ONION,2016,270,767,497,184.07407407407408
Shegaon,Black Gram,2015,6803,7300,497,7.305600470380714
Pune,Bottle Gourd,2016,415,912,497,119.75903614457832
Khed-Chakan,Squash Gourd,2015,3511,4008,497,14.155511250356025
Karad,Capsicum,2016,1707,2204,497,29.115407147041594
Indapur,Ground Nut Pods (Dry),2016,4860,5357,497,10.22633744855967
Dound,Gram,2015,3947,4444,497,12.59184190524449
Osmanabad,CABBAGE,2016,565,1062,497,87.96460176991151
Sengaon,BLACK GRAM,2016,6146,6643,497,8.086560364464692
Nandura,Sesamum,2015,6457,6954,497,7.697072944091683
Solapur,Green Gram,2015,7357,7854,497,6.755470980019029
Akot,Cotton,2015,3944,4441,497,12.601419878296147
Karad,Tomato,2014,1074,1571,497,46.2756052141527
Devala,Gram,2015,3144,3641,497,15.807888040712468
Shirpur,Maize,2016,911,1408,497,54.555433589462126
Mumbai-Onion And Potato Mkt,Potato,2016,1263,1760,497,39.3507521773555
Vai,Flower,2016,2014,2511,497,24.6772591857001
Pune-Moshi,WAL PAPDI,2016,1469,1966,497,33.83253914227365
Shegaon,Black Gram,2015,8041,8538,497,6.180823280686481
Kalyan,Orange,2016,1293,1790,497,38.437741686001544
Mohol,Gram,2015,3768,4264,496,13.163481953290871
Karad,Cluster Bean,2016,2389,2885,496,20.76182503139389
Dudhani,Bajri,2014,1129,1625,496,43.932683790965456
Karad,Shevga,2016,2078,2574,496,23.86910490856593
Chalisgaon,Onion,2016,356,852,496,139.32584269662922
Vai,Ginger (Fresh),2015,3119,3615,496,15.902532863097147
Pune-Pimpri,Cabbage,2016,2236,2732,496,22.182468694096602
Chandrapur,Banana,2015,519,1015,496,95.56840077071291
Karad,Ginger (Fresh),2016,1841,2337,496,26.941879413362305
Satara,Tomato,2015,615,1111,496,80.65040650406505
Karad,Shevga,2016,1937,2433,496,25.60660815694373
Pune,Gr.Nut Kernels,2015,8800,9296,496,5.636363636363637
Shrirampur,Chikoo,2015,1008,1504,496,49.20634920634921
Satana,Maize,2016,900,1396,496,55.111111111111114
Pune,Squash Gourd,2015,443,939,496,111.96388261851015
Vai,Ginger (Fresh),2015,2867,3363,496,17.300313916986397
Pune-Manjri,Cucumber,2015,1125,1621,496,44.08888888888889
Akluj,Onion,2016,324,820,496,153.08641975308643
Bhivandi,Other Vegetables,2015,895,1391,496,55.41899441340782
Umarga,Green Gram,2015,6737,7233,496,7.362327445450497
Mumbai,Water Melon,2015,542,1038,496,91.5129151291513
Wardha,Gram,2015,3833,4329,496,12.94025567440647
Patur,Gram,2016,6317,6813,496,7.8518283995567515
Mumbai,Chikoo,2014,1213,1709,496,40.89035449299258
Satara,Brinjal,2015,700,1196,496,70.85714285714286
Chikhali,Wheat(Husked),2016,1493,1989,496,33.22170127260549
Nashik-Devlali,Kanda Pat,2016,754,1250,496,65.78249336870026
Mumbai-Fruit Market,Mosambi,2016,1552,2048,496,31.95876288659794
Ramtek,Chavli (Shenga ),2016,964,1460,496,51.45228215767635
Nandura,PIGEON PEA (TUR),2016,5153,5649,496,9.625460896565107
Malkapur,Onion,2016,257,753,496,192.99610894941634
Lasalgaon,Bajri,2015,1268,1764,496,39.11671924290221
Risod,Green Gram,2015,5504,6000,496,9.011627906976743
Manmad,Gram,2015,2693,3189,496,18.418121054585963
Shirpur,Sesamum,2015,6958,7454,496,7.128485196895659
Satara,Bitter Gourd,2015,3409,3905,496,14.549721325902023
Amarawati-Fruit And Vegetables,Methi (Bhaji),2016,3791,4287,496,13.08361909786336
Kolhapur-Laxmipuri,Green Gram,2015,8704,9200,496,5.698529411764706
Aarni,Pigeon Pea (Tur),2015,5267,5763,496,9.417125498386179
Ghoti,Flower,2015,1284,1780,496,38.62928348909657
Nagpur,Green Chilli,2016,2692,3188,496,18.424962852897472
Amalner,Green Gram,2015,7314,7810,496,6.781514902925895
Nashik-Devlali,Methi (Bhaji),2016,1455,1950,495,34.02061855670103
Pune,Carrot,2016,550,1045,495,90.0
Bhokar,Turmeric,2016,6450,6945,495,7.674418604651163
Shahapur,Ghosali(Bhaji),2015,1700,2195,495,29.11764705882353
Vai,Green Chilli,2015,2350,2845,495,21.06382978723404
Shegaon,Green Gram,2014,6681,7176,495,7.409070498428379
Kada,Wheat(Husked),2016,1508,2003,495,32.824933687002655
Chandrapur-Ganjwad,Brinjal,2015,595,1090,495,83.19327731092437
Pune,Beet Root,2015,285,780,495,173.68421052631578
Latur,Sunflower,2016,3248,3743,495,15.240147783251231
Shrirampur,Ladies Finger,2015,1435,1930,495,34.494773519163765
Kamthi,Pumpkin,2016,567,1062,495,87.3015873015873
Patan,Ladies Finger,2015,2475,2970,495,20.0
Kalyan,Small Gourd,2016,2275,2770,495,21.75824175824176
Pune-Pimpri,Cucumber,2015,1057,1552,495,46.83065279091769
Kolhapur,Maize(Corn.),2016,405,900,495,122.22222222222223
Ahmednagar,Cucumber,2016,138,633,495,358.69565217391306
Junnar-Otur,Cucumber,2016,430,925,495,115.11627906976744
Kamthi,Cabbage,2014,710,1205,495,69.71830985915493
Akot,SOYBEAN,2016,2389,2884,495,20.719966513185433
Shirpur,Onion,2016,126,621,495,392.85714285714283
Malkapur,Soybean,2014,2836,3331,495,17.454160789844853
Ahmednagar,Wheat(Husked),2015,1580,2075,495,31.329113924050635
Shahapur,Ghosali(Bhaji),2015,1022,1517,495,48.43444227005871
Hinganghat,Gram,2016,3718,4213,495,13.31360946745562
Shirpur,Wheat(Husked),2015,1464,1959,495,33.81147540983606
Aurangabad,Onion,2016,128,623,495,386.71875
Ralegaon,Cotton,2016,4135,4630,495,11.970979443772672
Babhulgaon,Gram,2016,3777,4272,495,13.105639396346307
Nandurbar,Sorgum(Jawar),2014,1168,1663,495,42.38013698630137
Babhulgaon,Soybean,2016,3239,3734,495,15.28249459709787
Satara,Tomato,2015,483,978,495,102.48447204968944
Sangali,Green Gram,2016,5338,5833,495,9.273136005994754
Pusad,BLACK GRAM,2016,7008,7503,495,7.063356164383562
Kalamb (Os),Sorgum(Jawar),2015,1629,2124,495,30.386740331491712
Nampur,Onion,2016,342,837,495,144.73684210526315
Satara,Flower,2015,757,1252,495,65.38969616908851
Manchar,Onion,2016,285,780,495,173.68421052631578
Kille Dharur,Gram,2015,4200,4695,495,11.785714285714286
Lasalgaon-Vinchur,Soybean,2016,2731,3226,495,18.12522885389967
Sinner,Soybean,2015,3228,3723,495,15.33457249070632
Majalgaon,Gram,2014,2393,2888,495,20.685332218972
Latur,Sorgum(Jawar),2015,1779,2273,494,27.76840921866217
Sangali,Bajri,2015,1300,1794,494,38.0
Kalyan,Small Gourd,2016,1588,2082,494,31.10831234256927
Jamkhed,Wheat(Husked),2015,1874,2368,494,26.360725720384206
Solapur,Sorgum(Jawar),2015,1810,2304,494,27.29281767955801
Baramati,Bajri,2016,1461,1955,494,33.81245722108145
Rahuri-Vambori,Green Gram,2016,4349,4843,494,11.358933088066221
Arvi,Pigeon Pea (Tur),2015,6097,6591,494,8.102345415778252
Shirpur,Bajri,2014,935,1429,494,52.83422459893048
Jalgaon,Potato,2015,850,1344,494,58.11764705882353
Sangrampur-Varvatbakal,Soybean,2016,3086,3580,494,16.007777057679846
Umared,Pigeon Pea (Tur),2015,7720,8214,494,6.398963730569948
Kalamb (Os),Wheat(Husked),2016,2080,2574,494,23.75
Pune,Squash Gourd,2015,571,1065,494,86.51488616462346
Jalgaon,Tomato,2015,1089,1583,494,45.362718089990814
Khed-Chakan,Brinjal,2015,2641,3135,494,18.705035971223023
Bhokar,Sorgum(Jawar),2015,1131,1625,494,43.67816091954023
Sangrampur,Gram,2014,2056,2550,494,24.027237354085603
Kada,Bajri,2016,1256,1750,494,39.3312101910828
Chandrapur-Ganjwad,Cabbage,2015,350,844,494,141.14285714285714
Digras,Pigeon Pea (Tur),2015,8308,8802,494,5.94607607125662
Solapur,Jaggery,2015,1868,2362,494,26.445396145610278
Kej,Sorgum(Jawar),2014,1852,2346,494,26.673866090712743
Jalgaon,Gram,2015,3951,4445,494,12.503163756011137
Nandgaon,Sorgum(Jawar),2015,1131,1625,494,43.67816091954023
Indapur,Onion,2016,126,620,494,392.06349206349205
Pune,Gram,2015,5353,5847,494,9.228470016813002
Dondaicha,Wheat(Husked),2015,1495,1989,494,33.04347826086956
Kalamb (Os),Pigeon Pea (Tur),2016,7612,8106,494,6.489753021544929
Amarawati,Green Chilli,2016,4769,5263,494,10.358565737051793
Vai,Brinjal,2016,1865,2359,494,26.487935656836463
Kalyan,Ridge Gourd,2016,2794,3288,494,17.680744452397995
Dondaicha,Black Gram,2016,6886,7380,494,7.173976183560848
Barshi,Green Chilli,2016,665,1158,493,74.13533834586467
Arvi,Gram,2015,3847,4340,493,12.815180660254743
Pune,Gram,2015,5367,5860,493,9.185764859325507
Khed,Cabbage,2016,290,783,493,170.0
Amarawati,Dhemse,2016,3800,4293,493,12.973684210526315
Purna,Pigeon Pea (Tur),2016,5637,6130,493,8.745786766010289
Nagpur,Ground Nut Pods (Dry),2016,3169,3662,493,15.556958030924582
Junnar (Alephata),Onion,2016,500,993,493,98.6
Karmala,Wheat(Husked),2016,1750,2243,493,28.17142857142857
Lasalgaon,Sorgum(Jawar),2016,1340,1833,493,36.791044776119406
Pune-Manjri,Green Chilli,2016,1221,1714,493,40.37674037674038
Hinganghat,SOYBEAN,2016,2440,2933,493,20.204918032786885
Daryapur,Soybean,2016,2988,3481,493,16.499330655957163
Taloda,Black Gram,2015,3359,3852,493,14.676987198571004
Baramati,Sorgum(Jawar),2014,1677,2170,493,29.39773404889684
Chandrapur-Ganjwad,Carrot,2015,764,1257,493,64.52879581151832
Rahata,Tomato,2016,343,836,493,143.731778425656
Varora,Soybean,2016,3100,3593,493,15.903225806451612
Nashik,Cucumber,2016,529,1022,493,93.19470699432893
Pulgaon,Pigeon Pea (Tur),2016,8208,8701,493,6.006335282651072
Hingoli,Turmeric,2016,8620,9113,493,5.719257540603248
Shrirampur,WHEAT(HUSKED),2016,1825,2318,493,27.013698630136986
Kada,Gram,2015,2579,3072,493,19.115936409461032
Ahmednagar,Pigeon Pea (Tur),2016,7657,8150,493,6.438552958077576
Murum,Black Gram,2016,9240,9733,493,5.3354978354978355
Pune-Pimpri,Cluster Bean,2015,2247,2740,493,21.940364931019136
Ahmedpur,Green Gram,2015,6846,7339,493,7.201285422144318
Nagpur,Onion,2016,329,822,493,149.84802431610942
Manora,Soybean,2014,2865,3358,493,17.20767888307155
Koregaon,Onion,2016,425,918,493,116.0
Patan,Ladies Finger,2016,2938,3431,493,16.78012253233492
Mumbai,Tomato,2015,1349,1842,493,36.54558932542624
Kalyan,Bitter Gourd,2015,2748,3241,493,17.940320232896653
Shirpur,Ground Nut Pods (Dry),2016,4031,4524,493,12.23021582733813
Karmala,Sunflower,2015,3245,3738,493,15.192604006163329
Malkapur,Onion,2015,775,1268,493,63.61290322580645
Pune-Pimpri,Brinjal,2014,3380,3873,493,14.585798816568047
Karmala,BAJRI,2016,1063,1556,493,46.37817497648165
Pune-Pimpri,BOTTLE GOURD,2016,697,1190,493,70.73170731707317
Akluj,Tomato,2016,492,984,492,100.0
Karad,Chikoo,2015,1400,1892,492,35.142857142857146
Kej,Soybean,2016,3189,3681,492,15.428033866415804
Amarawati,Mosambi,2015,2385,2877,492,20.628930817610062
Nagpur,MOSAMBI,2016,2932,3424,492,16.780354706684857
Karad,Cluster Bean,2016,1965,2457,492,25.0381679389313
Shahapur,Bitter Gourd,2015,1283,1775,492,38.34762275915822
Shrirampur,Potato,2016,1008,1500,492,48.80952380952381
Gangapur,Gram,2016,5978,6470,492,8.230177316828371
Osmanabad,Sorgum(Jawar),2016,1701,2193,492,28.924162257495592
Satara,Cucumber,2015,1008,1500,492,48.80952380952381
Karad,Ghevda,2016,1856,2348,492,26.50862068965517
Dound,Pigeon Pea (Tur),2016,6700,7192,492,7.343283582089552
Karad,Ghevda,2016,1396,1888,492,35.24355300859599
Aurangabad,Cucumber,2015,804,1296,492,61.19402985074627
Shrirampur,Wheat(Husked),2014,1374,1866,492,35.80786026200873
Kurdwadi,Sorgum(Jawar),2015,1484,1976,492,33.15363881401617
Pune,Potato,2016,1246,1738,492,39.48635634028892
Kada,Bajri,2016,1158,1650,492,42.487046632124354
Karad,GHEVDA,2016,1776,2268,492,27.7027027027027
Shrigonda,Sorgum(Jawar),2016,1633,2125,492,30.128597672994488
Yeola,Gram,2015,2632,3124,492,18.693009118541035
Aurangabad,Bottle Gourd,2016,765,1257,492,64.31372549019608
Kalamb (Os),Gram,2015,4021,4513,492,12.235762248196966
Kolhapur-Laxmipuri,Wheat(Husked),2015,2300,2792,492,21.391304347826086
Sailu,Gram,2016,7026,7518,492,7.002561912894961
Khed-Chakan,Brinjal,2016,1281,1773,492,38.40749414519906
Patan,Ghevda,2016,1900,2392,492,25.894736842105264
Jalgaon,Bitter Gourd,2015,2350,2842,492,20.93617021276596
Yeotmal,Gram,2016,3800,4292,492,12.947368421052632
Gevrai,Gram,2015,3958,4450,492,12.430520464881253
Nagpur,Ground Nut Pods (Dry),2014,3104,3596,492,15.850515463917526
Murbad,BRINJAL,2016,2177,2669,492,22.599908130454754
Pusad,Pigeon Pea (Tur),2016,6409,6901,492,7.676704634108285
Dound,Wheat(Husked),2015,1446,1938,492,34.024896265560166
Raver,Pigeon Pea (Tur),2016,7468,7960,492,6.588109266202464
Satara,Flower,2015,971,1462,491,50.56642636457261
Sindi,Soybean,2016,3068,3559,491,16.003911342894394
Mumbai,Jaggery,2016,3774,4265,491,13.010068892421833
Yawal,BANANA,2016,369,860,491,133.06233062330622
Shrirampur,Ginger (Fresh),2015,2500,2991,491,19.64
Shirpur,WHEAT(HUSKED),2016,1743,2234,491,28.16982214572576
Vai,Ladies Finger,2016,1642,2133,491,29.90255785627284
Amarawati,Pigeon Pea (Tur),2015,4934,5425,491,9.951357924604784
Kalmeshwar,Gram,2016,3766,4257,491,13.037705788635156
Khamgaon,Soybean,2015,2822,3313,491,17.39900779588944
Kille Dharur,Bajri,2014,1339,1830,491,36.669156086631816
Vadgaon Peth,Cabbage,2016,550,1041,491,89.27272727272727
Ramtek,Coriander  ,2016,1557,2048,491,31.53500321130379
Parli-Vaijnath,Pigeon Pea (Tur),2016,7489,7980,491,6.55628254773668
Umarkhed,Gram,2016,4000,4491,491,12.275
Kalyan,Flower,2015,782,1273,491,62.78772378516624
Rahata,Green Chilli,2016,3364,3855,491,14.595719381688466
Mumbai,BOTTLE GOURD,2016,438,929,491,112.10045662100457
Shrirampur,Chikoo,2015,1500,1991,491,32.733333333333334
Jintur,Sorgum(Jawar),2014,1153,1644,491,42.584562012142236
Vai,Ridge Gourd,2015,3042,3533,491,16.14069690992768
Deglur,Gram,2015,3800,4291,491,12.921052631578947
Taloda,Gram,2015,3215,3706,491,15.272161741835149
Amarawati,Ground Nut Pods (Dry),2015,4800,5291,491,10.229166666666666
Jalgaon,Cucumber,2014,738,1229,491,66.53116531165311
Kolhapur-Laxmipuri,Split Gram,2016,5360,5851,491,9.16044776119403
Baramati,Bajri,2016,1721,2212,491,28.52992446252179
Vai,Ridge Gourd,2015,2417,2908,491,20.314439387670667
Anajngaon Surji,Gram,2015,3975,4466,491,12.352201257861635
Lasur Station,Pigeon Pea (Tur),2016,7954,8445,491,6.172994719637918
Mahur,Pigeon Pea (Tur),2016,7714,8205,491,6.365050557428053
Kolhapur,Water Melon,2016,410,900,490,119.51219512195122
Aarni,Gram,2015,4000,4490,490,12.25
Karanja,Gram,2014,2334,2824,490,20.99400171379606
Nashik,Lemon,2016,344,834,490,142.4418604651163
Jalgaon,CUCUMBER,2016,563,1053,490,87.03374777975134
Nandurbar,Bajri,2016,1131,1621,490,43.32449160035367
Rahata,Shevga,2016,2070,2560,490,23.67149758454106
Chandrapur-Ganjwad,FLOWER,2016,426,916,490,115.02347417840376
Shahapur,Ladies Finger,2014,2600,3090,490,18.846153846153847
Shrirampur,Sweet Potato,2015,1350,1840,490,36.2962962962963
Shahapur,Chavli (Shenga ),2015,1610,2100,490,30.434782608695652
Lonand,Sorgum(Jawar),2016,1598,2088,490,30.663329161451816
Chikhali,Wheat(Husked),2016,1388,1878,490,35.30259365994236
Solapur,Black Gram,2014,5304,5794,490,9.238310708898943
Umarkhed-Danki,Soybean,2014,2670,3160,490,18.352059925093634
Dhule,Onion,2016,274,764,490,178.83211678832117
Chopda,Gram,2015,3783,4273,490,12.95268305577584
Vadgaon Peth,Cabbage,2015,690,1180,490,71.01449275362319
Nagpur,Soybean,2015,2862,3352,490,17.120894479385047
Pandharpur,Gram,2016,6010,6500,490,8.153078202995008
Lasur Station,Sorgum(Jawar),2015,1195,1685,490,41.00418410041841
Katol,Soybean,2014,2796,3286,490,17.525035765379112
Pune,Wheat(Husked),2015,2316,2806,490,21.157167530224527
Pathari,Sorgum(Jawar),2015,1818,2308,490,26.952695269526952
Amarawati,Bor,2016,1463,1953,490,33.49282296650718
Dound,Wheat(Husked),2016,1659,2149,490,29.535864978902953
Jalgaon,Onion,2016,355,845,490,138.0281690140845
Vai,Ginger (Fresh),2016,3287,3777,490,14.90721022208701
Katol,Gram,2016,6081,6571,490,8.057885216247328
Kopargaon,Black Gram,2016,6210,6700,490,7.890499194847021
Akkolkot,Green Gram,2016,4413,4903,490,11.10355767051892
Sinner,Sunflower,2015,2801,3291,490,17.493752231345947
Beed,Wheat(Husked),2015,1773,2263,490,27.63677382966723
Akkolkot,PIGEON PEA (TUR),2016,5650,6140,490,8.672566371681416
Khed (Shel Pimpalgaon),Ladies Finger,2014,1055,1545,490,46.44549763033175
Arvi,Soybean,2015,3479,3968,489,14.055763150330554
Dhule,Onion,2016,142,631,489,344.36619718309856
Jalgaon,Carrot,2016,800,1289,489,61.125
Patan,Green Chilli,2015,1894,2383,489,25.818373812038015
Kamthi,Bottle Gourd,2015,641,1130,489,76.28705148205928
Anajngaon Surji,Gram,2016,5900,6389,489,8.288135593220339
Jalgaon Jamod-Aasalgaon,Soybean,2016,3100,3589,489,15.774193548387096
Mumbai,Split Lentil,2014,5953,6442,489,8.214345708046363
Karmala,Gram,2015,3425,3914,489,14.277372262773723
Mangalwedha,Bitter Gourd,2016,4116,4605,489,11.880466472303207
Akluj,Onion,2016,344,833,489,142.15116279069767
Shirpur,Bajri,2014,945,1434,489,51.74603174603175
Latur,SORGUM(JAWAR),2016,1658,2147,489,29.493365500603137
Savner,Wheat(Husked),2016,1347,1836,489,36.30289532293987
Nagpur,Papai,2015,583,1072,489,83.87650085763293
Aurangabad,Green-Peas,2015,2395,2884,489,20.417536534446764
Dondaicha,Sorgum(Jawar),2016,1417,1906,489,34.50952717007763
Mangrulpeer,Gram,2014,2179,2668,489,22.441486920605783
Satara,Onion,2015,1267,1756,489,38.59510655090766
Mangrulpeer,Sorgum(Jawar),2015,1088,1577,489,44.94485294117647
Vai,Tomato,2015,2896,3385,489,16.885359116022098
Pathardi,Gram,2016,3658,4147,489,13.367960634226353
Nashik,Flower,2015,583,1072,489,83.87650085763293
Pune-Manjri,Cabbage,2016,600,1089,489,81.5
Mumbai,Onion,2016,809,1298,489,60.44499381953028
Mohol,Wheat(Husked),2015,1515,2004,489,32.277227722772274
Kamthi,Brinjal,2016,352,841,489,138.92045454545453
Satara,Potato,2016,811,1300,489,60.29593094944513
Vasai,Potato,2015,925,1414,489,52.86486486486486
Dhule,Bajri,2014,1009,1498,489,48.46382556987116
Majalgaon,Bajri,2014,1187,1676,489,41.196293176074136
Jalgaon,Cucumber,2015,744,1233,489,65.7258064516129
Akola,Batbati,2016,3511,4000,489,13.927655938479067
Vaijapur,Gram,2016,6330,6819,489,7.725118483412322
Nashik-Devlali,Raddish,2016,1515,2004,489,32.277227722772274
Pimpalgaon (B)-Saykheda,Onion,2016,211,700,489,231.75355450236967
Ulhasnagar,Onion,2016,1000,1488,488,48.8
Indapur-Bhigwan,Gram,2015,3750,4238,488,13.013333333333334
Kada,Gram,2014,2116,2604,488,23.062381852551987
Indapur,Ground Nut Pods (Dry),2016,4950,5438,488,9.858585858585858
Sangali,Soybean,2016,3238,3726,488,15.071031500926498
Chalisgaon,Wheat(Husked),2016,1425,1913,488,34.24561403508772
Arvi,Gram,2016,3746,4234,488,13.027229044313934
Sangali,Soybean,2015,3448,3936,488,14.153132250580047
Arvi,Soybean,2016,3146,3634,488,15.51176096630642
Risod,Pigeon Pea (Tur),2016,6529,7017,488,7.474345228978404
Balapur,Soybean,2016,2800,3288,488,17.428571428571427
Risod,Pigeon Pea (Tur),2015,5652,6140,488,8.634111818825195
Kej,BAJRI,2016,1181,1669,488,41.32091447925487
Karad,Brinjal,2015,1175,1663,488,41.53191489361702
Arvi,Soybean,2016,3144,3632,488,15.521628498727736
Udgir,Pigeon Pea (Tur),2016,6558,7046,488,7.44129307715767
Chandur Bajar,Soybean,2016,2675,3163,488,18.242990654205606
Bhokar,Turmeric,2015,6564,7052,488,7.434491163924436
Nandura,Gram,2015,2357,2845,488,20.704285108188376
Chalisgaon,Bajri,2016,1417,1905,488,34.43895553987297
Lasalgaon,Wheat(Husked),2016,1539,2027,488,31.70890188434048
Kalyan,Brinjal,2016,2279,2767,488,21.41290039491005
Wardha,Soybean,2015,3342,3830,488,14.602034709754639
Jalgaon,Jaggery,2016,2914,3402,488,16.746739876458477
Loha,Sesamum,2014,9012,9500,488,5.415002219263204
Vai,Tomato,2015,2340,2828,488,20.854700854700855
Nagpur,Math (Bhaji),2016,3100,3588,488,15.741935483870968
Vai,Green Chilli,2015,2706,3194,488,18.0339985218034
Parli-Vaijnath,Safflower,2016,2122,2610,488,22.99717247879359
Amarawati,Chikoo,2016,1106,1594,488,44.12296564195298
Kalyan,Orange,2016,2700,3188,488,18.074074074074073
Pune,Wheat(Husked),2016,2041,2529,488,23.90984811366977
Kalyan,Bitter Gourd,2016,3896,4384,488,12.525667351129364
Solapur,Sorgum(Jawar),2016,1839,2327,488,26.536160957041872
Baramati,Sorgum(Jawar),2016,1722,2210,488,28.339140534262487
Satara,Carrot,2015,1112,1600,488,43.884892086330936
Latur-Murud,Soybean,2016,3337,3825,488,14.62391369493557
Lasalgaon,SORGUM(JAWAR),2016,1386,1874,488,35.20923520923521
Shrirampur,Cucumber,2016,1375,1863,488,35.49090909090909
Chalisgaon,Onion,2016,313,801,488,155.91054313099042
Washim,Green Gram,2015,6821,7308,487,7.139715584225187
Babhulgaon,Soybean,2014,2779,3266,487,17.52428931270241
Nagpur,Coriander  ,2016,1695,2182,487,28.73156342182891
Kalyan,Chikoo,2016,1488,1975,487,32.72849462365591
Jintur-Bori,Pigeon Pea (Tur),2015,7676,8163,487,6.344450234497134
Karad,Cucumber,2015,888,1375,487,54.84234234234234
Dondaicha,Wheat(Husked),2015,1463,1950,487,33.28776486671224
Barshi,Capsicum,2016,543,1030,487,89.68692449355433
Mangrulpeer,Soybean,2016,3282,3769,487,14.838513101767216
Bhokar,Sesamum,2016,6085,6572,487,8.00328677074774
Amarawati,Green Gram,2015,8097,8584,487,6.014573298752625
Savner,Ground Nut Pods (Dry),2016,4778,5265,487,10.192549183758896
Aurangabad,Green-Peas,2015,1413,1900,487,34.46567586694975
Kolhapur-Malkapur,Flower,2016,188,675,487,259.0425531914894
Pune-Pimpri,Bottle Gourd,2015,1220,1707,487,39.91803278688525
Umared,Green Gram,2016,5033,5520,487,9.676137492549175
Chandrapur-Ganjwad,Tomato,2016,486,973,487,100.20576131687243
Shegaon,Sesamum,2014,8884,9371,487,5.481764970733904
Jamkhed,Wheat(Husked),2016,1594,2081,487,30.55207026348808
Pune,Carrot,2016,574,1061,487,84.84320557491289
Mangalwedha,Sorgum(Jawar),2015,1857,2344,487,26.225094238018308
Umared,Soybean,2016,3407,3894,487,14.294100381567361
Dondaicha,Chillies(Red),2016,1009,1496,487,48.26560951437067
Mumbai,Curry Leaves,2014,1196,1683,487,40.719063545150505
Chandrapur-Ganjwad,Ladies Finger,2016,663,1150,487,73.45399698340874
Tuljapur,Green Gram,2015,6712,7199,487,7.255661501787842
Nira,JAGGERY,2016,3447,3934,487,14.128227444154337
Chikhali,Wheat(Husked),2016,1452,1939,487,33.539944903581265
Umarkhed-Danki,Gram,2016,4000,4487,487,12.175
Shrirampur,Capsicum,2015,1542,2029,487,31.58236057068742
Akole,Paddy-Unhusked,2015,1488,1975,487,32.72849462365591
Karad,Ladies Finger,2016,2387,2874,487,20.402178466694597
Kolhapur-Laxmipuri,Spilt Gerrn Gram,2016,9513,10000,487,5.119310417323662
Akluj,Tomato,2015,555,1042,487,87.74774774774775
Lasur Station,Wheat(Husked),2016,1681,2168,487,28.9708506841166
Jalgaon Jamod-Aasalgaon,Gram,2016,5013,5500,487,9.7147416716537
Akola,Soybean,2016,3541,4028,487,13.753177068624682
Nandura,Gram,2015,3550,4037,487,13.71830985915493
Basmat,Pigeon Pea (Tur),2015,5151,5638,487,9.454474859250631
Shrirampur,Tomato,2015,1471,1958,487,33.10673011556764
Kille Dharur,Wheat(Husked),2016,1746,2232,486,27.835051546391753
Patan,Green Chilli,2015,1427,1913,486,34.05746320953048
Kalyan,Flower,2015,1027,1513,486,47.32229795520935
Solapur,Matki,2014,5982,6468,486,8.124373119358074
Kurdwadi,Sorgum(Jawar),2016,1677,2163,486,28.980322003577818
Chandrapur-Ganjwad,Tomato,2015,600,1086,486,81.0
Lasur Station,Wheat(Husked),2016,1516,2002,486,32.05804749340369
Amarawati-Fruit And Vegetables,Papai,2016,1821,2307,486,26.68863261943987
Nagpur,Onion,2016,364,850,486,133.5164835164835
Jamkhed,BLACK GRAM,2016,6314,6800,486,7.697180867912575
Jalgaon,Cabbage,2016,533,1019,486,91.18198874296435
Amarawati,Tomato,2016,2671,3157,486,18.19543242231374
Nagpur,Paddy-Unhusked,2015,1509,1995,486,32.20675944333996
Parshiwani,Pigeon Pea (Tur),2016,8071,8557,486,6.021558666831867
Vani,Pigeon Pea (Tur),2016,8109,8595,486,5.993340732519423
Kamthi,Methi (Bhaji),2015,493,979,486,98.58012170385396
Manmad,Sorgum(Jawar),2016,1440,1926,486,33.75
Ramtek,Bitter Gourd,2015,1757,2243,486,27.660785429709733
Shahapur,Ladies Finger,2015,2323,2809,486,20.921222557038313
Beed,Bajri,2015,1327,1813,486,36.623963828183875
Akluj,Potato,2016,1424,1910,486,34.12921348314607
Majalgaon,Gram,2016,6134,6620,486,7.923051842191066
Nandurbar,Pigeon Pea (Tur),2016,6090,6576,486,7.980295566502463
Purna,Pigeon Pea (Tur),2016,6959,7445,486,6.983762034775111
Karad,Bitter Gourd,2014,2500,2986,486,19.44
Mumbai,Ladies Finger,2015,1906,2392,486,25.498426023084996
Panvel,Bitter Gourd,2014,3871,4357,486,12.554895375871867
Baramati,Sunflower,2016,3056,3541,485,15.870418848167539
Mumbai,Bitter Gourd,2015,1996,2481,485,24.298597194388776
Nandura,Sesamum,2015,6469,6954,485,7.497294790539496
Parli-Vaijnath,Gram,2015,2228,2713,485,21.768402154398565
Satara,Tomato,2015,807,1292,485,60.09913258983891
Pune-Pimpri,Ground Nut Pods (Dry),2016,3200,3685,485,15.15625
Junnar,Potato,2016,486,971,485,99.79423868312757
Jalna,Soybean,2015,3147,3632,485,15.411503018748014
Malegaon,BAJRI,2016,1332,1817,485,36.411411411411414
Satara,Green Chilli,2014,1778,2263,485,27.277840269966255
Vai,LADIES FINGER,2016,2050,2535,485,23.658536585365855
Chalisgaon,Onion,2016,322,807,485,150.62111801242236
Majalgaon,Wheat(Husked),2016,1571,2056,485,30.872056015276893
Tumsar,Other Pulses,2015,1951,2436,485,24.85904664274731
Karad,Bitter Gourd,2014,2200,2685,485,22.045454545454547
Vaijapur,GRAM,2016,7418,7903,485,6.538150444863844
Jalgaon,Cucumber,2014,1015,1500,485,47.783251231527096
Pusad,Soybean,2016,3358,3843,485,14.443120905300773
Shahapur,Bitter Gourd,2014,2892,3377,485,16.770401106500692
Karanja,Wheat(Husked),2015,1221,1706,485,39.72153972153972
Shrirampur,Green Chilli,2015,1200,1685,485,40.416666666666664
Phaltan,Wheat(Husked),2016,1600,2085,485,30.3125
Jalgaon,Cabbage,2016,505,990,485,96.03960396039604
Shrirampur,Lemon,2015,1435,1920,485,33.79790940766551
Karad,Shevga,2016,1950,2435,485,24.871794871794872
Vai,Ginger (Fresh),2016,2761,3246,485,17.56609923940601
Kalmeshwar,Gram,2015,3451,3936,485,14.05389742103738
Vai,Ladies Finger,2015,2900,3385,485,16.724137931034484
Pimpalgaon (B)-Saykheda,Onion,2016,319,804,485,152.03761755485894
Kalvan,Bajri,2016,1480,1965,485,32.770270270270274
Vita,Potato,2016,977,1462,485,49.6417604912999
Aurangabad,Wal Bhaji,2015,1110,1595,485,43.693693693693696
Satara,Carrot,2016,1025,1510,485,47.31707317073171
Mangrulpeer,Soybean,2014,2697,3182,485,17.982944011865037
Shrirampur,Lemon,2014,1705,2190,485,28.44574780058651
Baramati,Bajri,2015,1453,1938,485,33.37921541637991
Karad,Ghevda,2016,1588,2072,484,30.478589420654913
Karad,Ginger (Fresh),2016,1284,1768,484,37.69470404984423
Shahapur,Capsicum,2015,1133,1617,484,42.71844660194175
Paithan,Green Gram,2016,4076,4560,484,11.874386653581944
Parli-Vaijnath,Pigeon Pea (Tur),2014,3808,4292,484,12.710084033613445
Khed-Chakan,Flower,2016,872,1356,484,55.5045871559633
Chandrapur,Pigeon Pea (Tur),2016,6921,7405,484,6.9932090738332615
Mangrulpeer,Soybean,2015,2848,3332,484,16.99438202247191
Aurangabad,Wal Bhaji,2015,1284,1768,484,37.69470404984423
Karad,Cluster Bean,2016,2588,3072,484,18.701700154559507
Nagpur,Onion,2016,319,803,484,151.72413793103448
Katol,Pigeon Pea (Tur),2016,5545,6029,484,8.72858431018936
Karanja,Pigeon Pea (Tur),2014,4227,4711,484,11.450201088242252
Armori,Ground Nut Pods (Dry),2015,3630,4114,484,13.333333333333334
Nashik,Shahale ,2015,1633,2117,484,29.638701775872626
Shegaon,Gram,2015,3869,4353,484,12.509692426983717
Satara,Pavtta,2015,1444,1928,484,33.51800554016621
Hingoli,Turmeric,2016,8013,8497,484,6.040184699862723
Nagpur,Wal Bhaji,2015,2033,2517,484,23.80718150516478
Mumbai-Fruit Market,Mosambi,2016,1280,1764,484,37.8125
Jalgaon,Black Gram,2014,4611,5095,484,10.496638473216223
Karad,Bitter Gourd,2016,2992,3476,484,16.176470588235293
Khed-Chakan,Capsicum,2016,1962,2446,484,24.668705402650357
Mumbai,Water Melon,2016,614,1098,484,78.82736156351791
Manora,Black Gram,2015,8333,8817,484,5.808232329293172
Pune,Lentil,2014,6091,6575,484,7.946150057461829
Jalgaon,Coriander (Dry),2016,8369,8853,484,5.783247699844665
Kolhapur,Sweet Potato,2016,383,867,484,126.37075718015666
Pathardi,Cotton,2016,4183,4667,484,11.57064307912981
Hingna,Soybean,2015,3083,3567,484,15.698994485890367
Mumbai-Fruit Market,Orange,2016,1479,1963,484,32.72481406355646
Pune,FLOWER,2016,456,940,484,106.14035087719299
Balapur,Green Gram,2015,6533,7017,484,7.408541252104699
Karad,Brinjal,2016,1656,2140,484,29.22705314009662
Chandrapur-Ganjwad,Raddish,2014,917,1400,483,52.67175572519084
Amarawati,Linseed,2016,6767,7250,483,7.13757942958475
Mumbai,Curry Leaves,2015,1126,1609,483,42.89520426287744
Sangali,Green Peas (Dry),2016,3000,3483,483,16.1
Telhara,GREEN GRAM,2016,4298,4781,483,11.237785016286646
Jalgaon Jamod-Aasalgaon,Soybean,2016,3217,3700,483,15.013988187752565
Pathari,Black Gram,2016,5734,6217,483,8.423439134984305
Amarawati,Gram,2015,2684,3167,483,17.995529061102832
Ahmednagar,Pigeon Pea (Tur),2015,5767,6250,483,8.375238425524536
Satara,Bottle Gourd,2016,1000,1483,483,48.3
Kalmeshwar,Gram,2015,4028,4511,483,11.991062562065542
Barshi,Wheat(Husked),2016,1613,2096,483,29.94420334779913
Khed,Cucumber,2016,317,800,483,152.36593059936908
Indapur-Bhigwan,Ground Nut Pods (Dry),2016,3617,4100,483,13.35360796239978
Rahata,Shevga,2016,1367,1850,483,35.332845647403076
Jalgaon,Onion,2016,342,825,483,141.2280701754386
Amarawati,Cluster Bean,2016,3676,4159,483,13.139281828073994
Kalyan,Tomato,2015,1217,1700,483,39.68775677896467
Ahmednagar,Cabbage,2015,750,1233,483,64.4
Dhule,Sesamum,2014,10465,10948,483,4.615384615384615
Hinganghat,Soybean,2015,3011,3494,483,16.041182331451346
Dhamangaon-Rly,Gram,2015,3267,3750,483,14.784205693296602
Ramtek,Lemon,2015,1050,1533,483,46.0
Pune-Pimpri,TOMATO,2016,710,1193,483,68.02816901408451
Akola,Sunflower,2016,4177,4660,483,11.563322959061528
Solapur,Cabbage,2016,410,893,483,117.8048780487805
Dhamangaon-Rly,PIGEON PEA (TUR),2016,5133,5616,483,9.409701928696668
Chikhali,Wheat(Husked),2016,1364,1847,483,35.410557184750736
Kalamb (Yawatmal),Pigeon Pea (Tur),2016,8268,8751,483,5.8417997097242385
Akole,Soybean,2016,3400,3883,483,14.205882352941176
Kalvan,Ground Nut Pods (Dry),2016,3867,4350,483,12.490302560124126
Akola,Wheat(Husked),2016,2062,2545,483,23.423860329776915
Shegaon,Soybean,2015,2973,3456,483,16.24621594349142
Kalyan,Black Gram,2015,8000,8483,483,6.0375
Mumbai,Flower,2016,1178,1661,483,41.00169779286927
Ratanagari,Tomato,2015,529,1012,483,91.30434782608695
Nashik-Devlali,Methi (Bhaji),2016,415,898,483,116.3855421686747
Shegaon,Soybean,2015,3150,3633,483,15.333333333333334
Patur,Wheat(Husked),2015,1300,1783,483,37.15384615384615
Hingna,Pigeon Pea (Tur),2015,4834,5317,483,9.991725279271824
Amarawati,Black Gram,2015,5766,6249,483,8.376690946930282
Mumbai,Arvi,2016,1100,1583,483,43.90909090909091
Rahata,Tomato,2016,650,1133,483,74.3076923076923
Karad,Tomato,2014,1167,1650,483,41.38817480719794
Dhamangaon-Rly,Cotton,2016,4488,4971,483,10.762032085561497
Sangali,Soybean,2015,3229,3712,483,14.958191390523382
Amarawati,Mosambi,2015,1739,2222,483,27.77458309373203
Pune-Manjri,Bottle Gourd,2016,771,1254,483,62.64591439688716
Vai,Pavata,2015,2225,2708,483,21.707865168539325
Majalgaon,Gram,2016,6963,7446,483,6.936665230504093
Tumsar,Linseed,2016,4969,5452,483,9.720265647011471
Mumbai,Capsicum,2015,2900,3383,483,16.655172413793103
Kalyan,Ladies Finger,2016,3213,3696,483,15.032679738562091
Sinner,Soybean,2015,3188,3671,483,15.15056461731493
Kalyan,Flower,2016,950,1433,483,50.8421052631579
Latur,Soybean,2015,3359,3841,482,14.349508782375707
Shahapur,Ghosali(Bhaji),2015,1000,1482,482,48.2
Dound,Sorgum(Jawar),2015,1587,2069,482,30.37177063642092
Mumbai,Split Lentil,2015,7273,7755,482,6.627251478069573
Jalgaon,Potato,2015,601,1083,482,80.19966722129784
Telhara,Pigeon Pea (Tur),2016,8046,8528,482,5.990554312701963
Pune,Sorgum(Jawar),2015,2395,2877,482,20.12526096033403
Ramtek,Bitter Gourd,2016,1800,2282,482,26.77777777777778
Junnar,Onion,2016,544,1026,482,88.6029411764706
Morshi,Green Chilli,2014,1718,2200,482,28.055878928987195
Dhule,Matki,2016,6761,7243,482,7.12912291081201
Khed-Chakan,Tomato,2016,656,1138,482,73.47560975609755
Pune-Moshi,Onion,2016,478,960,482,100.83682008368201
Nandurbar,Sunflower,2016,2866,3348,482,16.817864619678996
Karad,Pavata,2016,1270,1752,482,37.95275590551181
Mangalwedha,Wheat(Husked),2015,1698,2180,482,28.386336866902237
Kalyan,Bitter Gourd,2015,1718,2200,482,28.055878928987195
Karad,Bitter Gourd,2016,2386,2868,482,20.201173512154234
Nashik-Devlali,RADDISH,2016,732,1214,482,65.84699453551913
Pune,Cabbage,2015,435,917,482,110.80459770114942
Lasur Station,Pigeon Pea (Tur),2016,7911,8393,482,6.092782201997219
Murtizapur,Green Gram,2015,7195,7677,482,6.69909659485754
Babhulgaon,Soybean,2016,3242,3724,482,14.8673658235657
Umared,Other Pulses,2016,5901,6383,482,8.168107100491442
Jalna,Soybean,2016,3197,3679,482,15.076634344698155
Pune-Pimpri,Ghevda,2016,3006,3488,482,16.03459747172322
Katol,Pigeon Pea (Tur),2016,5285,5767,482,9.120151371807001
Amarawati-Fruit And Vegetables,Onion,2016,659,1141,482,73.14112291350531
Amarawati,Ground Nut Pods (Dry),2016,4356,4838,482,11.065197428833793
Anajngaon Surji,Soybean,2016,2445,2927,482,19.713701431492844
Jalgaon,Tomato,2016,998,1480,482,48.296593186372746
Rahuri-Vambori,Gram,2014,2165,2647,482,22.263279445727484
Sangamner,Tomato,2014,505,986,481,95.24752475247524
Akot,Soybean,2016,2961,3442,481,16.24451198919284
Pune,Cabbage,2015,367,848,481,131.06267029972753
Nagpur,Papai,2015,525,1006,481,91.61904761904762
Shrirampur,Ladies Finger,2015,1157,1638,481,41.57303370786517
Umared,Green Gram,2015,5963,6444,481,8.066409525406675
Karad,Bottle Gourd,2016,1192,1673,481,40.352348993288594
Shirpur,Soybean,2014,2583,3064,481,18.62175764614789
Pimpalgaon (B)-Saykheda,Onion,2016,270,751,481,178.14814814814815
Lasalgaon-Niphad,Onion,2016,175,656,481,274.85714285714283
Lasalgaon-Niphad,Onion,2016,348,829,481,138.2183908045977
Kalamb (Os),Wheat(Husked),2014,1346,1827,481,35.73551263001486
Barshi-Vairag,Black Gram,2016,7007,7488,481,6.8645640074211505
Anajngaon Surji,Soybean,2016,3246,3727,481,14.818237831176834
Anajngaon Surji,Pigeon Pea (Tur),2014,4364,4845,481,11.021998166819431
Akola,Black Gram,2016,8938,9419,481,5.381517117923472
Kolhapur-Laxmipuri,Cowpea,2016,5144,5625,481,9.350699844479005
Karanja,Soybean,2015,3271,3752,481,14.704983185570162
Mumbai-Fruit Market,PAPAI,2016,588,1069,481,81.80272108843538
Ulhasnagar,Onion,2016,804,1285,481,59.82587064676617
Dhule,Bajri,2014,1005,1486,481,47.86069651741293
Mumbai,Chikoo,2015,969,1450,481,49.63880288957689
Pandharpur,CABBAGE,2016,315,796,481,152.6984126984127
Beed,Gram,2016,3897,4378,481,12.342827816268924
Loha,Wheat(Husked),2016,1533,2014,481,31.37638617090672
Ambad(Vadi Godri),Pigeon Pea (Tur),2014,4869,5350,481,9.878825220784556
Sillod,SOYBEAN,2016,2243,2724,481,21.444493981275077
Nagpur,Ladies Finger,2016,2052,2533,481,23.44054580896686
Dondaicha,Wheat(Husked),2016,1492,1973,481,32.238605898123325
Ausa,GREEN GRAM,2016,4390,4871,481,10.956719817767654
Solapur,Banana,2015,392,873,481,122.70408163265306
Nandura,Green Gram,2016,7593,8074,481,6.334782036085868
Shegaon,Gram,2016,5167,5648,481,9.30907683375266
Pune-Pimpri,Cucumber,2016,1376,1857,481,34.95639534883721
Pune,Squash Gourd,2015,505,986,481,95.24752475247524
Barshi,Pigeon Pea (Tur),2015,5421,5902,481,8.872901678657074
Nagpur,Dhemse,2015,1700,2181,481,28.294117647058822
Himayatnagar,Green Gram,2015,8520,9000,480,5.633802816901408
Paranda,Maize,2015,1200,1680,480,40.0
Pune,Squash Gourd,2015,385,865,480,124.67532467532467
Amarawati,Capsicum,2016,4475,4955,480,10.726256983240223
Gangapur,Pigeon Pea (Tur),2014,4394,4874,480,10.923987255348202
Anajngaon Surji,Green Gram,2015,7372,7852,480,6.511123168746609
Kalyan,Shevga,2016,2333,2813,480,20.574367766823833
Aurangabad,Cucumber,2015,860,1340,480,55.81395348837209
Ausa,Gram,2016,3778,4258,480,12.70513499205929
Osmanabad,Kharbuj,2016,1260,1740,480,38.095238095238095
Akluj,Banana,2015,150,630,480,320.0
Pune-Manjri,Papai,2016,2360,2840,480,20.338983050847457
Ahmedpur,Gram,2015,3908,4388,480,12.282497441146367
Amarawati,Potato,2015,750,1230,480,64.0
Vai,Pavata,2016,3270,3750,480,14.678899082568808
Phaltan,Wheat(Husked),2014,1567,2047,480,30.63178047223995
Jalgaon Jamod-Aasalgaon,Pigeon Pea (Tur),2014,4360,4840,480,11.009174311926605
Jintur-Bori,Gram,2015,2501,2981,480,19.192323070771693
Nagpur,Papai,2015,560,1040,480,85.71428571428571
Nandgaon Khandeshwar,Pigeon Pea (Tur),2015,5800,6280,480,8.275862068965518
Nandurbar,Sorgum(Jawar),2016,1412,1892,480,33.994334277620396
Pune,Cabbage,2014,396,876,480,121.21212121212122
Balapur,Pigeon Pea (Tur),2016,8270,8750,480,5.804111245465538
Chandrapur-Ganjwad,Brinjal,2015,280,760,480,171.42857142857142
Nagpur,Sorgum(Jawar),2014,1600,2080,480,30.0
Mumbai,Snake Gourd,2016,1860,2340,480,25.806451612903224
Akola,Pigeon Pea (Tur),2014,4491,4971,480,10.68804275217101
Akole,Soybean,2015,2960,3440,480,16.216216216216218
Satara,Cucumber,2015,970,1450,480,49.48453608247423
Partur,Green Gram,2015,7324,7804,480,6.553795740032769
Dound,Sorgum(Jawar),2015,1571,2051,480,30.553787396562697
Chopda,Black Gram,2014,4384,4864,480,10.94890510948905
Chandrapur-Ganjwad,Capsicum,2016,1160,1640,480,41.37931034482759
Vaijapur,Ground Nut Pods (Dry),2014,3365,3845,480,14.264487369985142
Shahapur,Cucumber,2016,1620,2100,480,29.62962962962963
Aurangabad,Bitter Gourd,2014,2072,2552,480,23.166023166023166
Kalyan,Orange,2016,2660,3140,480,18.045112781954888
Shahapur,Cluster Bean,2015,1600,2080,480,30.0
Murbad,Ghosali(Bhaji),2016,4400,4880,480,10.909090909090908
Kalyan,Bitter Gourd,2016,2660,3140,480,18.045112781954888
Balapur,Wheat(Husked),2015,1330,1810,480,36.090225563909776
Jalna,Bajri,2016,1358,1838,480,35.34609720176731
Kolhapur,Mango,2015,1766,2246,480,27.180067950169875
Satara,Bottle Gourd,2016,764,1244,480,62.82722513089005
Pune-Manjri,Rajgira,2015,660,1140,480,72.72727272727273
Pachora,Pigeon Pea (Tur),2016,5262,5742,480,9.122006841505131
Ahmednagar,Potato,2016,570,1050,480,84.21052631578948
Shevgaon,Gram,2015,3310,3790,480,14.501510574018127
Akole,Wheat(Husked),2015,1500,1980,480,32.0
Kalyan,Tomato,2016,4530,5010,480,10.596026490066226
Amarawati-Fruit And Vegetables,Methi (Bhaji),2016,2980,3460,480,16.107382550335572
Sinner,Matki,2016,5438,5918,480,8.826774549466716
Ramtek,Chavli (Shenga ),2016,2302,2782,480,20.851433536055605
Mumbai,Shevga,2015,2272,2752,480,21.12676056338028
Jalgaon,Squash Gourd,2015,650,1130,480,73.84615384615384
Patan,Ladies Finger,2014,2507,2986,479,19.106501794974072
Mumbai,Ladies Finger,2015,3004,3483,479,15.945406125166445
Sangali,Bajri,2015,1282,1761,479,37.36349453978159
Vai,Green Chilli,2015,1943,2422,479,24.65259907359753
Bhivandi,Onion,2015,1585,2064,479,30.22082018927445
Gevrai,Pigeon Pea (Tur),2016,7909,8388,479,6.056391452775319
Nilanga,Gram,2014,2285,2764,479,20.962800875273523
Osmanabad,Gram,2016,5148,5627,479,9.304584304584305
Pune-Pimpri,Bottle Gourd,2015,954,1433,479,50.20964360587002
Malegaon (Washim),Soybean,2016,2508,2987,479,19.098883572567782
Mangrulpeer,Wheat(Husked),2016,1553,2032,479,30.843528654217643
Kamthi,CABBAGE,2016,566,1045,479,84.62897526501767
Jalna,Soybean,2014,2634,3113,479,18.185269552012148
Sailu,Gram,2015,3851,4330,479,12.438327707089067
Tumsar,Gram,2016,5895,6374,479,8.125530110262934
Pune,Squash Gourd,2015,379,858,479,126.38522427440633
Rahuri-Vambori,Green Gram,2016,4618,5097,479,10.372455608488524
Pune-Manjri,Flower,2015,600,1079,479,79.83333333333333
Kamthi,Carrot,2016,650,1129,479,73.6923076923077
Satara,Cucumber,2014,805,1284,479,59.50310559006211
Akluj,Potato,2015,984,1463,479,48.67886178861789
Ratanagari,Cabbage,2016,979,1458,479,48.92747701736466
Washim,Green Gram,2014,5691,6170,479,8.416798453698823
Kalyan,Bitter Gourd,2016,4089,4568,479,11.714355588163365
Sangali,Bajri,2015,1303,1782,479,36.761320030698386
Lasalgaon,Wheat(Husked),2015,1450,1929,479,33.03448275862069
Ahmednagar,Sorgum(Jawar),2015,1622,2100,478,29.469790382244142
Akkolkot,Wheat(Unhusked),2015,2620,3098,478,18.244274809160306
Khamgaon,Soybean,2014,2713,3191,478,17.61887209730925
Nagpur,Chavli (Shenga ),2016,2900,3378,478,16.482758620689655
Majalgaon,Sorgum(Jawar),2016,1292,1770,478,36.9969040247678
Karad,Ghevda,2016,1270,1748,478,37.63779527559055
Pune-Pimpri,Ghosali(Bhaji),2015,2589,3067,478,18.462726921591347
Malkapur,Green Gram,2015,6776,7254,478,7.0543093270365995
Shahapur,Ghosali(Bhaji),2016,2478,2956,478,19.289749798224374
Shirpur,Soybean,2014,2780,3258,478,17.194244604316548
Naigaon,Green Gram,2015,7392,7870,478,6.466450216450217
Arvi,Gram,2015,3338,3816,478,14.319952067106051
Chandur Bajar,Gram,2016,3957,4435,478,12.079858478645438
Umared,Soybean,2015,2800,3278,478,17.071428571428573
Aurangabad,Mango(Raw),2015,727,1205,478,65.74965612104539
Palus,TOMATO,2016,772,1250,478,61.917098445595855
Shegaon,Soybean,2014,2918,3396,478,16.381082933516108
Karad,Onion,2016,526,1004,478,90.8745247148289
Kada,Gram,2014,2153,2631,478,22.20157919182536
Pune-Manjri,Flower,2015,535,1013,478,89.34579439252336
Kalmeshwar,Soybean,2016,3084,3562,478,15.49935149156939
Dudhani,Gram,2014,2150,2628,478,22.232558139534884
Majalgaon,Bajri,2015,1549,2027,478,30.858618463524856
Jalgaon,Potato,2016,1053,1531,478,45.394112060778724
Kalyan,Black Gram,2015,5630,6108,478,8.490230905861457
Karad,Carrot,2015,800,1278,478,59.75
Mumbai,Curry Leaves,2014,1185,1663,478,40.33755274261603
Nandgaon Khandeshwar,Soybean,2016,2905,3383,478,16.454388984509468
Murbad,Ghosali(Bhaji),2016,3311,3789,478,14.436726064633042
Kamthi,Bottle Gourd,2016,483,961,478,98.9648033126294
Sangli-Phale Bhajipalam,Potato,2016,1248,1726,478,38.30128205128205
Aarni,Soybean,2015,3227,3705,478,14.812519367833902
Mangrulpeer,Gram,2016,5148,5626,478,9.285159285159285
Indapur-Bhigwan,Bajri,2015,1425,1903,478,33.54385964912281
Mantha,Pigeon Pea (Tur),2015,5122,5600,478,9.332292073408825
Amarawati,Green Gram,2015,7003,7481,478,6.825646151649293
Karanja,Batbati,2015,4850,5328,478,9.855670103092784
Manwat,Gram,2015,3805,4282,477,12.536136662286465
Mohol,Sorgum(Jawar),2015,1628,2105,477,29.2997542997543
Shrirampur,Brinjal,2015,1350,1827,477,35.333333333333336
Shirpur,Onion,2016,118,595,477,404.23728813559325
Rahata,Flower,2016,1177,1654,477,40.5267629566695
Shrirampur,Papai,2015,1000,1477,477,47.7
Mohol,Sorgum(Jawar),2015,1564,2041,477,30.498721227621484
Pune,Beet Root,2016,482,959,477,98.96265560165975
Shirpur,Bajri,2014,874,1351,477,54.5766590389016
Chalisgaon,Gram,2015,3536,4013,477,13.489819004524886
Akluj,Bor,2016,931,1408,477,51.235230934479056
Jalgaon,Cucumber,2015,867,1344,477,55.017301038062286
Dhule,Bajri,2016,1116,1593,477,42.74193548387097
Aurangabad,Carrot,2016,956,1433,477,49.89539748953975
Risod,Pigeon Pea (Tur),2014,4515,4992,477,10.564784053156146
Digras,Gram,2016,6525,7002,477,7.310344827586207
Parbhani,Green Gram,2014,6468,6945,477,7.374768089053803
Risod,Gram,2016,3972,4449,477,12.009063444108762
Shrirampur,Tomato,2016,1331,1808,477,35.83771600300526
Shegaon,Green Gram,2014,7793,8270,477,6.120877710766072
Kannad,Wheat(Husked),2016,1613,2090,477,29.572225666460014
Sinner,Gram,2015,3944,4421,477,12.094320486815416
Junnar-Otur,Onion,2016,533,1010,477,89.49343339587242
Pune,Cabbage,2016,298,775,477,160.06711409395973
Parbhani,Pigeon Pea (Tur),2015,6116,6593,477,7.7992151733158925
Latur,Bajri,2015,1397,1874,477,34.14459556191839
Pune-Manjri,Tomato,2014,523,1000,477,91.20458891013385
Shahapur,Ghosali(Bhaji),2016,1646,2123,477,28.979343863912515
Kalyan,Ghevda,2016,2488,2965,477,19.172025723472668
Dondaicha,Wheat(Husked),2015,1402,1879,477,34.0228245363766
Karad,Cluster Bean,2016,1585,2062,477,30.094637223974765
Dondaicha,Matki,2015,6551,7027,476,7.266066249427569
Umared,Soybean,2015,2922,3398,476,16.290212183436
Pathardi,Bajri,2016,1295,1771,476,36.75675675675676
Kamthi,Tomato,2016,527,1003,476,90.3225806451613
Mumbai,Green-Peas,2016,1952,2428,476,24.385245901639344
Baramati,Sunflower,2016,2963,3439,476,16.064799190010124
Baramati,Soybean,2016,3250,3726,476,14.646153846153846
Indapur-Bhigwan,Ground Nut Pods (Dry),2016,5150,5626,476,9.242718446601941
Washim,Gram,2014,2876,3352,476,16.55076495132128
Aarni,Gram,2016,3800,4276,476,12.526315789473685
Malegaon,Gram,2016,7250,7726,476,6.56551724137931
Lasalgaon,Wheat(Husked),2015,1528,2004,476,31.151832460732983
Mantha,Sorgum(Jawar),2015,1143,1619,476,41.644794400699915
Murbad,Ladies Finger,2016,2648,3124,476,17.97583081570997
Sangli-Phale Bhajipalam,Potato,2016,1024,1500,476,46.484375
Majalgaon,Safflower,2016,2650,3126,476,17.962264150943398
Beed,Sorgum(Jawar),2016,1643,2119,476,28.971393791844186
Karad,Potato,2016,1128,1604,476,42.198581560283685
Vai,Brinjal,2016,1488,1964,476,31.989247311827956
Pune,TOMATO,2016,328,804,476,145.1219512195122
Karad,Chikoo,2016,1329,1805,476,35.816403310759966
Chopda,Green Gram,2015,5921,6397,476,8.039182570511738
Bhokar,Turmeric,2014,4416,4892,476,10.778985507246377
Chandrapur-Ganjwad,Chavli (Pala),2014,848,1324,476,56.132075471698116
Mumbai,FRENCH BEAN,2016,1362,1838,476,34.948604992657856
Shirpur,Wheat(Husked),2015,1470,1946,476,32.38095238095238
Shrigonda,Onion,2016,175,650,475,271.42857142857144
Nandurbar,Wheat(Husked),2016,1509,1984,475,31.477799867461897
Partur,Soybean,2015,3251,3726,475,14.610888957243924
Nagpur,Ground Nut Pods (Dry),2016,3138,3613,475,15.137029955385596
Aurangabad,Kharbuj,2015,1275,1750,475,37.254901960784316
Koregaon,Sorgum(Jawar),2016,1600,2075,475,29.6875
Taloda,Green Gram,2015,6716,7191,475,7.072662298987493
Akole,Paddy-Unhusked,2014,1425,1900,475,33.333333333333336
Deglur,Black Gram,2016,6700,7175,475,7.08955223880597
Mantha,Pigeon Pea (Tur),2016,8200,8675,475,5.7926829268292686
Vai,Ladies Finger,2015,2994,3469,475,15.865063460253841
Solapur,Matki,2015,5550,6025,475,8.558558558558559
Lonand,Bajri,2014,1263,1738,475,37.608867775138556
Kamthi,Raddish,2016,300,775,475,158.33333333333334
Jalgaon,Coriander (Dry),2015,9658,10133,475,4.918202526402982
Karad,Pavata,2015,2400,2875,475,19.791666666666668
Pusad,Soybean,2016,3290,3765,475,14.437689969604863
Indapur-Bhigwan,Ground Nut Pods (Dry),2016,4956,5431,475,9.584342211460855
Aurangabad,Capsicum,2016,2058,2533,475,23.080660835762878
Nagpur,Ginger (Fresh),2015,2500,2975,475,19.0
Vai,Pavata,2015,3100,3575,475,15.32258064516129
Rahata,Bitter Gourd,2014,1150,1625,475,41.30434782608695
Patan,Cucumber,2015,1300,1775,475,36.53846153846154
Darwha,Pigeon Pea (Tur),2015,5000,5475,475,9.5
Mehkar,Gram,2016,4882,5357,475,9.72961900860303
Ahmednagar,Tamarind,2016,4900,5375,475,9.693877551020408
Vaijapur,Pigeon Pea (Tur),2016,8094,8569,475,5.868544600938967
Beed,Sesamum,2015,10193,10668,475,4.660060826057098
Karad,Ginger (Fresh),2015,2125,2600,475,22.352941176470587
Kalyan,Green Chilli,2016,1275,1750,475,37.254901960784316
Murum,GRAM,2016,6875,7350,475,6.909090909090909
Satara,Potato,2015,663,1138,475,71.64404223227753
Hadgaon-Tamsa,Wheat(Husked),2016,1525,2000,475,31.147540983606557
Solapur,Bajri,2015,951,1426,475,49.94742376445846
Akkolkot,Pigeon Pea (Tur),2015,5568,6043,475,8.530890804597702
Shrigonda,Sorgum(Jawar),2016,1675,2150,475,28.35820895522388
Ulhasnagar,Potato,2016,800,1275,475,59.375
Chalisgaon,Gram,2014,2180,2655,475,21.788990825688074
Solapur,Green Peas (Dry),2016,3675,4150,475,12.92517006802721
Baramati,Jaggery,2014,2860,3335,475,16.60839160839161
Amalner,Soybean,2016,2892,3367,475,16.424619640387274
Dound,Bajri,2015,1387,1862,475,34.24657534246575
Sailu,Gram,2015,3726,4201,475,12.74825550187869
Washim,Gram,2015,4684,5159,475,10.140905209222886
Solapur,Papai,2016,471,946,475,100.84925690021231
Patur,Green Gram,2015,5175,5650,475,9.178743961352657
Ambejogai,Gram,2015,3540,4015,475,13.418079096045197
Umari,Pigeon Pea (Tur),2016,7488,7963,475,6.343482905982906
Satara,Capsicum,2015,963,1438,475,49.32502596053998
Karad,Ghevda,2016,3813,4288,475,12.457382638342512
Shevgaon-Bodhegaon,Gram,2016,6083,6558,475,7.808647049153378
Shahapur,Ladies Finger,2015,1113,1588,475,42.677448337825695
Dound,Cowpea,2015,6200,6675,475,7.661290322580645
Baramati,Bajri,2016,1651,2126,475,28.770442156268928
Shrirampur,Bitter Gourd,2015,1435,1910,475,33.10104529616725
Kada,Green Gram,2016,4250,4725,475,11.176470588235293
Junnar-Otur,BRINJAL,2016,440,915,475,107.95454545454545
Nira,Wheat(Husked),2015,1575,2050,475,30.158730158730158
Ahmedpur,Pigeon Pea (Tur),2016,8201,8676,475,5.791976588220948
Jintur,Pigeon Pea (Tur),2016,5700,6175,475,8.333333333333334
Palus,LADIES FINGER,2016,1263,1738,475,37.608867775138556
Kolhapur,Wal Papdi,2015,1300,1775,475,36.53846153846154
Rahata,Bitter Gourd,2015,1325,1800,475,35.84905660377358
Yeola,Gram,2015,3647,4122,475,13.024403619413217
Chandvad,Onion,2016,438,913,475,108.44748858447488
Satara,Onion,2016,375,850,475,126.66666666666667
Akole,Paddy-Unhusked,2015,1450,1925,475,32.758620689655174
Baramati,Pigeon Pea (Tur),2015,4100,4575,475,11.585365853658537
Paranda,Sorgum(Jawar),2016,1465,1940,475,32.42320819112628
Chopda,Sunflower,2014,2388,2863,475,19.89112227805695
Jalgaon,Chavli (Shenga ),2014,2742,3217,475,17.323121808898613
Barshi,Bitter Gourd,2016,965,1440,475,49.22279792746114
Khamgaon,Sesamum,2015,5301,5776,475,8.960573476702509
Baramati,Jaggery,2015,1800,2275,475,26.38888888888889
Nira,Bajri,2015,1475,1950,475,32.20338983050848
Mangalwedha,Wheat(Husked),2016,1759,2234,475,27.003979533826037
Ramtek,Chavli (Pala),2015,1225,1700,475,38.775510204081634
Morshi,Pigeon Pea (Tur),2016,8450,8925,475,5.621301775147929
Parola,Gram,2016,3682,4157,475,12.900597501357957
Palus,Cabbage,2016,650,1125,475,73.07692307692308
Kolhapur,Potato,2016,1508,1983,475,31.49867374005305
Chikhali,WHEAT(HUSKED),2016,1517,1992,475,31.31179960448253
Karanja,Wheat(Husked),2016,1703,2177,474,27.833235466823254
Pune,Cabbage,2015,321,795,474,147.66355140186917
Nagpur,Dhemse,2016,3073,3547,474,15.424666449723397
Umarga,Wheat(Husked),2015,1243,1717,474,38.13354786806114
Kej,Pigeon Pea (Tur),2015,9526,10000,474,4.975855553222758
Junnar-Otur,Flower,2016,194,668,474,244.3298969072165
Shahapur,Brinjal,2015,1065,1539,474,44.50704225352113
Shahapur,Cucumber,2015,1026,1500,474,46.198830409356724
Mumbai,Potato,2015,1046,1520,474,45.31548757170172
Kada,Sorgum(Jawar),2015,1497,1971,474,31.663326653306612
Wardha,Pigeon Pea (Tur),2016,6146,6620,474,7.712333224861698
Pathari,Wheat(Husked),2015,1451,1925,474,32.6671261199173
Malegaon,Wheat(Husked),2016,1572,2046,474,30.15267175572519
Karad,Tomato,2015,1017,1491,474,46.607669616519175
Pune-Pimpri,Bottle Gourd,2015,1004,1478,474,47.211155378486055
Deglur,Black Gram,2014,4952,5426,474,9.5718901453958
Akot,Soybean,2016,3046,3520,474,15.56139198949442
Lasur Station,Bajri,2014,1126,1600,474,42.09591474245116
Latur,Sunflower,2016,2912,3386,474,16.27747252747253
Dudhani,Pigeon Pea (Tur),2015,6247,6721,474,7.587642068192732
Arvi,Pigeon Pea (Tur),2016,8608,9082,474,5.506505576208179
Karanja,Gram,2014,2278,2752,474,20.807726075504828
Chalisgaon,Onion,2016,276,750,474,171.7391304347826
Shrirampur,Wheat(Husked),2016,1493,1967,474,31.74815807099799
Basmat,Pigeon Pea (Tur),2016,7350,7824,474,6.448979591836735
Raver,Wheat(Husked),2015,1036,1510,474,45.75289575289575
Sangamner,Bajri,2016,1522,1996,474,31.14323258869908
Shahapur,Ghosali(Bhaji),2016,2353,2827,474,20.14449638759031
Mohol,Sorgum(Jawar),2016,1665,2139,474,28.46846846846847
Chikhali,Wheat(Husked),2016,1324,1798,474,35.80060422960725
Akola,Black Gram,2015,5194,5668,474,9.125914516750097
Kalyan,Ladies Finger,2015,2039,2513,474,23.246689553702794
Indapur-Bhigwan,Bajri,2015,1433,1907,474,33.07745987438939
Khed-Chakan,Cucumber,2016,857,1330,473,55.192532088681446
Ambad(Vadi Godri),Wheat(Husked),2015,1524,1997,473,31.036745406824146
Kamthi,Spinach,2016,380,853,473,124.47368421052632
Malkapur,Gram,2014,2173,2646,473,21.767142199723885
Nagpur,Mango(Raw),2016,3782,4255,473,12.506610259122157
Rahata,Brinjal,2015,618,1091,473,76.53721682847896
Nandura,Gram,2016,3765,4238,473,12.563081009296148
Satana,Gram,2015,2775,3248,473,17.045045045045047
Vai,Ladies Finger,2015,3636,4109,473,13.008800880088009
Dhule,Onion,2016,153,626,473,309.1503267973856
Akola,Green Gram,2016,4209,4682,473,11.237823711095272
Pune-Pimpri,Ridge Gourd,2015,2432,2905,473,19.449013157894736
Jalgaon,Papai,2015,845,1318,473,55.976331360946745
Telhara,Pigeon Pea (Tur),2016,5836,6309,473,8.104866346812885
Raver,Gram,2016,3712,4185,473,12.742456896551724
Navapur,GREEN CHILLI,2016,724,1197,473,65.33149171270718
Yeotmal,Pigeon Pea (Tur),2015,6723,7196,473,7.03554960583073
Kalyan,Green Chilli,2015,2227,2700,473,21.23933542882802
Jamkhed,Sorgum(Jawar),2016,1795,2268,473,26.350974930362117
Pune,Lentil,2016,6040,6513,473,7.83112582781457
Chandrapur-Ganjwad,Spinach,2014,916,1389,473,51.63755458515284
Pune,Lentil,2015,6618,7091,473,7.147174372922333
Kolhapur-Laxmipuri,Split Black Gram,2014,8587,9060,473,5.508326540118785
Nagpur,Cucumber,2015,1150,1623,473,41.130434782608695
Karad,Cucumber,2015,982,1455,473,48.16700610997963
Shrirampur,Brinjal,2015,1227,1700,473,38.54930725346373
Deulgaon Raja,Cotton,2016,4118,4591,473,11.486158329286061
Pune,Arvi,2016,2794,3267,473,16.929133858267715
Vai,Green-Peas,2015,2636,3109,473,17.943854324734446
Rahata,Potato,2014,2318,2791,473,20.405522001725625
Nandurbar,SORGUM(JAWAR),2016,1213,1686,473,38.99422918384172
Karad,Pavata,2016,1557,2030,473,30.37893384714194
Rahata,Bitter Gourd,2014,2136,2609,473,22.144194756554306
Shevgaon,Green Gram,2016,4356,4828,472,10.8356290174472
Mumbai,BITTER GOURD,2016,614,1086,472,76.8729641693811
Pune,Lentil,2015,6028,6500,472,7.8301260783012605
Dondaicha,Wheat(Husked),2015,1451,1923,472,32.529290144727774
Shahada,Sorgum(Jawar),2016,1417,1889,472,33.309809456598444
Chandrapur-Ganjwad,Potato,2016,676,1148,472,69.8224852071006
Naigaon,Soybean,2016,2380,2852,472,19.831932773109244
Pune,Wheat(Husked),2015,2249,2721,472,20.987105380168963
Kille Dharur,Bajri,2015,1405,1877,472,33.594306049822066
Vai,Cucumber,2016,1900,2372,472,24.842105263157894
Kolhapur,Jaggery,2016,3496,3968,472,13.501144164759726
Purna,Soybean,2016,3293,3765,472,14.333434558153659
Ulhasnagar,POTATO,2016,1222,1694,472,38.62520458265139
Shahada,SOYBEAN,2016,2338,2810,472,20.188195038494438
Mangrulpeer,Soybean,2015,2946,3418,472,16.021724372029873
Pandharkawada,Soybean,2014,2737,3209,472,17.245158933138473
Chalisgaon,Gram,2016,3784,4256,472,12.473572938689218
Karad,Brinjal,2016,1238,1710,472,38.12600969305331
Nagpur,Dhemse,2016,2438,2910,472,19.360131255127154
Nagpur,Dhemse,2016,2248,2720,472,20.99644128113879
Aurangabad,Capsicum,2015,1506,1978,472,31.341301460823374
Anajngaon Surji,Gram,2015,4023,4495,472,11.732537907034551
Anajngaon Surji,Soybean,2016,3339,3811,472,14.135968852949985
Shegaon,Soybean,2016,3109,3581,472,15.18173045995497
Pathardi,Wheat(Husked),2016,1628,2100,472,28.992628992628994
Ahmednagar,Cabbage,2016,155,627,472,304.51612903225805
Malkapur,Soybean,2014,2782,3254,472,16.966211358734725
Karad,Bitter Gourd,2016,1292,1764,472,36.53250773993808
Pune-Moshi,Capsicum,2016,1746,2218,472,27.033218785796105
Pune-Pimpri,Ladies Finger,2014,3164,3636,472,14.917825537294563
Udgir,Pigeon Pea (Tur),2016,6818,7290,472,6.922851276034027
Baramati,Wheat(Unhusked),2016,3344,3816,472,14.114832535885167
Junnar,Potato,2015,522,994,472,90.42145593869732
Parli-Vaijnath,Pigeon Pea (Tur),2015,5939,6411,472,7.947465903350732
Nagpur,CORIANDER ,2016,1506,1978,472,31.341301460823374
Karad,Flower,2016,952,1424,472,49.57983193277311
Sangali,Gram,2016,4813,5285,472,9.806773322252234
Pune-Manjri,Hemp,2016,421,893,472,112.11401425178147
Sangali,Bajri,2014,1321,1793,472,35.730507191521575
Shahapur,Ladies Finger,2015,1207,1679,472,39.105219552609775
Anajngaon Surji,Gram,2016,3980,4451,471,11.834170854271356
Nagpur,Ginger (Fresh),2014,2810,3281,471,16.76156583629893
Karad,Capsicum,2016,1771,2242,471,26.595143986448335
Vai,Cucumber,2015,2050,2521,471,22.975609756097562
Kalyan,Green-Peas,2015,3229,3700,471,14.586559306286777
Satara,Potato,2016,1900,2371,471,24.789473684210527
Pune-Manjri,HARBARA(PENDI),2016,1686,2157,471,27.93594306049822
Arvi,Pigeon Pea (Tur),2015,5204,5675,471,9.050730207532666
Sailu,Sorgum(Jawar),2015,1215,1686,471,38.76543209876543
Hingoli,Wheat(Husked),2015,1492,1963,471,31.568364611260055
Tumsar,Jaggery,2015,1927,2398,471,24.442138038401662
Solapur,Sorgum(Jawar),2015,1713,2184,471,27.495621716287214
Vai,Ridge Gourd,2016,3429,3900,471,13.73578302712161
Vadgaon Peth,Cucumber,2015,786,1257,471,59.9236641221374
Lasur Station,Sorgum(Jawar),2016,1518,1989,471,31.027667984189723
Kada,Soybean,2015,3104,3575,471,15.17396907216495
Raver,SORGUM(JAWAR),2016,1120,1591,471,42.05357142857143
Amarawati,Mosambi,2015,1586,2057,471,29.697351828499368
Udgir,Black Gram,2015,9912,10383,471,4.75181598062954
Shrirampur,Capsicum,2016,1286,1757,471,36.625194401244165
Nashik-Devlali,Tandulja,2016,414,885,471,113.76811594202898
Junnar,Onion,2016,493,964,471,95.53752535496957
Majalgaon,Soybean,2014,2625,3096,471,17.942857142857143
Pathari,Pigeon Pea (Tur),2016,5275,5746,471,8.928909952606634
Nagpur,Sorgum(Jawar),2016,1500,1971,471,31.4
Umrane,Onion,2016,460,931,471,102.3913043478261
Mehkar,Gram,2016,3951,4422,471,11.921032649962035
Malegaon,Green Gram,2014,7549,8020,471,6.23923698503113
Anajngaon Surji,Gram,2015,2969,3440,471,15.863927248231727
Jalgaon,Squash Gourd,2015,624,1095,471,75.48076923076923
Amarawati-Fruit And Vegetables,Bor,2016,1229,1700,471,38.323840520748575
Dhule,Wheat(Husked),2014,1175,1646,471,40.08510638297872
Kalamb (Os),Gram,2015,3435,3906,471,13.7117903930131
Pune-Pimpri,Green Chilli,2014,3100,3571,471,15.193548387096774
Wardha,Gram,2016,4725,5196,471,9.968253968253968
Partur,Wheat(Husked),2015,1812,2283,471,25.99337748344371
Karad,Ladies Finger,2015,1786,2257,471,26.37178051511758
Vai,Ridge Gourd,2015,2900,3370,470,16.20689655172414
Shegaon,Black Gram,2015,6641,7111,470,7.077247402499624
Nagpur,Soybean,2014,2881,3351,470,16.313779937521694
Shahada,Soybean,2016,2334,2804,470,20.137103684661525
Karmala,Bajri,2016,1144,1614,470,41.08391608391609
Baramati,Bajri,2016,1659,2129,470,28.330319469559974
Kalamb (Os),Black Gram,2014,4425,4895,470,10.621468926553673
Jalgaon,Wal Papdi,2016,1470,1940,470,31.972789115646258
Shrirampur,Brinjal,2014,1030,1500,470,45.63106796116505
Hingoli,Soybean,2015,3350,3820,470,14.029850746268657
Vai,Pavata,2015,2400,2870,470,19.583333333333332
Ambad(Vadi Godri),Gram,2016,5232,5702,470,8.983180428134556
Washim-Ansing,BLACK GRAM,2016,6486,6956,470,7.246376811594203
Patan,Pavtta,2015,1451,1921,470,32.39145416953825
Osmanabad,Gram,2015,3567,4037,470,13.176338659938324
Beed,Pigeon Pea (Tur),2016,8027,8497,470,5.8552385698268345
Pusad,Soybean,2015,3095,3565,470,15.18578352180937
Beed,SORGUM(JAWAR),2016,1938,2408,470,24.251805985552117
Dound,Cowpea,2016,7380,7850,470,6.368563685636857
Babhulgaon,Soybean,2015,2981,3451,470,15.766521301576653
Mangrulpeer,Wheat(Husked),2015,1338,1808,470,35.1270553064275
Malkapur,Gram,2015,2668,3138,470,17.616191904047977
Pune,Wal Bhaji,2015,2850,3320,470,16.49122807017544
Nagpur,Gram,2015,3019,3489,470,15.568068896985757
Shrirampur,SORGUM(JAWAR),2016,1653,2123,470,28.433151845130066
Ratanagari,Brinjal,2015,540,1010,470,87.03703703703704
Mumbai-Fruit Market,Pineapple,2016,1706,2176,470,27.549824150058615
Sangrampur-Varvatbakal,Pigeon Pea (Tur),2016,6000,6470,470,7.833333333333333
Zarijamini,Cotton,2016,4100,4570,470,11.463414634146341
Junnar-Otur,Beet Root,2016,493,963,470,95.33468559837728
Nandgaon Khandeshwar,PIGEON PEA (TUR),2016,5230,5700,470,8.98661567877629
Mumbai,Shevga,2016,3426,3896,470,13.718622300058376
Khed-Chakan,Tomato,2016,1378,1848,470,34.107402031930334
Shahapur,Mango(Raw),2016,1639,2109,470,28.67602196461257
Amarawati,Onion,2016,941,1411,470,49.94686503719447
Nagpur,Carrot,2015,1352,1822,470,34.76331360946745
Satana,Ground Nut Pods (Dry),2015,4887,5357,470,9.617352158788623
Lonand,Sorgum(Jawar),2015,1590,2060,470,29.559748427672957
Ahmednagar,Wheat(Husked),2016,1750,2220,470,26.857142857142858
Dondaicha,Gram,2015,3501,3970,469,13.396172522136533
Nagpur,Coriander  ,2014,2323,2792,469,20.189410245372365
Lasalgaon,Bajri,2015,1334,1803,469,35.15742128935532
Satana,Bajri,2016,1517,1986,469,30.91628213579433
Majalgaon,Gram,2016,3849,4318,469,12.184983112496752
Mumbai,Capsicum,2016,2700,3169,469,17.37037037037037
Sonpeth,Sorgum(Jawar),2016,1371,1840,469,34.20860685630927
Shahada,Gram,2014,2273,2742,469,20.633523977122746
Nagpur,Green Chilli,2014,2531,3000,469,18.530225207427893
Pune-Pimpri,Onion,2015,2546,3015,469,18.42105263157895
Lasur Station,Green Gram,2016,4680,5149,469,10.021367521367521
Baramati,Gram,2015,3576,4045,469,13.115212527964205
Pune-Pimpri,Ghosali(Bhaji),2015,3000,3469,469,15.633333333333333
Rahata,Potato,2014,1954,2423,469,24.00204708290686
Buldhana,Gram,2015,3850,4319,469,12.181818181818182
Pune-Pimpri,Ghosali(Bhaji),2014,2344,2813,469,20.00853242320819
Kada,Wheat(Husked),2015,1651,2120,469,28.407026044821322
Kopargaon,Wheat(Husked),2015,1306,1775,469,35.91117917304747
Sangli-Phale Bhajipalam,Papai,2015,208,677,469,225.48076923076923
Pune-Manjri,FLOWER,2016,738,1207,469,63.550135501355015
Akola,Wheat(Husked),2016,1919,2388,469,24.439812402292862
Sinner,Bajri,2016,1401,1870,469,33.47608850820842
Shrirampur,Green Gram,2015,6317,6786,469,7.424410321355073
Lonand,Sorgum(Jawar),2016,1600,2069,469,29.3125
Nagpur,Capsicum,2014,2869,3338,469,16.347159288950856
Shrigonda,Wheat(Husked),2016,1594,2063,469,29.422835633626097
Nagpur,Bitter Gourd,2015,1212,1681,469,38.696369636963695
Anajngaon Surji,Gram,2016,5279,5747,468,8.86531540064406
Nashik,Onion,2016,149,617,468,314.09395973154363
Khed-Chakan,BOTTLE GOURD,2016,608,1076,468,76.97368421052632
Rahuri-Vambori,Bajri,2016,1302,1770,468,35.944700460829495
Mumbai,Potato,2015,708,1176,468,66.10169491525424
Satara,Carrot,2015,1364,1832,468,34.3108504398827
Yawal,Cotton,2016,4050,4518,468,11.555555555555555
Shrirampur,Brinjal,2016,1374,1842,468,34.06113537117904
Chandrapur-Ganjwad,Onion,2015,1338,1806,468,34.97757847533632
Washim,Pigeon Pea (Tur),2016,6271,6739,468,7.4629245734332645
Dondaicha,Ground Nut Pods (Dry),2016,4445,4913,468,10.528683914510687
Mumbai,Sweet Potato,2016,918,1386,468,50.98039215686274
Kalyan,Ladies Finger,2015,1200,1668,468,39.0
Ghoti,Bitter Gourd,2016,963,1431,468,48.598130841121495
Morshi,Soybean,2015,3120,3588,468,15.0
Nira,Jaggery,2015,2593,3061,468,18.048592364057075
Mumbai,Papai,2015,532,1000,468,87.96992481203007
Malegaon,Wheat(Husked),2016,1570,2038,468,29.808917197452228
Jalgaon,Squash Gourd,2015,653,1121,468,71.66921898928024
Mumbai,Split Lentil,2015,6823,7291,468,6.859152865308515
Shrirampur,Brinjal,2015,979,1447,468,47.80388151174668
Chandrapur,Banana,2016,548,1016,468,85.4014598540146
Junnar (Alephata),Onion,2016,565,1033,468,82.83185840707965
Nagpur,Green Chilli,2015,1960,2428,468,23.877551020408163
Manchar,Flower,2015,975,1443,468,48.0
Shirur,Tamarind,2015,1646,2114,468,28.432563791008505
Malkapur,Onion,2016,288,756,468,162.5
Akluj,Banana,2014,620,1088,468,75.48387096774194
Washim,Green Gram,2015,7955,8423,468,5.883092394720301
Shegaon,Gram,2015,3654,4122,468,12.807881773399014
Pune-Manjri,Flower,2016,843,1310,467,55.39739027283511
Shrirampur,Tomato,2015,1179,1646,467,39.609838846480066
Pune,Sweet Potato,2015,1100,1567,467,42.45454545454545
Junnar-Otur,Onion,2016,583,1050,467,80.10291595197256
Shrirampur,GINGER (FRESH),2016,1095,1562,467,42.64840182648402
Vadgaon Peth,Cucumber,2015,733,1200,467,63.710777626193725
Murum,Black Gram,2015,8417,8884,467,5.548295117025068
Satara,Carrot,2016,1944,2411,467,24.022633744855966
Jalgaon,Wal Papdi,2015,1583,2050,467,29.500947567909034
Pathardi,Wheat(Husked),2015,1533,2000,467,30.4631441617743
Sangrampur-Varvatbakal,Soybean,2016,2908,3375,467,16.05914718019257
Karad,Ladies Finger,2015,1444,1911,467,32.340720221606645
Jamkhed,Black Gram,2015,8833,9300,467,5.286991961960829
Koregaon,Onion,2015,833,1300,467,56.062424969987994
Anajngaon Surji,Gram,2015,4050,4517,467,11.530864197530864
Yeotmal,Gram,2015,3507,3974,467,13.316224693470202
Panvel,Ridge Gourd,2016,4000,4467,467,11.675
Taloda,Pigeon Pea (Tur),2015,4888,5355,467,9.554009819967266
Mangalwedha,Wheat(Husked),2014,1475,1942,467,31.661016949152543
Kalyan,Indian Bean,2015,4000,4467,467,11.675
Bhokar,Sesamum,2016,5883,6350,467,7.938126806051335
Satara,Onion,2016,400,867,467,116.75
Kalyan,Sorgum(Jawar),2016,1833,2300,467,25.47735951991271
Shahada,Green Gram,2015,6362,6829,467,7.340458975165043
Lasur Station,Wheat(Husked),2016,1585,2052,467,29.463722397476342
Khamgaon,Black Gram,2015,4928,5395,467,9.47646103896104
Mumbai,Cluster Bean,2016,3033,3500,467,15.397296406198484
Indapur-Bhigwan,Green Peas (Dry),2015,2033,2500,467,22.97097884899164
Manora,Green Gram,2015,6233,6700,467,7.492379271618804
Digras,Black Gram,2016,6448,6915,467,7.242555831265508
Jalgaon,Melon,2015,858,1325,467,54.42890442890443
Pathari,Gram,2015,3633,4100,467,12.85439031103771
Vasai,Bajri,2015,1333,1800,467,35.033758439609905
Jalgaon,Cabbage,2015,868,1335,467,53.80184331797235
Nandgaon Khandeshwar,Chino,2015,3233,3700,467,14.444788122486854
Vadgaon Peth,Snake Gourd,2015,1233,1700,467,37.87510137875101
Amarawati-Fruit And Vegetables,Potato,2016,800,1267,467,58.375
Jalgaon Jamod-Aasalgaon,Pigeon Pea (Tur),2014,3833,4300,467,12.183668145056092
Murbad,Cabbage,2016,2300,2767,467,20.304347826086957
Pandharpur,Banana,2014,548,1015,467,85.21897810218978
Karad,Pavtta,2014,2250,2717,467,20.755555555555556
Shahapur,Mango(Raw),2016,1600,2067,467,29.1875
Karad,Ridge Gourd,2014,1550,2017,467,30.129032258064516
Mumbai,Horse Gram,2014,3500,3967,467,13.342857142857143
Mumbai,Horse Gram,2014,3500,3967,467,13.342857142857143
Osmanabad,Cabbage,2016,733,1200,467,63.710777626193725
Umarkhed,Pigeon Pea (Tur),2016,6600,7067,467,7.075757575757576
Jalgaon,Papai,2015,1000,1467,467,46.7
Nandura,Soybean,2016,3067,3534,467,15.226605803716987
Malkapur,Gram,2016,3884,4351,467,12.023686920700309
Bhiwapur,Soybean,2016,3233,3700,467,14.444788122486854
Latur-Murud,Sunflower,2015,3037,3504,467,15.377016792887718
Aurangabad,Ladies Finger,2014,821,1288,467,56.88185140073082
Ratanagari,Cabbage,2016,494,961,467,94.53441295546558
Pusad,Bajri,2016,1564,2031,467,29.85933503836317
Majalgaon,Bajri,2015,1226,1693,467,38.091353996737354
Chandrapur-Ganjwad,Spinach,2015,933,1400,467,50.053590568060024
Indapur-Bhigwan,Coriander (Dry),2016,8833,9300,467,5.286991961960829
Akole,Paddy-Unhusked,2015,1500,1967,467,31.133333333333333
Chopda,Sesamum,2015,5933,6400,467,7.8712287207146465
Vai,Ridge Gourd,2014,2100,2567,467,22.238095238095237
Ahmednagar,GREEN GRAM,2016,4756,5223,467,9.819175777964675
Sangali,Soybean,2015,3325,3792,467,14.045112781954888
Amarawati-Fruit And Vegetables,Ladies Finger,2016,3733,4200,467,12.510045539780338
Patan,Ghevda,2014,1883,2350,467,24.800849707912906
Kalyan,Cluster Bean,2015,3450,3917,467,13.53623188405797
Ramtek,Carrot,2016,933,1400,467,50.053590568060024
Pune,Lentil,2015,7483,7950,467,6.240812508352265
Chandrapur,Jambhul,2015,1333,1800,467,35.033758439609905
Nagpur,Coriander  ,2016,2138,2604,466,21.796071094480823
Shahapur,Cucumber,2015,1867,2333,466,24.95982860203535
Rahuri-Vambori,Gram,2015,3584,4050,466,13.002232142857142
Gevrai,Gram,2015,3836,4302,466,12.148070907194995
Kalyan,Green Gram,2015,8667,9133,466,5.3767162801430715
Solapur,Wheat(Husked),2016,2147,2613,466,21.70470423847229
Shrirampur,Water Melon,2014,978,1444,466,47.648261758691206
Patan,Pavtta,2016,3067,3533,466,15.194000652103032
Pune-Pimpri,Bitter Gourd,2014,3204,3670,466,14.544319600499376
Amarawati,Coriander  ,2016,2867,3333,466,16.25392396232996
Sinner,Wheat(Husked),2016,1688,2154,466,27.606635071090047
Sangrampur,Gram,2014,2067,2533,466,22.54475084663764
Jamkhed,Wheat(Husked),2015,1828,2294,466,25.49234135667396
Solapur,Sorgum(Jawar),2016,1855,2321,466,25.121293800539082
Pune-Pimpri,Chavli (Shenga ),2016,3167,3633,466,14.714240606251973
Shegaon,Black Gram,2014,5038,5504,466,9.2497022628027
Pune,Gram,2016,6967,7433,466,6.688675183005598
Mangrulpeer,Soybean,2014,2843,3309,466,16.391136123812874
Jalgaon Jamod-Aasalgaon,Black Gram,2014,3967,4433,466,11.746912024199647
Lonand,Bajri,2016,1563,2029,466,29.81445937300064
Yawal,Ground Nut Pods (Dry),2016,4867,5333,466,9.574686665296898
Ramtek,Lemon,2016,1867,2333,466,24.95982860203535
Barshi,Gram,2015,3171,3637,466,14.695679596341847
Amalner,Sorgum(Jawar),2016,1580,2046,466,29.49367088607595
Kolhapur,Guava,2016,367,833,466,126.97547683923706
Mumbai,Bitter Gourd,2015,2992,3458,466,15.574866310160427
Lonar,Pigeon Pea (Tur),2016,6288,6754,466,7.410941475826972
Ahmednagar,Sorgum(Jawar),2016,1637,2103,466,28.466707391569944
Chandrapur-Ganjwad,Chavli (Pala),2016,1367,1833,466,34.08924652523775
Karanja,Gram,2014,2259,2725,466,20.628596724214255
Sangamner,Flower,2014,517,983,466,90.13539651837525
Nira-Saswad,Gram,2016,3767,4233,466,12.370586673745686
Taloda,Black Gram,2015,3256,3722,466,14.312039312039312
Bhivandi,Other Vegetables,2014,1010,1476,466,46.13861386138614
Palus,Cabbage,2016,667,1133,466,69.86506746626686
Varud-Rajura Bazar,Soybean,2016,3241,3707,466,14.378278309163838
Nandura,Pigeon Pea (Tur),2014,4027,4493,466,11.571889744226471
Pune-Manjri,Cucumber,2015,780,1245,465,59.61538461538461
Navapur,Tomato,2015,952,1417,465,48.84453781512605
Nagpur,Tomato,2015,1981,2446,465,23.47299343765775
Kada,BAJRI,2016,1270,1735,465,36.61417322834646
Mangrulpeer,Soybean,2016,3265,3730,465,14.241960183767228
Amalner,Gram,2016,5081,5546,465,9.151741783113561
Aurangabad,Brinjal,2015,748,1213,465,62.16577540106952
Khed-Chakan,Tomato,2016,650,1115,465,71.53846153846153
Nashik,Spinach,2014,320,785,465,145.3125
Ausa,Black Gram,2015,8145,8610,465,5.70902394106814
Umared,Pigeon Pea (Tur),2015,4324,4789,465,10.753931544865864
Amalner,Soybean,2016,2578,3043,465,18.037238169123352
Udgir,Black Gram,2016,9135,9600,465,5.090311986863711
Akot,Gram,2015,2875,3340,465,16.17391304347826
Savner,SOYBEAN,2016,2294,2759,465,20.27027027027027
Akole,Paddy-Unhusked,2015,1395,1860,465,33.333333333333336
Malegaon,Horse Gram,2015,2425,2890,465,19.175257731958762
Malegaon,Cowpea,2015,4000,4465,465,11.625
Solapur,PAPAI,2016,388,853,465,119.84536082474227
Lonand,Bajri,2015,1260,1725,465,36.904761904761905
Bhandara,Gram,2015,4522,4987,465,10.283060592658115
Vani,Soybean,2015,2799,3264,465,16.613076098606644
Satana,Bajri,2014,1138,1603,465,40.86115992970123
Nagpur,Flower,2015,1208,1673,465,38.49337748344371
Kalyan,Bitter Gourd,2016,2065,2530,465,22.5181598062954
Vani,Soybean,2015,3290,3755,465,14.133738601823708
Manchar,Maize(Corn.),2015,1189,1654,465,39.1084945332212
Pune,Onion,2016,448,913,465,103.79464285714286
Mangalwedha,Wheat(Husked),2015,1579,2044,465,29.449018366054464
Umared,Green Gram,2016,4808,5273,465,9.671381031613977
Chimur,Pigeon Pea (Tur),2016,6594,7059,465,7.0518653321201095
Sindi,Soybean,2014,2916,3381,465,15.946502057613168
Nandurbar,Wheat(Husked),2016,1500,1965,465,31.0
Shirpur,Pigeon Pea (Tur),2016,6495,6960,465,7.159353348729792
Pune,Lemon,2015,96,561,465,484.375
Pune,Arvi,2016,2425,2890,465,19.175257731958762
Nagpur,Math (Bhaji),2015,2554,3019,465,18.206734534064214
Jamkhed,Wheat(Husked),2014,1936,2400,464,23.96694214876033
Kamthi,FLOWER,2016,475,939,464,97.6842105263158
Pune,Gr.Nut Kernels,2016,7613,8077,464,6.094837777485879
Bhokar,Pigeon Pea (Tur),2015,6211,6675,464,7.470616647882789
Kamthi,Bottle Gourd,2015,712,1176,464,65.1685393258427
Dudhani,Gram,2016,7060,7524,464,6.572237960339943
Aarni,Soybean,2016,3200,3664,464,14.5
Karad,Banana,2016,1008,1472,464,46.03174603174603
Kalyan,Ghevda,2016,2157,2621,464,21.51135836810385
Shahapur,Ghosali(Bhaji),2014,1012,1476,464,45.8498023715415
Shahapur,Ghosali(Bhaji),2014,1679,2143,464,27.635497319833235
Karad,Chikoo,2016,1552,2016,464,29.896907216494846
Khed-Chakan,Chavli (Shenga ),2016,1940,2404,464,23.917525773195877
Dound,Sorgum(Jawar),2016,1658,2122,464,27.98552472858866
Pune-Pimpri,Bitter Gourd,2015,2018,2482,464,22.993062438057482
Pune,Lentil,2015,5436,5900,464,8.535688005886682
Aurangabad,Flower,2016,888,1352,464,52.252252252252255
Anajngaon Surji,Wheat(Husked),2016,1507,1971,464,30.78964830789648
Jalna,Banana,2015,293,757,464,158.36177474402731
Karmala,Sunflower,2015,3311,3775,464,14.013893083660525
Hinganghat,Pigeon Pea (Tur),2014,4512,4976,464,10.28368794326241
Dound,GREEN GRAM,2016,4386,4850,464,10.579115367077064
Majalgaon,Bajri,2016,1711,2175,464,27.11864406779661
Dound,Bajri,2016,1473,1937,464,31.500339443312967
Washim,Pigeon Pea (Tur),2015,5368,5832,464,8.64381520119225
Shrirampur,Tamarind,2015,1427,1891,464,32.51576734407848
Dhamangaon-Rly,Soybean,2014,2817,3281,464,16.471423500177494
Satara,Potato,2016,875,1338,463,52.91428571428571
Vaijapur,Pigeon Pea (Tur),2016,7198,7661,463,6.432342317310364
Paithan,Pigeon Pea (Tur),2016,7970,8433,463,5.809284818067754
Patan,Cluster Bean,2016,1750,2213,463,26.457142857142856
Solapur,Green Peas (Dry),2014,4350,4813,463,10.64367816091954
Dindori-Vani,Onion,2016,508,971,463,91.14173228346456
Khamgaon,Green Gram,2016,6038,6501,463,7.668102020536602
Bhokar,Cotton,2015,3912,4375,463,11.835378323108385
Sengaon,Turmeric,2016,7200,7663,463,6.430555555555555
Chalisgaon,Pigeon Pea (Tur),2014,3456,3919,463,13.39699074074074
Amarawati,Coriander  ,2015,2450,2913,463,18.897959183673468
Kada,Wheat(Husked),2014,1534,1997,463,30.18252933507171
Nagpur,Ladies Finger,2016,1742,2205,463,26.578645235361652
Kada,Sorgum(Jawar),2015,1429,1892,463,32.40027991602519
Jalgaon,Jaggery,2015,2090,2553,463,22.15311004784689
Pandharpur,Cabbage,2016,675,1138,463,68.5925925925926
Akot,Ground Nut Pods (Dry),2016,4931,5394,463,9.389576150882174
Achalpur,Green Gram,2015,6575,7038,463,7.0418250950570345
Pune-Manjri,TOMATO,2016,634,1097,463,73.02839116719242
Ratanagari,Carrot,2016,1400,1863,463,33.07142857142857
Shrirampur,Ladies Finger,2014,1364,1827,463,33.94428152492669
Ghansawangi,Pigeon Pea (Tur),2015,7925,8388,463,5.842271293375394
Gevrai,Wheat(Husked),2015,1461,1924,463,31.690622861054074
Ahmedpur,Sesamum,2015,5417,5880,463,8.547166328225956
Vaijapur,Wheat(Husked),2015,1391,1854,463,33.28540618260244
Dhule,HORSE GRAM,2016,3550,4013,463,13.04225352112676
Jalgaon,Squash Gourd,2015,629,1092,463,73.60890302066773
Kej,Soybean,2016,3208,3671,463,14.432668329177057
Pune-Pimpri,Ghevda,2015,3155,3618,463,14.675118858954042
Nandgaon Khandeshwar,Black Gram,2016,6498,6961,463,7.1252693136349645
Manchar,Chavli (Shenga ),2015,2000,2463,463,23.15
Jalgaon,Cucumber,2015,679,1142,463,68.18851251840942
Satara,Ground Nut Pods (Dry),2015,2983,3446,463,15.521287294669795
Mumbai,Ridge Gourd,2015,1793,2256,463,25.822643614054655
Patan,Cucumber,2015,975,1438,463,47.48717948717949
Aurangabad,Carrot,2015,1475,1938,463,31.389830508474578
Indapur-Bhigwan,Gram,2016,6225,6688,463,7.437751004016064
Vai,Bottle Gourd,2016,1482,1945,463,31.241565452091766
Satara,Onion,2016,525,988,463,88.19047619047619
Paithan,Wheat(Husked),2016,1673,2135,462,27.615062761506277
Palus,Tomato,2016,488,950,462,94.67213114754098
Kalamb (Os),Sorgum(Jawar),2014,1343,1805,462,34.4005956813105
Mumbai,Shevga,2016,3846,4308,462,12.012480499219969
Majalgaon,Soybean,2016,3183,3645,462,14.514608859566447
Balapur,Wheat(Husked),2016,1338,1800,462,34.52914798206278
Samudrapur,Soybean,2014,2855,3317,462,16.182136602451838
Rahata,Cabbage,2016,600,1062,462,77.0
Pandharpur,Cabbage,2016,294,756,462,157.14285714285714
Pachora,Bajri,2016,1232,1694,462,37.5
Sangali,Gram,2016,4190,4652,462,11.026252983293556
Pune-Pimpri,Bottle Gourd,2015,1067,1529,462,43.29896907216495
Shirpur,Gram,2016,6539,7001,462,7.065300504664322
Rahata,Ginger (Fresh),2016,2615,3077,462,17.667304015296367
Kolhapur,TOMATO,2016,169,631,462,273.37278106508876
Akole,Wheat(Husked),2016,1513,1975,462,30.53536021150033
Nashik,Cucumber,2016,819,1281,462,56.41025641025641
Shegaon,Gram,2014,2198,2660,462,21.019108280254777
Akola,Gram,2015,2830,3292,462,16.325088339222614
Achalpur,Ground Nut Pods (Dry),2016,4210,4672,462,10.973871733966746
Shahapur,Chavli (Shenga ),2016,2500,2962,462,18.48
Varud-Rajura Bazar,Green Chilli,2016,890,1352,462,51.91011235955056
Karad,Jaggery,2014,2808,3270,462,16.45299145299145
Mumbai,Green-Peas,2015,2592,3054,462,17.824074074074073
Vadgaon Peth,Cabbage,2016,700,1162,462,66.0
Pathari,Bajri,2015,1017,1479,462,45.42772861356932
Beed,Wheat(Husked),2016,1683,2145,462,27.45098039215686
Lasalgaon,Wheat(Husked),2014,1533,1995,462,30.136986301369863
Kada,Wheat(Husked),2014,1447,1909,462,31.928127159640635
Hingna,Soybean,2015,3038,3500,462,15.2073732718894
Jalna,Gram,2015,4229,4691,462,10.92456845589974
Indapur,Bajri,2016,1545,2007,462,29.902912621359224
Aurangabad,Tomato,2015,532,994,462,86.84210526315789
Barshi,Wheat(Husked),2015,1415,1876,461,32.579505300353354
Vani,Cotton,2014,3400,3861,461,13.558823529411764
Nagpur,Soybean,2016,3402,3863,461,13.550852439741329
Karad,Chikoo,2015,1231,1692,461,37.44922826969943
Shrirampur,Tomato,2015,1148,1609,461,40.15679442508711
Dhule,Wheat(Husked),2015,1514,1975,461,30.449141347424042
Rahata,Cucumber,2015,839,1300,461,54.94636471990465
Aurangabad,Brinjal,2014,1535,1996,461,30.03257328990228
Washim,Green Gram,2016,4639,5100,461,9.937486527268808
Umared,Sunflower,2015,2894,3355,461,15.929509329647546
Digras,Pigeon Pea (Tur),2015,6133,6594,461,7.516712864829611
Shirpur,Wheat(Husked),2015,1247,1708,461,36.968724939855655
Khamgaon,Lemon,2016,207,668,461,222.70531400966183
Chikhali,Wheat(Husked),2016,1450,1911,461,31.79310344827586
Dound,Sorgum(Jawar),2016,1755,2216,461,26.267806267806268
Pune,Elephant Root,2016,2565,3026,461,17.97270955165692
Satara,Ladies Finger,2016,1174,1635,461,39.26746166950596
Nagpur,Wal Bhaji,2016,2089,2550,461,22.06797510770704
Nagpur,Lemon,2016,104,565,461,443.2692307692308
Ambejogai,Pigeon Pea (Tur),2014,3754,4215,461,12.28023441662227
Yeola,Onion,2016,125,586,461,368.8
Partur,Wheat(Husked),2015,1447,1908,461,31.859018659295092
Ahmednagar,Wheat(Husked),2016,1842,2303,461,25.0271444082519
Khed-Chakan,Bottle Gourd,2016,662,1123,461,69.63746223564955
Nandurbar,Sorgum(Jawar),2016,1390,1851,461,33.16546762589928
Shrirampur,Sorgum(Jawar),2016,1654,2115,461,27.871825876662637
Satara,Cucumber,2015,548,1009,461,84.12408759124088
Dound,Wheat(Husked),2015,1549,2010,461,29.76113621691414
Nagpur,Bitter Gourd,2016,1622,2083,461,28.42170160295931
Pathardi,Gram,2015,3880,4341,461,11.881443298969073
Chandrapur-Ganjwad,Raddish,2014,962,1423,461,47.92099792099792
Gevrai,Gram,2015,3361,3822,461,13.716155905980363
Pune-Moshi,Cabbage,2016,881,1342,461,52.32690124858116
Khed-Chakan,Walvad,2015,2197,2658,461,20.983158852981337
Amarawati,Ground Nut Pods (Dry),2015,4060,4520,460,11.330049261083744
Shahapur,Cucumber,2016,1570,2030,460,29.29936305732484
Kamthi,Bottle Gourd,2015,577,1037,460,79.72270363951473
Pune,Lentil,2015,6280,6740,460,7.32484076433121
Paithan,Wheat(Husked),2016,1676,2136,460,27.446300715990454
Kolhapur-Laxmipuri,Spilt Gerrn Gram,2014,8533,8993,460,5.390835579514825
Bhivandi,Rice(Paddy-Hus),2015,2080,2540,460,22.115384615384617
Malegaon,Bajri,2016,1567,2027,460,29.35545628589662
Murbad,Bottle Gourd,2016,2560,3020,460,17.96875
Chandrapur-Ganjwad,Squash Gourd,2016,1000,1460,460,46.0
Kalmeshwar,Soybean,2014,2902,3362,460,15.851137146795313
Yawal,Ground Nut Pods (Dry),2016,4423,4883,460,10.40018087271083
Chandrapur,Mosambi,2015,2540,3000,460,18.11023622047244
Aurangabad,Cabbage,2016,380,840,460,121.05263157894737
Hinganghat,Gram,2016,3780,4240,460,12.16931216931217
Akole,Wheat(Husked),2015,1500,1960,460,30.666666666666668
Pachora,Bajri,2016,1101,1561,460,41.78019981834696
Jalgaon,Melon,2015,780,1240,460,58.97435897435897
Indapur-Bhigwan,Ground Nut Pods (Dry),2014,3020,3480,460,15.2317880794702
Kalyan,Bitter Gourd,2015,3820,4280,460,12.041884816753926
Daryapur,Soybean,2015,3183,3643,460,14.45177505497958
Lasur Station,Bajri,2014,1122,1582,460,40.998217468805706
Ghoti,Brinjal,2014,1360,1820,460,33.8235294117647
Chandrapur,Soybean,2014,2839,3299,460,16.202888340965128
Satara,Cabbage,2015,652,1112,460,70.5521472392638
Kamthi,Onion,2016,540,1000,460,85.18518518518519
Mangalwedha,Wheat(Husked),2014,1419,1879,460,32.41719520789288
Vai,Cucumber,2015,1930,2390,460,23.83419689119171
Vai,Brinjal,2016,1720,2180,460,26.74418604651163
Patan,Green Chilli,2014,2425,2885,460,18.969072164948454
Mumbai,Spilt Gerrn Gram,2016,7395,7855,460,6.220419202163624
Junnar,Onion,2016,575,1035,460,80.0
Nandurbar,Wheat(Husked),2015,1422,1882,460,32.34880450070324
Kalmeshwar,Coriander  ,2015,4871,5331,460,9.443646068569082
Mumbai-Fruit Market,Pineapple,2016,1364,1824,460,33.72434017595308
Pulgaon,Soybean,2015,3138,3598,460,14.65901848311026
Akot,Soybean,2016,3471,3931,460,13.252664938058196
Kolhapur-Laxmipuri,Split Black Gram,2016,14200,14660,460,3.23943661971831
Ratanagari,Carrot,2016,1080,1540,460,42.592592592592595
Barshi,Onion,2016,200,660,460,230.0
Pune,Gram,2015,5300,5760,460,8.679245283018869
Lasur Station,Pigeon Pea (Tur),2015,5064,5524,460,9.083728278041074
Murtizapur,Gram,2015,4683,5143,460,9.822763185991885
Karad,Ghevda,2015,1720,2180,460,26.74418604651163
Pune-Pimpri,Lentil,2015,5620,6080,460,8.185053380782918
Nagpur,Capsicum,2016,2256,2716,460,20.390070921985817
Nagpur,WAL BHAJI,2016,1160,1620,460,39.6551724137931
Karad,Ladies Finger,2015,1660,2120,460,27.710843373493976
Pulgaon,Pigeon Pea (Tur),2016,8547,9007,460,5.382005382005382
Vai,ONION,2016,540,1000,460,85.18518518518519
Buldhana,Pigeon Pea (Tur),2015,4780,5240,460,9.623430962343097
Karanja,Black Gram,2014,5071,5531,460,9.071189114573063
Balapur,Sorgum(Jawar),2016,1160,1620,460,39.6551724137931
Balapur,Green Gram,2016,4320,4780,460,10.648148148148149
Barshi-Vairag,Ground Nut Pods (Dry),2015,4520,4980,460,10.176991150442477
Jalkot,Green Gram,2015,6330,6790,460,7.2669826224328595
Dhule,Bajri,2016,1371,1831,460,33.55215171407732
Kalamb (Os),Soybean,2015,3246,3706,460,14.17128773875539
Jawala-Bajar,Turmeric,2016,7580,8040,460,6.068601583113456
Pune-Pimpri,Ghevda,2014,2080,2540,460,22.115384615384617
Ramtek,Squash Gourd,2016,2059,2518,459,22.29237493929092
Loha,Pigeon Pea (Tur),2016,8401,8860,459,5.463635281514105
Barshi,Turmeric,2016,6892,7351,459,6.659895531050493
Ramtek,Carrot,2015,1614,2073,459,28.438661710037174
Rahata,Ginger (Fresh),2015,3333,3792,459,13.771377137713772
Murbad,Bitter Gourd,2016,4253,4712,459,10.792381848107219
Kada,Pigeon Pea (Tur),2015,4710,5169,459,9.745222929936306
Partur,Green Gram,2015,8160,8619,459,5.625
Varud,Orange,2015,879,1338,459,52.218430034129696
Junnar-Otur,Beet Root,2016,232,691,459,197.8448275862069
Kalyan,BITTER GOURD,2016,1408,1867,459,32.59943181818182
Jalgaon,Cucumber,2014,755,1214,459,60.794701986754966
Umarga,Soybean,2015,3177,3636,459,14.44759206798867
Manora,Soybean,2015,3641,4100,459,12.606426805822576
Nandura,Green Gram,2016,4610,5069,459,9.956616052060738
Vai,Cucumber,2014,1882,2341,459,24.38894792773645
Karad,Brinjal,2014,1233,1692,459,37.22627737226277
Sinner,Sorgum(Jawar),2015,1512,1971,459,30.357142857142858
Khamgaon,Soybean,2016,3026,3485,459,15.168539325842696
Chalisgaon,Bajri,2016,1429,1888,459,32.12036389083275
Aurangabad,Cluster Bean,2014,1608,2067,459,28.544776119402986
Bhokar,Soybean,2015,3301,3760,459,13.90487730990609
Nagpur,Soybean,2016,3175,3634,459,14.456692913385826
Lasalgaon,Sorgum(Jawar),2016,1267,1726,459,36.22730860299921
Ramtek,Flower,2016,705,1164,459,65.1063829787234
Dhamangaon-Rly,Gram,2016,6975,7434,459,6.580645161290323
Barshi,Cabbage,2016,429,888,459,106.99300699300699
Aurangabad,Onion,2016,158,616,458,289.873417721519
Satara,Carrot,2016,952,1410,458,48.109243697478995
Pune,Sweet Potato,2015,871,1329,458,52.58323765786452
Arvi,Soybean,2016,3145,3603,458,14.562798092209857
Sangli-Phale Bhajipalam,Papai,2016,208,666,458,220.19230769230768
Shirpur,Soybean,2014,2776,3234,458,16.498559077809798
Risod,Pigeon Pea (Tur),2015,6926,7384,458,6.612763499855617
Sailu,Wheat(Husked),2015,1350,1808,458,33.925925925925924
Umared,Sorgum(Jawar),2015,1571,2029,458,29.153405474220243
Nagpur,Gram,2014,2489,2947,458,18.400964242667737
Nagpur,Cucumber,2015,1238,1696,458,36.995153473344104
Washim,Gram,2015,4544,5002,458,10.079225352112676
Nagpur,Math (Bhaji),2016,2526,2984,458,18.131433095803644
Jalgaon,Onion,2016,340,798,458,134.7058823529412
Pune-Pimpri,Ladies Finger,2014,2226,2684,458,20.575022461814914
Akluj,Onion,2016,295,753,458,155.25423728813558
Solapur,Chikoo,2014,521,979,458,87.90786948176583
Pune,Onion,2016,338,796,458,135.50295857988166
Nandura,Soybean,2015,3180,3638,458,14.40251572327044
Shegaon,Sesamum,2014,9330,9788,458,4.908896034297964
Nagpur,Ladies Finger,2016,1767,2225,458,25.91963780418789
Chandrapur-Ganjwad,Flower,2014,525,983,458,87.23809523809524
Dhamangaon-Rly,Pigeon Pea (Tur),2016,5931,6389,458,7.722137919406508
Kamthi,BRINJAL,2016,497,955,458,92.15291750503017
Mantha,Soybean,2015,3170,3628,458,14.447949526813881
Barshi,Spinach,2016,425,883,458,107.76470588235294
Akluj,Ladies Finger,2014,942,1400,458,48.61995753715499
Karad,Bitter Gourd,2015,2125,2583,458,21.55294117647059
Kurdwadi,Black Gram,2016,6309,6767,458,7.259470597559043
Digras,Pigeon Pea (Tur),2015,5346,5804,458,8.567153011597457
Murtizapur,Green Gram,2016,5386,5844,458,8.503527664314891
Shegaon,Soybean,2015,3063,3521,458,14.95266079007509
Dhule,Wheat(Husked),2014,1310,1768,458,34.961832061068705
Kalyan,Ladies Finger,2015,2218,2676,458,20.649233543733093
Karad,Bor,2014,875,1333,458,52.34285714285714
Shrirampur,Bor,2015,1071,1529,458,42.76377217553688
Bhandara,Soybean,2014,2871,3329,458,15.952629745733194
Solapur,Jaggery,2015,2243,2701,458,20.419081587160054
Nagpur,Flower,2016,1939,2396,457,23.568849922640535
Pune-Pimpri,Tomato,2015,1714,2171,457,26.662777129521587
Tuljapur,Black Gram,2016,6335,6792,457,7.213891081294396
Nagpur,Chavli (Shenga ),2016,1878,2335,457,24.33439829605964
Osmanabad,Gram,2016,4811,5268,457,9.499064643525255
Solapur,Banana,2014,454,911,457,100.66079295154185
Shrirampur,Wheat(Husked),2015,1478,1935,457,30.920162381596754
Manwat,Wheat(Husked),2015,1534,1991,457,29.791395045632335
Nandurbar,Green Gram,2015,6938,7395,457,6.586912654943788
Vai,Green-Peas,2016,2929,3386,457,15.602594742232844
Nagpur,Flower,2016,1204,1661,457,37.95681063122924
Amarawati,Capsicum,2016,4500,4957,457,10.155555555555555
Digras,Pigeon Pea (Tur),2016,7706,8163,457,5.930443810018168
Manora,Pigeon Pea (Tur),2014,4612,5069,457,9.908933217692974
Mumbai-Fruit Market,Melon,2016,1505,1962,457,30.365448504983387
Kalyan,Flower,2016,838,1295,457,54.5346062052506
Karad,Banana,2014,1086,1543,457,42.081031307550646
Aurangabad,Ladies Finger,2015,1578,2035,457,28.96070975918885
Jamkhed,Wheat(Husked),2014,1907,2364,457,23.964341898269534
Kalmeshwar,Methi (Bhaji),2014,859,1316,457,53.20139697322468
Digras,Pigeon Pea (Tur),2016,8422,8879,457,5.426264545238661
Raver,Black Gram,2016,6569,7026,457,6.9569188613183135
Karad,Green Chilli,2015,1043,1500,457,43.81591562799616
Mumbai,Squash Gourd,2016,2826,3283,457,16.171266808209484
Kada,Pigeon Pea (Tur),2014,4350,4807,457,10.505747126436782
Shrirampur,Bor,2014,1500,1957,457,30.466666666666665
Akot,Soybean,2016,3148,3605,457,14.51715374841169
Vai,Pavata,2015,2143,2600,457,21.325244983667755
Amarawati-Fruit And Vegetables,Cluster Bean,2016,3857,4314,457,11.848586984703138
Murtizapur,Pigeon Pea (Tur),2016,6400,6857,457,7.140625
Ahmednagar,SORGUM(JAWAR),2016,2030,2487,457,22.51231527093596
Taloda,Gram,2016,3011,3468,457,15.177681833277981
Ratanagari,Carrot,2016,1286,1743,457,35.53654743390358
Nandurbar,Sorgum(Jawar),2016,1103,1560,457,41.4324569356301
Anajngaon Surji,Gram,2016,3824,4281,457,11.950836820083682
Kej,Black Gram,2015,4900,5357,457,9.326530612244898
Karanja,Wheat(Husked),2015,1358,1815,457,33.65243004418262
Akluj,Tomato,2015,881,1338,457,51.87287173666288
Kalyan,Capsicum,2015,1983,2440,457,23.045890065557238
Kej,Sesamum,2015,7318,7775,457,6.24487564908445
Nandurbar,Pigeon Pea (Tur),2015,4810,5267,457,9.501039501039502
Umared,Soybean,2016,3300,3757,457,13.848484848484848
Washim,Wheat(Husked),2016,1488,1945,457,30.712365591397848
Shirpur,Sorgum(Jawar),2014,1358,1814,456,33.57879234167894
Aurangabad,Cluster Bean,2015,1256,1712,456,36.30573248407644
Vadgaon Peth,Cucumber,2015,569,1025,456,80.14059753954305
Lasalgaon,Bajri,2016,1396,1852,456,32.664756446991404
Pune-Moshi,Ginger (Fresh),2016,2437,2893,456,18.71153057037341
Ramtek,Chavli (Shenga ),2015,1463,1919,456,31.16883116883117
Nagpur,Ground Nut Pods (Dry),2015,3319,3775,456,13.739078035552877
Pune-Pimpri,GHEVDA,2016,3109,3565,456,14.667095529109039
Kolhapur-Malkapur,Cabbage,2016,161,617,456,283.2298136645963
Satara,Onion,2016,500,956,456,91.2
Akole,Bajri,2015,1394,1850,456,32.7116212338594
Parbhani,Green Gram,2015,7788,8244,456,5.855161787365177
Aurangabad,Flower,2015,1088,1544,456,41.911764705882355
Murtizapur,Pigeon Pea (Tur),2016,8600,9056,456,5.3023255813953485
Vadgaon Peth,Tomato,2015,511,967,456,89.23679060665361
Murtizapur,Pigeon Pea (Tur),2016,7833,8289,456,5.821524320183838
Akot,Soybean,2016,3002,3458,456,15.189873417721518
Solapur,Green Peas (Dry),2015,2744,3200,456,16.61807580174927
Baramati,Wheat(Husked),2016,1644,2100,456,27.73722627737226
Nagpur,Bitter Gourd,2016,1094,1550,456,41.681901279707496
Nagpur,Bitter Gourd,2016,2500,2956,456,18.24
Dudhani,Wheat(Husked),2015,1565,2021,456,29.13738019169329
Hinganghat,Soybean,2014,2751,3207,456,16.575790621592148
Dondaicha,Wheat(Husked),2016,1499,1955,456,30.420280186791196
Lonand,Bajri,2014,1290,1746,456,35.348837209302324
Malegaon,Bajri,2016,1662,2118,456,27.43682310469314
Nandura,Green Gram,2015,6525,6981,456,6.988505747126437
Aurangabad,Brinjal,2016,1400,1856,456,32.57142857142857
Vai,Ridge Gourd,2015,1569,2025,456,29.063097514340345
Shrirampur,Cucumber,2015,1444,1900,456,31.57894736842105
Mumbai,Green-Peas,2014,2707,3163,456,16.84521610639084
Panvel,Ladies Finger,2016,3722,4178,456,12.251477700161203
Kolhapur,Potato,2015,679,1135,456,67.15758468335788
Lasalgaon,Wheat(Husked),2015,1639,2095,456,27.82184258694326
Pune-Pimpri,Ladies Finger,2016,1885,2341,456,24.190981432360743
Nandgaon,Soybean,2015,3255,3711,456,14.009216589861751
Umrane,Onion,2016,396,852,456,115.15151515151516
Vani,Pigeon Pea (Tur),2016,5900,6356,456,7.728813559322034
Jalgaon Jamod-Aasalgaon,Soybean,2015,3022,3478,456,15.089344804765057
Murtizapur,Gram,2015,4353,4809,456,10.47553411440386
Yeola,Gram,2016,3857,4313,456,11.822660098522167
Murbad,Ladies Finger,2016,1944,2400,456,23.45679012345679
Satana,Bajri,2014,1099,1555,456,41.49226569608735
Amarawati,Pigeon Pea (Tur),2016,8130,8586,456,5.608856088560886
Nashik,Tomato,2016,481,937,456,94.8024948024948
Satara,Ginger (Fresh),2015,2878,3333,455,15.80958999305073
Mumbai,Sweet Potato,2016,1117,1572,455,40.73410922112802
Manmad,Sorgum(Jawar),2016,1435,1890,455,31.70731707317073
Nagpur,Parwar,2015,1175,1630,455,38.723404255319146
Pune,Sweet Potato,2015,818,1273,455,55.62347188264059
Gevrai,Bajri,2016,1248,1703,455,36.458333333333336
Mangalwedha,Sorgum(Jawar),2016,1731,2186,455,26.28538417099942
Wardha,Soybean,2015,3303,3758,455,13.775355737208598
Amarawati,Ground Nut Pods (Dry),2016,4860,5315,455,9.362139917695472
Pusad,Bajri,2015,1343,1798,455,33.87937453462398
Khed-Chakan,Cucumber,2016,1156,1611,455,39.3598615916955
Arvi,Gram,2016,3850,4305,455,11.818181818181818
Bhivandi,Potato,2015,1489,1944,455,30.557421087978508
Wardha,Soybean,2016,3315,3770,455,13.72549019607843
Arvi,Soybean,2015,3223,3678,455,14.117282035370772
Satara,Onion,2014,1278,1733,455,35.60250391236307
Chandrapur-Ganjwad,Math (Bhaji),2015,478,933,455,95.18828451882845
Chandrapur-Ganjwad,Potato,2016,800,1255,455,56.875
Dindori-Vani,Onion,2016,559,1014,455,81.3953488372093
Lasalgaon-Niphad,Green Gram,2016,5009,5464,455,9.083649431024156
Sindi (Selu),Soybean,2016,3328,3783,455,13.671875
Varud,Cotton,2016,4680,5135,455,9.722222222222221
Jalkot,Black Gram,2016,5992,6447,455,7.593457943925234
Pune,Tamarind,2015,4078,4533,455,11.157430112800393
Baramati,Bajri,2015,1289,1744,455,35.29868114817688
Sangli-Phale Bhajipalam,WATER MELON,2016,83,538,455,548.1927710843373
Shrigonda,Wheat(Husked),2016,1565,2020,455,29.073482428115017
Akot,Green Gram,2016,4014,4469,455,11.335326357747883
Nagpur,Cluster Bean,2015,1450,1904,454,31.310344827586206
Khamgaon,Green Gram,2015,6961,7415,454,6.522051429392329
Rahata,Ginger (Fresh),2016,3591,4045,454,12.6427179058758
Majalgaon,Gram,2015,2446,2900,454,18.560915780866722
Junnar (Narayangaon),TOMATO,2016,205,659,454,221.46341463414635
Yeotmal,Cotton,2016,4488,4942,454,10.115864527629233
Patan,Green Chilli,2015,2038,2492,454,22.276741903827283
Aarni,Pigeon Pea (Tur),2016,8500,8954,454,5.341176470588235
Shrirampur,Brinjal,2015,1004,1458,454,45.21912350597609
Mumbai,Chikoo,2015,1232,1686,454,36.85064935064935
Lonar,Pigeon Pea (Tur),2016,7840,8294,454,5.790816326530612
Lasalgaon,Sorgum(Jawar),2016,1482,1936,454,30.634278002699055
Nagpur,Flower,2015,1423,1877,454,31.904427266338722
Bhusaval,Black Gram,2016,5838,6292,454,7.776635834189791
Aurangabad,Flower,2014,1171,1625,454,38.770281810418446
Nandgaon Khandeshwar,Wheat(Husked),2015,1033,1487,454,43.94966118102614
Nagpur,Spinach,2016,1391,1845,454,32.638389647735444
Amarawati,Green Gram,2016,6813,7267,454,6.663731102304418
Indapur-Bhigwan,Wheat(Husked),2016,1667,2121,454,27.234553089382125
Karad,Ginger (Fresh),2016,1531,1985,454,29.653821032005226
Nagpur,Gram,2014,2399,2853,454,18.924551896623594
Pune-Pimpri,Ghevda,2015,2733,3187,454,16.611781924624953
Kalmeshwar,Coriander  ,2016,5668,6122,454,8.009880028228652
Karmala,Maize,2016,983,1437,454,46.18514750762971
Nashik-Devlali,KANDA PAT,2016,538,992,454,84.38661710037175
Nagpur,Math (Bhaji),2016,2288,2742,454,19.842657342657343
Vadgaon Peth,Tomato,2015,300,754,454,151.33333333333334
Karad,Squash Gourd,2016,1300,1754,454,34.92307692307692
Dound,Sorgum(Jawar),2015,1879,2333,454,24.161788185204895
Jalgaon,Wal Papdi,2016,1831,2285,454,24.795193883123975
Satara,Bitter Gourd,2016,1392,1846,454,32.61494252873563
Shrirampur,Brinjal,2016,992,1446,454,45.766129032258064
Nagpur,Bitter Gourd,2016,1754,2208,454,25.883694412770808
Akluj,Onion,2016,386,840,454,117.61658031088083
Pune-Pimpri,Tomato,2015,1071,1525,454,42.39028944911298
Lonand,Bajri,2016,1663,2116,453,27.23992784125075
Mandhal,Soybean,2015,3294,3747,453,13.752276867030965
Akot,Green Gram,2015,7500,7953,453,6.04
Sinner,SORGUM(JAWAR),2016,1371,1824,453,33.04157549234136
Bhiwapur,Cotton,2016,4109,4562,453,11.024580189827208
Risod,Gram,2015,3128,3581,453,14.482097186700766
Ramtek,Spinach,2016,490,943,453,92.44897959183673
Chalisgaon,Bajri,2016,1262,1715,453,35.89540412044374
Vai,Flower,2014,1893,2346,453,23.93026941362916
Risod,Gram,2016,4924,5377,453,9.199837530463038
Ausa,Black Gram,2016,6089,6542,453,7.439645261947775
Sangali,Soybean,2016,3365,3818,453,13.462109955423477
Karanja,SOYBEAN,2016,2424,2877,453,18.68811881188119
Kalyan,Ridge Gourd,2015,2447,2900,453,18.512464241928893
Nandura,Black Gram,2014,4366,4819,453,10.375629867155292
Palghar(Bevur),Wheat(Husked),2015,1871,2324,453,24.2116515232496
Risod,Gram,2015,4076,4529,453,11.113837095191364
Dondaicha,Wheat(Husked),2016,1450,1903,453,31.24137931034483
Khed-Chakan,Carrot,2016,882,1335,453,51.36054421768708
Digras,Pigeon Pea (Tur),2016,8647,9100,453,5.238811148375159
Palus,BITTER GOURD,2016,1275,1728,453,35.529411764705884
Junnar-Otur,Small Gourd,2016,351,804,453,129.05982905982907
Nagpur,Mosambi,2016,2793,3246,453,16.219119226638025
Mohol,Wheat(Husked),2016,1750,2203,453,25.885714285714286
Karad,Snake Gourd,2016,1114,1567,453,40.66427289048474
Dondaicha,Matki,2015,7003,7456,453,6.468656290161359
Anajngaon Surji,Wheat(Husked),2016,1429,1882,453,31.700489853044086
Sangali,Bajri,2015,1376,1829,453,32.92151162790697
Kalamb (Yawatmal),Pigeon Pea (Tur),2016,7495,7948,453,6.044029352901934
Hinganghat,Soybean,2016,2813,3266,453,16.103803768218985
Chopda,GREEN GRAM,2016,4157,4610,453,10.897281693528987
Vadgaon Peth,Cabbage,2014,662,1115,453,68.42900302114803
Shahapur,Brinjal,2014,1447,1900,453,31.306150656530754
Mumbai,Snake Gourd,2016,2700,3153,453,16.77777777777778
Ratanagari,Tomato,2015,511,964,453,88.64970645792563
Murum,Pigeon Pea (Tur),2014,4853,5306,453,9.334432309911396
Satara,Bottle Gourd,2014,526,979,453,86.12167300380229
Kej,GREEN GRAM,2016,4022,4475,453,11.263053207359523
Patur,Soybean,2016,3170,3622,452,14.258675078864353
Kurdwadi,Pigeon Pea (Tur),2015,4550,5002,452,9.934065934065934
Yeotmal,Soybean,2015,3442,3894,452,13.131900058105753
Karad,ONION,2016,556,1008,452,81.29496402877697
Kolhapur,Cabbage,2015,200,652,452,226.0
Mumbai,Chikoo,2015,1022,1474,452,44.22700587084149
Mohol,Gram,2015,3850,4302,452,11.74025974025974
Jamkhed,Wheat(Husked),2015,1840,2292,452,24.565217391304348
Malegaon,Wheat(Husked),2015,1518,1970,452,29.776021080368906
Telhara,Green Gram,2016,4605,5057,452,9.81541802388708
Mumbai,Jaggery,2016,3748,4200,452,12.059765208110992
Mumbai,Water Melon,2015,1056,1508,452,42.803030303030305
Karad,Bottle Gourd,2016,1143,1595,452,39.54505686789151
Vai,Ladies Finger,2015,1748,2200,452,25.85812356979405
Sengaon,Ground Nut Pods (Dry),2016,4796,5248,452,9.424520433694745
Devala,Pigeon Pea (Tur),2016,7357,7809,452,6.143808617643061
Chalisgaon,Wheat(Husked),2016,1444,1896,452,31.301939058171744
Satana,BAJRI,2016,1336,1788,452,33.83233532934132
Akot,Soybean,2016,3318,3770,452,13.622664255575648
Umared,Soybean,2015,3489,3941,452,12.95500143307538
Shahapur,Ghosali(Bhaji),2015,1453,1905,452,31.108052305574674
Kalyan,Ladies Finger,2016,1910,2362,452,23.664921465968586
Lonand,Wheat(Husked),2014,1450,1902,452,31.17241379310345
Ausa,Paddy-Unhusked,2016,700,1152,452,64.57142857142857
Washim,Gram,2015,3616,4068,452,12.5
Mumbai,Melon,2014,1220,1672,452,37.049180327868854
Majalgaon,Bajri,2014,1107,1559,452,40.83107497741644
Amarawati,Pigeon Pea (Tur),2015,5523,5975,452,8.183957993843926
Ratanagari,Tomato,2016,532,984,452,84.9624060150376
Manmad,GREEN GRAM,2016,4553,5005,452,9.927520316274984
Mumbai,Snake Gourd,2014,904,1356,452,50.0
Baramati,Green Gram,2016,4850,5302,452,9.31958762886598
Ahmednagar,Potato,2016,1016,1468,452,44.488188976377955
Tumsar,Rice(Paddy-Hus),2015,3211,3663,452,14.07661164746185
Hingoli,Ground Nut Pods (Dry),2016,5617,6069,452,8.047000178030977
Varora,Cotton,2016,4114,4566,452,10.986874088478366
Mumbai-Onion And Potato Mkt,Potato,2016,1283,1735,452,35.22992985190959
Dudhani,GREEN GRAM,2016,4316,4768,452,10.472659870250231
Parli-Vaijnath,Green Gram,2015,6488,6940,452,6.9667077681874225
Yeola,Pigeon Pea (Tur),2015,7237,7689,452,6.245681912394638
Karad,Green Chilli,2016,1057,1509,452,42.762535477767265
Mumbai,Carrot,2016,1020,1472,452,44.31372549019608
Pune-Pimpri,Bottle Gourd,2016,1605,2057,452,28.161993769470406
Kalvan,Gram,2015,3133,3585,452,14.427066709224386
Ulhasnagar,Banana,2016,340,792,452,132.94117647058823
Manmad,Bajri,2016,1471,1922,451,30.659415363698166
Khed-Chakan,Tomato,2015,1220,1671,451,36.967213114754095
Solapur,Gram,2015,3293,3744,451,13.695718190100212
Pathari,Pigeon Pea (Tur),2016,5941,6392,451,7.591314593502777
Sindi,Soybean,2015,3338,3789,451,13.511084481725584
Nira,Wheat(Husked),2015,1700,2151,451,26.529411764705884
Savner,Pigeon Pea (Tur),2015,5175,5626,451,8.714975845410628
Phaltan,Bajri,2014,1333,1784,451,33.833458364591145
Majalgaon,Bajri,2016,1246,1697,451,36.195826645264845
Dhule,Black Gram,2014,5442,5893,451,8.28739434031606
Gangakhed,Wheat(Husked),2016,1516,1967,451,29.74934036939314
Sangli-Phale Bhajipalam,Papai,2016,194,645,451,232.4742268041237
Dound,Bajri,2015,1374,1825,451,32.82387190684134
Partur,Pigeon Pea (Tur),2016,7622,8073,451,5.9170821306743635
Hanegaon,Black Gram,2016,6408,6859,451,7.038077403245943
Ambejogai,Gram,2016,3982,4433,451,11.32596685082873
Tumsar,Jaggery,2016,2150,2601,451,20.976744186046513
Hingoli,Sorgum(Jawar),2015,1244,1695,451,36.254019292604504
Devani,Pigeon Pea (Tur),2016,9019,9470,451,5.0005543851868275
Hinganghat,Gram,2014,2199,2650,451,20.509322419281492
Chopda,Pigeon Pea (Tur),2015,4350,4801,451,10.367816091954023
Washim,Gram,2015,4400,4851,451,10.25
Loha,Pigeon Pea (Tur),2016,8014,8465,451,5.6276516096830544
Chandrapur-Ganjwad,Cucumber,2016,700,1150,450,64.28571428571429
Karad,Snake Gourd,2014,1175,1625,450,38.297872340425535
Aurangabad,Sorgum(Jawar),2015,1550,2000,450,29.032258064516128
Nandgaon,Onion,2016,372,822,450,120.96774193548387
Kolhapur-Laxmipuri,Split Lentil,2015,7000,7450,450,6.428571428571429
Vadgaon Peth,Potato,2014,2200,2650,450,20.454545454545453
Kolhapur-Laxmipuri,Split Lentil,2015,7817,8267,450,5.75668414992964
Pune-Pimpri,Gram,2015,5333,5783,450,8.438027376711045
Pune-Manjri,Raddish,2016,900,1350,450,50.0
Kolhapur-Laxmipuri,SPLIT GRAM,2016,12100,12550,450,3.71900826446281
Nandgaon Khandeshwar,Green Gram,2015,7750,8200,450,5.806451612903226
Varud-Rajura Bazar,Pigeon Pea (Tur),2016,8075,8525,450,5.572755417956657
Karad,Bitter Gourd,2015,2225,2675,450,20.224719101123597
Karad,Sweet Potato,2016,1200,1650,450,37.5
Khed-Chakan,Sweet Potato,2016,900,1350,450,50.0
Katol,Mosambi,2015,1200,1650,450,37.5
Nandurbar,GREEN GRAM,2016,3867,4317,450,11.636927851047323
Latur,Black Gram,2015,5000,5450,450,9.0
Kalyan,Flower,2014,1250,1700,450,36.0
Vadgaon Peth,Cucumber,2015,700,1150,450,64.28571428571429
Sindi,Ground Nut Pods (Dry),2016,4000,4450,450,11.25
Kalyan,Ghevda,2014,3100,3550,450,14.516129032258064
Amarawati,Onion,2016,400,850,450,112.5
Hingoli,Ground Nut Pods (Dry),2015,5203,5653,450,8.64885642898328
Kalyan,Ghevda,2014,2750,3200,450,16.363636363636363
Indapur-Bhigwan,SUNFLOWER,2016,2500,2950,450,18.0
Kalyan,Green Chilli,2014,3150,3600,450,14.285714285714286
Pachora,Soybean,2016,3080,3530,450,14.61038961038961
Kalyan,Ladies Finger,2014,3400,3850,450,13.235294117647058
Pune,Beet Root,2015,610,1060,450,73.77049180327869
Kalyan,Papai,2014,1250,1700,450,36.0
Nashik,Grapes,2015,1500,1950,450,30.0
Kalyan,Ridge Gourd,2014,3550,4000,450,12.67605633802817
Shrirampur,Sorgum(Jawar),2015,1390,1840,450,32.37410071942446
Chandrapur-Ganjwad,Jack Fruit(Raw),2016,800,1250,450,56.25
Shahapur,Chavli (Shenga ),2016,2550,3000,450,17.647058823529413
Bhivandi,Wheat(Husked),2014,1388,1838,450,32.4207492795389
Pune-Pimpri,Green Gram,2015,7200,7650,450,6.25
Mumbai,Water Melon,2014,732,1182,450,61.47540983606557
Lasalgaon-Niphad,Onion,2016,280,730,450,160.71428571428572
Achalpur,Pigeon Pea (Tur),2016,5714,6164,450,7.875393769688484
Chandrapur-Ganjwad,Coriander  ,2015,470,920,450,95.74468085106383
Akkolkot,Sorgum(Jawar),2015,1550,2000,450,29.032258064516128
Sangali,Bajri,2015,1380,1830,450,32.608695652173914
Malegaon (Washim),Pigeon Pea (Tur),2015,6600,7050,450,6.818181818181818
Kolhapur,Ghevda,2016,800,1250,450,56.25
Akole,Soybean,2015,3000,3450,450,15.0
Murbad,Bottle Gourd,2016,2350,2800,450,19.148936170212767
Pune-Manjri,Tomato,2015,590,1040,450,76.27118644067797
Sangli-Phale Bhajipalam,Potato,2015,700,1150,450,64.28571428571429
Mumbai,Sweet Potato,2015,1508,1958,450,29.840848806366047
Ratanagari,Tomato,2016,463,913,450,97.19222462203024
Murbad,Bottle Gourd,2016,1050,1500,450,42.857142857142854
Manchar,Cabbage,2016,100,550,450,450.0
Mumbai,Sweet Potato,2015,1013,1463,450,44.42250740375123
Akole,Paddy-Unhusked,2015,1400,1850,450,32.142857142857146
Murbad,TOMATO,2016,1590,2040,450,28.30188679245283
Jalgaon,Shevga,2016,1100,1550,450,40.90909090909091
Nandurbar,Wheat(Husked),2015,1430,1880,450,31.46853146853147
Majalgaon,Gram,2016,5225,5675,450,8.61244019138756
Murbad,Brinjal,2016,1075,1525,450,41.86046511627907
Anajngaon Surji,Wheat(Husked),2015,1255,1705,450,35.85657370517928
Chandrapur-Ganjwad,Bitter Gourd,2015,450,900,450,100.0
Kada (Ashti),BAJRI,2016,1176,1626,450,38.265306122448976
Nagpur,Green Chilli,2014,2473,2923,450,18.196522442377677
Rahata,Brinjal,2015,500,950,450,90.0
Akole,Wheat(Husked),2015,1475,1925,450,30.508474576271187
Kada (Ashti),Pigeon Pea (Tur),2016,6300,6750,450,7.142857142857143
Shirpur,Black Gram,2016,8600,9050,450,5.232558139534884
Chandrapur-Ganjwad,Chavli (Shenga ),2014,1100,1550,450,40.90909090909091
Solapur,Cabbage,2014,314,764,450,143.31210191082803
Kolhapur,Jaggery,2015,2806,3256,450,16.037063435495366
Nagpur,Ladies Finger,2015,1123,1573,450,40.07123775601069
Kolhapur,Snake Gourd,2016,750,1200,450,60.0
Dound,Pigeon Pea (Tur),2016,5050,5500,450,8.910891089108912
Pune-Manjri,Spinach,2016,450,900,450,100.0
Akole,Paddy-Unhusked,2014,1450,1900,450,31.03448275862069
Kolhapur-Laxmipuri,Bajri,2015,1350,1800,450,33.333333333333336
Ghansawangi,Gram,2015,3950,4400,450,11.39240506329114
Aurangabad,Chikoo,2015,1300,1750,450,34.61538461538461
Ghansawangi,Gram,2015,3983,4433,450,11.298016570424304
Akot,Sesamum,2015,6000,6450,450,7.5
Chalisgaon,Green Gram,2016,4400,4850,450,10.227272727272727
Jalgaon,Cucumber,2016,700,1150,450,64.28571428571429
Chandrapur-Ganjwad,Cabbage,2016,618,1068,450,72.81553398058253
Aurangabad,Bor,2015,733,1183,450,61.391541609822646
Jalgaon Jamod-Aasalgaon,Gram,2016,3550,4000,450,12.67605633802817
Jalgaon Jamod-Aasalgaon,Gram,2016,4667,5117,450,9.642168416541676
Nampur,SUNFLOWER,2016,2900,3350,450,15.517241379310345
Kolhapur,Guava,2016,600,1050,450,75.0
Kalamb (Os),Sesamum,2015,7000,7450,450,6.428571428571429
Buldhana,Gram,2014,1800,2250,450,25.0
Chalisgaon,Potato,2016,750,1200,450,60.0
Dound,Green Gram,2016,4600,5050,450,9.782608695652174
Lonand,Gram,2016,6000,6450,450,7.5
Nashik,Raddish,2016,1600,2050,450,28.125
Aurangabad,Cucumber,2014,658,1108,450,68.38905775075987
Karmala,Bajri,2016,1350,1800,450,33.333333333333336
Yawal,Cotton,2016,4500,4950,450,10.0
Nagpur,Coriander (Dry),2016,6950,7400,450,6.474820143884892
Kolhapur,Maize(Corn.),2016,375,825,450,120.0
Kada,GREEN GRAM,2016,4230,4680,450,10.638297872340425
Hadgaon-Tamsa,Pigeon Pea (Tur),2016,7558,8008,450,5.953956073035195
Chandrapur-Ganjwad,Raddish,2015,550,1000,450,81.81818181818181
Pune,Squash Gourd,2015,494,944,450,91.09311740890688
Shahapur,Bitter Gourd,2014,1267,1717,450,35.51696921862668
Rahuri-Songaon,Potato,2016,1125,1575,450,40.0
Newasa,Gram,2016,4600,5050,450,9.782608695652174
Kalvan,Gram,2014,1867,2317,450,24.1028387787895
Tumsar,Jaggery,2014,2700,3150,450,16.666666666666668
Karad,Chikoo,2015,1425,1875,450,31.57894736842105
Ahmednagar,Potato,2015,425,875,450,105.88235294117646
Aarni,Soybean,2014,3000,3450,450,15.0
Balapur,Sorgum(Jawar),2016,1350,1800,450,33.333333333333336
Darwha,Pigeon Pea (Tur),2016,8700,9150,450,5.172413793103448
Manora,Gram,2016,3300,3750,450,13.636363636363637
Pathardi,Sorgum(Jawar),2014,1550,2000,450,29.032258064516128
Barshi,Matki,2016,3050,3500,450,14.754098360655737
Pune-Pimpri,Hemp-Seed,2016,200,650,450,225.0
Nagpur,Coriander (Dry),2015,6000,6450,450,7.5
Karad,Chikoo,2015,1100,1550,450,40.90909090909091
Karad,Snake Gourd,2015,1250,1700,450,36.0
Mantha,Green Gram,2014,6142,6592,450,7.3266037121458805
Junnar-Otur,Potato,2016,1200,1650,450,37.5
Karad,Ghevda,2015,1283,1733,450,35.074045206547154
Nira,Jaggery,2016,3633,4083,450,12.386457473162675
Nagpur,Papai,2016,663,1113,450,67.87330316742081
Vai,Green-Peas,2015,2650,3100,450,16.9811320754717
Barshi,Coriander  ,2014,200,650,450,225.0
Ahmednagar,Wheat(Husked),2015,1550,2000,450,29.032258064516128
Jintur,Turmeric,2015,8851,9301,450,5.084171280081347
Dhule,Green Gram,2016,6075,6525,450,7.407407407407407
Dondaicha,Wheat(Husked),2015,1463,1913,450,30.758714969241286
Amarawati,Black Gram,2015,5275,5725,450,8.530805687203792
Rahata,BRINJAL,2016,423,873,450,106.38297872340425
Karad,Ghevda,2015,2017,2467,450,22.310361923648983
Karad,Banana,2016,712,1162,450,63.20224719101124
Patan,Pavtta,2016,2375,2825,450,18.94736842105263
Paithan,ONION,2016,150,600,450,300.0
Balapur,Wheat(Husked),2015,1400,1850,450,32.142857142857146
Solapur,Coriander  ,2015,100,550,450,450.0
Bhokardan,Pigeon Pea (Tur),2016,7150,7600,450,6.293706293706293
Junnar-Otur,Onion,2016,564,1014,450,79.7872340425532
Manchar,Flower,2016,450,900,450,100.0
Shahapur,Ladies Finger,2014,1217,1667,450,36.976170912078885
Patan,Pavtta,2015,2700,3150,450,16.666666666666668
Jalna,Neem-Seed,2016,722,1172,450,62.32686980609418
Indapur-Bhigwan,Horse Gram,2016,2101,2551,450,21.41837220371252
Khamgaon,Soybean,2016,3270,3720,450,13.761467889908257
Satara,Sweet Potato,2016,1650,2100,450,27.272727272727273
Vaijapur,Gram,2014,2067,2517,450,21.77068214804064
Manchar,Green Chilli,2015,1900,2350,450,23.68421052631579
Khed-Chakan,Green-Peas,2016,1729,2179,450,26.026604973973395
Karad,Cabbage,2016,1258,1708,450,35.77106518282989
Ratanagari,Bottle Gourd,2015,683,1133,450,65.88579795021963
Khed,Coriander  ,2015,51,501,450,882.3529411764706
Pune-Manjri,Goosefoot,2016,664,1114,450,67.7710843373494
Ratanagari,Sweet Potato,2014,800,1250,450,56.25
Lonand,Sorgum(Jawar),2014,1550,2000,450,29.032258064516128
Junnar-Otur,Potato,2015,975,1425,450,46.15384615384615
Patan,Cucumber,2016,1006,1456,450,44.731610337972164
Ulhasnagar,Onion,2016,992,1442,450,45.36290322580645
Khed (Shel Pimpalgaon),Green Chilli,2016,2625,3075,450,17.142857142857142
Karad,Pavata,2015,2700,3150,450,16.666666666666668
Patan,Flower,2016,1350,1800,450,33.333333333333336
Junnar (Narayangaon),Coriander  ,2016,101,551,450,445.54455445544556
Shahapur,Capsicum,2015,1383,1833,450,32.53796095444685
Kalmeshwar,Pigeon Pea (Tur),2015,5232,5682,450,8.600917431192661
Pune-Manjri,Methi (Bhaji),2016,450,900,450,100.0
Manchar,Beet Root,2016,1000,1450,450,45.0
Nagpur,Brinjal,2016,1858,2308,450,24.219590958019374
Karad,Potato,2016,1415,1865,450,31.802120141342755
Rahata,Green Peas (Dry),2015,2450,2900,450,18.367346938775512
Morshi,Gram,2016,6975,7425,450,6.451612903225806
Rahata,Green Peas (Dry),2015,2430,2880,450,18.51851851851852
Nagpur,Onion,2016,349,799,450,128.93982808022923
Patan,Ghevda,2016,2500,2950,450,18.0
Ramtek,Chavli (Pala),2015,1633,2083,450,27.556644213104715
Amarawati,Green Chilli,2016,4400,4850,450,10.227272727272727
Nagpur,Capsicum,2015,1467,1917,450,30.67484662576687
Nagpur,Bitter Gourd,2016,2683,3133,450,16.772269847185985
Mumbai,Horse Gram,2014,3500,3950,450,12.857142857142858
Nagpur,Bitter Gourd,2016,2675,3125,450,16.822429906542055
Karad,SWEET POTATO,2016,650,1100,450,69.23076923076923
Jalgaon,Shevga,2015,2250,2700,450,20.0
Patan,Ginger (Fresh),2016,1865,2315,450,24.128686327077748
Kamthi,Kanda Pat,2016,700,1150,450,64.28571428571429
Udgir,Maize,2016,4600,5050,450,9.782608695652174
Junnar-Otur,Bottle Gourd,2016,333,783,450,135.13513513513513
Barshi,Wheat(Husked),2016,1595,2045,450,28.213166144200628
Solapur,Carrot,2015,750,1200,450,60.0
Umared,Wheat(Husked),2014,1500,1950,450,30.0
Indapur,Ground Nut Pods (Dry),2015,3625,4075,450,12.413793103448276
Palghar(Bevur),Onion,2015,3250,3700,450,13.846153846153847
Manchar,Farshi,2015,850,1300,450,52.94117647058823
Ratanagari,Carrot,2015,2000,2450,450,22.5
Mantha,Wheat(Husked),2015,1450,1900,450,31.03448275862069
Vani,Soybean,2015,3213,3662,449,13.974478680361033
Karanja,Gram,2015,3890,4339,449,11.54241645244216
Junnar (Alephata),Onion,2016,538,987,449,83.45724907063197
Taloda,Sorgum(Jawar),2015,1625,2074,449,27.630769230769232
Kopargaon,Pigeon Pea (Tur),2015,4534,4983,449,9.902955447728274
Sindkhed Raja,Green Gram,2016,4576,5025,449,9.812062937062937
Kille Dharur,Soybean,2016,3584,4033,449,12.527901785714286
Nashik,Raddish,2014,393,842,449,114.24936386768448
Lasur Station,Wheat(Husked),2015,1381,1830,449,32.512671976828386
Khed (Shel Pimpalgaon),Cluster Bean,2015,1341,1790,449,33.48247576435496
Nandurbar,Wheat(Husked),2015,1411,1860,449,31.82140326009922
Amalner,SORGUM(JAWAR),2016,1645,2094,449,27.29483282674772
Kille Dharur,Sesamum,2014,10401,10850,449,4.316892606480146
Nagpur,Onion,2016,299,748,449,150.16722408026754
Tuljapur,Turmeric,2016,8151,8600,449,5.50852656115814
Mangrulpeer,Soybean,2015,2824,3273,449,15.89943342776204
Kille Dharur,Sorgum(Jawar),2014,1566,2015,449,28.67177522349936
Partur,Gram,2015,3884,4333,449,11.560247167868177
Nagpur,Soybean,2014,2782,3231,449,16.13946800862689
Indapur-Bhigwan,Rajgira,2015,6000,6449,449,7.483333333333333
Hingna,Soybean,2015,3251,3700,449,13.81113503537373
Murtizapur,Soybean,2014,2820,3269,449,15.921985815602836
Lonand,Onion,2016,150,599,449,299.3333333333333
Majalgaon,Bajri,2015,1058,1507,449,42.438563327032135
Osmanabad,Sorgum(Jawar),2016,1707,2155,448,26.24487404803749
Vita,BRINJAL,2016,600,1048,448,74.66666666666667
Kamthi,Bottle Gourd,2016,557,1005,448,80.43087971274686
Solapur,Cabbage,2014,369,817,448,121.40921409214093
Nagpur,Soybean,2015,2842,3290,448,15.763546798029557
Varud-Rajura Bazar,Gram,2015,5281,5729,448,8.483241810263207
Mumbai,Squash Gourd,2016,3504,3952,448,12.785388127853881
Nagpur,Brinjal,2015,1068,1516,448,41.947565543071164
Lasalgaon,Sorgum(Jawar),2016,1335,1783,448,33.558052434456926
Murtizapur,Black Gram,2014,4372,4820,448,10.247026532479415
Majalgaon,Soybean,2014,2905,3353,448,15.421686746987952
Latur,Bajri,2014,1144,1592,448,39.16083916083916
Osmanabad,Gram,2016,3883,4331,448,11.537471027556013
Jintur,Pigeon Pea (Tur),2016,7966,8414,448,5.62390158172232
Latur,Sunflower,2016,3604,4052,448,12.430632630410654
Majalgaon,Sorgum(Jawar),2016,1383,1831,448,32.393347794649316
Shrirampur,Bitter Gourd,2015,1052,1500,448,42.58555133079848
Yeola,Gram,2016,5020,5468,448,8.92430278884462
Solapur,Cabbage,2015,348,796,448,128.73563218390805
Osmanabad,Cabbage,2016,747,1195,448,59.97322623828648
Solapur,Gram,2016,4165,4613,448,10.756302521008404
Satana,Maize,2016,1151,1599,448,38.92267593397046
Nagpur,Soybean,2016,3310,3758,448,13.534743202416918
Nandura,Onion,2016,319,767,448,140.43887147335423
Nandurbar,Gram,2014,2189,2637,448,20.46596619460941
Amarawati-Fruit And Vegetables,Tomato,2016,2964,3412,448,15.114709851551957
Nagpur,Capsicum,2016,2392,2840,448,18.729096989966557
Aurangabad,Cucumber,2016,1035,1483,448,43.28502415458937
Murtizapur,Soybean,2015,3258,3706,448,13.750767341927563
Nandurbar,Bajri,2015,1049,1497,448,42.707340324118206
Mumbai,Melon,2015,1514,1962,448,29.590488771466315
Karad,Tomato,2016,1096,1544,448,40.87591240875913
Nagpur,Green Chilli,2016,2438,2886,448,18.375717801476622
Shrirampur,Cucumber,2016,1065,1513,448,42.06572769953052
Ambejogai,Gram,2014,2337,2785,448,19.16987590928541
Pathardi,SORGUM(JAWAR),2016,1658,2106,448,27.020506634499398
Dhule,Bajri,2016,1602,2050,448,27.965043695380775
Pune,Potato,2015,815,1263,448,54.969325153374236
Junnar-Otur,Onion,2016,552,1000,448,81.15942028985508
Nashik,Methi (Bhaji),2016,383,831,448,116.97127937336815
Umarga,GREEN GRAM,2016,4121,4568,447,10.846881824799805
Digras,Pigeon Pea (Tur),2015,6562,7009,447,6.811947576958245
Ghoti,Tomato,2015,1162,1609,447,38.46815834767642
Mangrulpeer,Wheat(Husked),2016,1250,1697,447,35.76
Pune,Wheat(Husked),2016,2009,2456,447,22.24987555998009
Digras,Wheat(Husked),2016,1559,2006,447,28.6722257857601
Ratanagari,Cabbage,2016,805,1252,447,55.52795031055901
Pune-Pimpri,Wheat(Husked),2016,1913,2360,447,23.366440146366962
Amarawati-Fruit And Vegetables,Coriander  ,2016,2606,3053,447,17.152724481964697
Kalmeshwar,Soybean,2015,3003,3450,447,14.885114885114884
Nagpur,Math (Bhaji),2016,2479,2926,447,18.031464300121016
Satara,Cabbage,2015,538,985,447,83.08550185873607
Mohol,Gram,2016,5874,6321,447,7.609805924412666
Pune,GREEN GRAM,2016,5486,5933,447,8.148013124316442
Mumbai,Bitter Gourd,2016,1638,2085,447,27.28937728937729
Satara,Bitter Gourd,2015,1974,2421,447,22.64437689969605
Mandhal,Pigeon Pea (Tur),2016,7385,7832,447,6.052809749492214
Jalgaon,Cucumber,2014,693,1140,447,64.5021645021645
Risod,Gram,2016,3940,4387,447,11.345177664974619
Chimur,Pigeon Pea (Tur),2016,7749,8196,447,5.768486256291134
Murbad,Bitter Gourd,2016,3621,4068,447,12.344656172328087
Aurad Shahajani,Pigeon Pea (Tur),2016,7667,8114,447,5.830181296465371
Karanja,Wheat(Husked),2015,1331,1778,447,33.58377160030052
Sengaon,Pigeon Pea (Tur),2016,7988,8435,447,5.595893840761142
Shahapur,Cucumber,2015,1333,1780,447,33.53338334583646
Ramtek,Spinach,2016,1542,1989,447,28.988326848249027
Nagpur,Small Gourd,2016,1543,1990,447,28.96953985742061
Varud,Cotton,2016,4507,4954,447,9.917905480363878
Shirur,Tamarind,2015,1520,1967,447,29.407894736842106
Nagpur,Mosambi,2016,2314,2761,447,19.317199654278305
Nagpur,Dhemse,2015,1338,1785,447,33.408071748878925
Kalamb (Os),Sorgum(Jawar),2015,1569,2016,447,28.489483747609942
Pandharpur,Banana,2015,380,827,447,117.63157894736842
Kamthi,MINT,2016,731,1177,446,61.01231190150479
Chandrapur-Ganjwad,Cabbage,2014,645,1091,446,69.14728682170542
Nashik,Tomato,2014,324,770,446,137.65432098765433
Gevrai,Gram,2014,1962,2408,446,22.73190621814475
Nagpur,Bitter Gourd,2015,1617,2063,446,27.581941867656152
Satara,Cucumber,2015,825,1271,446,54.06060606060606
Wardha,Pigeon Pea (Tur),2015,6879,7325,446,6.483500508794883
Pune,Onion,2016,456,902,446,97.80701754385964
Solapur,Tomato,2016,135,581,446,330.3703703703704
Kej,Bajri,2016,1297,1743,446,34.38704703161141
Lasalgaon-Niphad,Onion,2016,389,835,446,114.65295629820051
Gadhinglaj,Jaggery,2014,2172,2618,446,20.534069981583794
Kille Dharur,Wheat(Husked),2016,2110,2556,446,21.137440758293838
Mehkar,Soybean,2015,3420,3866,446,13.04093567251462
Nagpur,Dhemse,2015,1267,1713,446,35.201262825572215
Satara,BITTER GOURD,2016,1045,1491,446,42.67942583732057
Satara,Bitter Gourd,2016,1068,1514,446,41.760299625468164
Khamgaon,Soybean,2016,3208,3654,446,13.902743142144638
Malkapur,Black Gram,2015,7129,7575,446,6.256136905596858
Aurangabad,Brinjal,2014,1058,1504,446,42.15500945179584
Majalgaon,Wheat(Husked),2016,1639,2085,446,27.211714460036607
Kamthi,Spinach,2016,357,803,446,124.92997198879551
Lasur Station,WHEAT(HUSKED),2016,1836,2282,446,24.29193899782135
Hingoli,Ground Nut Pods (Dry),2016,5026,5472,446,8.873855949064863
Chandrapur-Ganjwad,Cabbage,2015,407,853,446,109.58230958230958
Mumbai,Water Melon,2015,546,992,446,81.68498168498168
Rahata,Bitter Gourd,2015,1036,1482,446,43.05019305019305
Vai,Flower,2016,1969,2415,446,22.65109192483494
Ahmedpur,GREEN GRAM,2016,4030,4476,446,11.066997518610421
Kolhapur-Laxmipuri,Wheat(Husked),2016,2342,2788,446,19.043552519214348
Pulgaon,Pigeon Pea (Tur),2015,4762,5208,446,9.365812683746325
Jalgaon,Papai,2015,947,1393,446,47.0960929250264
Nagpur,Ground Nut Pods (Dry),2016,3196,3642,446,13.954943679599499
Vadgaon Peth,Tomato,2016,527,973,446,84.62998102466793
Shahada,Gram,2015,3274,3720,446,13.622480146609652
Manora,Pigeon Pea (Tur),2014,4595,5041,446,9.70620239390642
Amarawati,Harbara(Pendi),2015,969,1415,446,46.02683178534572
Manchar,Cabbage,2016,745,1191,446,59.86577181208054
Jalgaon,Jaggery,2016,2526,2972,446,17.65637371338084
Jalgaon,Cabbage,2015,700,1146,446,63.714285714285715
Kurdwadi,Gram,2014,2282,2728,446,19.544259421560035
Panvel,Ridge Gourd,2016,5111,5556,445,8.706711015456857
Umarkhed,Gram,2016,4044,4489,445,11.003956478733928
Nandurbar,Cluster Bean,2015,3497,3942,445,12.725193022590792
Chandur Bajar,Gram,2014,2200,2645,445,20.227272727272727
Kalvan,Onion,2016,370,815,445,120.27027027027027
Ratanagari,Cucumber,2015,964,1409,445,46.16182572614108
Umared,SOYBEAN,2016,2489,2934,445,17.878666130976296
Bhivandi,Potato,2015,1133,1578,445,39.27625772285966
Satara,Carrot,2015,964,1409,445,46.16182572614108
Udgir,Pigeon Pea (Tur),2015,9430,9875,445,4.71898197242842
Pune-Moshi,Ground Nut Pods (Dry),2016,3359,3804,445,13.247990473355165
Satara,Onion,2015,922,1367,445,48.2646420824295
Karanja,Pigeon Pea (Tur),2014,4701,5146,445,9.46607104871304
Aurangabad,Wal Bhaji,2015,1270,1715,445,35.039370078740156
Karad,Snake Gourd,2014,922,1367,445,48.2646420824295
Amarawati-Fruit And Vegetables,Bitter Gourd,2016,3491,3936,445,12.747063878544829
Amarawati-Fruit And Vegetables,Flower,2016,3523,3968,445,12.631280158955436
Pune,Squash Gourd,2015,482,927,445,92.32365145228216
Rahata,Bottle Gourd,2015,411,856,445,108.27250608272506
Akole,Bajri,2015,1395,1840,445,31.899641577060933
Lasalgaon,Bajri,2015,1176,1621,445,37.84013605442177
Ghatanji,Ground Nut Pods (Dry),2016,4838,5283,445,9.19801570897065
Kalvan,Gram,2014,1925,2370,445,23.116883116883116
Shevgaon,Gram,2016,3939,4384,445,11.297283574511297
Karad,CARROT,2016,1011,1456,445,44.01582591493571
Ahmedpur,Pigeon Pea (Tur),2014,3735,4180,445,11.914323962516734
Karad,Cucumber,2016,1011,1456,445,44.01582591493571
Karanja,Soybean,2016,3140,3585,445,14.171974522292993
Nagpur,Chavli (Shenga ),2016,2775,3220,445,16.036036036036037
Latur,Soybean,2015,3462,3907,445,12.853841709994223
Karad,Chikoo,2015,1111,1556,445,40.054005400540056
Varora,Soybean,2014,2967,3412,445,14.998314796090327
Babhulgaon,Soybean,2016,3534,3979,445,12.591963780418789
Deglur,Green Gram,2015,7404,7849,445,6.010264721772015
Aurangabad,Brinjal,2016,832,1276,444,53.36538461538461
Akluj,Carrot,2015,500,944,444,88.8
Babhulgaon,Soybean,2016,3248,3692,444,13.669950738916256
Indapur-Bhigwan,Bajri,2015,1340,1784,444,33.134328358208954
Barshi-Vairag,Ground Nut Pods (Dry),2014,3195,3639,444,13.896713615023474
Nagpur,Cluster Bean,2016,1504,1948,444,29.52127659574468
Dondaicha,Ground Nut Pods (Dry),2015,5450,5894,444,8.146788990825687
Junnar-Otur,Onion,2015,1044,1488,444,42.52873563218391
Pune,Cabbage,2015,452,896,444,98.23008849557522
Nagpur,Beet Root,2016,1417,1861,444,31.33380381086803
Mumbai,Capsicum,2015,1416,1860,444,31.35593220338983
Ramtek,Chavli (Shenga ),2015,1275,1719,444,34.8235294117647
Katol,Soybean,2016,2428,2872,444,18.28665568369028
Solapur,Gram,2015,3236,3680,444,13.720642768850432
Gangapur,Sorgum(Jawar),2015,1339,1783,444,33.159073935772966
Kada,Bajri,2014,1251,1695,444,35.4916067146283
Mumbai,Melon,2015,1356,1800,444,32.743362831858406
Karad,Capsicum,2015,1556,2000,444,28.53470437017995
Pune-Moshi,Capsicum,2016,1789,2233,444,24.818334264952487
Dondaicha,Bajri,2016,1375,1819,444,32.29090909090909
Mumbai,Cucumber,2016,1500,1944,444,29.6
Manora,Gram,2016,5003,5447,444,8.87467519488307
Chopda,Sorgum(Jawar),2015,1360,1804,444,32.64705882352941
Sinner,Bajri,2014,1052,1496,444,42.20532319391635
Nagpur,Bitter Gourd,2016,2272,2716,444,19.54225352112676
Patan,Brinjal,2016,1731,2175,444,25.64991334488735
Pune,Cabbage,2014,465,909,444,95.48387096774194
Jamkhed,Gram,2015,3419,3863,444,12.9862532904358
Latur,Soybean,2016,3387,3831,444,13.108945969884854
Mumbai,Water Melon,2014,596,1040,444,74.49664429530202
Chandrapur-Ganjwad,Brinjal,2016,517,961,444,85.88007736943908
Sangali,Bajri,2014,1333,1777,444,33.30832708177044
Chalisgaon,Wheat(Husked),2016,1452,1896,444,30.578512396694215
Nashik-Devlali,Raddish,2016,430,874,444,103.25581395348837
Umarkhed,Soybean,2014,2678,3122,444,16.579536967886483
Kalyan,Flower,2016,878,1322,444,50.569476082004556
Kalyan,Flower,2015,978,1422,444,45.39877300613497
Washim,Green Gram,2015,6385,6829,444,6.953797963978074
Panvel,Ridge Gourd,2016,1400,1844,444,31.714285714285715
Kalamb (Os),Gram,2015,3017,3461,444,14.716605899900564
Shrirampur,Brinjal,2014,1019,1462,443,43.47399411187439
Chandur Bajar,Soybean,2016,3214,3657,443,13.783447417548226
Umared,Green Peas (Dry),2015,1741,2184,443,25.445146467547385
Sinner,Soybean,2016,3295,3738,443,13.444613050075873
Varora,Soybean,2015,3170,3613,443,13.974763406940063
Kinwat,Pigeon Pea (Tur),2016,8232,8675,443,5.381438289601555
Nagpur,Parwar,2016,2264,2707,443,19.56713780918728
Solapur,Sorgum(Jawar),2015,2110,2553,443,20.99526066350711
Jalna,Banana,2015,207,650,443,214.0096618357488
Aurangabad,Guava,2015,890,1333,443,49.7752808988764
Sangamner,WHEAT(HUSKED),2016,1730,2173,443,25.606936416184972
Panvel,Ghevda,2016,5571,6014,443,7.951893735415545
Chandrapur-Ganjwad,Small Gourd,2014,900,1343,443,49.22222222222222
Samudrapur,SOYBEAN,2016,2486,2929,443,17.819790828640386
Jamkhed,Soybean,2016,3000,3443,443,14.766666666666667
Karad,Bor,2016,800,1243,443,55.375
Jalgaon,Cucumber,2015,689,1132,443,64.29608127721335
Nandurbar,Bajri,2015,1196,1639,443,37.04013377926422
Kamthi,Tomato,2016,540,983,443,82.03703703703704
Pune,Arvi,2016,2489,2932,443,17.798312575331458
Nagpur,Capsicum,2015,2142,2585,443,20.681605975723624
Kalyan,Mosambi,2016,2514,2957,443,17.621320604614162
Akole,Bajri,2015,1357,1800,443,32.64554163596168
Aurangabad,Chikoo,2015,943,1386,443,46.977730646871684
Washim,Gram,2015,4309,4752,443,10.280807611974936
Akhadabalapur,Black Gram,2016,6000,6443,443,7.383333333333334
Shrirampur,BITTER GOURD,2016,971,1414,443,45.62306900102987
Chandrapur-Ganjwad,Brinjal,2016,436,879,443,101.60550458715596
Jalgaon,GREEN CHILLI,2016,433,876,443,102.3094688221709
Gangapur,Wheat(Husked),2016,1542,1985,443,28.72892347600519
Jintur,Sorgum(Jawar),2015,1410,1853,443,31.418439716312058
Phaltan,Bajri,2015,1250,1693,443,35.44
Aurangabad,Wal Bhaji,2016,1288,1731,443,34.3944099378882
Lonar,Gram,2015,3816,4259,443,11.60901467505241
Kalamb (Os),Gram,2016,5268,5710,442,8.390280941533788
Daryapur,Soybean,2016,3012,3454,442,14.674634794156706
Solapur,Cabbage,2016,204,646,442,216.66666666666666
Pune,Gram,2015,5933,6375,442,7.4498567335243555
Lasalgaon,Sorgum(Jawar),2016,1216,1658,442,36.348684210526315
Satara,Cucumber,2016,611,1053,442,72.34042553191489
Babhulgaon,Soybean,2015,2863,3305,442,15.438351379671673
Nagpur,Spinach,2015,1046,1488,442,42.25621414913958
Aurad Shahajani,Pigeon Pea (Tur),2016,8941,9383,442,4.943518622078067
Aurangabad,Wal Bhaji,2015,1229,1671,442,35.96419853539463
Hingoli,Pigeon Pea (Tur),2015,6960,7402,442,6.350574712643678
Satara,Tomato,2015,875,1317,442,50.51428571428571
Murtizapur,Green Gram,2016,4538,4980,442,9.739973556632878
Karad,Brinjal,2016,1058,1500,442,41.77693761814745
Khed (Shel Pimpalgaon),Brinjal,2014,2297,2739,442,19.242490204614715
Ahmednagar,Bottle Gourd,2016,158,600,442,279.746835443038
Kolhapur-Laxmipuri,Spilt Gerrn Gram,2016,9133,9575,442,4.839592685864448
Aurangabad,Cluster Bean,2016,1171,1613,442,37.745516652433814
Nagpur,Coriander  ,2015,1296,1738,442,34.10493827160494
Akola,Black Gram,2014,5141,5583,442,8.597549114958179
Mantha,Sorgum(Jawar),2014,1129,1571,442,39.1496899911426
Kej,Soybean,2015,3351,3793,442,13.190092509698598
Chandur Bajar,Gram,2015,3017,3459,442,14.650314882333443
Jintur,Sorgum(Jawar),2016,1477,1919,442,29.92552471225457
Shrirampur,Wheat(Husked),2016,1544,1986,442,28.626943005181346
Pathari,Wheat(Husked),2015,1549,1991,442,28.534538411878632
Hinganghat,Soybean,2016,2625,3067,442,16.83809523809524
Bhivandi,Wheat(Husked),2016,2027,2469,442,21.805624074987666
Jamkhed,Black Gram,2014,4889,5331,442,9.040703620372264
Karad,Ridge Gourd,2015,1650,2092,442,26.78787878787879
Rahata,Brinjal,2016,583,1025,442,75.8147512864494
Pune,Wheat(Husked),2015,2208,2650,442,20.018115942028984
Sinner,Bajri,2016,1535,1977,442,28.794788273615634
Hingoli,Wheat(Husked),2015,1430,1872,442,30.90909090909091
Shrirampur,BRINJAL,2016,1029,1471,442,42.95432458697765
Barshi,Green Gram,2015,6912,7354,442,6.394675925925926
Kolhapur-Laxmipuri,Spilt Pigeon Pea,2015,17400,17842,442,2.5402298850574714
Patan,Ladies Finger,2016,1879,2321,442,23.523150612027674
Satara,Bottle Gourd,2016,871,1313,442,50.74626865671642
Kamthi,Pumpkin,2016,400,842,442,110.5
Malkapur,Black Gram,2014,4833,5275,442,9.14545830746948
Sangrampur,Pigeon Pea (Tur),2014,3933,4375,442,11.238240528858379
Shahada,Gram,2014,2531,2972,441,17.4239431054919
Nandgaon Khandeshwar,Wheat(Husked),2016,1084,1525,441,40.68265682656826
Nagpur,Soybean,2016,3169,3610,441,13.916061849163775
Dindori-Vani,Onion,2016,457,898,441,96.49890590809628
Karad,Banana,2015,917,1358,441,48.091603053435115
Mantha,Soybean,2015,3123,3564,441,14.121037463976945
Pune,Green Gram,2016,5450,5891,441,8.091743119266056
Gevrai,Wheat(Husked),2015,1576,2017,441,27.982233502538072
Ausa,Pigeon Pea (Tur),2015,8858,9299,441,4.978550462858433
Samudrapur,Soybean,2016,3233,3674,441,13.640581503247757
Khamgaon,Gram,2016,4105,4546,441,10.742996345919611
Umared,Gram,2016,4025,4466,441,10.956521739130435
Ghoti,Tomato,2016,927,1368,441,47.57281553398058
Nandurbar,Wheat(Husked),2015,1379,1820,441,31.97969543147208
Solapur,Banana,2015,324,765,441,136.11111111111111
Latur,Gram,2016,5575,6016,441,7.910313901345291
Barshi,Jaggery,2014,1900,2341,441,23.210526315789473
Amalner,Wheat(Husked),2014,1400,1841,441,31.5
Baramati,Soybean,2014,2875,3316,441,15.339130434782609
Loha,Gram,2016,7150,7591,441,6.1678321678321675
Murtizapur,Soybean,2015,3241,3682,441,13.606911447084233
Kamthi,Bottle Gourd,2016,483,924,441,91.30434782608695
Indapur,Green Gram,2016,5609,6050,441,7.8623640577643075
Murbad,Ladies Finger,2016,1917,2358,441,23.004694835680752
Mangrulpeer,Wheat(Husked),2015,1250,1691,441,35.28
Nagpur,Cluster Bean,2016,1700,2141,441,25.941176470588236
Phaltan,Bajri,2016,1525,1966,441,28.918032786885245
Baramati,Sorgum(Jawar),2016,1695,2136,441,26.01769911504425
Latur,Sorgum(Jawar),2015,2054,2495,441,21.470301850048685
Mukhed,SOYBEAN,2016,2369,2810,441,18.615449556775012
Kille Dharur,Sorgum(Jawar),2015,1976,2417,441,22.317813765182187
Kurdwadi-Modnimb,Bor,2015,600,1040,440,73.33333333333333
Chopda,SESAMUM,2016,5040,5480,440,8.73015873015873
Shahapur,Ridge Gourd,2015,3260,3700,440,13.496932515337424
Nagpur,Ladies Finger,2016,1256,1696,440,35.031847133757964
Dhamangaon-Rly,Soybean,2014,3072,3512,440,14.322916666666666
Kurdwadi-Modnimb,Wheat(Husked),2016,1594,2034,440,27.603513174404014
Kalmeshwar,Pigeon Pea (Tur),2015,6654,7094,440,6.612563871355576
Nagpur,Onion,2016,1010,1450,440,43.56435643564357
Karad,LADIES FINGER,2016,1280,1720,440,34.375
Ghansawangi,Pigeon Pea (Tur),2016,8000,8440,440,5.5
Mumbai-Fruit Market,Papai,2016,968,1408,440,45.45454545454545
Karad,Potato,2015,640,1080,440,68.75
Pusad,Green Gram,2016,4912,5352,440,8.957654723127035
Shrirampur,Brinjal,2015,1245,1685,440,35.34136546184739
Rajura,Cotton,2016,4067,4507,440,10.818785345463487
Lonand,Bajri,2014,1263,1703,440,34.837688044338876
Risod,Gram,2014,2831,3271,440,15.542211232779936
Barshi,Onion,2016,248,688,440,177.41935483870967
Pandharkawada,Pigeon Pea (Tur),2015,4448,4888,440,9.892086330935252
Koregaon,Potato,2015,588,1028,440,74.82993197278911
Koregaon,Gram,2015,4188,4628,440,10.506208213944603
Satara,Brinjal,2016,724,1164,440,60.773480662983424
Deulgaon Raja,Cotton,2016,4061,4501,440,10.834769761142576
Rahata,Gram,2016,5700,6140,440,7.719298245614035
Anajngaon Surji,Soybean,2014,2817,3257,440,15.61945331913383
Panvel,Cluster Bean,2016,4540,4980,440,9.691629955947137
Satara,Sweet Potato,2015,1460,1900,440,30.136986301369863
Shahapur,Ridge Gourd,2014,2100,2540,440,20.952380952380953
Malkapur,Onion,2016,779,1219,440,56.48267008985879
Anajngaon Surji,Wheat(Husked),2015,1268,1708,440,34.70031545741325
Latur,Soybean,2015,3481,3921,440,12.640045963803505
Atpadi,Bajri,2014,1380,1820,440,31.884057971014492
Ghatanji,Ground Nut Pods (Dry),2016,5150,5590,440,8.54368932038835
Balapur,Wheat(Husked),2015,1340,1780,440,32.83582089552239
Nira-Saswad,Bajri,2016,1575,2015,440,27.936507936507937
Akluj,Water Melon,2016,527,967,440,83.49146110056925
Satara,Cabbage,2016,740,1180,440,59.45945945945946
Mumbai,Arvi,2016,1360,1800,440,32.35294117647059
Lonand,Bajri,2015,1330,1770,440,33.08270676691729
Jalna,Banana,2014,410,850,440,107.3170731707317
Pune-Pimpri,Ghosali(Bhaji),2015,2800,3240,440,15.714285714285714
Kalamb (Os),Green Gram,2015,6636,7076,440,6.630500301386378
Umared,Sorgum(Jawar),2016,1740,2180,440,25.28735632183908
Akole,Paddy-Unhusked,2015,1440,1880,440,30.555555555555557
Amarawati,Maize(Corn.),2016,680,1120,440,64.70588235294117
Dondaicha,Ground Nut Pods (Dry),2015,4092,4532,440,10.75268817204301
Kolhapur-Laxmipuri,Spilt Gerrn Gram,2016,7100,7540,440,6.197183098591549
Latur,Wheat(Husked),2015,1547,1987,440,28.44214608920491
Nandurbar,Sorgum(Jawar),2015,1334,1774,440,32.98350824587706
Kalyan,Ladies Finger,2016,2224,2664,440,19.784172661870503
Manchar,Onion,2016,541,981,440,81.33086876155268
Nashik,Raddish,2016,1660,2100,440,26.50602409638554
Umarga,Soybean,2014,2871,3311,440,15.32567049808429
Vai,Pavtta,2016,1600,2040,440,27.5
Pune-Manjri,Bottle Gourd,2016,730,1170,440,60.273972602739725
Tumsar,Other Pulses,2015,2115,2555,440,20.803782505910167
Kille Dharur,Soybean,2015,2830,3270,440,15.547703180212014
Aurangabad,Banana,2014,305,745,440,144.2622950819672
Gevrai,Cotton,2016,4000,4440,440,11.0
Umarkhed-Danki,Pigeon Pea (Tur),2016,7615,8054,439,5.764937623112278
Nagpur,Beet Root,2015,815,1254,439,53.86503067484663
Kalyan,Bottle Gourd,2016,1861,2300,439,23.589468027941965
Shirpur,Soybean,2016,3298,3737,439,13.311097634930261
Pune,Sorgum(Jawar),2016,2285,2724,439,19.212253829321664
Dhule,Bajri,2016,1472,1911,439,29.82336956521739
Mumbai,Bottle Gourd,2016,1400,1839,439,31.357142857142858
Babhulgaon,Soybean,2015,2953,3392,439,14.866237724348121
Lasalgaon-Niphad,Onion,2016,393,832,439,111.70483460559797
Umarga,Pigeon Pea (Tur),2016,8115,8554,439,5.40973505853358
Rahuri-Vambori,BAJRI,2016,1205,1644,439,36.43153526970954
Kada,Black Gram,2015,8572,9011,439,5.121325244983668
Mumbai,Bottle Gourd,2016,1146,1585,439,38.30715532286213
Varud-Rajura Bazar,Gram,2016,6079,6518,439,7.221582497121237
Amarawati,Onion,2016,439,878,439,100.0
Lonand,Sorgum(Jawar),2015,1631,2070,439,26.916002452483138
Nagpur,Ladies Finger,2015,1088,1527,439,40.349264705882355
Vadgaon Peth,Bitter Gourd,2015,717,1156,439,61.22733612273361
Malkapur,Wheat(Husked),2015,1337,1776,439,32.834704562453254
Nandgaon,Onion,2016,109,548,439,402.7522935779817
Nagpur,Soybean,2016,3344,3783,439,13.12799043062201
Karad,Ladies Finger,2016,1065,1504,439,41.220657276995304
Kamthi,Bottle Gourd,2015,623,1062,439,70.46548956661316
Kopargaon,Gram,2015,2213,2652,439,19.837324898328063
Mumbai,Carrot,2015,1373,1812,439,31.97378004369993
Nagpur,Chavli (Pala),2015,870,1309,439,50.45977011494253
Pune-Pimpri,Cucumber,2015,1322,1761,439,33.20726172465961
Manora,Pigeon Pea (Tur),2016,6191,6630,439,7.090938459053465
Hingoli,Pigeon Pea (Tur),2016,6121,6560,439,7.172030713935632
Nagpur,Bitter Gourd,2016,2591,3030,439,16.943265148591276
Parbhani,Cotton,2016,4123,4562,439,10.647586708707252
Junnar-Otur,Onion,2015,1317,1756,439,33.333333333333336
Nagpur,Bitter Gourd,2015,1165,1604,439,37.682403433476395
Pune,Arvi,2015,2769,3208,439,15.854098952690501
Sangrampur,Soybean,2015,2790,3229,439,15.734767025089607
Satara,Cucumber,2015,646,1085,439,67.95665634674923
Hingoli,Ground Nut Pods (Dry),2014,3638,4077,439,12.067069818581638
Nampur,Onion,2016,104,543,439,422.11538461538464
Tuljapur,Gram,2015,3925,4363,438,11.159235668789808
Nagpur,Capsicum,2015,1354,1792,438,32.348596750369275
Varora,Soybean,2016,3200,3638,438,13.6875
Satara,Onion,2014,1350,1788,438,32.44444444444444
Shegaon,Pigeon Pea (Tur),2015,7394,7832,438,5.923721936705437
Akkolkot,Green Gram,2015,7889,8327,438,5.552034478387628
Phaltan,Wheat(Husked),2015,1500,1938,438,29.2
Varud-Rajura Bazar,Green Chilli,2015,869,1307,438,50.40276179516686
Baramati,Wheat(Husked),2016,1680,2118,438,26.071428571428573
Kurdwadi,Sorgum(Jawar),2015,1232,1670,438,35.55194805194805
Mumbai,Chikoo,2014,1124,1562,438,38.96797153024911
Nira,Bajri,2015,1525,1963,438,28.721311475409838
Mumbai,Bitter Gourd,2015,1476,1914,438,29.67479674796748
Solapur,Green Gram,2015,7328,7766,438,5.97707423580786
Rahata,Capsicum,2016,1125,1563,438,38.93333333333333
Shrirampur,Tomato,2015,1086,1524,438,40.331491712707184
Akola,Gram,2014,2536,2974,438,17.271293375394322
Kille Dharur,Soybean,2016,3278,3716,438,13.361805979255644
Junnar-Otur,Cucumber,2016,155,593,438,282.5806451612903
Ulhasnagar,Onion,2016,885,1323,438,49.49152542372882
Mumbai-Fruit Market,Papai,2016,677,1115,438,64.69719350073855
Gangapur,Gram,2014,2318,2756,438,18.895599654874893
Rahuri,Papai,2015,175,613,438,250.28571428571428
Nandgaon Khandeshwar,Soybean,2015,3400,3838,438,12.882352941176471
Sangrampur,Pigeon Pea (Tur),2014,4325,4763,438,10.127167630057803
Panvel,Ghevda,2016,4654,5092,438,9.411259131929523
Dondaicha,Wheat(Husked),2016,1548,1986,438,28.294573643410853
Pathardi,Sorgum(Jawar),2015,1550,1988,438,28.258064516129032
Akola,SOYBEAN,2016,2406,2844,438,18.204488778054863
Khed-Chakan,Chavli (Shenga ),2016,1483,1921,438,29.534726904922454
Manora,Pigeon Pea (Tur),2015,6805,7243,438,6.436443791329904
Pune-Pimpri,Tomato,2014,1458,1896,438,30.041152263374485
Rahata,Ginger (Fresh),2015,4000,4438,438,10.95
Sangamner,Bajri,2016,1607,2045,438,27.255756067205972
Lasur Station,Bajri,2015,1114,1552,438,39.31777378815081
Aurangabad,Tomato,2015,552,990,438,79.34782608695652
Lonand,Wheat(Husked),2014,1400,1838,438,31.285714285714285
Loha,Sorgum(Jawar),2014,1294,1732,438,33.84853168469861
Jalgaon,Onion,2016,338,775,437,129.28994082840237
Pune-Pimpri,Brinjal,2015,1026,1463,437,42.592592592592595
Junnar-Otur,Carrot,2016,337,774,437,129.67359050445103
Akluj,Water Melon,2016,388,825,437,112.62886597938144
Ghoti,Brinjal,2015,1963,2400,437,22.26184411614875
Ramtek,Cluster Bean,2016,1463,1900,437,29.87012987012987
Lonar,Black Gram,2016,6626,7063,437,6.595230908542107
Manchar,Methi (Bhaji),2015,146,583,437,299.3150684931507
Gangapur,Gram,2014,2242,2679,437,19.491525423728813
Chandrapur-Ganjwad,Coriander  ,2015,588,1025,437,74.31972789115646
Nagpur,Cluster Bean,2016,1538,1975,437,28.413524057217167
Anajngaon Surji,SOYBEAN,2016,2345,2782,437,18.63539445628998
Nagpur,Parwar,2016,1145,1582,437,38.16593886462882
Dudhani,Gram,2015,3046,3483,437,14.346684175968484
Jalna,Gram,2016,4052,4489,437,10.784797630799606
Chandur Rly.,Pigeon Pea (Tur),2016,8271,8708,437,5.283520735098537
Chalisgaon,Bajri,2016,1449,1886,437,30.158730158730158
Jalgaon,Cluster Bean,2016,5063,5500,437,8.631246296662058
Chandrapur-Ganjwad,Raddish,2014,844,1281,437,51.77725118483412
Pune-Pimpri,Tomato,2014,1305,1742,437,33.486590038314176
Chalisgaon,Castor Seed,2016,2313,2750,437,18.893212278426287
Dhamangaon-Rly,Gram,2014,2213,2650,437,19.74694984184365
Vai,Ginger (Fresh),2016,3170,3607,437,13.785488958990536
Mumbai,Bitter Gourd,2014,3193,3630,437,13.686188537425618
Manchar,Onion,2016,336,773,437,130.0595238095238
Baramati,Wheat(Husked),2016,1588,2025,437,27.51889168765743
Amarawati-Fruit And Vegetables,Coriander  ,2016,2363,2800,437,18.4934405416843
Osmanabad,Bor,2016,788,1225,437,55.45685279187817
Kej,Gram,2015,4182,4619,437,10.449545671927307
Patan,Flower,2016,1353,1790,437,32.29859571322986
Parli-Vaijnath,Soybean,2016,3694,4131,437,11.829994585814834
Chandrapur-Ganjwad,Wal Bhaji,2016,838,1275,437,52.14797136038186
Mumbai,Jaggery,2016,3795,4232,437,11.515151515151516
Gadhinglaj,Jaggery,2016,2267,2704,437,19.276576973974414
Paithan,Wheat(Husked),2016,1596,2033,437,27.38095238095238
Ausa,Green Gram,2016,4150,4587,437,10.53012048192771
Umared,Soybean,2014,2950,3387,437,14.813559322033898
Gadhinglaj,Jaggery,2015,1760,2197,437,24.829545454545453
Dound,Sorgum(Jawar),2016,1729,2166,437,25.274725274725274
Malkapur,Onion,2014,1025,1461,436,42.53658536585366
Patur,Pigeon Pea (Tur),2016,7893,8329,436,5.5238819206892185
Jintur-Bori,Black Gram,2014,3741,4177,436,11.65463779738038
Baramati,Jaggery,2016,3432,3868,436,12.703962703962704
Kalmeshwar,Pigeon Pea (Tur),2015,4963,5399,436,8.785009067096514
Amarawati,Coriander  ,2016,3464,3900,436,12.58660508083141
Pandharpur,Banana,2016,784,1220,436,55.61224489795919
Hingoli,Sorgum(Jawar),2014,1273,1709,436,34.24980361351139
Sangrampur,Soybean,2015,2709,3145,436,16.094499815430048
Telhara,Sorgum(Jawar),2015,1184,1620,436,36.82432432432432
Paranda,Sorgum(Jawar),2016,1773,2209,436,24.591088550479412
Chakur,Pigeon Pea (Tur),2016,8937,9373,436,4.8785946066912835
Satana,Wheat(Husked),2015,1533,1969,436,28.440965427266796
Bhadrawati,Soybean,2015,3000,3436,436,14.533333333333333
Nagpur,Gram,2016,3898,4334,436,11.185223191380196
Shegaon,Green Gram,2014,7718,8154,436,5.649131899455818
Kolhapur-Laxmipuri,Green Gram,2016,8000,8436,436,5.45
Kalyan,Flower,2016,1028,1464,436,42.4124513618677
Lasalgaon,Wheat(Husked),2015,1536,1972,436,28.385416666666668
Kalamb (Os),Black Gram,2015,6686,7122,436,6.521088842357164
Aurangabad,Brinjal,2014,1700,2136,436,25.647058823529413
Katol,Gram,2014,2177,2613,436,20.027560863573726
Mumbai,Squash Gourd,2016,2182,2618,436,19.98166819431714
Amarawati-Fruit And Vegetables,Ginger (Fresh),2016,2400,2836,436,18.166666666666668
Pachora,Ground Nut Pods (Dry),2016,4874,5310,436,8.945424702503077
Anajngaon Surji,Gram,2015,2935,3371,436,14.85519591141397
Katol,Cotton,2015,4063,4498,435,10.706374600049225
Malegaon,Pigeon Pea (Tur),2015,7490,7925,435,5.807743658210948
Barshi-Vairag,Black Gram,2015,8001,8436,435,5.436820397450319
Osmanabad,Cabbage,2014,723,1158,435,60.16597510373444
Sindi,Soybean,2014,2973,3408,435,14.631685166498487
Ramtek,Cluster Bean,2016,1386,1821,435,31.385281385281385
Vai,Flower,2015,1806,2241,435,24.08637873754153
Nandurbar,Bajri,2016,1409,1844,435,30.872959545777146
Shegaon,Gram,2014,2189,2624,435,19.87208771128369
Sindi,Soybean,2015,3025,3460,435,14.380165289256198
Dudhani,Gram,2015,3508,3943,435,12.400228050171037
Kalyan,Shevga,2016,1765,2200,435,24.64589235127479
Amarawati,Kharbuj,2016,1541,1976,435,28.228423101881894
Nagpur,Gram,2016,3893,4328,435,11.173901875160544
Rahata,Cucumber,2015,865,1300,435,50.28901734104046
Sailu,Pigeon Pea (Tur),2015,9311,9746,435,4.671893459349157
Satana,Gram,2014,2318,2753,435,18.766177739430542
Akot,Sesamum,2016,4500,4935,435,9.666666666666666
Khamgaon,Cotton,2016,4116,4551,435,10.568513119533527
Murtizapur,Green Gram,2015,7067,7502,435,6.15537002971558
Mahagaon,Gram,2016,4830,5265,435,9.006211180124224
Indapur-Bhigwan,Wheat(Husked),2016,1706,2141,435,25.49824150058617
Mumbai,Capsicum,2016,2226,2661,435,19.54177897574124
Manwat,Wheat(Husked),2015,1427,1862,435,30.48353188507358
Chandrapur,Pigeon Pea (Tur),2016,8019,8454,435,5.424616535727647
Nagpur,Potato,2015,794,1229,435,54.785894206549116
Ramtek,Bitter Gourd,2015,1306,1741,435,33.30781010719755
Hingoli,Gram,2015,4425,4860,435,9.830508474576272
Dhule,Bajri,2016,1455,1890,435,29.896907216494846
Mumbai,Arvi,2016,1565,2000,435,27.79552715654952
Hadgaon,Pigeon Pea (Tur),2016,7555,7990,435,5.757776307081403
Nagpur,Capsicum,2015,1446,1881,435,30.08298755186722
Mangrulpeer,Gram,2014,2177,2612,435,19.98162609095085
Amalner,Green Gram,2015,7450,7885,435,5.8389261744966445
Baramati,Jaggery,2016,3510,3945,435,12.393162393162394
Lasalgaon,Green Gram,2016,4850,5285,435,8.969072164948454
Kolhapur,Guava,2016,323,758,435,134.6749226006192
Khed-Chakan,Bottle Gourd,2016,726,1161,435,59.917355371900825
Mumbai,Ladies Finger,2016,1988,2423,435,21.88128772635815
Pune,Beet Root,2016,405,840,435,107.4074074074074
Chandrapur-Ganjwad,Cabbage,2016,740,1175,435,58.78378378378378
Lonar,Gram,2015,3968,4403,435,10.962701612903226
Pune-Moshi,Shevga,2016,2370,2804,434,18.31223628691983
Murtizapur,Pigeon Pea (Tur),2016,6057,6491,434,7.165263331682351
Mantha,GRAM,2016,6433,6867,434,6.746463547334058
Ambad(Vadi Godri),Sorgum(Jawar),2016,1575,2009,434,27.555555555555557
Barshi-Vairag,Pigeon Pea (Tur),2016,7133,7567,434,6.084396467124632
Aurangabad,Tomato,2015,459,893,434,94.55337690631808
Indapur-Bhigwan,Pigeon Pea (Tur),2016,5233,5667,434,8.293521880374547
Chandvad,Soybean,2015,3500,3934,434,12.4
Lonar,Pigeon Pea (Tur),2016,5902,6336,434,7.35343951202982
Kalvan,Gram,2015,3620,4054,434,11.988950276243093
Chalisgaon,Gram,2014,2233,2667,434,19.435736677115987
Barshi,Kanda Pat,2015,433,867,434,100.2309468822171
Pathardi,Wheat(Husked),2016,1583,2017,434,27.416298168035375
Kalyan,Elephant Root,2015,3472,3906,434,12.5
Ramtek,Maize(Corn.),2015,1483,1917,434,29.265003371544168
Mumbai,Bitter Gourd,2016,3196,3630,434,13.57947434292866
Achalpur,Green Gram,2015,6533,6967,434,6.643196081432726
Amarawati-Fruit And Vegetables,Ladies Finger,2016,3433,3867,434,12.642004078065831
Akole,Bajri,2016,1433,1867,434,30.286113049546405
Shrirampur,Wheat(Husked),2015,1365,1799,434,31.794871794871796
Anajngaon Surji,Wheat(Husked),2016,1416,1850,434,30.649717514124294
Kolhapur-Laxmipuri,Gr.Nut Kernels,2016,7758,8192,434,5.594225315803042
Malkapur,Green Gram,2016,4412,4846,434,9.836808703535812
Chandrapur-Ganjwad,RADDISH,2016,633,1067,434,68.56240126382306
Karad,Squash Gourd,2016,1483,1917,434,29.265003371544168
Aurangabad,Maize(Corn.),2016,933,1367,434,46.51661307609861
Pune-Pimpri,Cucumber,2016,1583,2017,434,27.416298168035375
Mehkar,Soybean,2015,2900,3334,434,14.96551724137931
Katol,Soybean,2015,3412,3846,434,12.719812426729192
Ambad(Vadi Godri),Gram,2016,3959,4393,434,10.96236423339227
Karad,Cucumber,2015,733,1167,434,59.208731241473394
Dudhani,Pigeon Pea (Tur),2016,6394,6828,434,6.787613387550829
Karad,Snake Gourd,2015,933,1367,434,46.51661307609861
Amarawati,Potato,2014,1208,1642,434,35.9271523178808
Jalgaon,Carrot,2015,894,1328,434,48.54586129753915
Lasur Station,Bajri,2016,1436,1870,434,30.22284122562674
Palus,GINGER (FRESH),2016,1583,2017,434,27.416298168035375
Malegaon,Gram,2015,2926,3360,434,14.832535885167465
Jamkhed,Gram,2015,3396,3830,434,12.779740871613663
Paithan,Gram,2016,6897,7331,434,6.292590981586197
Akhadabalapur,Pigeon Pea (Tur),2016,7833,8267,434,5.540661304736372
Washim,Gram,2016,5042,5476,434,8.60769535898453
Murum,Gram,2016,4897,5331,434,8.862568919746783
Koregaon,Onion,2016,233,667,434,186.26609442060087
Bhokar,Pigeon Pea (Tur),2016,8325,8759,434,5.213213213213213
Bhivandi,Onion,2016,1693,2127,434,25.634967513290018
Barshi-Vairag,Gram,2015,3912,4346,434,11.094069529652351
Khed-Chakan,Capsicum,2015,1842,2276,434,23.561346362649296
Pusad,Gram,2016,5169,5603,434,8.396208164054944
Yawal,Banana,2014,692,1125,433,62.57225433526011
Murbad,Ladies Finger,2016,1813,2246,433,23.883066740209596
Mumbai,Green Chilli,2015,2241,2674,433,19.32173136992414
Paranda,Onion,2016,111,544,433,390.0900900900901
Patan,Cucumber,2016,1167,1600,433,37.10368466152528
Nagpur,BOR,2016,600,1033,433,72.16666666666667
Hadgaon,Wheat(Husked),2015,1200,1633,433,36.083333333333336
Ambad(Vadi Godri),Bajri,2016,1200,1633,433,36.083333333333336
Nagpur,Papai,2015,506,939,433,85.57312252964427
Manchar,Squash Gourd,2016,600,1033,433,72.16666666666667
Amarawati,Spinach,2016,2417,2850,433,17.914770376499792
Ramtek,Cucumber,2015,1167,1600,433,37.10368466152528
Shegaon,Sesamum,2014,9651,10084,433,4.486581701378095
Kamthi,Cabbage,2016,497,930,433,87.12273641851107
Wardha,Soybean,2014,2986,3419,433,14.501004688546551
Patan,Cucumber,2016,1200,1633,433,36.083333333333336
Ratanagari,Bottle Gourd,2016,2067,2500,433,20.948234155781325
Shevgaon,Sorgum(Jawar),2015,1234,1667,433,35.089141004862235
Bhandara,Gram,2015,5061,5494,433,8.555621418691958
Kalyan,Bor,2015,2000,2433,433,21.65
Manchar,Ghevda,2016,1300,1733,433,33.30769230769231
Barshi-Vairag,Gram,2015,3434,3867,433,12.609202096680256
Nagpur,Sorgum(Jawar),2015,1367,1800,433,31.675201170446233
Chandrapur-Ganjwad,Cabbage,2015,467,900,433,92.71948608137045
Karad,Ladies Finger,2015,1517,1950,433,28.54317732366513
Murbad,Ghosali(Bhaji),2015,4642,5075,433,9.32787591555364
Patur,Wheat(Husked),2014,1317,1750,433,32.877752467729685
Karmala,Sunflower,2014,2910,3343,433,14.879725085910653
Manchar,Potato,2015,367,800,433,117.98365122615805
Phaltan,Flower,2016,967,1400,433,44.777662874870735
Amalner,Sesamum,2016,5050,5483,433,8.574257425742575
Nandurbar,SOYBEAN,2016,2364,2797,433,18.316412859560067
Mumbai,Bitter Gourd,2015,1713,2146,433,25.27729130180969
Chandrapur,Mosambi,2015,2600,3033,433,16.653846153846153
Nagpur,Bottle Gourd,2015,792,1225,433,54.67171717171717
Nagpur,Green Gram,2016,5100,5533,433,8.490196078431373
Nagpur,Green Chilli,2015,1567,2000,433,27.63241863433312
Kalyan,Small Gourd,2016,1756,2189,433,24.658314350797266
Ahmednagar,Ginger (Fresh),2015,3067,3500,433,14.118030648842517
Barshi-Vairag,Green Gram,2016,4174,4607,433,10.373742213703881
Shahapur,Cucumber,2014,1950,2383,433,22.205128205128204
Kopargaon,Gram,2015,2867,3300,433,15.102895012207883
Murtizapur,Green Gram,2016,4471,4904,433,9.684634309997763
Mantha,Sorgum(Jawar),2015,1150,1583,433,37.65217391304348
Solapur,Matki,2014,5965,6398,433,7.259010896898575
Solapur,Wheat(Husked),2016,2158,2591,433,20.064874884151994
Amarawati,Orange,2015,878,1311,433,49.31662870159453
Gevrai,Sesamum,2014,10434,10867,433,4.14989457542649
Washim,Gram,2016,4129,4562,433,10.486800678130297
Sinner,Tamarind,2016,2475,2908,433,17.494949494949495
Murtizapur,Pigeon Pea (Tur),2016,8003,8436,433,5.4104710733474946
Dondaicha,Wheat(Husked),2015,1424,1857,433,30.40730337078652
Jalna,Bajri,2015,1198,1631,433,36.143572621035055
Basmat,Black Gram,2015,8167,8600,433,5.301824415329986
Sangrampur,Green Gram,2015,7067,7500,433,6.1270694778548185
Shahapur,Brinjal,2015,1539,1972,433,28.135152696556204
Mantha,Wheat(Husked),2016,1667,2100,433,25.9748050389922
Shirpur,Green Gram,2015,6792,7225,433,6.375147232037691
Kalyan,LADIES FINGER,2016,2750,3183,433,15.745454545454546
Gangakhed,Sorgum(Jawar),2016,1636,2069,433,26.466992665036674
Kolhapur-Malkapur,Cabbage,2016,289,722,433,149.82698961937717
Indapur,Pigeon Pea (Tur),2016,7467,7900,433,5.798848265702424
Ramtek,Chavli (Pala),2015,1167,1600,433,37.10368466152528
Karad,Ladies Finger,2015,1642,2075,433,26.370280146163214
Jalgaon,Tomato,2014,680,1113,433,63.6764705882353
Kolhapur-Laxmipuri,SPILT GERRN GRAM,2016,7000,7433,433,6.185714285714286
Pune-Pimpri,Cluster Bean,2014,3500,3933,433,12.371428571428572
Mandhal,Soybean,2014,2795,3228,433,15.491949910554561
Kille Dharur,Soybean,2016,3469,3902,433,12.48198328048429
Amarawati,Kharbuj,2016,1947,2380,433,22.23934257832563
Pune-Manjri,Flower,2016,675,1107,432,64.0
Deulgaon Raja,Cotton,2015,4150,4582,432,10.409638554216867
Rahuri-Vambori,SOYBEAN,2016,2353,2785,432,18.359541011474715
Vai,Ginger (Fresh),2016,2465,2897,432,17.525354969574035
Alibag,Rice(Paddy-Hus),2015,2060,2492,432,20.97087378640777
Karad,Onion,2016,528,960,432,81.81818181818181
Kurdwadi,Sorgum(Jawar),2016,1834,2266,432,23.555070883315157
Barshi-Vairag,Pigeon Pea (Tur),2015,4856,5288,432,8.896210873146623
Nagpur,Mango(Raw),2016,2184,2616,432,19.78021978021978
Mumbai-Fruit Market,Guava,2016,1205,1637,432,35.850622406639005
Karad,BANANA,2016,980,1412,432,44.08163265306123
Solapur,Ghevda,2016,2006,2438,432,21.535393818544367
Lonand,Bajri,2015,1306,1738,432,33.078101071975496
Malegaon,Bajri,2015,1326,1758,432,32.57918552036199
Kamthi,Chavli (Pala),2015,410,842,432,105.36585365853658
Osmanabad,Soybean,2016,3125,3557,432,13.824
Mandhal,Soybean,2015,3212,3644,432,13.449564134495642
Nandurbar,Bajri,2014,1073,1505,432,40.26095060577819
Gevrai,BAJRI,2016,1207,1639,432,35.791217895608945
Washim,WHEAT(HUSKED),2016,1925,2357,432,22.441558441558442
Mumbai,Water Melon,2014,764,1196,432,56.544502617801044
Shrirampur,Pigeon Pea (Tur),2015,4350,4782,432,9.931034482758621
Jintur,Sorgum(Jawar),2016,1458,1890,432,29.62962962962963
Kamthi,TOMATO,2016,418,850,432,103.34928229665071
Varora,Gram,2016,3742,4174,432,11.544628540887226
Pathari,Bajri,2016,1112,1544,432,38.84892086330935
Rahuri-Vambori,Gram,2015,4436,4867,431,9.715960324616772
Aurangabad,CUCUMBER,2016,1250,1681,431,34.48
Buldhana,Wheat(Husked),2016,1488,1919,431,28.96505376344086
Nagpur,Cluster Bean,2016,1919,2350,431,22.45961438249088
Jalgaon,Jaggery,2015,2085,2516,431,20.67146282973621
Sangali,Gram,2015,3213,3644,431,13.414254590725179
Amarawati,Capsicum,2016,2954,3385,431,14.590385917400136
Lonand,Wheat(Husked),2015,1475,1906,431,29.220338983050848
Shrirampur,Ginger (Fresh),2016,2231,2662,431,19.318691169878978
Aurangabad,Tomato,2015,515,946,431,83.68932038834951
Ramtek,Capsicum,2016,970,1401,431,44.43298969072165
Murtizapur,Soybean,2016,3278,3709,431,13.148261134838316
Nagpur,Dhemse,2016,1292,1723,431,33.359133126934985
Lonand,Bajri,2016,1538,1969,431,28.023407022106632
Pune,Cabbage,2016,365,796,431,118.08219178082192
Sonpeth,Pigeon Pea (Tur),2016,5840,6271,431,7.38013698630137
Lasur Station,Wheat(Husked),2015,1534,1965,431,28.096479791395044
Chopda,Sesamum,2014,10362,10793,431,4.159428681721676
Sangali,Green Peas (Dry),2016,2988,3419,431,14.424364123159304
Rahuri-Vambori,Bajri,2016,1136,1567,431,37.940140845070424
Nagpur,Cluster Bean,2015,1358,1789,431,31.737849779086893
Nira,Wheat(Husked),2015,1600,2031,431,26.9375
Mumbai,Ladies Finger,2015,1338,1769,431,32.21225710014948
Pune,Beet Root,2016,565,996,431,76.28318584070796
Pune,Wheat(Husked),2016,2039,2470,431,21.137812653261403
Nagpur,Capsicum,2014,2815,3246,431,15.310834813499111
Vita,Ladies Finger,2016,832,1263,431,51.80288461538461
Mumbai,Tomato,2015,2369,2800,431,18.193330519206416
Ambad(Vadi Godri),Pigeon Pea (Tur),2015,5226,5657,431,8.247225411404516
Washim,Wheat(Husked),2016,1527,1958,431,28.22527832351015
Mehkar,Soybean,2014,2963,3394,431,14.546068174147823
Parli-Vaijnath,Pigeon Pea (Tur),2016,7101,7532,431,6.069567666525842
Pune,Cabbage,2015,525,956,431,82.0952380952381
Nagpur,Ladies Finger,2016,2174,2605,431,19.825206991720332
Achalpur,Pigeon Pea (Tur),2016,8161,8592,431,5.281215537311604
Washim,Green Gram,2015,5744,6175,431,7.5034818941504176
Chandrapur,Soybean,2014,2782,3213,431,15.492451473759886
Mauda,Green Gram,2016,4845,5276,431,8.89576883384933
Rahata,Bottle Gourd,2015,819,1250,431,52.62515262515262
Akole,Bajri,2016,1430,1860,430,30.06993006993007
Rahata,Ginger (Fresh),2016,2450,2880,430,17.551020408163264
Pune,Gram,2016,4832,5262,430,8.899006622516556
Satara,Brinjal,2016,1083,1513,430,39.70452446906741
Indapur,Gram,2016,4659,5089,430,9.229448379480575
Babhulgaon,Pigeon Pea (Tur),2016,5657,6087,430,7.601202050556832
Ahmednagar,Maize (Corn.),2016,762,1192,430,56.43044619422572
Koregaon,Onion,2016,200,630,430,215.0
Mangalwedha,Wheat(Unhusked),2016,2772,3202,430,15.512265512265513
Udgir,Gram,2016,8810,9240,430,4.880817253121453
Shegaon,Green Gram,2015,5823,6253,430,7.384509702902284
Indapur (Nimgaon Ketki),Bajri,2015,1117,1547,430,38.49597135183527
Pusad,Pigeon Pea (Tur),2016,8070,8500,430,5.328376703841388
Chikhali,Gram,2015,3351,3781,430,12.831990450611757
Patan,Tomato,2015,1543,1973,430,27.867790019442644
Jalgaon,Cabbage,2015,600,1030,430,71.66666666666667
Nagpur,Cluster Bean,2015,1162,1592,430,37.00516351118761
Varora,Soybean,2015,2900,3330,430,14.827586206896552
Pune-Pimpri,Tomato,2015,705,1135,430,60.99290780141844
Sangali,Soybean,2016,3362,3792,430,12.790005948839976
Junnar-Otur,CARROT,2016,300,730,430,143.33333333333334
Baramati,Gram,2016,5034,5464,430,8.54191497814859
Nagpur,Carrot,2015,1245,1675,430,34.53815261044177
Kurdwadi-Modnimb,Maize,2016,1489,1919,430,28.87844190732035
Pulgaon,Gram,2015,3541,3971,430,12.143462298785654
Kej,Soybean,2016,3219,3649,430,13.358185771978876
Dhule,Wheat(Husked),2015,1304,1734,430,32.97546012269939
Kopargaon,Soybean,2015,3271,3701,430,13.145826964231121
Akot,Ground Nut Pods (Dry),2016,4150,4580,430,10.36144578313253
Lonand,Wheat(Husked),2015,1475,1905,430,29.152542372881356
Shrigonda,Sorgum(Jawar),2016,1670,2100,430,25.748502994011975
Mehkar,Soybean,2016,3309,3739,430,12.994862496222424
Kolhapur-Laxmipuri,Split Gram,2016,6510,6940,430,6.605222734254992
Pusad,Soybean,2014,2944,3374,430,14.605978260869565
Nashik-Devlali,Shepu,2016,703,1133,430,61.16642958748222
Solapur,Pigeon Pea (Tur),2015,5829,6259,430,7.376908560645051
Aurangabad,Orange,2015,593,1023,430,72.51264755480607
Lasalgaon-Niphad,Soybean,2016,3347,3777,430,12.847325963549448
Navapur,Ground Nut Pods (Dry),2016,4800,5230,430,8.958333333333334
Vai,Brinjal,2016,2565,2995,430,16.764132553606238
Mumbai,Shevga,2015,1522,1952,430,28.252299605781864
Pune-Pimpri,Ghevda,2014,3735,4165,430,11.512717536813922
Mangrulpeer,Gram,2016,3484,3914,430,12.342135476463834
Nandgaon Khandeshwar,Chino,2015,3689,4119,430,11.656275413391162
Kalamb (Yawatmal),Pigeon Pea (Tur),2016,6590,7020,430,6.525037936267071
Nashik,Methi (Bhaji),2015,180,610,430,238.88888888888889
Akkolkot,Wheat(Husked),2015,1430,1860,430,30.06993006993007
Kalyan,Ridge Gourd,2015,2362,2792,430,18.204911092294665
Hingoli,Pigeon Pea (Tur),2015,5761,6191,430,7.463981947578546
Kalamb (Os),Black Gram,2014,4983,5413,430,8.62933975516757
Kamthi,Tomato,2016,500,929,429,85.8
Ahmedpur,Green Gram,2016,4916,5345,429,8.72660699755899
Chalisgaon,Wheat(Husked),2016,1528,1957,429,28.07591623036649
Murbad,Brinjal,2016,3271,3700,429,13.115255273616631
Mumbai,Ginger (Dry),2015,2919,3348,429,14.696813977389517
Vani,Soybean,2015,3304,3733,429,12.984261501210653
Pune,Lentil,2016,5265,5694,429,8.148148148148149
Kalyan,Elephant Root,2016,3321,3750,429,12.917795844625113
Pune-Manjri,Rajgira,2015,471,900,429,91.0828025477707
Pune,Wheat(Husked),2014,2127,2556,429,20.169252468265164
Pune-Pimpri,Cucumber,2015,1071,1500,429,40.056022408963585
Pune,Lentil,2016,5988,6417,429,7.16432865731463
Pune-Manjri,Spinach,2015,814,1243,429,52.7027027027027
Dhule,Bajri,2016,1488,1917,429,28.830645161290324
Satara,Onion,2016,357,786,429,120.16806722689076
Rahuri-Vambori,Pigeon Pea (Tur),2016,6234,6663,429,6.881616939364774
Ratanagari,Cabbage,2015,500,929,429,85.8
Patan,Flower,2016,1357,1786,429,31.6138540899042
Washim,Gram,2015,4292,4721,429,9.99534016775396
Malkapur,Soybean,2014,2886,3315,429,14.864864864864865
Mangalwedha,ONION,2016,475,904,429,90.3157894736842
Rahata,Brinjal,2015,1014,1443,429,42.30769230769231
Rahata,Lemon,2015,3786,4215,429,11.33122028526149
Jalgaon,Brinjal,2015,454,883,429,94.49339207048457
Washim-Ansing,Gram,2016,7500,7929,429,5.72
Khamgaon,Lemon,2016,289,718,429,148.44290657439447
Aurangabad,Chavli (Shenga ),2014,1714,2143,429,25.029171528588098
Yeotmal,Gram,2016,6154,6583,429,6.971075723106923
Jalgaon Jamod-Aasalgaon,Soybean,2015,3157,3586,429,13.588850174216027
Ambejogai,Green Gram,2014,7506,7935,429,5.715427657873701
Nandurbar,Gram,2015,2277,2706,429,18.840579710144926
Nashik,Potato,2014,2262,2690,428,18.92130857648099
Pune,Tamarind,2015,3645,4073,428,11.742112482853223
Wardha,Gram,2014,2334,2762,428,18.337617823479007
Sangrampur-Varvatbakal,Wheat(Husked),2016,1290,1718,428,33.17829457364341
Kalyan,Brinjal,2015,2061,2489,428,20.76661814653081
Phaltan,Wheat(Husked),2016,1542,1970,428,27.756160830090792
Shahada,Pigeon Pea (Tur),2015,4739,5167,428,9.031441232327495
Karad,Bitter Gourd,2015,1245,1673,428,34.377510040160644
Khed (Shel Pimpalgaon),Farshi,2015,1057,1485,428,40.491958372753075
Jalgaon Jamod-Aasalgaon,Gram,2015,2943,3371,428,14.5429833503228
Shrirampur,Gram,2015,3250,3678,428,13.169230769230769
Barshi,CAPSICUM,2016,872,1300,428,49.08256880733945
Sailu,Soybean,2016,3380,3808,428,12.662721893491124
Nashik-Devlali,Tandulja,2016,400,828,428,107.0
Yeotmal,Soybean,2015,3311,3739,428,12.926608275445485
Kalamb (Os),Jaggery,2015,1800,2228,428,23.77777777777778
Malegaon,Wheat(Husked),2015,1482,1910,428,28.879892037786774
Chikhali,Gram,2016,5262,5690,428,8.133789433675409
Samudrapur,Soybean,2014,2854,3282,428,14.996496145760336
Nandurbar,Gram,2016,3810,4238,428,11.233595800524935
Sangli-Phale Bhajipalam,Potato,2016,1352,1780,428,31.65680473372781
Sinner,Black Gram,2014,4447,4875,428,9.624465932089048
Rahuri-Vambori,Sorgum(Jawar),2016,1418,1846,428,30.183356840620593
Nagpur,Jack Fruit,2016,1029,1457,428,41.59378036929057
Nagpur,Dhemse,2016,2380,2808,428,17.983193277310924
Paithan,Pigeon Pea (Tur),2015,5438,5866,428,7.870540639941155
Vai,Ginger (Fresh),2016,2172,2600,428,19.70534069981584
Khed-Chakan,Flower,2016,916,1344,428,46.724890829694324
Umarkhed,Soybean,2014,2743,3171,428,15.603353991979585
Pusad,Wheat(Husked),2015,1579,2007,428,27.105763141228625
Aurangabad,Mango(Raw),2016,1244,1672,428,34.40514469453376
Rahuri-Vambori,Gram,2016,3969,4397,428,10.783572688334592
Shrirampur,Capsicum,2015,1110,1538,428,38.55855855855856
Manora,Pigeon Pea (Tur),2016,6168,6595,427,6.922827496757458
Kamthi,Cabbage,2016,514,941,427,83.07392996108949
Mumbai,Ridge Gourd,2014,3635,4062,427,11.746905089408529
Kille Dharur,Bajri,2015,1551,1978,427,27.53062540296583
Nagpur,Green Chilli,2015,2550,2977,427,16.745098039215687
Kolhapur-Laxmipuri,Green Gram,2016,7300,7727,427,5.8493150684931505
Dondaicha,Ground Nut Pods (Dry),2014,3939,4366,427,10.840314800710841
Sangamner,BAJRI,2016,1349,1776,427,31.653076352853965
Chalisgaon,Gram,2016,3841,4268,427,11.11689664149961
Nagpur,Carrot,2016,1130,1557,427,37.78761061946903
Nagpur,Pumpkin,2016,909,1336,427,46.97469746974698
Pune,Onion,2016,430,857,427,99.30232558139535
Mohol,Sorgum(Jawar),2016,1725,2152,427,24.753623188405797
Latur,Gram,2015,4375,4802,427,9.76
Satana,Onion,2016,178,605,427,239.8876404494382
Dound,Sorgum(Jawar),2015,1583,2010,427,26.97409981048642
Lasalgaon,Bajri,2014,1104,1531,427,38.677536231884055
Karanja,Green Gram,2016,5087,5514,427,8.393945350894437
Nagpur,Carrot,2016,1668,2095,427,25.599520383693047
Kannad,WHEAT(HUSKED),2016,1643,2070,427,25.98904443091905
Umared,Soybean,2016,3378,3805,427,12.640615748963883
Pune-Manjri,Cabbage,2014,784,1211,427,54.464285714285715
Tumsar,Linseed,2016,6299,6726,427,6.778853786315288
Barshi,Pigeon Pea (Tur),2016,5810,6237,427,7.349397590361446
Ambejogai,Wheat(Husked),2015,1450,1877,427,29.448275862068964
Satara,Bottle Gourd,2016,969,1396,427,44.06604747162023
Yeotmal,Gram,2015,4154,4581,427,10.279248916706788
Murbad,Ladies Finger,2016,1180,1607,427,36.186440677966104
Ashti-Karanja,Soybean,2016,3163,3590,427,13.499841922225736
Shahada,Wheat(Husked),2015,1309,1736,427,32.62032085561497
Nagpur,Cluster Bean,2015,1123,1550,427,38.02315227070347
Amarawati,Cluster Bean,2016,3380,3807,427,12.633136094674557
Panvel,Ladies Finger,2016,3882,4309,427,10.999484801648634
Loha,Wheat(Husked),2016,1433,1860,427,29.797627355198884
Khed (Shel Pimpalgaon),Green Chilli,2014,2598,3025,427,16.435719784449578
Kalamb (Os),Sorgum(Jawar),2014,1423,1850,427,30.00702740688686
Solapur,Sorgum(Jawar),2015,1634,2060,426,26.070991432068542
Vai,Ladies Finger,2014,1453,1879,426,29.31865106675843
Parshiwani,Soybean,2014,2825,3251,426,15.079646017699115
Shrirampur,Sorgum(Jawar),2015,1869,2295,426,22.792937399678973
Mahur,Pigeon Pea (Tur),2016,7109,7535,426,5.992403994935996
Varud,Cotton,2015,3892,4318,426,10.945529290853031
Lonand,Sorgum(Jawar),2015,1563,1989,426,27.2552783109405
Chandrapur-Ganjwad,Cabbage,2016,213,639,426,200.0
Risod,Gram,2015,2828,3254,426,15.063649222065063
Murtizapur,Gram,2016,7483,7909,426,5.692903915541895
Pune,Sorgum(Jawar),2014,2478,2904,426,17.19128329297821
Satara,Brinjal,2015,820,1246,426,51.951219512195124
Barshi,Turmeric,2015,6762,7188,426,6.299911268855368
Dondaicha,SORGUM(JAWAR),2016,1538,1964,426,27.698309492847855
Indapur-Bhigwan,Sunflower,2015,2550,2976,426,16.705882352941178
Solapur,Wheat(Husked),2016,2219,2645,426,19.197836863452004
Kurdwadi,Gram,2015,3166,3592,426,13.455464308275426
Sinner,Ground Nut Pods (Dry),2014,3025,3451,426,14.082644628099173
Vani,Gram,2016,5785,6211,426,7.363872082973207
Kolhapur-Laxmipuri,Split Gram,2015,6383,6809,426,6.673977753407488
Indapur-Bhigwan,Sunflower,2016,2300,2726,426,18.52173913043478
Aurangabad,Carrot,2014,1458,1884,426,29.218106995884774
Mumbai,Capsicum,2015,1789,2215,426,23.812185578535495
Nagpur,Parwar,2015,1095,1521,426,38.9041095890411
Akola,Gram,2014,2584,3010,426,16.486068111455108
Khamgaon,Lemon,2014,97,523,426,439.17525773195877
Jintur,Soybean,2016,2430,2856,426,17.530864197530864
Vadvani,SORGUM(JAWAR),2016,1625,2051,426,26.215384615384615
Mangaon(Bhadav),Paddy-Unhusked,2014,1182,1607,425,35.95600676818951
Ahmednagar,Sorgum(Jawar),2015,1575,2000,425,26.984126984126984
Buldhana,Green Gram,2015,7475,7900,425,5.68561872909699
Satara,Onion,2016,350,775,425,121.42857142857143
Nagpur,Dhemse,2016,3065,3490,425,13.866231647634583
Jalgaon,Papai,2015,775,1200,425,54.83870967741935
Balapur,Wheat(Husked),2015,1300,1725,425,32.69230769230769
Satara,Pavtta,2016,1165,1590,425,36.48068669527897
Ausa,Sunflower,2015,3237,3662,425,13.129440840284214
Shegaon,Soybean,2016,3141,3566,425,13.53072269977714
Chandvad,Cucumber,2015,1005,1430,425,42.288557213930346
Pune-Pimpri,Carrot,2016,1650,2075,425,25.757575757575758
Lasur Station,Pigeon Pea (Tur),2016,5660,6085,425,7.508833922261484
Bhivandi,Potato,2015,1163,1588,425,36.54342218400688
Amarawati,Linseed,2016,5200,5625,425,8.173076923076923
Junnar-Otur,Potato,2015,888,1313,425,47.86036036036036
Mantha,Soybean,2016,3325,3750,425,12.781954887218046
Varora,Soybean,2015,3000,3425,425,14.166666666666666
Manchar,Carrot,2015,1650,2075,425,25.757575757575758
Shirpur,Gram,2014,2140,2565,425,19.85981308411215
Bhokar,Gram,2016,5850,6275,425,7.264957264957265
Palus,Green Chilli,2016,925,1350,425,45.945945945945944
Shrigonda,Bajri,2016,1397,1822,425,30.42233357193987
Sangali,Green Peas (Dry),2016,2970,3395,425,14.30976430976431
Kalvan,Green Gram,2015,7125,7550,425,5.964912280701754
Balapur,Wheat(Husked),2016,1375,1800,425,30.90909090909091
Kalamb (Os),Green Gram,2016,6425,6850,425,6.614785992217898
Gangapur,Gram,2014,2149,2574,425,19.776640297812936
Amarawati,Soybean,2016,2836,3261,425,14.98589562764457
Deulgaon Raja,Cotton,2016,4448,4873,425,9.554856115107913
Lonand,Wheat(Husked),2014,1463,1888,425,29.049897470950103
Ahmednagar,POTATO,2016,700,1125,425,60.714285714285715
Manora,Gram,2016,7000,7425,425,6.071428571428571
Naigaon,Black Gram,2015,8829,9254,425,4.813682183712765
Satara,Onion,2016,413,838,425,102.90556900726392
Kamthi,Spinach,2016,114,539,425,372.8070175438597
Kille Dharur,Wheat(Husked),2014,1550,1975,425,27.419354838709676
Umarkhed,Pigeon Pea (Tur),2016,8000,8425,425,5.3125
Ambad(Vadi Godri),Bajri,2015,1160,1585,425,36.63793103448276
Indapur,Gram,2016,5239,5664,425,8.11223515938156
Akole,Wheat(Husked),2016,1475,1900,425,28.8135593220339
Kamthi,Onion,2016,500,925,425,85.0
Ahmednagar,Gram,2014,2307,2732,425,18.422193324664065
Nagpur,Spinach,2015,1267,1692,425,33.5438042620363
Karad,Brinjal,2014,888,1313,425,47.86036036036036
Lasalgaon-Niphad,Wheat(Husked),2016,1536,1961,425,27.669270833333332
Umarkhed,Soybean,2015,3000,3425,425,14.166666666666666
Jalgaon Jamod-Aasalgaon,Gram,2015,3875,4300,425,10.96774193548387
Varud-Rajura Bazar,Soybean,2015,3195,3620,425,13.302034428794991
Vai,BRINJAL,2016,2020,2445,425,21.03960396039604
Achalpur,Gram,2016,7367,7792,425,5.768969729876476
Shahapur,Chavli (Shenga ),2016,1738,2163,425,24.453394706559262
Shirur,Cowpea,2015,4406,4831,425,9.64593735814798
Telhara,Gram,2015,4088,4513,425,10.396281800391389
Lonar,Black Gram,2014,4375,4800,425,9.714285714285714
Akole,Paddy-Unhusked,2016,1500,1925,425,28.333333333333332
Nanded,Pigeon Pea (Tur),2015,7750,8175,425,5.483870967741935
Akole,Wheat(Husked),2015,1475,1900,425,28.8135593220339
Chandrapur-Ganjwad,Tomato,2014,417,842,425,101.91846522781775
Risod,Gram,2015,4598,5023,425,9.243149195302305
Jalgaon,Bitter Gourd,2015,2338,2763,425,18.17792985457656
Karad,Bottle Gourd,2016,956,1381,425,44.45606694560669
Nagpur,Small Gourd,2015,1150,1575,425,36.95652173913044
Indapur-Bhigwan,Gram,2015,2950,3375,425,14.40677966101695
Nagpur,Ladies Finger,2016,1985,2410,425,21.410579345088163
Chandrapur-Ganjwad,Cabbage,2015,275,700,425,154.54545454545453
Pune,Sorgum(Jawar),2014,2472,2897,425,17.192556634304207
Akole,Wheat(Husked),2014,1475,1900,425,28.8135593220339
Sangamner,Sorgum(Jawar),2015,1925,2350,425,22.07792207792208
Pune-Pimpri,Sorgum(Jawar),2016,2404,2829,425,17.678868552412645
Kalyan,Ridge Gourd,2016,2100,2525,425,20.238095238095237
Sindi,Soybean,2016,3083,3508,425,13.785274083684723
Ahmednagar,Green Gram,2015,6600,7025,425,6.4393939393939394
Nagpur,Wheat(Husked),2014,1616,2041,425,26.29950495049505
Amarawati,Guava,2015,638,1063,425,66.61442006269593
Malegaon,Horse Gram,2014,2100,2525,425,20.238095238095237
Koregaon,Onion,2015,925,1350,425,45.945945945945944
Aurangabad,Guava,2015,1400,1825,425,30.357142857142858
Kada,Bajri,2016,1550,1975,425,27.419354838709676
Vai,Cucumber,2016,1660,2085,425,25.602409638554217
Manchar,Cucumber,2016,175,600,425,242.85714285714286
Nampur,Onion,2016,355,780,425,119.71830985915493
Jalgaon Jamod-Aasalgaon,Gram,2016,8675,9100,425,4.899135446685879
Kolhapur-Laxmipuri,Spilt Pigeon Pea,2015,7400,7825,425,5.743243243243243
Osmanabad,Cabbage,2015,625,1050,425,68.0
Kamthi,Onion,2016,600,1025,425,70.83333333333333
Koregaon,Ghevda Seed,2015,3783,4208,425,11.234469997356594
Pathardi,Bajri,2016,1342,1767,425,31.669150521609538
Purna,Sorgum(Jawar),2015,1185,1609,424,35.780590717299575
Wardha,Soybean,2015,3411,3835,424,12.430372324831428
Khed-Chakan,TOMATO,2016,548,972,424,77.37226277372262
Pune,Onion,2016,337,761,424,125.8160237388724
Karad,Green Chilli,2016,892,1316,424,47.53363228699551
Kalyan,Tomato,2016,2512,2936,424,16.878980891719745
Mumbai,Sweet Potato,2015,800,1224,424,53.0
Junnar-Otur,Onion,2016,560,984,424,75.71428571428571
Arvi,Soybean,2016,3354,3778,424,12.641621943947525
Chandur Bajar,Soybean,2016,3163,3587,424,13.404995257666773
Pune-Pimpri,Ridge Gourd,2015,2035,2459,424,20.835380835380835
Aurangabad,Ladies Finger,2014,1368,1792,424,30.994152046783626
Baramati,Maize,2016,1629,2053,424,26.028238182934317
Deulgaon Raja,Cotton,2016,4237,4661,424,10.007080481472741
Aurad Shahajani,Pigeon Pea (Tur),2016,8666,9090,424,4.892684052619432
Aurangabad,Shevga,2016,656,1080,424,64.63414634146342
Pune-Pimpri,Onion,2015,1490,1914,424,28.456375838926174
Washim,Pigeon Pea (Tur),2015,6327,6750,423,6.685633001422475
Nagpur,Cucumber,2015,1158,1581,423,36.52849740932643
Aurangabad,Potato,2014,1686,2109,423,25.08896797153025
Ratanagari,Cabbage,2015,775,1198,423,54.58064516129032
Murtizapur,Gram,2015,4035,4458,423,10.483271375464684
Nagpur,Paddy-Unhusked,2015,1553,1976,423,27.237604636188024
Majalgaon,Gram,2016,6076,6499,423,6.9618169848584595
Amarawati,Melon,2016,809,1232,423,52.286773794808404
Washim,Gram,2014,2679,3102,423,15.789473684210526
Kolhapur,Snake Gourd,2015,574,997,423,73.69337979094077
Ghoti,Brinjal,2016,1372,1795,423,30.830903790087465
Sangali,Bajri,2015,1403,1826,423,30.14967925873129
Kille Dharur,Bajri,2016,1636,2059,423,25.855745721271393
Nanded,Pigeon Pea (Tur),2015,5178,5601,423,8.16917728852839
Pune-Manjri,Flower,2015,483,906,423,87.5776397515528
Kada,Sorgum(Jawar),2015,1421,1844,423,29.767769176636172
Shrirampur,Wheat(Husked),2016,1552,1975,423,27.25515463917526
Jalgaon,Cucumber,2016,1171,1594,423,36.122971818958156
Mumbai,Ridge Gourd,2015,2523,2946,423,16.76575505350773
Ausa,Sorgum(Jawar),2016,1594,2017,423,26.537013801756586
Yeola,Bajri,2016,1553,1976,423,27.237604636188024
Manmad,Pigeon Pea (Tur),2016,6407,6830,423,6.602153894178243
Taloda,Gram,2014,3002,3425,423,14.090606262491672
Rahata,Ladies Finger,2016,1454,1877,423,29.09215955983494
Alibag,Rice(Paddy-Hus),2015,3077,3500,423,13.747156321091973
Rahata,Garlic,2014,3092,3515,423,13.680465717981889
Baramati,Jaggery,2015,2251,2674,423,18.791648156374944
Karad,Onion,2016,577,1000,423,73.3102253032929
Bhivandi,Onion,2015,1633,2056,423,25.90324556031843
Ahmednagar,Pigeon Pea (Tur),2015,5586,6009,423,7.57250268528464
Karanja,Black Gram,2015,4825,5248,423,8.766839378238341
Manora,Gram,2015,3845,4268,423,11.001300390117034
Sindi (Selu),Soybean,2016,3016,3439,423,14.025198938992043
Katol,Soybean,2015,3242,3665,423,13.047501542257866
Kalvan,Gram,2016,5096,5519,423,8.300627943485086
Barshi,Cucumber,2016,456,879,423,92.76315789473684
Bhivandi,Wheat(Husked),2016,1826,2249,423,23.16538882803943
Karad,Cucumber,2016,1277,1700,423,33.12451057165231
Jintur,Sorgum(Jawar),2016,1493,1916,423,28.332217012726055
Nandura,Soybean,2016,2973,3396,423,14.228052472250253
Pusad,Soybean,2016,3255,3677,422,12.964669738863288
Aurangabad,WAL BHAJI,2016,1278,1700,422,33.020344287949925
Pune,Tomato,2016,304,726,422,138.81578947368422
Udgir,Pigeon Pea (Tur),2015,11206,11628,422,3.765839728716759
Aurangabad,Green Chilli,2016,719,1141,422,58.692628650904034
Gevrai,Sorgum(Jawar),2015,1300,1722,422,32.46153846153846
Yeola,Onion,2016,341,763,422,123.75366568914956
Devala,Onion,2016,311,733,422,135.69131832797427
Aurangabad,Guava,2014,964,1386,422,43.77593360995851
Jalgaon,Tomato,2015,667,1089,422,63.26836581709146
Pusad,Soybean,2016,3466,3888,422,12.175418349682632
Jamkhed,Soybean,2015,3213,3635,422,13.134142545907252
Solapur,Jaggery,2015,2158,2580,422,19.555143651529193
Taloda,Wheat(Husked),2015,1344,1766,422,31.398809523809526
Indapur-Bhigwan,Wheat(Husked),2015,1576,1998,422,26.776649746192895
Jalgaon Jamod-Aasalgaon,Gram,2015,3622,4044,422,11.651021535063501
Sillod-Bharadi,Sorgum(Jawar),2014,1220,1642,422,34.59016393442623
Shahapur,Capsicum,2015,1567,1989,422,26.930440331844288
Murbad,Cabbage,2016,2489,2911,422,16.954600241060668
Bhandara,Gram,2015,4499,4921,422,9.379862191598132
Satara,Capsicum,2016,1087,1509,422,38.822447102115916
Pune,Onion,2016,438,860,422,96.34703196347031
Karad,Bor,2016,926,1348,422,45.57235421166307
Bhokar,Pigeon Pea (Tur),2016,7807,8229,422,5.405405405405405
Jalgaon,Onion,2016,278,700,422,151.79856115107913
Barshi,Gram,2016,3975,4397,422,10.616352201257861
Kalamb (Os),Sorgum(Jawar),2015,1565,1987,422,26.96485623003195
Mumbai,Bitter Gourd,2015,1265,1687,422,33.359683794466406
Chakur,Pigeon Pea (Tur),2016,6307,6729,422,6.690978278103694
Patur,Green Gram,2016,4411,4833,422,9.566991611879393
Amalner,Black Gram,2016,6128,6550,422,6.886422976501305
Pune-Manjri,Chavli (Pala),2015,581,1003,422,72.63339070567986
Karad,Chikoo,2016,2030,2452,422,20.788177339901477
Nandgaon Khandeshwar,Chino,2015,4200,4621,421,10.023809523809524
Vai,Ginger (Fresh),2016,2838,3259,421,14.834390415785764
Patan,Brinjal,2015,1318,1739,421,31.942336874051595
Kolhapur-Laxmipuri,Cowpea,2016,6579,7000,421,6.399148806809546
Malegaon,Horse Gram,2014,2254,2675,421,18.67790594498669
Nagpur,Tomato,2015,1119,1540,421,37.622877569258264
Nagpur,Tomato,2015,912,1333,421,46.16228070175438
Akola,Soybean,2016,3283,3704,421,12.823636917453548
Akola,Soybean,2016,3281,3702,421,12.831453825053337
Nandura,Wheat(Husked),2016,1455,1876,421,28.93470790378007
Pusad,Soybean,2016,3325,3746,421,12.661654135338345
Kalmeshwar,Green Chilli,2016,6016,6437,421,6.998005319148936
Hingoli,Pigeon Pea (Tur),2015,5534,5955,421,7.607517166606433
Kalyan,Shevga,2016,2816,3237,421,14.950284090909092
Barshi,Bitter Gourd,2016,705,1126,421,59.716312056737586
Sangali,Bajri,2016,1418,1839,421,29.689703808180536
Nashik-Devlali,Coriander  ,2016,540,961,421,77.96296296296296
Shrirampur,Green-Peas,2015,1721,2142,421,24.462521789657178
Majalgaon,Wheat(Husked),2015,1480,1901,421,28.445945945945947
Jintur,Gram,2015,3641,4062,421,11.562757484207635
Ratanagari,Cabbage,2015,879,1300,421,47.89533560864619
Digras,Gram,2015,3880,4301,421,10.850515463917526
Nagpur,Paddy-Unhusked,2015,1636,2057,421,25.73349633251834
Shrirampur,Capsicum,2015,1767,2188,421,23.82569326542162
Nagpur,Chavli (Shenga ),2016,1475,1896,421,28.54237288135593
Savner,Pigeon Pea (Tur),2015,6750,7171,421,6.237037037037037
Nagpur,Spinach,2016,1122,1543,421,37.5222816399287
Mangalwedha,Sorgum(Jawar),2015,1604,2025,421,26.246882793017456
Patan,Ladies Finger,2016,2518,2939,421,16.719618745035742
Sinner,Bajri,2016,1581,2002,421,26.628716002530044
Nilanga,Soybean,2015,3406,3827,421,12.360540223135644
Lasalgaon,Sorgum(Jawar),2016,1296,1717,421,32.48456790123457
Dhule,Cowpea,2015,3222,3642,420,13.035381750465548
Nagpur,Ladies Finger,2015,1388,1808,420,30.259365994236312
Kolhapur,Chikoo,2015,630,1050,420,66.66666666666667
Aurangabad,Brinjal,2015,736,1156,420,57.06521739130435
Achalpur,Gram,2015,3660,4080,420,11.475409836065573
Risod,Green Gram,2015,6118,6538,420,6.864988558352403
Kolhapur,Cabbage,2016,388,808,420,108.24742268041237
Murum,Green Gram,2016,6297,6717,420,6.669842782277275
Nandgaon,Wheat(Husked),2015,1526,1946,420,27.522935779816514
Pune,Squash Gourd,2015,468,888,420,89.74358974358974
Shahapur,Chavli (Shenga ),2014,1360,1780,420,30.88235294117647
Barshi,Ghevda,2016,1439,1859,420,29.186935371785964
Beed,Wheat(Husked),2015,1627,2047,420,25.81438229870928
Ghansawangi,Gram,2016,3950,4370,420,10.632911392405063
Shrirampur,Shevga,2016,1140,1560,420,36.8421052631579
Mumbai,Capsicum,2015,1163,1583,420,36.11349957007739
Murtizapur,Black Gram,2015,8668,9088,420,4.8454083987078915
Ambad(Vadi Godri),Pigeon Pea (Tur),2016,7613,8033,420,5.516879022724288
Beed,Soybean,2015,3290,3710,420,12.76595744680851
Pune,Squash Gourd,2014,500,920,420,84.0
Achalpur,Sesamum,2016,5815,6235,420,7.222699914015477
Manmad,Gram,2015,4186,4606,420,10.033444816053512
Dhule,Soybean,2014,2536,2956,420,16.561514195583594
Karad,Cucumber,2014,1260,1680,420,33.333333333333336
Akkolkot,Pigeon Pea (Tur),2016,8060,8480,420,5.2109181141439205
Ghoti,Cucumber,2016,1008,1428,420,41.666666666666664
Chandrapur,Awala,2014,1400,1820,420,30.0
Shirpur,Green Gram,2015,5380,5800,420,7.806691449814126
Akole,Wheat(Husked),2016,1480,1900,420,28.37837837837838
Ashti (Jalna),Soybean,2015,3131,3551,420,13.41424465027148
Majalgaon,Sorgum(Jawar),2016,1488,1908,420,28.225806451612904
Chopda,Green Gram,2014,6169,6589,420,6.808234721997082
Kalyan,Flower,2015,620,1040,420,67.74193548387096
Kalyan,Jaggery,2016,4160,4580,420,10.096153846153847
Chandrapur,Papai,2015,1400,1820,420,30.0
Jalgaon,Papai,2015,980,1400,420,42.857142857142854
Tumsar,Jaggery,2015,2336,2756,420,17.97945205479452
Kej,Wheat(Husked),2016,2205,2625,420,19.047619047619047
Aurangabad,Chavli (Shenga ),2016,992,1412,420,42.33870967741935
Sindi,Gram,2016,3900,4320,420,10.76923076923077
Rahata,Green Peas (Dry),2016,2500,2920,420,16.8
Bhivandi,Wheat(Husked),2016,1897,2317,420,22.14022140221402
Sinner,Sorgum(Jawar),2016,1386,1806,420,30.303030303030305
Shrirampur,Wheat(Husked),2016,1526,1946,420,27.522935779816514
Paithan,Green Gram,2016,4451,4871,420,9.43608177937542
Paithan,Wheat(Husked),2016,1695,2115,420,24.778761061946902
Pune,Gr.Nut Kernels,2015,8288,8708,420,5.0675675675675675
Osmanabad,Cabbage,2015,565,985,420,74.33628318584071
Khamgaon,Soybean,2014,2990,3410,420,14.046822742474916
Kamthi,BOTTLE GOURD,2016,484,904,420,86.77685950413223
Balapur,Wheat(Husked),2016,1380,1800,420,30.434782608695652
Yeotmal,Gram,2015,3680,4100,420,11.41304347826087
Nagpur,Wal Bhaji,2016,1890,2310,420,22.22222222222222
Gadhinglaj,Jaggery,2015,2225,2645,420,18.876404494382022
Sailu,Green Gram,2015,7867,8287,420,5.338756832337613
Gadhinglaj,Jaggery,2016,3125,3545,420,13.44
Aarni,Pigeon Pea (Tur),2015,5488,5908,420,7.653061224489796
Panvel,Flower,2016,2620,3040,420,16.03053435114504
Mangalwedha,Wheat(Unhusked),2016,2856,3276,420,14.705882352941176
Purna,Pigeon Pea (Tur),2016,6100,6520,420,6.885245901639344
Kalmeshwar,Soybean,2016,3347,3767,420,12.54855094114132
Kalyan,Ladies Finger,2016,969,1388,419,43.24045407636739
Satara,Cabbage,2016,762,1181,419,54.98687664041995
Mumbai,Flower,2015,658,1077,419,63.67781155015197
Savner,Gram,2016,3803,4222,419,11.017617670260321
Nashik,Potato,2015,900,1319,419,46.55555555555556
Risod,Soybean,2014,2886,3305,419,14.518364518364518
Shahapur,Mango(Raw),2016,1456,1875,419,28.77747252747253
Ramtek,Wal Bhaji,2016,1267,1686,419,33.07024467245462
Chandrapur-Ganjwad,BRINJAL,2016,257,676,419,163.03501945525292
Vani,SOYBEAN,2016,2388,2807,419,17.54606365159129
Karanja,Gram,2015,3891,4310,419,10.768439989719866
Varud-Rajura Bazar,Gram,2016,4542,4961,419,9.225011008366359
Pusad,Soybean,2015,3276,3695,419,12.78998778998779
Pune-Moshi,Onion,2016,442,861,419,94.79638009049773
Nashik,Flower,2016,509,928,419,82.31827111984283
Dondaicha,Sorgum(Jawar),2015,1264,1683,419,33.14873417721519
Karad,Snake Gourd,2016,906,1325,419,46.24724061810154
Karad,Snake Gourd,2016,719,1138,419,58.27538247566064
Kalyan,Banana,2016,1573,1992,419,26.636999364272093
Mumbai,Shevga,2016,758,1177,419,55.27704485488127
Kolhapur-Malkapur,Cabbage,2016,150,569,419,279.3333333333333
Arvi,Gram,2015,3762,4181,419,11.137692716640085
Yeotmal,Gram,2015,4202,4621,419,9.97144217039505
Aarni,Soybean,2015,3284,3703,419,12.758830694275273
Vai,Green Chilli,2015,1481,1900,419,28.291694800810262
Gevrai,GREEN GRAM,2016,4130,4549,419,10.145278450363197
Savner,Pigeon Pea (Tur),2016,5606,6025,419,7.474134855511951
Chandrapur-Ganjwad,Tomato,2014,457,876,419,91.68490153172867
Sangamner,Tomato,2014,269,688,419,155.76208178438662
Chandrapur-Ganjwad,Brinjal,2016,467,886,419,89.72162740899357
Amarawati-Fruit And Vegetables,Dhemse,2016,3645,4064,419,11.49519890260631
Devala,Onion,2016,477,896,419,87.84067085953879
Nagpur,Green Chilli,2015,1481,1900,419,28.291694800810262
Solapur,Banana,2016,508,927,419,82.48031496062993
Wardha,Soybean,2016,3334,3753,419,12.56748650269946
Manchar,Onion,2016,547,966,419,76.59963436928702
Kolhapur-Laxmipuri,Split Lentil,2015,7971,8390,419,5.256555011918204
Nagpur,Capsicum,2016,1527,1946,419,27.439423706614278
Panvel,Brinjal,2016,2545,2964,419,16.463654223968565
Wardha,Cotton,2016,4130,4549,419,10.145278450363197
Anajngaon Surji,Green Gram,2015,8118,8537,419,5.161369795516137
Jalna,Banana,2014,303,722,419,138.2838283828383
Aurangabad,Wal Bhaji,2015,1581,2000,419,26.502213788741305
Barshi,Tomato,2016,482,901,419,86.92946058091286
Amarawati,Soybean,2016,3191,3610,419,13.130680037605766
Savner,Soybean,2016,3306,3725,419,12.673926194797339
Aurangabad,Awala,2015,1000,1419,419,41.9
Nampur,Onion,2016,383,802,419,109.39947780678851
Kannad,Wheat(Husked),2016,1598,2017,419,26.220275344180227
Malkapur,Wheat(Husked),2016,1598,2017,419,26.220275344180227
Jawala-Bajar,Pigeon Pea (Tur),2015,5127,5545,418,8.152915935244783
Amarawati-Fruit And Vegetables,Melon,2016,973,1391,418,42.959917780061666
Dhamangaon-Rly,Gram,2016,3863,4281,418,10.820605746828889
Yeola,Gram,2015,3753,4171,418,11.13775646149747
Vai,Brinjal,2015,1727,2145,418,24.203821656050955
Dound,Sorgum(Jawar),2015,1560,1978,418,26.794871794871796
Partur,Wheat(Husked),2015,1554,1972,418,26.8983268983269
Patan,Cabbage,2016,1429,1847,418,29.251224632610217
Dhamangaon-Rly,Gram,2015,4340,4758,418,9.631336405529954
Devala,Green Gram,2015,7243,7661,418,5.771089327626674
Kurdwadi-Modnimb,Black Gram,2016,5530,5948,418,7.55877034358047
Karad,Brinjal,2016,752,1170,418,55.58510638297872
Nilanga,Soybean,2015,3364,3782,418,12.425683709869203
Indapur-Bhigwan,Bajri,2014,1420,1838,418,29.43661971830986
Pune,Bajri,2014,1703,2121,418,24.544920728126836
Vai,Brinjal,2015,1382,1800,418,30.246020260492042
Khamgaon,Lemon,2015,213,631,418,196.24413145539907
Ahmedpur,Pigeon Pea (Tur),2016,8337,8755,418,5.013793930670505
Rahata,Capsicum,2015,1138,1556,418,36.7311072056239
Kolhapur,Guava,2016,267,685,418,156.55430711610487
Ulhasnagar,Potato,2016,800,1218,418,52.25
Manora,Gram,2015,3782,4200,418,11.052353252247489
Manora,Soybean,2015,3048,3466,418,13.713910761154855
Amarawati-Fruit And Vegetables,Coriander  ,2016,3478,3896,418,12.018401380103509
Aurangabad,Capsicum,2016,1205,1623,418,34.68879668049792
Kille Dharur,Soybean,2015,3190,3608,418,13.10344827586207
Umarga,Sorgum(Jawar),2015,1394,1812,418,29.985652797704446
Umarga,Wheat(Husked),2015,1532,1950,418,27.284595300261095
Sindi,Cotton,2016,4071,4489,418,10.267747482191108
Sindi,Soybean,2015,3139,3557,418,13.316342784326219
Jintur,Pigeon Pea (Tur),2014,3929,4347,418,10.638839399338254
Yeotmal,Pigeon Pea (Tur),2014,4489,4907,418,9.311650701715305
Rahata,Tomato,2014,418,836,418,100.0
Mehkar,Soybean,2015,3424,3842,418,12.207943925233645
Amarawati,Ground Nut Pods (Dry),2016,4754,5172,418,8.792595708876735
Nagpur,Dhemse,2015,1591,2009,418,26.272784412319297
Akola,Wheat(Husked),2015,1316,1734,418,31.762917933130698
Sangali,Gram,2016,5255,5673,418,7.954329210275928
Ambejogai,Gram,2016,5338,5756,418,7.830648182840015
Manmad,Bajri,2014,1114,1532,418,37.52244165170556
Kalamb (Yawatmal),SOYBEAN,2016,2448,2866,418,17.075163398692812
Karad,Onion,2016,514,932,418,81.32295719844358
Achalpur,Sesamum,2014,8333,8750,417,5.0042001680067205
Jalgaon,Coriander (Dry),2016,7083,7500,417,5.887335874629394
Ahmednagar,Wheat(Husked),2016,2552,2969,417,16.34012539184953
Kolhapur-Malkapur,Brinjal,2016,444,861,417,93.91891891891892
Chandrapur-Ganjwad,Onion,2015,900,1317,417,46.333333333333336
Chandur Bajar,WHEAT(HUSKED),2016,1700,2117,417,24.529411764705884
Majalgaon,Bajri,2016,1346,1763,417,30.98068350668648
Satana,Bajri,2016,1393,1810,417,29.935391241923906
Solapur,Gram,2016,6171,6588,417,6.757413709285367
Kalamb (Yawatmal),Gram,2016,5133,5550,417,8.123904149620104
Nagpur,Soybean,2015,3211,3628,417,12.986608533167237
Solapur,Jaggery,2016,3055,3472,417,13.64975450081833
Chikhali,PIGEON PEA (TUR),2016,4617,5034,417,9.03183885640026
Kada,Sorgum(Jawar),2015,1461,1878,417,28.542094455852155
Varora,Gram,2016,3800,4217,417,10.973684210526315
Nagpur,Ginger (Dry),2015,2150,2567,417,19.3953488372093
Kalyan,Bitter Gourd,2016,3933,4350,417,10.602593440122044
Aurangabad,Ladies Finger,2015,1148,1565,417,36.32404181184669
Jalna-Badnapur,Pigeon Pea (Tur),2015,8771,9188,417,4.754303956219359
Sindi (Selu),Soybean,2016,2543,2960,417,16.397955171057806
Nagbhid,Paddy-Unhusked,2014,1661,2078,417,25.105358217941
Paithan,GREEN GRAM,2016,4501,4918,417,9.264607864918906
Satara,Flower,2015,650,1067,417,64.15384615384616
Sengaon,Turmeric,2016,6483,6900,417,6.432207311429893
Malkapur,SORGUM(JAWAR),2016,1161,1578,417,35.917312661498705
Mangrulpeer,Wheat(Husked),2015,1171,1588,417,35.61058923996584
Varora,Soybean,2016,3133,3550,417,13.309926587934887
Ratanagari,Bottle Gourd,2016,750,1167,417,55.6
Karad,Carrot,2014,950,1367,417,43.89473684210526
Kalyan,Capsicum,2016,1613,2030,417,25.852448853068815
Bhiwapur,Pigeon Pea (Tur),2016,6852,7269,417,6.085814360770578
Aurangabad,Cucumber,2015,687,1104,417,60.698689956331876
Satara,Potato,2016,1111,1528,417,37.53375337533753
Pandharkawada,Soybean,2015,3151,3568,417,13.233894001904158
Sakri,ONION,2016,350,767,417,119.14285714285714
Umrane,Onion,2016,397,814,417,105.03778337531486
Dondaicha,Matki,2016,4667,5084,417,8.935076065995286
Karad,Green Chilli,2015,2058,2475,417,20.262390670553938
Akkolkot,Gram,2015,3463,3880,417,12.041582442968524
Mumbai,Flower,2015,758,1175,417,55.0131926121372
Phaltan,Bajri,2014,1350,1767,417,30.88888888888889
Kalyan,Flower,2016,1283,1700,417,32.50194855806703
Nagpur,Ginger (Fresh),2016,2500,2917,417,16.68
Anajngaon Surji,Soybean,2016,3250,3667,417,12.830769230769231
Dound,Bajri,2016,1683,2100,417,24.777183600713013
Shirpur,Sorgum(Jawar),2015,1272,1689,417,32.783018867924525
Pachora,Sunflower,2016,3131,3547,416,13.286489939316512
Nagpur,Capsicum,2016,1521,1937,416,27.35042735042735
Aurangabad,Cucumber,2015,837,1253,416,49.70131421744325
Aurangabad,Flower,2015,937,1353,416,44.39701173959445
Nagpur,Dhemse,2016,2438,2854,416,17.063166529942578
Pune-Pimpri,Cluster Bean,2014,2617,3033,416,15.896064195643866
Nagpur,Mango,2015,1117,1533,416,37.24261414503133
Katol,Orange,2015,1567,1983,416,26.547543075941288
Lasalgaon-Vinchur,SORGUM(JAWAR),2016,1200,1616,416,34.666666666666664
Loha,Sorgum(Jawar),2015,1437,1853,416,28.94919972164231
Shrirampur,Sorgum(Jawar),2015,1418,1834,416,29.337094499294782
Junnar-Otur,Onion,2015,892,1308,416,46.63677130044843
Lonand,Gram,2015,3617,4033,416,11.50124412496544
Amarawati-Fruit And Vegetables,Bitter Gourd,2016,3963,4379,416,10.49709815796114
Akluj,Onion,2016,258,674,416,161.24031007751938
Aurangabad,Flower,2016,624,1040,416,66.66666666666667
Nagpur,Chavli (Pala),2015,763,1179,416,54.521625163827
Ghansawangi,Pigeon Pea (Tur),2016,7067,7483,416,5.886514787038347
Pune,Cabbage,2015,295,711,416,141.01694915254237
Washim,Wheat(Husked),2016,1475,1891,416,28.203389830508474
Indapur-Bhigwan,Sesamum,2015,6917,7333,416,6.014167991904005
Ausa,Sesamum,2014,8634,9050,416,4.818160759786889
Karad,Cucumber,2016,984,1400,416,42.27642276422764
Shrirampur,Green-Peas,2015,2442,2858,416,17.035217035217034
Murbad,Bitter Gourd,2016,1042,1458,416,39.923224568138195
Kalyan,Small Gourd,2015,2867,3283,416,14.509940704569237
Shirpur,Soybean,2016,3075,3491,416,13.528455284552846
Ahmedpur,Pigeon Pea (Tur),2016,7839,8255,416,5.306799336650083
Umari,Pigeon Pea (Tur),2015,8441,8857,416,4.928326027721834
Mumbai,Green-Peas,2015,1917,2333,416,21.70057381324987
Kolhapur-Laxmipuri,Split Lentil,2016,6588,7004,416,6.314511232544019
Mumbai-Fruit Market,Guava,2016,1184,1600,416,35.13513513513514
Pune-Pimpri,Tomato,2015,668,1084,416,62.275449101796404
Lonand,Wheat(Husked),2016,1567,1983,416,26.547543075941288
Nashik,Flower,2016,624,1040,416,66.66666666666667
Tumsar,Linseed,2015,3803,4219,416,10.938732579542467
Kopargaon,Bajri,2015,1091,1507,416,38.13015582034831
Nagpur,Cucumber,2016,1096,1512,416,37.956204379562045
Pune-Moshi,Ghosali(Bhaji),2016,1917,2333,416,21.70057381324987
Kamthi,Small Gourd,2015,767,1183,416,54.23728813559322
Shahada,Black Gram,2014,5024,5440,416,8.280254777070065
Varora,Cotton,2016,4107,4522,415,10.104699293888483
Varora,Cotton,2015,3961,4376,415,10.477152234284272
Deulgaon Raja,Cotton,2016,4467,4882,415,9.290351466308485
Shrirampur,Brinjal,2015,952,1367,415,43.59243697478992
Kopargaon,Bajri,2016,1603,2018,415,25.888958203368684
Hingoli-Kanegaon Naka,Green Gram,2016,4560,4975,415,9.100877192982455
Sindi,Soybean,2014,2900,3315,415,14.310344827586206
Shegaon,SOYBEAN,2016,2420,2835,415,17.14876033057851
Akluj,Banana,2015,350,765,415,118.57142857142857
Barshi,Shevga,2016,425,840,415,97.6470588235294
Karad,Cucumber,2015,1314,1729,415,31.58295281582953
Karanja,Green Gram,2015,7035,7450,415,5.899076048329779
Sangamner,Bajri,2015,1300,1715,415,31.923076923076923
Karad,Bottle Gourd,2014,1071,1486,415,38.74883286647992
Majalgaon,Bajri,2015,1019,1434,415,40.72620215897939
Malegaon,WHEAT(HUSKED),2016,1755,2170,415,23.646723646723647
Osmanabad,Soybean,2016,3235,3650,415,12.828438948995363
Patur,Gram,2016,3685,4100,415,11.261872455902306
Yawal,Onion,2015,1163,1578,415,35.683576956147895
Sonpeth,Soybean,2016,3577,3992,415,11.601901034386357
Katol,Soybean,2014,2745,3160,415,15.1183970856102
Patan,Tomato,2014,1863,2278,415,22.27589908749329
Mumbai,Cucumber,2016,1558,1973,415,26.63671373555841
Vani,Gram,2015,3450,3865,415,12.028985507246377
Kamthi,Bottle Gourd,2015,448,863,415,92.63392857142857
Shrirampur,Cucumber,2016,953,1368,415,43.546694648478486
Satara,Cabbage,2015,711,1126,415,58.36849507735584
Gevrai,Gram,2014,2038,2453,415,20.363101079489695
Kolhapur-Laxmipuri,Green Gram,2016,7975,8390,415,5.2037617554858935
Nashik-Devlali,Chavli (Pala),2016,513,928,415,80.89668615984405
Chandrapur-Ganjwad,Spinach,2014,1054,1469,415,39.37381404174573
Buldhana,Gram,2015,3329,3744,415,12.466206067888255
Anajngaon Surji,Pigeon Pea (Tur),2016,8338,8753,415,4.977212760853922
Murtizapur,Soybean,2014,2629,3044,415,15.785469760365158
Morshi,Soybean,2015,3071,3486,415,13.513513513513514
Shirpur,Sorgum(Jawar),2016,1535,1950,415,27.035830618892508
Vai,Bottle Gourd,2016,1908,2323,415,21.750524109014677
Pathari,Wheat(Husked),2015,1520,1935,415,27.30263157894737
Nagpur,Small Gourd,2015,981,1396,415,42.303771661569826
Shirpur,Gram,2014,2392,2807,415,17.349498327759196
Anajngaon Surji,Gram,2016,3914,4329,415,10.602963719979561
Kille Dharur,Gram,2016,3926,4341,415,10.570555272542027
Kalyan,Brinjal,2015,1500,1915,415,27.666666666666668
Pune-Moshi,Flower,2016,743,1157,414,55.720053835800805
Manmad,Onion,2016,382,796,414,108.37696335078535
Chandrapur-Ganjwad,Tomato,2015,457,871,414,90.59080962800876
Vai,Cabbage,2016,1900,2314,414,21.789473684210527
Kalyan,Chikoo,2015,1829,2243,414,22.635319846910882
Pune-Pimpri,Bottle Gourd,2014,1427,1841,414,29.011913104414855
Nagpur,Carrot,2016,1618,2032,414,25.587144622991346
Ghatanji,Gram,2016,4722,5136,414,8.767471410419313
Sillod,GREEN GRAM,2016,4600,5014,414,9.0
Rahata,Ginger (Fresh),2016,1586,2000,414,26.103404791929382
Achalpur,PIGEON PEA (TUR),2016,5357,5771,414,7.728206085495613
Rahata,Ground Nut Pods (Dry),2016,3629,4043,414,11.408101405345825
Mandhal,Soybean,2015,2686,3100,414,15.4132539091586
Ulhasnagar,Banana,2016,386,800,414,107.25388601036269
Pune,Lentil,2016,5527,5941,414,7.49050117604487
Chalisgaon,WHEAT(HUSKED),2016,1440,1854,414,28.75
Nagpur,Sorgum(Jawar),2015,1586,2000,414,26.103404791929382
Pune,Beet Root,2015,424,838,414,97.64150943396227
Shrirampur,Gram,2016,3899,4313,414,10.618107206976148
Junnar-Otur,Onion,2016,529,943,414,78.26086956521739
Barshi,Cluster Bean,2016,509,923,414,81.33595284872298
Ahmedpur,Green Gram,2015,6701,7115,414,6.1781823608416655
Latur,Soybean,2016,3573,3987,414,11.586901763224182
Amarawati,Cabbage,2016,3186,3600,414,12.994350282485875
Nagpur,Onion,2016,282,696,414,146.80851063829786
Mumbai,Chikoo,2014,1195,1609,414,34.64435146443515
Solapur,Jaggery,2016,3029,3443,414,13.667877187190491
Ahmedpur,Sunflower,2015,2955,3369,414,14.01015228426396
Parli-Vaijnath,Soybean,2016,2565,2979,414,16.140350877192983
Dudhani,Sorgum(Jawar),2016,1667,2081,414,24.83503299340132
Kalamb (Os),Pigeon Pea (Tur),2016,5623,6037,414,7.362617819669215
Jalgaon,Tomato,2016,420,834,414,98.57142857142857
Karad,Ridge Gourd,2015,1507,1921,414,27.471798274717983
Pune-Pimpri,Ladies Finger,2015,2457,2871,414,16.84981684981685
Aurangabad,Cucumber,2014,722,1135,413,57.202216066481995
Nandurbar,BLACK GRAM,2016,5081,5494,413,8.12832119661484
Kurdwadi-Modnimb,Green Gram,2016,4282,4695,413,9.645025688930406
Jintur,Wheat(Husked),2015,1448,1861,413,28.522099447513813
Malegaon,Wheat(Husked),2015,1423,1836,413,29.023190442726634
Aurad Shahajani,Gram,2016,6345,6758,413,6.509062253743105
Kolhapur,Water Melon,2015,452,865,413,91.3716814159292
Shirur,Indian Bean,2015,3749,4162,413,11.016271005601494
Karanja,Gram,2015,2702,3115,413,15.284974093264248
Rahuri-Vambori,Wheat(Husked),2015,1622,2035,413,25.462392108508016
Pune-Pimpri,Tomato,2015,1067,1480,413,38.706654170571696
Paranda,SORGUM(JAWAR),2016,1800,2213,413,22.944444444444443
Pune,Cabbage,2015,508,921,413,81.2992125984252
Rahuri-Vambori,Wheat(Husked),2015,1330,1743,413,31.05263157894737
Dound,Wheat(Husked),2016,1636,2049,413,25.244498777506113
Chandrapur-Ganjwad,Potato,2015,706,1119,413,58.4985835694051
Shirpur,Bajri,2014,1002,1415,413,41.21756487025948
Sinner,Bajri,2014,1026,1439,413,40.253411306042885
Umared,Wheat(Husked),2015,1500,1913,413,27.533333333333335
Jalgaon,Potato,2016,760,1173,413,54.3421052631579
Pune-Moshi,Bottle Gourd,2016,840,1253,413,49.166666666666664
Shirpur,Bajri,2015,964,1377,413,42.84232365145228
Kamthi,Raddish,2015,467,880,413,88.43683083511777
Jalna,Mosambi,2015,1320,1733,413,31.28787878787879
Murtizapur,Soybean,2016,3296,3709,413,12.530339805825243
Baramati,Wheat(Husked),2015,1650,2063,413,25.03030303030303
Shevgaon,Pigeon Pea (Tur),2015,4750,5163,413,8.694736842105263
Ausa,Soybean,2015,3301,3714,413,12.511360193880643
Satara,Onion,2015,1950,2363,413,21.17948717948718
Rahuri-Vambori,Gram,2015,3766,4178,412,10.939989378651088
Ausa,Gram,2014,2060,2472,412,20.0
Jintur-Bori,Pigeon Pea (Tur),2015,5176,5588,412,7.959814528593508
Balapur,Sorgum(Jawar),2016,1188,1600,412,34.68013468013468
Mantha,Green Gram,2015,5642,6054,412,7.302375044310528
Nagpur,Parwar,2016,1324,1736,412,31.117824773413897
Kopargaon,Bajri,2015,1065,1477,412,38.68544600938967
Khamgaon,Black Gram,2015,6848,7260,412,6.016355140186916
Aarni,Soybean,2014,2900,3312,412,14.206896551724139
Kurdwadi,Gram,2016,4988,5400,412,8.259823576583802
Baramati,Jaggery,2015,2342,2754,412,17.591801878736124
Karad,GINGER (FRESH),2016,1156,1568,412,35.6401384083045
Chandrapur-Ganjwad,TOMATO,2016,484,896,412,85.12396694214875
Vai,Pavata,2016,1913,2325,412,21.53685311029796
Shahapur,Ladies Finger,2014,1847,2259,412,22.30644288034651
Mangalwedha,Gram,2016,5005,5417,412,8.231768231768232
Shrirampur,Sorgum(Jawar),2014,1535,1947,412,26.84039087947883
Balapur,Wheat(Husked),2015,1413,1825,412,29.157820240622787
Vadgaon Peth,Cucumber,2015,688,1100,412,59.883720930232556
Panvel,Ladies Finger,2016,3038,3450,412,13.561553653719553
Ausa,Soybean,2015,3392,3804,412,12.14622641509434
Jalgaon Jamod-Aasalgaon,Soybean,2016,3013,3425,412,13.674078991038831
Murtizapur,Gram,2015,3998,4410,412,10.305152576288144
Rajura,SOYBEAN,2016,2317,2729,412,17.78161415623651
Karanja,Green Gram,2016,4075,4487,412,10.110429447852761
Pusad,Bajri,2014,1440,1852,412,28.61111111111111
Wardha,Pigeon Pea (Tur),2015,8788,9200,412,4.688211197086937
Nagpur,Tomato,2015,1198,1610,412,34.390651085141904
Akole,Bajri,2015,1388,1800,412,29.68299711815562
Umared,Soybean,2016,3300,3712,412,12.484848484848484
Amarawati-Fruit And Vegetables,Coriander  ,2016,1882,2294,412,21.891604675876728
Kada,Gram,2015,3716,4128,412,11.08719052744887
Ghansawangi,Pigeon Pea (Tur),2016,8163,8575,412,5.047164032831067
Khed-Chakan,Walvad,2016,888,1300,412,46.3963963963964
Akole,Paddy-Unhusked,2015,1488,1900,412,27.688172043010752
Devala,Black Gram,2016,7097,7509,412,5.805269832323517
Malegaon (Washim),Pigeon Pea (Tur),2015,6663,7075,412,6.1834008704787635
Khed-Chakan,Chavli (Shenga ),2016,1596,2008,412,25.81453634085213
Baramati,Jaggery,2016,3403,3815,412,12.106964443138407
Ghoti,Brinjal,2016,1440,1852,412,28.61111111111111
Shrirampur,Chikoo,2015,1029,1441,412,40.03887269193392
Satana,Wheat(Husked),2016,1583,1995,412,26.026531901452937
Lonand,Wheat(Husked),2016,1538,1950,412,26.788036410923276
Mumbai-Onion And Potato Mkt,Onion,2016,529,940,411,77.6937618147448
Nandura,Soybean,2015,2898,3309,411,14.182194616977226
Zarijamini,Soybean,2015,3184,3595,411,12.908291457286433
Samudrapur,Soybean,2016,3140,3551,411,13.089171974522293
Nandurbar,Wheat(Husked),2016,1518,1929,411,27.07509881422925
Manchar,Chavli (Shenga ),2015,1218,1629,411,33.74384236453202
Dondaicha,Green Gram,2015,6360,6771,411,6.462264150943396
Ramtek,Spinach,2015,583,994,411,70.49742710120069
Dhamangaon-Rly,Gram,2014,2243,2654,411,18.323673651359787
Jamkhed,Black Gram,2014,5005,5416,411,8.211788211788212
Ratanagari,Cabbage,2015,689,1100,411,59.65166908563135
Malegaon,Soybean,2015,3050,3461,411,13.475409836065573
Ramtek,Onion,2016,1189,1600,411,34.56686291000841
Murbad,Capsicum,2016,1611,2022,411,25.512104283054004
Gangapur,Gram,2015,3698,4109,411,11.114115738236885
Patan,Green Chilli,2016,1253,1664,411,32.80127693535515
Kalyan,Ridge Gourd,2016,2468,2879,411,16.653160453808752
Sindkhed Raja,Wheat(Husked),2016,1578,1989,411,26.045627376425855
Aurangabad,PAPAI,2016,1133,1544,411,36.275375110326564
Mumbai,CLUSTER BEAN,2016,1783,2194,411,23.051037577117217
Katol,Gram,2015,3797,4208,411,10.824335001316829
Kopargaon,Wheat(Husked),2015,1302,1713,411,31.566820276497698
Shegaon,Gram,2014,2381,2792,411,17.261654766904662
Kalyan,Ghevda,2015,2805,3216,411,14.6524064171123
Bhivandi,Other Vegetables,2015,1089,1500,411,37.74104683195592
Panvel,Brinjal,2016,2722,3133,411,15.099191770756796
Partur,Soybean,2015,3278,3689,411,12.538133007931666
Bhivandi,Potato,2015,1267,1678,411,32.438831886345696
Shegaon,Black Gram,2016,7077,7488,411,5.807545570156846
Pandharpur,Gram,2016,6000,6411,411,6.85
Kamthi,Bottle Gourd,2016,404,815,411,101.73267326732673
Chandur Bajar,Soybean,2015,2820,3231,411,14.574468085106384
Pune,Arvi,2016,2617,3028,411,15.705005731753916
Navapur,Wal Papdi,2016,2324,2735,411,17.68502581755594
Shirur,Gram,2015,3552,3963,411,11.570945945945946
Kej,Soybean,2016,3468,3879,411,11.85121107266436
Pandharpur,Banana,2015,414,825,411,99.27536231884058
Kalyan,Banana,2016,1845,2255,410,22.22222222222222
Ratanagari,Brinjal,2015,780,1190,410,52.56410256410256
Chandrapur-Ganjwad,Wal Bhaji,2015,1210,1620,410,33.88429752066116
Khamgaon,Lemon,2016,290,700,410,141.3793103448276
Kopargaon,Sorgum(Jawar),2016,1330,1740,410,30.827067669172934
Nagpur,Wheat(Husked),2014,1618,2028,410,25.339925834363413
Khamgaon,Lemon,2015,970,1380,410,42.2680412371134
Buldhana,Wheat(Husked),2016,1540,1950,410,26.623376623376622
Aurangabad,Wal Bhaji,2014,1840,2250,410,22.282608695652176
Karad,Brinjal,2015,1032,1442,410,39.72868217054263
Solapur,Bajri,2016,1483,1893,410,27.646662171274443
Nandura,Pigeon Pea (Tur),2016,8510,8920,410,4.81786133960047
Barshi-Vairag,Sorgum(Jawar),2015,1772,2182,410,23.13769751693002
Chandur Bajar,Gram,2015,3025,3435,410,13.553719008264462
Akkolkot,Gram,2016,5075,5485,410,8.078817733990148
Dudhani,Gram,2014,2582,2992,410,15.879163439194423
Nandura,Gram,2016,3914,4324,410,10.475217169136434
Washim,Green Gram,2015,6063,6473,410,6.7623288800923635
Akole,Paddy-Unhusked,2016,1490,1900,410,27.516778523489933
Dhule,Wheat(Husked),2016,1594,2004,410,25.721455457967377
Murbad,Ladies Finger,2016,1745,2155,410,23.49570200573066
Bhokar,Turmeric,2015,6288,6698,410,6.520356234096692
Balapur,Wheat(Husked),2015,1310,1720,410,31.297709923664122
Palus,Cabbage,2016,500,910,410,82.0
Ambejogai,Sorgum(Jawar),2014,1507,1917,410,27.2063702720637
Rahata,Bottle Gourd,2015,420,830,410,97.61904761904762
Satana,Wheat(Husked),2016,1532,1942,410,26.762402088772845
Mumbai,Sweet Potato,2015,1258,1668,410,32.591414944356124
Kille Dharur,Cotton,2016,4166,4576,410,9.841574651944311
Kej,Pigeon Pea (Tur),2016,6745,7155,410,6.078576723498888
Raver,Wheat(Husked),2015,1090,1500,410,37.61467889908257
Mohol,Black Gram,2014,4100,4510,410,10.0
Kopargaon,Sorgum(Jawar),2015,1225,1635,410,33.46938775510204
Partur,Green Gram,2015,7250,7660,410,5.655172413793103
Dudhani,Bajri,2014,1095,1505,410,37.44292237442922
Nagpur,Mango(Raw),2016,2360,2770,410,17.372881355932204
Tuljapur,Gram,2015,3321,3731,410,12.345679012345679
Achalpur,Pigeon Pea (Tur),2016,8189,8599,410,5.006716326779826
Gangapur,Pigeon Pea (Tur),2015,5350,5760,410,7.663551401869159
Chandur Rly.,Soybean,2015,3261,3671,410,12.572830420116528
Indapur-Bhigwan,Bajri,2016,1590,2000,410,25.78616352201258
Kalmeshwar,Pigeon Pea (Tur),2015,6889,7299,410,5.951516911017564
Manchar,Maize(Corn.),2015,700,1110,410,58.57142857142857
Umarkhed-Danki,Soybean,2014,2750,3160,410,14.909090909090908
Nashik,Flower,2016,670,1080,410,61.19402985074627
Mangrulpeer,Pigeon Pea (Tur),2014,3939,4348,409,10.383346026910383
Vai,Ladies Finger,2015,1173,1582,409,34.86786018755328
Partur,Wheat(Husked),2016,1761,2170,409,23.225440090857468
Mumbai,Bottle Gourd,2016,1343,1752,409,30.454206999255398
Rahata,Ladies Finger,2016,1836,2245,409,22.276688453159043
Barshi,Cluster Bean,2016,1848,2257,409,22.13203463203463
Umarkhed,Gram,2015,2991,3400,409,13.674356402540957
Nagpur,Green-Peas,2014,2733,3142,409,14.965239663373582
Rahata,Gram,2015,2769,3178,409,14.770675334055616
Vai,Brinjal,2016,1909,2318,409,21.4248297537978
Vai,Brinjal,2016,1562,1971,409,26.18437900128041
Satana,Bajri,2016,1218,1627,409,33.579638752052546
Umarga,Wheat(Husked),2015,1588,1997,409,25.75566750629723
Kalyan,Tomato,2015,2791,3200,409,14.654245790039413
Raver,Maize,2016,1266,1675,409,32.30647709320695
Lasalgaon-Niphad,Onion,2016,333,742,409,122.82282282282283
Nandura,Green Gram,2015,6341,6750,409,6.4500867371077115
Mantha,Gram,2016,5783,6192,409,7.072453743731627
Nagpur,Math (Bhaji),2015,1817,2226,409,22.509631260319207
Nandura,Soybean,2014,2725,3134,409,15.009174311926605
Sindi,Soybean,2016,3205,3614,409,12.761310452418098
Amarawati,Bitter Gourd,2016,3827,4236,409,10.6872223673896
Lasur Station,Gram,2016,3860,4269,409,10.595854922279793
Umared,Sunflower,2016,3086,3495,409,13.253402462734932
Karad,Capsicum,2015,1283,1692,409,31.878409976617302
Mumbai,Ridge Gourd,2015,1361,1770,409,30.051432770022043
Malegaon,Bajri,2015,1251,1660,409,32.69384492406075
Manmad,Kanda Pat,2016,265,674,409,154.33962264150944
Sangli-Phale Bhajipalam,Potato,2015,704,1113,409,58.09659090909091
Manchar,Bottle Gourd,2016,427,836,409,95.78454332552693
Karanja,Soybean,2014,2944,3353,409,13.892663043478262
Mumbai,Carrot,2015,1129,1538,409,36.2267493356953
Shirpur,Bajri,2016,1071,1480,409,38.18860877684407
Nagpur,Parwar,2016,1229,1638,409,33.279088689991866
Jalgaon,Cabbage,2016,668,1077,409,61.22754491017964
Rahata,Shevga,2015,1791,2200,409,22.836404243439418
Risod,Gram,2015,4417,4826,409,9.25967851482907
Jintur-Bori,Pigeon Pea (Tur),2014,3946,4355,409,10.364926507856056
Pune-Pimpri,Cluster Bean,2016,2936,3345,409,13.930517711171662
Dound,Wheat(Husked),2015,1517,1926,409,26.961107448912326
Hinganghat,Gram,2014,2213,2622,409,18.481699051061906
Patan,Cucumber,2015,1091,1500,409,37.48854262144821
Nagpur,Chavli (Pala),2015,869,1277,408,46.95051783659379
Katol,Mosambi,2015,1290,1698,408,31.627906976744185
Mumbai,Capsicum,2015,1388,1796,408,29.394812680115272
Telhara,Pigeon Pea (Tur),2015,5860,6268,408,6.962457337883959
Gangapur,Gram,2015,3970,4378,408,10.277078085642318
Kopargaon,Bajri,2014,1056,1464,408,38.63636363636363
Ambad(Vadi Godri),Sorgum(Jawar),2015,1199,1607,408,34.02835696413678
Satara,Green Chilli,2016,1009,1417,408,40.43607532210109
Dhamangaon-Rly,Gram,2016,3797,4205,408,10.745325256781669
Baramati,Sunflower,2016,3004,3412,408,13.581890812250332
Nagpur,Bitter Gourd,2016,2075,2483,408,19.662650602409638
Rahata,Potato,2014,2150,2558,408,18.976744186046513
Bhokar,Pigeon Pea (Tur),2016,8445,8853,408,4.8312611012433395
Shevgaon,Sorgum(Jawar),2014,1582,1990,408,25.790139064475348
Morshi,Gram,2016,5275,5683,408,7.734597156398104
Amarawati,Green Gram,2016,4150,4558,408,9.831325301204819
Pune,Potato,2015,609,1017,408,66.99507389162562
Mumbai,Tomato,2016,1985,2393,408,20.554156171284635
Akola,Pigeon Pea (Tur),2014,4642,5050,408,8.789314950452392
Solapur,Tomato,2016,120,528,408,340.0
Nagpur,Cucumber,2015,788,1196,408,51.776649746192895
Babhulgaon,Soybean,2015,2929,3337,408,13.929668828951861
Shrirampur,Green Chilli,2016,1135,1543,408,35.947136563876654
Umared,Soybean,2015,2900,3308,408,14.068965517241379
Chandur Bajar,Pigeon Pea (Tur),2014,4700,5108,408,8.680851063829786
Karad,Banana,2016,612,1020,408,66.66666666666667
Ulhasnagar,Potato,2016,777,1185,408,52.50965250965251
Dondaicha,Bajri,2016,1375,1783,408,29.672727272727272
Karad,Bottle Gourd,2014,1100,1508,408,37.09090909090909
Aurangabad,Mango(Raw),2016,1156,1564,408,35.294117647058826
Tumsar,Jaggery,2016,3578,3986,408,11.403018446059251
Karad,Flower,2014,1050,1458,408,38.857142857142854
Mangrulpeer,Wheat(Husked),2015,1200,1608,408,34.0
Nagpur,Cluster Bean,2016,1528,1936,408,26.701570680628272
Kalvan,Ground Nut Pods (Dry),2016,4357,4765,408,9.364241450539362
Panvel,Bottle Gourd,2016,2892,3300,408,14.107883817427386
Manwat,Sorgum(Jawar),2015,1308,1715,407,31.116207951070336
Malegaon,Bajri,2016,1496,1903,407,27.205882352941178
Jintur,Soybean,2014,2834,3241,407,14.361326746647848
Rahata,Flower,2016,1285,1692,407,31.673151750972764
Vai,Tomato,2016,1962,2369,407,20.74413863404689
Sinner,Sorgum(Jawar),2015,1272,1679,407,31.99685534591195
Kannad,Wheat(Husked),2016,1664,2071,407,24.459134615384617
Nandurbar,Pigeon Pea (Tur),2015,7737,8144,407,5.260436861832751
Dhule,Bajri,2016,1370,1777,407,29.708029197080293
Umarga,Gram,2014,2187,2594,407,18.60996799268404
Mumbai,Bitter Gourd,2015,3563,3970,407,11.422958181307887
Nashik-Devlali,Methi (Bhaji),2016,1706,2113,407,23.856975381008205
Yeola,Gram,2014,2068,2475,407,19.680851063829788
Sangali,Bajri,2015,1381,1788,407,29.471397538015932
Patan,Ladies Finger,2015,1886,2293,407,21.580063626723224
Nagpur,Carrot,2016,1293,1700,407,31.477184841453983
Pusad,Soybean,2016,3358,3765,407,12.120309708159619
Mumbai,Squash Gourd,2016,831,1238,407,48.97713598074609
Shegaon,Soybean,2016,3167,3574,407,12.851278812756552
Pune-Moshi,BOTTLE GOURD,2016,730,1137,407,55.75342465753425
Akola,Soybean,2015,3312,3719,407,12.28864734299517
Lasalgaon,Wheat(Husked),2016,1633,2040,407,24.923453766074708
Malkapur,Black Gram,2016,11309,11716,407,3.59890352816341
Jamkhed,Wheat(Husked),2015,1841,2248,407,22.107550244432375
Osmanabad,Sorgum(Jawar),2016,1346,1753,407,30.237741456166418
Manchar,Flower,2016,638,1045,407,63.793103448275865
Kamthi,Brinjal,2016,493,900,407,82.55578093306288
Mumbai,Carrot,2015,1281,1688,407,31.772053083528494
Kalamnuri,Pigeon Pea (Tur),2016,7773,8180,407,5.236073588061237
Kamthi,Bottle Gourd,2016,300,707,407,135.66666666666666
Pune-Manjri,Cabbage,2015,593,1000,407,68.63406408094436
Satana,Gram,2016,3918,4325,407,10.38795303726391
Murtizapur,Safflower,2015,2321,2728,407,17.53554502369668
Vai,Flower,2015,1779,2186,407,22.878021360314783
Sindi (Selu),Soybean,2016,3431,3838,407,11.862430778198776
Pune,Arvi,2015,2531,2938,407,16.08060055314105
Umrane,Onion,2016,376,783,407,108.24468085106383
Panvel,Cluster Bean,2016,3953,4360,407,10.295977738426512
Pusad,Green Gram,2016,4335,4742,407,9.388696655132641
Solapur,Cabbage,2016,340,746,406,119.41176470588235
Pachora,Black Gram,2016,6623,7029,406,6.130152498867583
Mangrulpeer,Gram,2015,3005,3411,406,13.5108153078203
Sinner,Sorgum(Jawar),2014,1579,1985,406,25.71247625079164
Parbhani,Pigeon Pea (Tur),2016,7469,7875,406,5.435801312089972
Nagpur,Mosambi,2015,2143,2549,406,18.945403639757348
Sonpeth,Soybean,2016,3244,3650,406,12.5154130702836
Barshi-Vairag,Gram,2015,3593,3999,406,11.299749512941831
Jintur,Ground Nut Pods (Dry),2015,5156,5562,406,7.874321179208689
Beed,Wheat(Husked),2015,1691,2097,406,24.009461856889416
Lasalgaon-Vinchur,Bajri,2016,1117,1523,406,36.34735899731423
Pulgaon,Pigeon Pea (Tur),2015,5355,5761,406,7.5816993464052285
Shegaon,Soybean,2016,2490,2896,406,16.305220883534137
Kamthi,Spinach,2015,327,733,406,124.15902140672783
Akluj,Cabbage,2015,429,835,406,94.63869463869464
Varud,Orange,2015,500,906,406,81.2
Jintur,Soybean,2015,3295,3701,406,12.321699544764796
Paithan,Wheat(Husked),2015,1445,1851,406,28.096885813148788
Pachora,Soybean,2016,2468,2874,406,16.450567260940034
Loha,Pigeon Pea (Tur),2015,6885,7291,406,5.896877269426289
Washim,Black Gram,2015,5365,5771,406,7.5675675675675675
Hingoli,Gram,2015,4370,4776,406,9.290617848970252
Akola,Wheat(Husked),2016,1669,2075,406,24.32594367884961
Chandrapur-Ganjwad,Spinach,2015,441,847,406,92.06349206349206
Amarawati,Cluster Bean,2016,3644,4050,406,11.141602634467619
Parola,Bajri,2016,1256,1662,406,32.32484076433121
Raver,Pigeon Pea (Tur),2015,7041,7447,406,5.766226388297117
Vadgaon Peth,Cabbage,2014,538,944,406,75.46468401486989
Akot,Soybean,2016,2782,3188,406,14.593817397555716
Lasur Station,Wheat(Husked),2015,1502,1908,406,27.030625832223702
Nashik-Devlali,Chavli (Pala),2016,333,739,406,121.92192192192192
Mumbai,Green Chilli,2016,5198,5604,406,7.810696421700654
Nagpur,Bor,2016,467,873,406,86.93790149892934
Pathari,Wheat(Husked),2015,1497,1903,406,27.120908483633933
Sangali,Soybean,2015,3038,3444,406,13.36405529953917
Nashik,Carrot,2016,662,1068,406,61.329305135951664
Pathardi,Sorgum(Jawar),2014,1262,1668,406,32.17115689381934
Amarawati,GREEN GRAM,2016,4377,4783,406,9.27575965273018
Patan,GINGER (FRESH),2016,1613,2019,406,25.170489770613763
Nagpur,Tomato,2016,2698,3104,406,15.048183839881393
Kalyan,Elephant Root,2015,2888,3294,406,14.058171745152354
Solapur,Black Gram,2014,4503,4909,406,9.016211414612481
Mangalwedha,Gram,2015,3694,4100,406,10.990795885219274
Nagpur,Cabbage,2016,1604,2009,405,25.24937655860349
Mehkar,Soybean,2016,3361,3766,405,12.049985123475157
Lonar,Gram,2015,4048,4453,405,10.004940711462451
Barshi,Wheat(Husked),2014,1351,1756,405,29.97779422649889
Yeotmal,Gram,2014,2241,2646,405,18.072289156626507
Solapur,Sorgum(Jawar),2015,1636,2041,405,24.755501222493887
Pusad,Ground Nut Pods (Dry),2015,5430,5835,405,7.458563535911602
Taloda,Black Gram,2015,2769,3174,405,14.626218851570965
Junnar-Otur,Ladies Finger,2016,388,793,405,104.38144329896907
Kalyan,Ridge Gourd,2015,3352,3757,405,12.08233890214797
Latur-Murud,Soybean,2016,3320,3725,405,12.198795180722891
Devala,Onion,2016,131,536,405,309.1603053435114
Raver,Pigeon Pea (Tur),2015,5840,6245,405,6.934931506849315
Karanja,Black Gram,2016,8346,8751,405,4.852624011502516
Karanja,Wheat(Husked),2015,1417,1822,405,28.58151023288638
Karanja,Sorgum(Jawar),2015,1125,1530,405,36.0
Mumbai,Chikoo,2015,1089,1494,405,37.1900826446281
Karad,Snake Gourd,2016,1040,1445,405,38.94230769230769
Patan,Brinjal,2016,1713,2118,405,23.642732049036777
Dound,Sorgum(Jawar),2015,1753,2158,405,23.103251568739303
Nandurbar,Green Gram,2015,7006,7411,405,5.780759349129318
Chandur Rly.,Pigeon Pea (Tur),2015,4797,5202,405,8.442776735459661
Pune,Sorgum(Jawar),2015,2475,2880,405,16.363636363636363
Shirpur,Bajri,2016,1358,1763,405,29.823269513991164
Sindi (Selu),Gram,2016,3733,4138,405,10.849182962764532
Basmat,Sunflower,2015,3150,3555,405,12.857142857142858
Nanded,Pigeon Pea (Tur),2016,8198,8603,405,4.940229324225421
Nandurbar,Sorgum(Jawar),2015,1310,1715,405,30.916030534351144
Sindi,Soybean,2016,3100,3505,405,13.064516129032258
Mantha,Sorgum(Jawar),2016,1293,1698,405,31.322505800464036
Ratanagari,Tomato,2016,538,943,405,75.27881040892193
Ramtek,Spinach,2015,1490,1895,405,27.181208053691275
Vita,Brinjal,2016,886,1291,405,45.71106094808126
Pune-Pimpri,Ground Nut Pods (Dry),2016,3295,3700,405,12.291350531107739
Kej,Wheat(Husked),2016,1796,2201,405,22.55011135857461
Kalyan,Ridge Gourd,2016,1506,1911,405,26.89243027888446
Kada,Gram,2015,3858,4263,405,10.497667185069984
Lonand,Bajri,2015,1269,1674,405,31.914893617021278
Ambad(Vadi Godri),Sorgum(Jawar),2015,1313,1718,405,30.845392231530845
Jalgaon,CABBAGE,2016,440,845,405,92.04545454545455
Malkapur,Gram,2015,3056,3460,404,13.219895287958115
Khed-Chakan,Cabbage,2016,842,1246,404,47.980997624703086
Mumbai,Bitter Gourd,2016,2358,2762,404,17.133163698049195
Karad,Capsicum,2016,848,1252,404,47.64150943396226
Kada,Bajri,2014,1234,1638,404,32.73905996758509
Kalyan,Onion,2015,1136,1540,404,35.563380281690144
Yeotmal,Pigeon Pea (Tur),2014,4411,4815,404,9.158920879619133
Amarawati,Tomato,2016,3082,3486,404,13.108371187540557
Nagpur,Beet Root,2015,592,996,404,68.24324324324324
Sailu,Gram,2015,3125,3529,404,12.928
Ambad(Vadi Godri),Gram,2015,3833,4237,404,10.54004696060527
Mumbai,Ladies Finger,2016,2625,3029,404,15.39047619047619
Aurangabad,Brinjal,2015,891,1295,404,45.34231200897867
Bhivandi,Wheat(Husked),2015,1913,2317,404,21.118661787767905
Mangrulpeer,Soybean,2016,3676,4080,404,10.990206746463548
Nagpur,Small Gourd,2015,925,1329,404,43.67567567567568
Udgir,Pigeon Pea (Tur),2016,8420,8824,404,4.798099762470309
Jalgaon,TOMATO,2016,467,871,404,86.50963597430408
Vita,POTATO,2016,1042,1446,404,38.771593090211134
Satara,Cabbage,2015,881,1285,404,45.85698070374574
Nagpur,Mosambi,2016,2456,2860,404,16.449511400651467
Nagpur,Papai,2015,473,877,404,85.41226215644821
Solapur,Papai,2015,363,767,404,111.29476584022039
Vai,Flower,2016,2248,2652,404,17.97153024911032
Nandgaon Khandeshwar,Green Gram,2016,4458,4862,404,9.062359802602064
Solapur,Sorgum(Jawar),2015,1537,1941,404,26.284970722186078
Manmad,Sorgum(Jawar),2016,1414,1818,404,28.571428571428573
Shegaon,Green Gram,2015,7084,7488,404,5.702992659514399
Barshi-Vairag,Gram,2015,3161,3565,404,12.780765580512496
Anajngaon Surji,Gram,2014,2423,2827,404,16.673545191910854
Mumbai,Carrot,2016,1000,1404,404,40.4
Pune,Wheat(Husked),2015,2163,2567,404,18.677762367082757
Jalgaon,Cucumber,2016,1435,1839,404,28.153310104529616
Murtizapur,Green Gram,2016,4526,4930,404,8.926204153778171
Nagpur,Mosambi,2016,1645,2049,404,24.559270516717326
Kurdwadi,Wheat(Husked),2015,1543,1947,404,26.182760855476346
Washim,Soybean,2016,2662,3066,404,15.17655897821187
Jalgaon,Squash Gourd,2015,721,1125,404,56.03328710124827
Ahmednagar,Sorgum(Jawar),2015,1604,2008,404,25.18703241895262
Sailu,Wheat(Husked),2015,1526,1930,404,26.474442988204455
Manmad,Onion,2016,149,552,403,270.4697986577181
Pandharpur,Cabbage,2016,319,722,403,126.33228840125392
Jalna,Gram,2016,4086,4489,403,9.862946647087616
Vai,Ginger (Fresh),2016,3007,3410,403,13.402061855670103
Lonand,Sorgum(Jawar),2014,1550,1953,403,26.0
Shirpur,Soybean,2015,3402,3805,403,11.845972957084069
Chandur Rly.,Soybean,2015,3381,3784,403,11.919550428867199
Kolhapur,Cabbage,2016,229,632,403,175.9825327510917
Hingoli,Pigeon Pea (Tur),2015,5083,5486,403,7.928388746803069
Murum,Gram,2015,3484,3887,403,11.567164179104477
Manora,Gram,2016,3879,4282,403,10.389275586491364
Patan,Tomato,2015,1119,1522,403,36.014298480786415
Sangali,Soybean,2014,3017,3420,403,13.35764003977461
Umared,Coriander (Dry),2016,7188,7591,403,5.606566499721758
Telhara,Pigeon Pea (Tur),2015,5313,5716,403,7.585168454733672
Dhamangaon-Rly,Gram,2015,4025,4428,403,10.012422360248447
Amalner,Sorgum(Jawar),2016,1511,1914,403,26.671078755790866
Nashik,Cabbage,2016,567,970,403,71.0758377425044
Gangapur,Wheat(Husked),2016,1538,1941,403,26.202860858257477
Nandura,Wheat(Husked),2015,1315,1718,403,30.64638783269962
Nandura,Soybean,2016,3504,3907,403,11.501141552511415
Ambad(Vadi Godri),Sorgum(Jawar),2016,1280,1683,403,31.484375
Nashik-Devlali,Coriander  ,2016,495,898,403,81.41414141414141
Varora,Cotton,2016,4203,4606,403,9.588389245776826
Pune-Manjri,Rajgira,2016,537,940,403,75.04655493482309
Mohol,Gram,2015,3300,3703,403,12.212121212121213
Aarni,Gram,2016,3838,4241,403,10.500260552371026
Rajura,Pigeon Pea (Tur),2015,5376,5779,403,7.496279761904762
Vani,Gram,2016,4768,5171,403,8.452181208053691
Malkapur,Gram,2016,3949,4352,403,10.205115219042796
Gevrai,Sorgum(Jawar),2016,1544,1947,403,26.10103626943005
Malegaon,Wheat(Husked),2016,1571,1973,402,25.58879694462126
Nandurbar,Sunflower,2014,2949,3351,402,13.631739572736521
Amarawati,Gram,2016,7714,8116,402,5.211304122374902
Pune,Wheat(Husked),2016,2123,2525,402,18.935468676401317
Dound,Wheat(Husked),2015,1549,1951,402,25.95222724338283
Mehkar,Sorgum(Jawar),2015,1025,1427,402,39.21951219512195
Nandurbar,Wheat(Husked),2016,1500,1902,402,26.8
Solapur,Gram,2015,4044,4446,402,9.940652818991097
Narkhed,Orange,2015,288,690,402,139.58333333333334
Kurdwadi-Modnimb,Maize,2016,1157,1559,402,34.74503025064823
Nandurbar,Bajri,2016,1383,1785,402,29.067245119305856
Amarawati,Green Gram,2016,4518,4920,402,8.897742363877821
Mandhal,Cotton,2016,4281,4683,402,9.390329362298528
Kolhapur,Strawberi,2016,774,1176,402,51.93798449612403
Mohol,Sorgum(Jawar),2016,1650,2052,402,24.363636363636363
Sangrampur-Varvatbakal,Wheat(Husked),2016,1467,1869,402,27.402862985685072
Rajura,Pigeon Pea (Tur),2015,5753,6155,402,6.987658612897619
Dound,Wheat(Husked),2016,1633,2035,402,24.617268830373547
Parbhani,Pigeon Pea (Tur),2016,7185,7587,402,5.5949895615866385
Loha,Wheat(Husked),2015,1417,1819,402,28.369795342272408
Sangrampur-Varvatbakal,Wheat(Husked),2016,1367,1768,401,29.334308705193855
Lonar,Pigeon Pea (Tur),2016,8524,8925,401,4.704364148287189
Washim,Wheat(Husked),2016,1501,1902,401,26.71552298467688
Baramati,Gram,2016,4051,4452,401,9.898790422117996
Gevrai,Pigeon Pea (Tur),2014,4259,4660,401,9.415355717304532
Arvi,Pigeon Pea (Tur),2016,8227,8628,401,4.8741947246870065
Amalner,Sorgum(Jawar),2016,1645,2046,401,24.376899696048632
Lonand,Bajri,2016,1381,1782,401,29.03692976104272
Manchar,Farshi,2016,2450,2851,401,16.367346938775512
Mauda,Coriander (Dry),2016,7000,7401,401,5.728571428571429
Satara,Bottle Gourd,2015,730,1131,401,54.93150684931507
Tasgaon,Gram,2015,4184,4585,401,9.584130019120458
Satana,Wheat(Husked),2015,1550,1951,401,25.870967741935484
Sinner,Green Gram,2015,7700,8101,401,5.207792207792208
Ulhasnagar,Potato,2016,1750,2151,401,22.914285714285715
Akola,Wheat(Husked),2015,1401,1802,401,28.622412562455388
Ausa,Soybean,2016,2903,3304,401,13.813296589734756
Indapur-Bhigwan,Ground Nut Pods (Dry),2015,3400,3801,401,11.794117647058824
Dhamangaon-Rly,Soybean,2016,3010,3411,401,13.322259136212624
Aurangabad,Onion,2016,166,567,401,241.56626506024097
Akola,Sorgum(Jawar),2016,1305,1706,401,30.727969348659006
Murtizapur,Safflower,2015,1800,2201,401,22.27777777777778
Mohol,Black Gram,2016,6473,6874,401,6.194963695349915
Dound,Sorgum(Jawar),2016,1744,2145,401,22.993119266055047
Ambad(Vadi Godri),Bajri,2016,1273,1674,401,31.500392772977218
Indapur-Bhigwan,Pigeon Pea (Tur),2015,3900,4301,401,10.282051282051283
Bhokar,Wheat(Husked),2015,1350,1751,401,29.703703703703702
Dharangaon,Black Gram,2016,6650,7051,401,6.030075187969925
Pathari,MAIZE,2016,4200,4601,401,9.547619047619047
Amarawati,Gram,2016,6557,6958,401,6.115601647094708
Nagpur,Green Gram,2015,6000,6400,400,6.666666666666667
Sangali,Castor Seed,2015,2800,3200,400,14.285714285714286
Mangrulpeer,Black Gram,2015,5317,5717,400,7.523039307880384
Aurangabad,Chikoo,2015,1600,2000,400,25.0
Ghansawangi,Sorgum(Jawar),2014,1100,1500,400,36.36363636363637
Ghansawangi,Tamarind,2016,1000,1400,400,40.0
Nagpur,Fenugreek,2016,1700,2100,400,23.529411764705884
Kille Dharur,Bajri,2015,1551,1951,400,25.789813023855576
Jalgaon Jamod-Aasalgaon,Green Gram,2016,4000,4400,400,10.0
Akole,Paddy-Unhusked,2014,1400,1800,400,28.571428571428573
Atpadi,Sorgum(Jawar),2016,1800,2200,400,22.22222222222222
Kille Dharur,Sesamum,2015,8800,9200,400,4.545454545454546
Aurangabad,Wheat(Husked),2016,1700,2100,400,23.529411764705884
Aurad Shahajani,Green Gram,2016,6600,7000,400,6.0606060606060606
Aurangabad,Sweet Potato,2015,1125,1525,400,35.55555555555556
Mohol,Wheat(Husked),2016,1755,2155,400,22.79202279202279
Sillod-Bharadi,Mustard,2016,3800,4200,400,10.526315789473685
Aurangabad,Carrot,2015,500,900,400,80.0
Ghansawangi,Gram,2015,4200,4600,400,9.523809523809524
Nagpur,Green Gram,2015,5200,5600,400,7.6923076923076925
Jalgaon Jamod-Aasalgaon,Sunflower,2015,2800,3200,400,14.285714285714286
Gevrai,Sorgum(Jawar),2016,1705,2105,400,23.46041055718475
Ghansawangi,Wheat(Husked),2015,1600,2000,400,25.0
Aurangabad,Sweet Potato,2014,1600,2000,400,25.0
Nagpur,Fenugreek,2016,2400,2800,400,16.666666666666668
Akole,Bajri,2015,1400,1800,400,28.571428571428573
Aurangabad,Ladies Finger,2015,930,1330,400,43.01075268817204
Akole,Bajri,2015,1400,1800,400,28.571428571428573
Nagpur,Green Gram,2015,5900,6300,400,6.779661016949152
Nagpur,Green Gram,2015,5978,6378,400,6.691201070592172
Jalgaon Jamod-Aasalgaon,Soybean,2016,3317,3717,400,12.059089538739824
Nandgaon Khandeshwar,Black Gram,2016,4000,4400,400,10.0
Aurangabad,Maize(Corn.),2016,300,700,400,133.33333333333334
Ghansawangi,Wheat(Husked),2015,1800,2200,400,22.22222222222222
Solapur,Coriander  ,2016,100,500,400,400.0
Rahata,Green Peas (Dry),2015,3567,3967,400,11.2139052425007
Aurad Shahajani,Pigeon Pea (Tur),2016,8800,9200,400,4.545454545454546
Aurangabad,Guava,2016,2100,2500,400,19.047619047619047
Akole,Wheat(Husked),2014,1500,1900,400,26.666666666666668
Nagpur,Mango(Raw),2015,1400,1800,400,28.571428571428573
Khed-Chakan,Onion,2016,314,714,400,127.38853503184713
Mehkar,Black Gram,2016,8500,8900,400,4.705882352941177
Ghansawangi,Pigeon Pea (Tur),2016,7575,7975,400,5.2805280528052805
Atpadi,Sorgum(Jawar),2016,1800,2200,400,22.22222222222222
Ghansawangi,Soybean,2015,4300,4700,400,9.30232558139535
Aurangabad,SWEET POTATO,2016,800,1200,400,50.0
Pandharpur,Ginger (Dry),2016,2600,3000,400,15.384615384615385
Solapur,Shepu,2016,100,500,400,400.0
Khed-Chakan,Potato,2016,929,1329,400,43.05705059203444
Lasalgaon-Vinchur,Wheat(Husked),2015,1460,1860,400,27.397260273972602
Anajngaon Surji,Sesamum,2015,5200,5600,400,7.6923076923076925
Atpadi,Sorgum(Jawar),2016,1750,2150,400,22.857142857142858
Mantha,Gram,2016,5350,5750,400,7.4766355140186915
Shrirampur,Carrot,2015,800,1200,400,50.0
Mantha,Soybean,2016,2700,3100,400,14.814814814814815
Manchar,Chavli (Shenga ),2015,2240,2640,400,17.857142857142858
Parshiwani,SOYBEAN,2016,2475,2875,400,16.161616161616163
Manchar,Beet Root,2016,600,1000,400,66.66666666666667
Mantha,Green Gram,2016,5000,5400,400,8.0
Sillod,Green Gram,2015,6800,7200,400,5.882352941176471
Mantha,Green Gram,2016,3733,4133,400,10.715242432360032
Sailu,Green Gram,2015,6400,6800,400,6.25
Atpadi,SORGUM(JAWAR),2016,2000,2400,400,20.0
Hingoli-Kanegaon Naka,Soybean,2016,2879,3279,400,13.893713094824593
Indapur,Gram,2014,2000,2400,400,20.0
Vaduj,Green Gram,2014,7000,7400,400,5.714285714285714
Naigaon,Gram,2014,2000,2400,400,20.0
Nagpur,Wal Bhaji,2016,800,1200,400,50.0
Nagpur,CORIANDER (DRY),2016,6600,7000,400,6.0606060606060606
Aarni,Soybean,2015,3000,3400,400,13.333333333333334
Vaduj,Ghevda Seed,2014,6000,6400,400,6.666666666666667
Hingoli,Green Gram,2016,6100,6500,400,6.557377049180328
Shrigonda,Bajri,2016,1600,2000,400,25.0
Amarawati,Melon,2016,800,1200,400,50.0
Jalgaon,Sweet Potato,2015,1150,1550,400,34.78260869565217
Kolhapur-Laxmipuri,Split Black Gram,2014,8600,9000,400,4.651162790697675
Hingna,Soybean,2015,2950,3350,400,13.559322033898304
Kolhapur-Laxmipuri,Split Gram,2014,4100,4500,400,9.75609756097561
Jalgaon,Cluster Bean,2016,3800,4200,400,10.526315789473685
Manchar,Beet Root,2015,1000,1400,400,40.0
Sillod,Mustard,2016,2800,3200,400,14.285714285714286
Kolhapur-Laxmipuri,Cowpea,2015,5500,5900,400,7.2727272727272725
Kolhapur-Laxmipuri,Cowpea,2015,4476,4876,400,8.936550491510276
Mauda,Paddy-Unhusked,2016,1800,2200,400,22.22222222222222
Nagpur,BLACK GRAM,2016,4000,4400,400,10.0
Jalgaon,Bitter Gourd,2016,2791,3191,400,14.331780723754926
Kolhapur-Laxmipuri,Gr.Nut Kernels,2016,8800,9200,400,4.545454545454546
Solapur,Mosambi,2016,100,500,400,400.0
Sillod,Castor Seed,2016,2800,3200,400,14.285714285714286
Amarawati,Soybean,2016,3138,3538,400,12.746972594008923
Shrigonda,BAJRI,2016,1083,1483,400,36.93444136657433
Sailu,Wheat(Husked),2015,1420,1820,400,28.169014084507044
Kopargaon,Pigeon Pea (Tur),2015,4251,4651,400,9.409550693954364
Mantha,Sorgum(Jawar),2015,1390,1790,400,28.776978417266186
Patan,Bitter Gourd,2014,2150,2550,400,18.6046511627907
Amarawati,Coriander  ,2015,2350,2750,400,17.02127659574468
Nagpur,Parwar,2016,1600,2000,400,25.0
Kurdwadi,Tamarind,2015,3600,4000,400,11.11111111111111
Amalner,Black Gram,2015,9300,9700,400,4.301075268817204
Ulhasnagar,Potato,2016,867,1267,400,46.1361014994233
Jalgaon,Wal Papdi,2014,1600,2000,400,25.0
Patan,Bitter Gourd,2016,1725,2125,400,23.18840579710145
Patan,Bitter Gourd,2016,1450,1850,400,27.586206896551722
Amarawati,Gram,2014,2488,2888,400,16.077170418006432
Indapur-Bhigwan,Bajri,2014,1350,1750,400,29.62962962962963
Nagpur,Paddy-Unhusked,2016,1900,2300,400,21.05263157894737
Amalner,Soybean,2016,3150,3550,400,12.698412698412698
Patan,Capsicum,2016,4000,4400,400,10.0
Jalgaon,Beet Root,2015,1200,1600,400,33.333333333333336
Shrirampur,Tomato,2016,1033,1433,400,38.72216844143272
Indapur-Bhigwan,Black Gram,2015,6650,7050,400,6.015037593984962
Patan,Flower,2016,1671,2071,400,23.937761819269898
Amalner,Gram,2016,5217,5617,400,7.667241709794902
Amarawati,Chikoo,2015,1100,1500,400,36.36363636363637
Manchar,Ladies Finger,2015,1900,2300,400,21.05263157894737
Ulhasnagar,Banana,2016,308,708,400,129.87012987012986
Amarawati,Coriander  ,2015,1933,2333,400,20.693222969477496
Koregaon,Black Gram,2015,5100,5500,400,7.8431372549019605
Shrirampur,Squash Gourd,2016,889,1289,400,44.99437570303712
Amarawati,Orange,2015,1275,1675,400,31.372549019607842
Jalgaon,Guava,2015,1300,1700,400,30.76923076923077
Koregaon,Gram,2015,4150,4550,400,9.63855421686747
Manchar,Tomato,2015,200,600,400,200.0
Washim,Gram,2016,4100,4500,400,9.75609756097561
Vadgaon Peth,Snake Gourd,2016,1000,1400,400,40.0
Raver,Gram,2015,3376,3776,400,11.848341232227488
Amarawati,Harbara(Pendi),2015,1400,1800,400,28.571428571428573
Manchar,Green Chilli,2015,2150,2550,400,18.6046511627907
Koregaon,Sorgum(Jawar),2016,1636,2036,400,24.449877750611247
Koregaon,Sorgum(Jawar),2016,1700,2100,400,23.529411764705884
Korpana,Pigeon Pea (Tur),2015,7000,7400,400,5.714285714285714
Aarni,Ground Nut Pods (Dry),2015,5000,5400,400,8.0
Patan,Flower,2015,850,1250,400,47.05882352941177
Indapur,Green Gram,2016,4175,4575,400,9.580838323353293
Kolhapur-Laxmipuri,Lentil,2014,6200,6600,400,6.451612903225806
Pune,Mango(Raw),2014,300,700,400,133.33333333333334
Kolhapur-Laxmipuri,Gram,2014,3400,3800,400,11.764705882352942
Rahata,Brinjal,2015,577,977,400,69.32409012131716
Ghoti,Bitter Gourd,2016,2840,3240,400,14.084507042253522
Arvi,Wheat(Husked),2015,1150,1550,400,34.78260869565217
Jalgaon Jamod,Sunflower,2015,2800,3200,400,14.285714285714286
Arvi,Soybean,2015,3000,3400,400,13.333333333333334
Arvi,Gram,2015,3100,3500,400,12.903225806451612
Kolhapur,Squash Gourd,2015,200,600,400,200.0
Ghoti,Capsicum,2016,1400,1800,400,28.571428571428573
Jalgaon Jamod,Pigeon Pea (Tur),2015,5800,6200,400,6.896551724137931
Ghoti,Flower,2016,2500,2900,400,16.0
Ratanagari,BOTTLE GOURD,2016,586,986,400,68.25938566552901
Ghoti,Ladies Finger,2016,1375,1775,400,29.09090909090909
Panvel,Bitter Gourd,2014,2850,3250,400,14.035087719298245
Jalgaon Jamod,Ground Nut Pods (Dry),2015,3750,4150,400,10.666666666666666
Achalpur,Wheat(Husked),2015,1400,1800,400,28.571428571428573
Armori-Desaiganj,Chillies(Red),2016,14433,14833,400,2.7714265918381487
Nagpur,Green Gram,2016,5000,5400,400,8.0
Pune-Manjri,Tomato,2016,900,1300,400,44.44444444444444
Ratanagari,Sweet Potato,2015,1600,2000,400,25.0
Jalgaon Jamod,Gram,2016,3800,4200,400,10.526315789473685
Panvel,Ridge Gourd,2014,3100,3500,400,12.903225806451612
Achalpur,Green Gram,2016,5250,5650,400,7.619047619047619
Atpadi,Sorgum(Jawar),2015,1700,2100,400,23.529411764705884
Jalgaon Jamod-Aasalgaon,Gram,2015,2800,3200,400,14.285714285714286
Atpadi,Sorgum(Jawar),2015,1700,2100,400,23.529411764705884
Atpadi,Sorgum(Jawar),2015,1700,2100,400,23.529411764705884
Atpadi,Sorgum(Jawar),2014,1700,2100,400,23.529411764705884
Atpadi,Sorgum(Jawar),2014,1700,2100,400,23.529411764705884
Ghatanji,Gram,2016,5000,5400,400,8.0
Atpadi,Sorgum(Jawar),2014,1700,2100,400,23.529411764705884
Atpadi,Bajri,2014,1500,1900,400,26.666666666666668
Ashti-Karanja,Pigeon Pea (Tur),2015,6700,7100,400,5.970149253731344
Ashti-Karanja,Soybean,2014,2850,3250,400,14.035087719298245
Akole,Soybean,2015,3000,3400,400,13.333333333333334
Jalgaon Jamod,Soybean,2016,3000,3400,400,13.333333333333334
Vadgaon Peth,Bottle Gourd,2015,300,700,400,133.33333333333334
Jalgaon Jamod,Pigeon Pea (Tur),2016,8000,8400,400,5.0
Nagpur,Papai,2015,515,915,400,77.66990291262135
Nagpur,Parwar,2015,840,1240,400,47.61904761904762
Sillod-Bharadi,Green Gram,2016,4525,4925,400,8.839779005524862
Pune,Sorgum(Jawar),2015,2336,2736,400,17.123287671232877
Kolhapur-Laxmipuri,Gr.Nut Kernels,2014,6400,6800,400,6.25
Panvel,Ghevda,2016,2838,3238,400,14.094432699083862
Panvel,Ghosali(Bhaji),2016,2833,3233,400,14.119308153900459
Panvel,Snake Gourd,2016,2800,3200,400,14.285714285714286
Panvel,Snake Gourd,2016,2785,3185,400,14.362657091561939
Anajngaon Surji,Green Gram,2014,6850,7250,400,5.839416058394161
Hadgaon-Tamsa,COTTON,2016,4600,5000,400,8.695652173913043
Kolhapur,Guava,2016,400,800,400,100.0
Paranda,Onion,2016,150,550,400,266.6666666666667
Hadgaon-Tamsa,Soybean,2016,3500,3900,400,11.428571428571429
Washim,Green Gram,2015,6650,7050,400,6.015037593984962
Nagpur,Ginger (Dry),2016,2250,2650,400,17.77777777777778
Jalgaon,Guava,2016,500,900,400,80.0
Ratanagari,SWEET POTATO,2016,1350,1750,400,29.62962962962963
Vadgaon Peth,Carrot,2015,667,1067,400,59.97001499250375
Sillod,Safflower,2016,2000,2400,400,20.0
Sailu,Wheat(Husked),2016,1600,2000,400,25.0
Pathardi,Black Gram,2016,6167,6567,400,6.486135884546782
Kolhapur-Laxmipuri,Cowpea,2014,4600,5000,400,8.695652173913043
Manchar,Bottle Gourd,2014,200,600,400,200.0
Nagpur,Ladies Finger,2016,1136,1536,400,35.2112676056338
Jalgaon Jamod,Pigeon Pea (Tur),2014,4200,4600,400,9.523809523809524
Panvel,Flower,2016,2775,3175,400,14.414414414414415
Anajngaon Surji,Wheat(Husked),2016,1431,1831,400,27.95248078266946
Pune-Manjri,Cabbage,2015,570,970,400,70.17543859649123
Panvel,Ridge Gourd,2015,3000,3400,400,13.333333333333334
Jalgaon,Sweet Potato,2016,1200,1600,400,33.333333333333336
Nagpur,Raddish,2015,740,1140,400,54.054054054054056
Nagpur,Raddish,2015,824,1224,400,48.54368932038835
Gondpimpri,Gram,2016,3800,4200,400,10.526315789473685
Panvel,Bitter Gourd,2016,5433,5833,400,7.362414872078042
Panvel,Carrot,2016,2750,3150,400,14.545454545454545
Panvel,Carrot,2016,2000,2400,400,20.0
Hadgaon,Gram,2015,3850,4250,400,10.38961038961039
Morshi,Black Gram,2016,6000,6400,400,6.666666666666667
Panvel,Coriander  ,2016,1200,1600,400,33.333333333333336
Hadgaon,Sorgum(Jawar),2015,1100,1500,400,36.36363636363637
Panvel,Cucumber,2016,2467,2867,400,16.214025131738953
Akole,Bajri,2016,1433,1833,400,27.91346824842987
Nagpur,Sorgum(Jawar),2015,1600,2000,400,25.0
Khed (Shel Pimpalgaon),Flower,2016,1125,1525,400,35.55555555555556
Jamkhed,Wheat(Husked),2015,1872,2272,400,21.367521367521366
Ausa,Jaggery,2014,2201,2601,400,18.173557473875512
Mumbai,Onion,2015,1300,1700,400,30.76923076923077
Pune,Potato,2016,1550,1950,400,25.806451612903224
Kalyan,Squash Gourd,2016,2250,2650,400,17.77777777777778
Kalyan,Wheat(Husked),2016,2400,2800,400,16.666666666666668
Nagpur,Jambhul,2016,2000,2400,400,20.0
Buldhana-Dhad,Sorgum(Jawar),2016,1200,1600,400,33.333333333333336
Buldhana-Dhad,Sorgum(Jawar),2016,1200,1600,400,33.333333333333336
Buldhana-Dhad,SORGUM(JAWAR),2016,1200,1600,400,33.333333333333336
Buldhana-Dhad,Green Gram,2016,4300,4700,400,9.30232558139535
Yawal,Wheat(Husked),2016,1488,1888,400,26.881720430107528
Yawal,Wheat(Husked),2016,1400,1800,400,28.571428571428573
Akhadabalapur,Pigeon Pea (Tur),2015,5900,6300,400,6.779661016949152
Kamthi,Sugarcane,2014,600,1000,400,66.66666666666667
Lonand,Wheat(Husked),2014,1400,1800,400,28.571428571428573
Dhule,Wheat(Husked),2015,1511,1911,400,26.472534745201852
Narkhed,ORANGE,2016,1540,1940,400,25.974025974025974
Narkhed,GROUND NUT PODS (DRY),2016,4150,4550,400,9.63855421686747
Kamthi,Bottle Gourd,2015,454,854,400,88.10572687224669
Navapur,Gram,2016,5800,6200,400,6.896551724137931
Murtizapur,Pigeon Pea (Tur),2015,7024,7424,400,5.694760820045558
Yawal,Soybean,2016,3200,3600,400,12.5
Lonand,Wheat(Husked),2015,1463,1863,400,27.34107997265892
Kalyan,Carrot,2016,1385,1785,400,28.880866425992778
Mumbai-Fruit Market,Naspatti ,2016,900,1300,400,44.44444444444444
Vadgaon Peth,CABBAGE,2016,511,911,400,78.27788649706459
Kalyan,Cow,2016,1800,2200,400,22.22222222222222
Kalyan,Cucumber,2016,1733,2133,400,23.08136180034622
Kalyan,Elephant Root,2016,3512,3912,400,11.389521640091116
Pune-Pimpri,Green Chilli,2014,2788,3188,400,14.347202295552368
Yawal,Cotton,2016,4500,4900,400,8.88888888888889
Umarga,Mustard,2015,3800,4200,400,10.526315789473685
Chandrapur,Ginger (Fresh),2015,2800,3200,400,14.285714285714286
Chandrapur,Bitter Gourd,2015,800,1200,400,50.0
Chalisgaon,Tomato,2016,800,1200,400,50.0
Chalisgaon,Soybean,2016,3000,3400,400,13.333333333333334
Sinner,Black Gram,2014,3900,4300,400,10.256410256410257
Yawal,WHEAT(HUSKED),2016,1400,1800,400,28.571428571428573
Kalyan,Math (Bhaji),2016,800,1200,400,50.0
Chalisgaon,Castor Seed,2016,3000,3400,400,13.333333333333334
Kamthi,Cabbage,2015,571,971,400,70.05253940455341
Kamthi,Cabbage,2015,587,987,400,68.14310051107326
Bhusaval,Gram,2016,4730,5130,400,8.456659619450317
Bhusaval,BLACK GRAM,2016,5333,5733,400,7.500468779298706
Mahagaon,Ground Nut Pods (Dry),2016,4200,4600,400,9.523809523809524
Sillod-Bharadi,Soybean,2016,3200,3600,400,12.5
Kamthi,Spinach,2015,494,894,400,80.97165991902834
Bhokar,Sorgum(Jawar),2015,1200,1600,400,33.333333333333336
Junnar-Otur,Potato,2015,557,957,400,71.8132854578097
Junnar-Otur,Potato,2015,767,1167,400,52.15123859191656
Malegaon,Maize,2015,1028,1428,400,38.91050583657587
Pune-Pimpri,Potato,2016,1400,1800,400,28.571428571428573
Sindkhed Raja,Soybean,2016,2700,3100,400,14.814814814814815
Pune-Pimpri,Carrot,2014,2800,3200,400,14.285714285714286
Junnar-Otur,Ladies Finger,2015,100,500,400,400.0
Junnar-Otur,Potato,2014,1320,1720,400,30.303030303030305
Nira-Saswad,Pigeon Pea (Tur),2016,5733,6133,400,6.977149834292692
Taloda,Sorgum(Jawar),2014,1400,1800,400,28.571428571428573
Pune,Tomato,2016,300,700,400,133.33333333333334
Junnar (Narayangaon),MATH (BHAJI),2016,101,501,400,396.03960396039605
Junnar (Narayangaon),Flower,2016,1000,1400,400,40.0
Yawal,Wheat(Husked),2016,1400,1800,400,28.571428571428573
Jalgaon,Chavli (Shenga ),2014,3650,4050,400,10.95890410958904
Kamthi,Potato,2015,629,1029,400,63.59300476947536
Bhokardan-Pimpalgaon Renu,Gram,2016,4667,5067,400,8.570816370259267
Dhule,Bottle Gourd,2016,800,1200,400,50.0
Kamthi,Chavli (Pala),2015,614,1014,400,65.14657980456026
Dhule,Cucumber,2016,1000,1400,400,40.0
Satara,Potato,2015,589,989,400,67.91171477079796
Newasa,Gram,2016,4383,4783,400,9.126169290440338
Mumbai-Fruit Market,KHARBUJ,2016,1600,2000,400,25.0
Newasa,Gram,2016,3625,4025,400,11.03448275862069
Akhadabalapur,Pigeon Pea (Tur),2016,8000,8400,400,5.0
Shrirampur,Papai,2015,992,1392,400,40.32258064516129
Kamthi,Jack Fruit,2015,600,1000,400,66.66666666666667
Bhokardan,Green Gram,2015,6625,7025,400,6.037735849056604
Kamthi,Orange,2015,317,717,400,126.18296529968454
Junnar-Otur,Ladies Finger,2016,600,1000,400,66.66666666666667
Tasgaon,Gram,2016,5400,5800,400,7.407407407407407
Vai,Ladies Finger,2015,1667,2067,400,23.995200959808038
Mahagaon,Wheat(Husked),2015,1300,1700,400,30.76923076923077
Kalyan,Capsicum,2016,1267,1667,400,31.570639305445937
Chandrapur,AWALA,2016,1800,2200,400,22.22222222222222
Kada (Ashti),Wheat(Husked),2014,1700,2100,400,23.529411764705884
Chandrapur-Ganjwad,Ladies Finger,2015,1200,1600,400,33.333333333333336
Chandrapur-Ganjwad,Carrot,2016,800,1200,400,50.0
Lonar,Bajri,2016,1500,1900,400,26.666666666666668
Mumbai,Bottle Gourd,2016,1350,1750,400,29.62962962962963
Chandrapur-Ganjwad,Carrot,2016,400,800,400,100.0
Kalyan,Bor,2015,800,1200,400,50.0
Chandrapur-Ganjwad,CUCUMBER,2016,600,1000,400,66.66666666666667
Mumbai,Arvi,2016,1273,1673,400,31.421838177533385
Kalyan,Carrot,2015,1850,2250,400,21.62162162162162
Ahmednagar,Maize(Corn.),2016,500,900,400,80.0
Chandrapur-Ganjwad,Tomato,2015,400,800,400,100.0
Chandrapur-Ganjwad,Sweet Potato,2015,700,1100,400,57.142857142857146
Kalyan,Flower,2015,800,1200,400,50.0
Chandrapur-Ganjwad,Pumpkin,2015,600,1000,400,66.66666666666667
Chandrapur-Ganjwad,Pumpkin,2015,400,800,400,100.0
Chandrapur-Ganjwad,Potato,2015,500,900,400,80.0
Kalyan,Ghevda,2015,3200,3600,400,12.5
Chandrapur-Ganjwad,Onion,2015,1200,1600,400,33.333333333333336
Chandrapur-Ganjwad,Cucumber,2016,800,1200,400,50.0
Chandrapur-Ganjwad,Cucumber,2016,833,1233,400,48.019207683073226
Kalyan,Bajri,2015,2000,2400,400,20.0
Kalyan,Bitter Gourd,2014,3200,3600,400,12.5
Chandrapur-Ganjwad,Spinach,2016,600,1000,400,66.66666666666667
Chandrapur-Ganjwad,Spinach,2016,600,1000,400,66.66666666666667
Chandrapur-Ganjwad,Small Gourd,2016,1000,1400,400,40.0
Chandrapur-Ganjwad,Small Gourd,2016,600,1000,400,66.66666666666667
Chandrapur-Ganjwad,Small Gourd,2016,600,1000,400,66.66666666666667
Mumbai,Carrot,2016,1000,1400,400,40.0
Chandrapur-Ganjwad,SQUASH GOURD,2016,800,1200,400,50.0
Chandrapur-Ganjwad,Raddish,2016,600,1000,400,66.66666666666667
Lonar,Black Gram,2016,6700,7100,400,5.970149253731344
Chandrapur-Ganjwad,Pumpkin,2016,600,1000,400,66.66666666666667
Chandrapur-Ganjwad,Potato,2016,1055,1455,400,37.91469194312796
Chandrapur-Ganjwad,Math (Bhaji),2016,800,1200,400,50.0
Chandrapur-Ganjwad,Math (Bhaji),2016,1600,2000,400,25.0
Kalyan,Ladies Finger,2014,1400,1800,400,28.571428571428573
Kalyan,Papai,2014,800,1200,400,50.0
Kalamb (Os),Black Gram,2016,6300,6700,400,6.349206349206349
Kalyan,Gram,2015,5200,5600,400,7.6923076923076925
Chandrapur-Ganjwad,Ladies Finger,2015,1000,1400,400,40.0
Murbad,Tomato,2016,1233,1633,400,32.441200324412
Kalyan,Green Gram,2015,9000,9400,400,4.444444444444445
Kalyan,Wheat(Husked),2015,2400,2800,400,16.666666666666668
Kalyan,Wheat(Husked),2015,1867,2267,400,21.424745581146222
Shrirampur,Tomato,2015,1071,1471,400,37.34827264239029
Kada (Ashti),Gram,2016,5000,5400,400,8.0
Vai,Shepu,2016,1000,1400,400,40.0
Chandrapur,Small Gourd,2016,800,1200,400,50.0
Chandrapur,Potato,2016,1400,1800,400,28.571428571428573
Chandrapur,Potato,2016,800,1200,400,50.0
Kada (Ashti),Tamarind Seed,2015,1000,1400,400,40.0
Kalyan,Banana,2016,867,1267,400,46.1361014994233
Kalyan,Brinjal,2016,2417,2817,400,16.54944145635085
Mumbai-Fruit Market,Naspatti ,2016,1400,1800,400,28.571428571428573
Kalyan,Brinjal,2016,3450,3850,400,11.594202898550725
Kada (Ashti),Pigeon Pea (Tur),2015,5000,5400,400,8.0
Chandrapur,Carrot,2016,200,600,400,200.0
Chandrapur,Cabbage,2016,200,600,400,200.0
Murbad,Tomato,2016,2967,3367,400,13.481631277384563
Umarkhed,Gram,2015,3143,3543,400,12.726694241170856
Chandrapur-Ganjwad,Chavli (Pala),2014,800,1200,400,50.0
Ramtek,Soybean,2015,3133,3533,400,12.767315671879988
Yawal,Gram,2016,4600,5000,400,8.695652173913043
Chandrapur-Ganjwad,Dhemse,2015,1400,1800,400,28.571428571428573
Kalyan,Green-Peas,2015,3200,3600,400,12.5
Chandrapur-Ganjwad,Chavli (Shenga ),2015,1133,1533,400,35.3045013239188
Kalamb (Os),Coriander (Dry),2015,9903,10303,400,4.0391800464505705
Umarkhed,Gram,2014,2700,3100,400,14.814814814814815
Kalyan,Jaggery,2015,3200,3600,400,12.5
Yawal,Gram,2016,4000,4400,400,10.0
Kalyan,Ladies Finger,2015,2100,2500,400,19.047619047619047
Chandrapur-Ganjwad,Cluster Bean,2014,1400,1800,400,28.571428571428573
Mumbai,Split Lentil,2015,6955,7355,400,5.7512580877066855
Mumbai,Split Lentil,2015,6883,7283,400,5.8114194391980245
Chandrapur-Ganjwad,Brinjal,2015,400,800,400,100.0
Chandrapur-Ganjwad,Bitter Gourd,2015,1200,1600,400,33.333333333333336
Kalyan,Ridge Gourd,2015,3400,3800,400,11.764705882352942
Phaltan,Cucumber,2016,800,1200,400,50.0
Kalyan,Tomato,2015,2400,2800,400,16.666666666666668
Ahmedpur,Ground Nut Pods (Dry),2014,3160,3560,400,12.658227848101266
Chandur Bajar,Wheat(Husked),2014,1400,1800,400,28.571428571428573
Mumbai,Ground Nut Pods (Dry),2016,4000,4400,400,10.0
Khamgaon,Mustard,2015,2950,3350,400,13.559322033898304
Mumbai,Ridge Gourd,2016,4000,4400,400,10.0
Mumbai,Ridge Gourd,2016,3200,3600,400,12.5
Rahata,Flower,2016,300,700,400,133.33333333333334
Rahata,Flower,2016,900,1300,400,44.44444444444444
Pune,CABBAGE,2016,296,696,400,135.13513513513513
Mumbai,Melon,2014,1350,1750,400,29.62962962962963
Jamkhed,Black Gram,2015,5000,5400,400,8.0
Mumbai,Squash Gourd,2016,957,1357,400,41.797283176593524
Solapur,Goosefoot,2016,500,900,400,80.0
Mumbai,Horse Gram,2014,3575,3975,400,11.188811188811188
Akluj,Shepu,2016,550,950,400,72.72727272727273
Sonpeth,Soybean,2015,3500,3900,400,11.428571428571429
Akluj,Skin & Bones,2016,300,700,400,133.33333333333334
Jamkhed,Soybean,2014,2880,3280,400,13.88888888888889
Mahur,Gram,2016,4600,5000,400,8.695652173913043
Nagpur,Coriander (Dry),2016,7100,7500,400,5.633802816901408
Baramati,Bajri,2016,1556,1956,400,25.70694087403599
Akluj,Cabbage,2016,344,744,400,116.27906976744185
Rahata,LADIES FINGER,2016,2600,3000,400,15.384615384615385
Solapur,Goosefoot,2016,400,800,400,100.0
Nagpur,Papai,2014,675,1075,400,59.25925925925926
Barshi,Shepu,2015,500,900,400,80.0
Umarkhed-Danki,Soybean,2015,3000,3400,400,13.333333333333334
Umarkhed-Danki,Soybean,2015,3000,3400,400,13.333333333333334
Mumbai,Beet Root,2015,900,1300,400,44.44444444444444
Karmala,Green Gram,2015,6250,6650,400,6.4
Barshi,Methi (Bhaji),2015,500,900,400,80.0
Patur,Green Gram,2016,4000,4400,400,10.0
Nagpur,Papai,2014,640,1040,400,62.5
Jamkhed,Wheat(Husked),2015,1856,2256,400,21.551724137931036
Ramtek,WAL BHAJI,2016,1000,1400,400,40.0
Dound,Lemon,2016,500,900,400,80.0
Karmala,Wheat(Husked),2016,1750,2150,400,22.857142857142858
Jamkhed,Wheat(Husked),2016,1750,2150,400,22.857142857142858
Rahata,Lemon,2016,2850,3250,400,14.035087719298245
Nagpur,Awala,2015,600,1000,400,66.66666666666667
Chopda,Green Gram,2016,6000,6400,400,6.666666666666667
Baramati,Jaggery,2015,2068,2468,400,19.342359767891683
Jalna-Badnapur,Pigeon Pea (Tur),2016,7100,7500,400,5.633802816901408
Kamthi,ORANGE,2016,400,800,400,100.0
Jalgaon,Papai,2014,1450,1850,400,27.586206896551722
Mumbai,Cabbage,2014,824,1224,400,48.54368932038835
Vadgaon Peth,CUCUMBER,2016,762,1162,400,52.493438320209975
Khamgaon,Sesamum,2016,6600,7000,400,6.0606060606060606
Mumbai,Arvi,2014,2591,2991,400,15.438054805094557
Tumsar,Gram,2014,2168,2568,400,18.45018450184502
Khed,Bottle Gourd,2016,600,1000,400,66.66666666666667
Nagpur,DHEMSE,2016,1517,1917,400,26.367831245880026
Khed (Shel Pimpalgaon),Coriander  ,2014,301,701,400,132.89036544850498
Pandharkawada,Soybean,2015,3200,3600,400,12.5
Lasur Station,Safflower,2015,2000,2400,400,20.0
Ausa,Tamarind,2015,4437,4837,400,9.015100292990759
Sangali,Gram,2016,4150,4550,400,9.63855421686747
Umared,Sorgum(Jawar),2015,1522,1922,400,26.281208935611037
Pandharpur,Cabbage,2014,543,943,400,73.66482504604052
Gangapur,Wheat(Husked),2015,1406,1806,400,28.44950213371266
Sangali,Bajri,2016,1543,1943,400,25.92352559948153
Purna,Wheat(Husked),2015,1504,1904,400,26.595744680851062
Nagpur,Cucumber,2016,1188,1588,400,33.67003367003367
Palus,Cucumber,2016,800,1200,400,50.0
Palus,Cucumber,2016,1325,1725,400,30.18867924528302
Balapur,Wheat(Husked),2015,1375,1775,400,29.09090909090909
Balapur,Soybean,2016,3363,3763,400,11.894142134998512
Balapur,Sorgum(Jawar),2016,1150,1550,400,34.78260869565217
Balapur,Sorgum(Jawar),2016,1250,1650,400,32.0
Pune,Arvi,2014,1800,2200,400,22.22222222222222
Patur,Gram,2014,2000,2400,400,20.0
Palus,Bottle Gourd,2016,783,1183,400,51.08556832694764
Balapur,Gram,2016,7900,8300,400,5.063291139240507
Balapur,Wheat(Husked),2015,1400,1800,400,28.571428571428573
Palus,Capsicum,2016,1200,1600,400,33.333333333333336
Balapur,Wheat(Husked),2015,1400,1800,400,28.571428571428573
Indapur-Bhigwan,Sesamum,2015,7100,7500,400,5.633802816901408
Mumbai,Snake Gourd,2016,2236,2636,400,17.88908765652952
Mumbai,Capsicum,2014,3368,3768,400,11.876484560570072
Umarkhed-Danki,Pigeon Pea (Tur),2016,8100,8500,400,4.938271604938271
Sangali,Green Peas (Dry),2016,3000,3400,400,13.333333333333334
Balapur,Soybean,2015,3088,3488,400,12.953367875647668
Barshi,Shepu,2015,400,800,400,100.0
Barshi,Shepu,2015,400,800,400,100.0
Dound,Ground Nut Pods (Dry),2015,2000,2400,400,20.0
Karad,Cluster Bean,2015,2150,2550,400,18.6046511627907
Akkolkot,Pigeon Pea (Tur),2016,8700,9100,400,4.597701149425287
Shahada,Matki,2015,6399,6799,400,6.250976715111737
Beed,Black Gram,2016,5073,5473,400,7.884880741178789
Dindori-Vani,Onion,2016,581,981,400,68.84681583476764
Tasgaon,Wheat(Husked),2016,1750,2150,400,22.857142857142858
Kannad,Ginger (Fresh),2016,1300,1700,400,30.76923076923077
Rahuri,Carrot,2015,1900,2300,400,21.05263157894737
Pune-Pimpri,Squash Gourd,2016,2185,2585,400,18.30663615560641
Tuljapur,BLACK GRAM,2016,5300,5700,400,7.547169811320755
Osmanabad,Soybean,2015,3100,3500,400,12.903225806451612
Osmanabad,Beet Root,2016,800,1200,400,50.0
Akluj,Coriander  ,2014,600,1000,400,66.66666666666667
Karad,Sweet Potato,2014,950,1350,400,42.10526315789474
Shahapur,Bitter Gourd,2014,2088,2488,400,19.157088122605366
Umarkhed-Danki,Ground Nut Pods (Dry),2014,3600,4000,400,11.11111111111111
Shahapur,Chavli (Shenga ),2014,2500,2900,400,16.0
Vasai,Onion,2014,1800,2200,400,22.22222222222222
Mumbai,Ground Nut Pods (Dry),2015,4200,4600,400,9.523809523809524
Beed,SOYBEAN,2016,2400,2800,400,16.666666666666668
Murum,Wheat(Unhusked),2014,2800,3200,400,14.285714285714286
Pune,Beet Root,2015,543,943,400,73.66482504604052
Solapur,Shepu,2015,200,600,400,200.0
Solapur,Shepu,2015,300,700,400,133.33333333333334
Kamthi,Papai,2016,800,1200,400,50.0
Bhivandi,Onion,2015,1400,1800,400,28.571428571428573
Junnar (Alephata),Potato,2015,700,1100,400,57.142857142857146
Pune-Pimpri,Bottle Gourd,2014,1221,1621,400,32.76003276003276
Kamthi,Pumpkin,2016,800,1200,400,50.0
Sindkhed Raja,Gram,2016,4000,4400,400,10.0
Mumbai,Horse Gram,2015,3100,3500,400,12.903225806451612
Loha,Gram,2014,2100,2500,400,19.047619047619047
Akkolkot,Sorgum(Jawar),2015,1800,2200,400,22.22222222222222
Bhandara,Soybean,2015,2700,3100,400,14.814814814814815
Junnar,Potato,2015,800,1200,400,50.0
Junnar,Potato,2015,500,900,400,80.0
Mumbai,Horse Gram,2015,3050,3450,400,13.114754098360656
Mumbai,Horse Gram,2015,3200,3600,400,12.5
Manchar,Mango(Raw),2016,2800,3200,400,14.285714285714286
Vasai,Paddy-Unhusked,2014,1413,1813,400,28.308563340410473
Osmanabad,Chikoo,2016,1100,1500,400,36.36363636363637
Sangamner,Gram,2015,3650,4050,400,10.95890410958904
Umarkhed-Danki,Gram,2015,3000,3400,400,13.333333333333334
Karad,SQUASH GOURD,2016,1108,1508,400,36.101083032490976
Ralegaon,Pigeon Pea (Tur),2016,7600,8000,400,5.2631578947368425
Umarkhed-Danki,Gram,2015,3900,4300,400,10.256410256410257
Mumbai-Fruit Market,Banana,2016,1250,1650,400,32.0
Ramtek,Kharbuj,2016,1350,1750,400,29.62962962962963
Nandurbar,Sorgum(Jawar),2014,1155,1555,400,34.63203463203463
Barshi,Bottle Gourd,2016,100,500,400,400.0
Akluj,Potato,2015,594,994,400,67.34006734006734
Daryapur,Black Gram,2016,7500,7900,400,5.333333333333333
Mumbai,Cabbage,2015,1108,1508,400,36.101083032490976
Patur,Pigeon Pea (Tur),2016,5475,5875,400,7.30593607305936
Akluj,Water Melon,2015,250,650,400,160.0
Phaltan,Wheat(Husked),2016,1733,2133,400,23.08136180034622
Mumbai,Bottle Gourd,2015,974,1374,400,41.06776180698152
Nagpur,Fenugreek,2014,2400,2800,400,16.666666666666668
Osmanabad,Squash Gourd,2016,800,1200,400,50.0
Karad,Green Chilli,2015,850,1250,400,47.05882352941177
Sangamner,Cotton,2015,4100,4500,400,9.75609756097561
Barshi,FLOWER,2016,900,1300,400,44.44444444444444
Karad,Banana,2016,873,1273,400,45.81901489117984
Umarga,Paddy-Unhusked,2014,800,1200,400,50.0
Shahapur,Brinjal,2015,1627,2027,400,24.585125998770742
Shahapur,Brinjal,2015,1000,1400,400,40.0
Dondaicha,Green Gram,2016,6000,6400,400,6.666666666666667
Karad,Sweet Potato,2015,300,700,400,133.33333333333334
Barshi,SHEPU,2016,200,600,400,200.0
Ramtek,Gram,2016,5787,6187,400,6.912044237083117
Shahapur,Cucumber,2015,886,1286,400,45.146726862302486
Umarkhed-Danki,Gram,2015,3133,3533,400,12.767315671879988
Akluj,Carrot,2015,553,953,400,72.33273056057867
Karad,Carrot,2016,1350,1750,400,29.62962962962963
Karad,Cucumber,2016,1046,1446,400,38.24091778202677
Barshi,Methi (Bhaji),2016,400,800,400,100.0
Shahapur,Ridge Gourd,2015,3183,3583,400,12.566760917373546
Ahmednagar,Bottle Gourd,2015,800,1200,400,50.0
Manmad,HORSE GRAM,2016,4001,4400,399,9.972506873281679
Majalgaon,Pigeon Pea (Tur),2014,3983,4382,399,10.017574692442881
Satana,Sorgum(Jawar),2014,1951,2350,399,20.45105074320861
Kalmeshwar,Gram,2016,3930,4329,399,10.15267175572519
Sinner,Bajri,2015,1159,1558,399,34.42622950819672
Loha,Green Gram,2015,6742,7141,399,5.918125185404924
Bhivandi,Wheat(Husked),2016,1929,2328,399,20.684292379471227
Ausa,Gram,2015,4140,4539,399,9.63768115942029
Khed-Chakan,Onion,2016,483,882,399,82.6086956521739
Rahata,Gram,2015,3810,4209,399,10.472440944881889
Lasur Station,GREEN GRAM,2016,4179,4578,399,9.547738693467336
Malkapur,Soybean,2015,2979,3378,399,13.39375629405841
Malkapur,Wheat(Husked),2015,1340,1739,399,29.776119402985074
Barshi,Pigeon Pea (Tur),2014,3942,4341,399,10.121765601217657
Akole,Paddy-Unhusked,2015,936,1335,399,42.62820512820513
Karanja,Wheat(Husked),2015,1347,1746,399,29.621380846325167
Anajngaon Surji,Wheat(Husked),2016,1439,1838,399,27.727588603196665
Tumsar,Black Gram,2016,9668,10067,399,4.127016963177493
Malkapur,Wheat(Husked),2016,1602,2001,399,24.906367041198504
Nashik,Bitter Gourd,2016,591,990,399,67.51269035532995
Indapur-Bhigwan,Wheat(Husked),2016,1676,2075,399,23.80668257756563
Nashik-Devlali,Spinach,2016,913,1312,399,43.70208105147864
Washim,Gram,2015,3986,4385,399,10.010035122930256
Mangrulpeer,Pigeon Pea (Tur),2016,8485,8884,399,4.702416028285209
Shirpur,Wheat(Husked),2016,1443,1842,399,27.65072765072765
Nashik-Devlali,Shepu,2016,303,702,399,131.68316831683168
Achalpur,Pigeon Pea (Tur),2014,4725,5124,399,8.444444444444445
Buldhana,Wheat(Husked),2015,1091,1490,399,36.57195233730523
Bhokar,Pigeon Pea (Tur),2016,5994,6393,399,6.656656656656657
Manwat,GREEN GRAM,2016,4386,4785,399,9.097127222982216
Murtizapur,Gram,2015,3190,3589,399,12.507836990595612
Murtizapur,Pigeon Pea (Tur),2014,4572,4970,398,8.705161854768154
Mumbai,Green Chilli,2016,4492,4890,398,8.860195903829029
Nagpur,Onion,2016,556,954,398,71.58273381294964
Nandura,Soybean,2015,2940,3338,398,13.537414965986395
Nandurbar,Bajri,2015,1026,1424,398,38.79142300194932
Telhara,Gram,2015,4240,4638,398,9.38679245283019
Nashik,Flower,2016,511,909,398,77.88649706457926
Solapur,Gram,2016,5022,5420,398,7.925129430505774
Pune,Sorgum(Jawar),2014,2669,3067,398,14.911952041963282
Lasur Station,Black Gram,2016,6478,6876,398,6.143871565297932
Kille Dharur,Sorgum(Jawar),2014,1509,1907,398,26.37508283631544
Lasalgaon,Onion,2016,436,834,398,91.28440366972477
Lasalgaon,Wheat(Husked),2015,1544,1942,398,25.77720207253886
Anajngaon Surji,Green Gram,2016,4000,4398,398,9.95
Jalna,Neem-Seed,2016,667,1065,398,59.67016491754123
Latur,Sorgum(Jawar),2016,1564,1962,398,25.44757033248082
Dudhani,PIGEON PEA (TUR),2016,5506,5904,398,7.228478023973847
Dound,Sorgum(Jawar),2016,1844,2242,398,21.58351409978308
Jalgaon,Tomato,2014,900,1298,398,44.22222222222222
Kille Dharur,Bajri,2016,1517,1915,398,26.235992089650626
Baramati,Bajri,2014,1456,1854,398,27.335164835164836
Kille Dharur,Wheat(Husked),2014,1435,1833,398,27.735191637630663
Dound,Gram,2015,4129,4527,398,9.639137805764108
Dindori-Vani,ONION,2016,620,1018,398,64.19354838709677
Rajura,Soybean,2014,2804,3202,398,14.19400855920114
Umarga,Soybean,2014,2778,3176,398,14.326853851691865
Sindi,Gram,2015,3073,3471,398,12.951513179303612
Morshi,Gram,2016,6020,6417,397,6.59468438538206
Chikhali,Sorgum(Jawar),2016,1300,1697,397,30.53846153846154
Karanja,Gram,2015,3111,3508,397,12.761170041787206
Nagpur,Wheat(Husked),2015,1659,2056,397,23.930078360458108
Aarni,Gram,2016,5133,5530,397,7.734268458990844
Pandharkawada,Pigeon Pea (Tur),2016,8277,8674,397,4.796423825057388
Pusad,Sesamum,2016,5513,5910,397,7.20116089243606
Chakur,Pigeon Pea (Tur),2016,7816,8213,397,5.079324462640737
Karanja,SORGUM(JAWAR),2016,1391,1788,397,28.54061826024443
Katol,Orange,2016,703,1100,397,56.47226173541963
Nandgaon Khandeshwar,Wheat(Husked),2015,1028,1425,397,38.61867704280156
Mul,Paddy-Unhusked,2014,2036,2433,397,19.49901768172888
Sindkhed Raja,Sorgum(Jawar),2016,1357,1754,397,29.255711127487103
Barshi,Fodder,2016,646,1043,397,61.45510835913313
Sonpeth,Green Gram,2016,4597,4994,397,8.636067000217533
Latur-Murud,Soybean,2016,3613,4010,397,10.988098533075007
Malegaon,Wheat(Husked),2014,1316,1713,397,30.167173252279635
Nandurbar,Bajri,2016,1279,1676,397,31.039874902267396
Jalgaon,Cucumber,2015,461,858,397,86.11713665943601
Akot,Sunflower,2015,2988,3385,397,13.286479250334672
Lasur Station,Gram,2015,2985,3382,397,13.299832495812396
Risod,Gram,2015,4085,4482,397,9.718482252141984
Nandura,Soybean,2014,2946,3342,396,13.441955193482688
Jalna,Bajri,2016,1386,1782,396,28.571428571428573
Mumbai,Ladies Finger,2016,2364,2760,396,16.751269035532996
Yawal,Banana,2016,748,1144,396,52.94117647058823
Osmanabad,Sorgum(Jawar),2016,1602,1998,396,24.719101123595507
Parbhani,Pigeon Pea (Tur),2016,8313,8709,396,4.763623240707326
Alibag,Rice(Paddy-Hus),2015,2228,2624,396,17.7737881508079
Sindi (Selu),Ground Nut Pods (Dry),2016,5088,5484,396,7.783018867924528
Nandurbar,Soybean,2014,2828,3224,396,14.002828854314004
Lasalgaon,Sorgum(Jawar),2016,1329,1725,396,29.79683972911964
Mumbai,Bottle Gourd,2015,727,1123,396,54.470426409903716
Wardha,SOYBEAN,2016,2596,2992,396,15.254237288135593
Chandrapur-Ganjwad,Tomato,2016,542,938,396,73.06273062730628
Lasur Station,Soybean,2016,3298,3694,396,12.007277137659187
Sinner,Sorgum(Jawar),2016,1254,1650,396,31.57894736842105
Shegaon,Gram,2015,2989,3385,396,13.2485781197725
Kamthi,Cabbage,2016,325,721,396,121.84615384615384
Pune,Cabbage,2016,300,696,396,132.0
Tiwasa,SOYBEAN,2016,2435,2831,396,16.262833675564682
Bhokar,Pigeon Pea (Tur),2016,7827,8223,396,5.0594097355308545
Dondaicha-Sindkheda,Matki,2016,4534,4930,396,8.734009704455227
Taloda,Sorgum(Jawar),2016,1553,1949,396,25.49903412749517
Junnar-Otur,FLOWER,2016,297,693,396,133.33333333333334
Gevrai,Wheat(Husked),2014,1392,1788,396,28.448275862068964
Shirpur,Wheat(Husked),2016,1527,1923,396,25.93320235756385
Devala,Pigeon Pea (Tur),2015,7940,8336,396,4.987405541561713
Sangali,Bajri,2015,1295,1691,396,30.57915057915058
Karad,Bottle Gourd,2016,872,1268,396,45.41284403669725
Varora,Pigeon Pea (Tur),2016,5446,5842,396,7.2713918472273225
Nagpur,Mango(Raw),2015,1408,1804,396,28.125
Kalyan,Ladies Finger,2016,2393,2789,396,16.5482657751776
Barshi Takli,Cotton,2016,4172,4568,396,9.491850431447746
Sinner,Sorgum(Jawar),2014,1659,2055,396,23.869801084990957
Karanja,Wheat(Husked),2016,1598,1994,396,24.780976220275345
Sailu,Sorgum(Jawar),2015,1120,1516,396,35.357142857142854
Kolhapur-Laxmipuri,Gr.Nut Kernels,2016,9704,10100,396,4.080791426215994
Vai,Tomato,2016,1416,1812,396,27.966101694915253
Nagpur,Cluster Bean,2016,1386,1782,396,28.571428571428573
Amarawati-Fruit And Vegetables,POTATO,2016,939,1335,396,42.17252396166134
Shrirampur,Cucumber,2014,1430,1826,396,27.692307692307693
Khed-Chakan,FLOWER,2016,524,920,396,75.57251908396947
Akluj,Cabbage,2015,379,774,395,104.22163588390501
Kalyan,Cucumber,2016,1343,1738,395,29.41176470588235
Arvi,Gram,2016,6150,6545,395,6.4227642276422765
Nandurbar,Gram,2015,3400,3795,395,11.617647058823529
Tumsar,Sarsav,2015,2353,2748,395,16.787080322991926
Ambad(Vadi Godri),Bajri,2015,1307,1702,395,30.221882172915073
Solapur,Gram,2016,7211,7606,395,5.477742338094577
Kada,Bajri,2016,1413,1808,395,27.954706298655342
Dondaicha,Bajri,2016,1330,1725,395,29.69924812030075
Udgir,PIGEON PEA (TUR),2016,6061,6456,395,6.517076390034648
Solapur,Grapes,2016,112,507,395,352.67857142857144
Ratanagari,Cabbage,2015,570,965,395,69.29824561403508
Morshi,Pigeon Pea (Tur),2016,8163,8558,395,4.838907264486096
Satara,CAPSICUM,2016,1057,1452,395,37.36991485335856
Nandgaon,Maize,2015,1058,1453,395,37.33459357277883
Hingoli,Sorgum(Jawar),2015,1164,1559,395,33.934707903780065
Pune-Manjri,Flower,2015,483,878,395,81.78053830227744
Hingoli,Wheat(Husked),2014,1396,1791,395,28.29512893982808
Mumbai,Chikoo,2015,1125,1520,395,35.111111111111114
Yeotmal,Soybean,2015,3363,3758,395,11.745465358311032
Shegaon,Gram,2014,2250,2645,395,17.555555555555557
Amarawati,Pigeon Pea (Tur),2014,4600,4995,395,8.58695652173913
Lonand,Wheat(Husked),2015,1530,1925,395,25.81699346405229
Pune,Wheat(Husked),2015,2190,2585,395,18.036529680365298
Baramati,Soybean,2016,3365,3760,395,11.738484398216938
Nagpur,Cucumber,2016,842,1237,395,46.912114014251785
Chandrapur-Ganjwad,Brinjal,2014,500,895,395,79.0
Dindori-Vani,Onion,2016,459,854,395,86.05664488017429
Amarawati,Papai,2015,822,1217,395,48.05352798053528
Khamgaon,Soybean,2014,2900,3295,395,13.620689655172415
Ner Parasopant,Pigeon Pea (Tur),2016,8332,8727,395,4.740758521363418
Tasgaon,Tamarind,2015,4052,4447,395,9.74827245804541
Kille Dharur,Wheat(Husked),2015,1572,1967,395,25.127226463104325
Hingoli,Gram,2016,6945,7340,395,5.6875449964002875
Dound,Cowpea,2016,8034,8429,395,4.916604431167538
Akluj,Potato,2016,1610,2005,395,24.53416149068323
Pune,Gram,2016,4806,5200,394,8.198085726175615
Kalyan,Mango,2015,2075,2469,394,18.987951807228917
Kada,Bajri,2016,1281,1675,394,30.757220921155348
Lonand,Sorgum(Jawar),2016,1600,1994,394,24.625
Pune-Manjri,Rajgira,2016,781,1175,394,50.44814340588989
Akkolkot,Gram,2016,4220,4614,394,9.336492890995261
Patan,Tomato,2014,1267,1661,394,31.097079715864247
Yawal,Banana,2016,840,1234,394,46.904761904761905
Kolhapur-Laxmipuri,Cowpea,2016,4975,5369,394,7.919597989949748
Umrane,Onion,2016,216,610,394,182.40740740740742
Gevrai,Gram,2015,3946,4340,394,9.984794728839331
Lasur Station,Pigeon Pea (Tur),2016,7706,8100,394,5.112899039709317
Aurangabad,Papai,2015,1306,1700,394,30.16845329249617
Nagpur,Soybean,2016,3146,3540,394,12.523839796567069
Vai,Cucumber,2016,1578,1972,394,24.96831432192649
Ahmednagar,Soybean,2015,3347,3741,394,11.771735882880192
Akola,Soybean,2016,2872,3266,394,13.71866295264624
Malegaon,Wheat(Husked),2015,1450,1844,394,27.17241379310345
Baramati,WHEAT(HUSKED),2016,1827,2221,394,21.565407772304322
Pachora,Sunflower,2016,3269,3663,394,12.052615478739675
Chopda,Gram,2014,2241,2635,394,17.581436858545292
Khamgaon,Sorgum(Jawar),2014,1054,1448,394,37.381404174573056
Sinner,Wheat(Husked),2015,1331,1725,394,29.601803155522163
Bhivandi,Potato,2016,1205,1599,394,32.697095435684645
Bhokar,Green Gram,2015,7866,8260,394,5.008899059242308
Junnar,Onion,2016,543,937,394,72.55985267034991
Murum,Pigeon Pea (Tur),2016,6333,6727,394,6.221380072635402
Chandrapur-Ganjwad,Carrot,2015,788,1182,394,50.0
Lasalgaon-Vinchur,WHEAT(HUSKED),2016,1735,2129,394,22.70893371757925
Amarawati-Fruit And Vegetables,Onion,2016,300,694,394,131.33333333333334
Kolhapur,Maize(Corn.),2016,450,844,394,87.55555555555556
Morshi,Soybean,2016,3100,3494,394,12.709677419354838
Bhiwapur,Cotton,2014,3717,4111,394,10.599946193166533
Kille Dharur,SOYBEAN,2016,2292,2686,394,17.19022687609075
Latur,Safflower,2014,2438,2831,393,16.11977030352748
Shirpur,Soybean,2016,3326,3719,393,11.815995189416716
Shrirampur,Ginger (Fresh),2015,3107,3500,393,12.648857418731895
Karad,Onion,2016,600,993,393,65.5
Dound,Gram,2016,3776,4169,393,10.407838983050848
Purna,Sorgum(Jawar),2016,1330,1723,393,29.548872180451127
Vai,GINGER (FRESH),2016,2223,2616,393,17.67881241565452
Khed-Chakan,Cucumber,2016,638,1031,393,61.5987460815047
Beed,Wheat(Husked),2016,1901,2294,393,20.673329826407155
Rahata,Ginger (Fresh),2015,4571,4964,393,8.597681032596807
Latur,Soybean,2014,2966,3359,393,13.250168577208361
Ambejogai,Soybean,2014,2798,3191,393,14.045746962115796
Khamgaon,Lemon,2015,107,500,393,367.2897196261682
Raver,Gram,2014,2293,2686,393,17.139119058002617
Shevgaon,Sorgum(Jawar),2016,1655,2048,393,23.746223564954683
Jalgaon,Jaggery,2015,2182,2575,393,18.010999083409715
Lasur Station,SORGUM(JAWAR),2016,1965,2358,393,20.0
Satana,Bajri,2015,1371,1764,393,28.665207877461707
Karanja,Ground Nut Pods (Dry),2015,5196,5589,393,7.563510392609699
Anajngaon Surji,Wheat(Husked),2016,1443,1836,393,27.234927234927234
Nandurbar,Wheat(Husked),2016,1533,1926,393,25.63600782778865
Manora,Soybean,2015,3055,3448,393,12.864157119476268
Manora,Soybean,2015,3084,3477,393,12.743190661478598
Mumbai,Carrot,2015,785,1178,393,50.06369426751592
Nandgaon,Bajri,2016,1538,1931,393,25.552665799739923
Vai,Tomato,2014,1145,1538,393,34.3231441048035
Manmad,Maize,2016,1034,1427,393,38.007736943907155
Manmad,Gram,2016,4042,4435,393,9.722909450766947
Kurdwadi-Modnimb,Wheat(Husked),2016,1608,2001,393,24.440298507462686
Vadgaon Peth,Flower,2015,357,750,393,110.08403361344538
Jalgaon,Tomato,2016,589,982,393,66.723259762309
Ambad(Vadi Godri),Bajri,2014,1226,1619,393,32.05546492659054
Gevrai,Wheat(Husked),2015,1527,1920,393,25.73673870333988
Akluj,Cabbage,2016,350,743,393,112.28571428571429
Kamthi,Raddish,2016,302,695,393,130.13245033112582
Kamthi,Orange,2016,388,781,393,101.28865979381443
Jintur,Sorgum(Jawar),2014,1343,1736,393,29.262844378257633
Vita,Potato,2016,1348,1741,393,29.154302670623146
Manora,Pigeon Pea (Tur),2016,7821,8214,393,5.024932873034139
Satana,Gram,2015,3013,3406,393,13.043478260869565
Malegaon,Bajri,2015,1375,1767,392,28.509090909090908
Malegaon,Pigeon Pea (Tur),2015,5886,6278,392,6.659870880054366
Sangamner,Bajri,2014,1338,1730,392,29.29745889387145
Murum,Gram,2015,3417,3809,392,11.472051507170033
Nagpur,Raddish,2016,983,1375,392,39.87792472024415
Nashik-Devlali,Methi (Bhaji),2016,451,843,392,86.9179600886918
Mehkar,Soybean,2014,2979,3371,392,13.158778113460892
Chandur Rly.,Soybean,2016,3557,3949,392,11.02052291256677
Pune,Wheat(Husked),2015,2175,2567,392,18.022988505747126
Nashik-Devlali,Kanda Pat,2016,362,754,392,108.28729281767956
Sengaon,Turmeric,2015,6978,7370,392,5.617655488678705
Hadgaon,Soybean,2016,3531,3923,392,11.101670914755028
Tumsar,Green Gram,2016,5562,5954,392,7.047824523552679
Nagpur,Small Gourd,2015,933,1325,392,42.01500535905681
Rahata,Shevga,2015,2408,2800,392,16.27906976744186
Mumbai,Green-Peas,2016,1568,1960,392,25.0
Nagpur,Mango(Raw),2016,1472,1864,392,26.630434782608695
Aurangabad,Cabbage,2016,708,1100,392,55.367231638418076
Phaltan,TOMATO,2016,600,992,392,65.33333333333333
Aarni,Soybean,2015,3220,3612,392,12.173913043478262
Karad,Squash Gourd,2016,1030,1422,392,38.05825242718446
Karad,Flower,2016,878,1270,392,44.64692482915718
Khed,CABBAGE,2016,267,659,392,146.81647940074907
Kamthi,Bottle Gourd,2015,427,819,392,91.80327868852459
Latur,Sorgum(Jawar),2014,1973,2365,392,19.868220983274202
Satara,Flower,2015,704,1096,392,55.68181818181818
Karad,Potato,2015,925,1317,392,42.37837837837838
Nagpur,Coriander  ,2016,1680,2072,392,23.333333333333332
Aurangabad,Cluster Bean,2014,1776,2168,392,22.07207207207207
Pathardi,Wheat(Husked),2015,1583,1975,392,24.76310802274163
Karad,Banana,2016,689,1081,392,56.894049346879534
Pune-Pimpri,Flower,2016,1596,1988,392,24.56140350877193
Udgir,SOYBEAN,2016,2426,2818,392,16.15828524319868
Solapur,Banana,2015,288,680,392,136.11111111111111
Kamthi,Chavli (Pala),2015,593,985,392,66.10455311973018
Vasai,Paddy-Unhusked,2015,1398,1790,392,28.04005722460658
Tumsar,Rice(Paddy-Hus),2015,3062,3454,392,12.802090137165251
Babhulgaon,Soybean,2015,2948,3340,392,13.297150610583447
Yawal,Banana,2016,763,1155,392,51.37614678899082
Anajngaon Surji,Pigeon Pea (Tur),2014,4478,4870,392,8.753907994640464
Nagpur,Bottle Gourd,2015,596,988,392,65.77181208053692
Rahata,Potato,2015,1050,1442,392,37.333333333333336
Nagpur,Bitter Gourd,2015,1423,1815,392,27.547434996486295
Anajngaon Surji,Soybean,2015,3433,3825,392,11.418584328575589
Nagpur,Beet Root,2015,792,1184,392,49.494949494949495
Ausa,Gram,2016,4857,5249,392,8.070825612518016
Mumbai,Bitter Gourd,2015,3504,3896,392,11.187214611872147
Ghoti,Flower,2015,1264,1656,392,31.0126582278481
Bhivandi,Wheat(Husked),2016,1843,2235,392,21.26966901790559
Malegaon (Washim),Gram,2016,5860,6252,392,6.689419795221843
Shahapur,Ghosali(Bhaji),2015,1062,1454,392,36.911487758945384
Kamthi,Bottle Gourd,2015,630,1022,392,62.22222222222222
Akola,Rice(Paddy-Hus),2016,3125,3517,392,12.544
Mumbai,Ridge Gourd,2015,1004,1396,392,39.04382470119522
Nandura,Maize,2016,1379,1770,391,28.353879622915155
Naigaon,Pigeon Pea (Tur),2015,8965,9356,391,4.361405465699944
Raver,Wheat(Husked),2016,1344,1735,391,29.092261904761905
Pune-Pimpri,Walvad,2015,3200,3591,391,12.21875
Ramtek,Raddish,2015,591,982,391,66.1590524534687
Bhiwapur,Pigeon Pea (Tur),2016,6892,7283,391,5.673244341265235
Ramtek,Green Peas (Dry),2015,2895,3286,391,13.506044905008636
Akluj,Water Melon,2015,427,818,391,91.56908665105387
Kalvan,Ground Nut Pods (Dry),2016,3184,3575,391,12.280150753768844
Mumbai-Fruit Market,Pineapple,2016,1317,1708,391,29.688686408504175
Lasur Station,Sorgum(Jawar),2016,1788,2179,391,21.86800894854586
Amarawati,Guava,2016,918,1309,391,42.592592592592595
Malegaon,Ground Nut Pods (Dry),2014,4000,4391,391,9.775
Nagpur,Ladies Finger,2016,1227,1618,391,31.866340668296658
Amarawati-Fruit And Vegetables,PAPAI,2016,1559,1950,391,25.080179602309173
Amarawati,Onion,2014,1388,1779,391,28.170028818443804
Telhara,Pigeon Pea (Tur),2015,4456,4847,391,8.774685816876122
Satara,Bottle Gourd,2015,885,1276,391,44.18079096045198
Jamkhed,Black Gram,2015,8988,9379,391,4.350244770805518
Ramtek,Tomato,2016,1126,1517,391,34.724689165186504
Mangalwedha,Gram,2015,3720,4111,391,10.510752688172044
Ambejogai,Soybean,2015,3385,3776,391,11.55096011816839
Deulgaon Raja,Cotton,2015,3821,4212,391,10.23292331850301
Vai,Brinjal,2016,1336,1727,391,29.266467065868262
Aurangabad,Papai,2014,1036,1427,391,37.74131274131274
Shirur,Gram,2015,3552,3943,391,11.007882882882884
Sinner,Green Gram,2016,4841,5232,391,8.07684362734972
Manchar,Cucumber,2016,287,677,390,135.8885017421603
Chikhali,Soybean,2014,2931,3321,390,13.30603889457523
Sangali,Soybean,2015,3020,3410,390,12.913907284768213
Murtizapur,Gram,2015,2812,3202,390,13.869132290184922
Barshi,Shepu,2016,430,820,390,90.69767441860465
Mantha,Pigeon Pea (Tur),2016,7422,7812,390,5.254648342764753
Jalna,Soybean,2016,3396,3786,390,11.484098939929329
Pune-Pimpri,Onion,2015,1905,2295,390,20.47244094488189
Khed (Shel Pimpalgaon),Ladies Finger,2016,767,1157,390,50.847457627118644
Taloda,Pigeon Pea (Tur),2015,5304,5694,390,7.352941176470588
Babhulgaon,Soybean,2015,2925,3315,390,13.333333333333334
Patur,Sorgum(Jawar),2014,1425,1815,390,27.36842105263158
Sinner,Soybean,2016,3728,4118,390,10.46137339055794
Jalgaon,Melon,2015,490,880,390,79.59183673469387
Ahmednagar,Pigeon Pea (Tur),2016,5520,5910,390,7.065217391304348
Sangamner,Gram,2016,5130,5520,390,7.60233918128655
Raver,Pigeon Pea (Tur),2015,4825,5215,390,8.082901554404145
Jalgaon,Maize(Corn.),2014,770,1160,390,50.64935064935065
Pathardi,Wheat(Husked),2015,1588,1978,390,24.55919395465995
Khamgaon,Soybean,2015,2950,3340,390,13.220338983050848
Nanded,Pigeon Pea (Tur),2015,5453,5843,390,7.15202640748212
Sakri,Onion,2016,167,557,390,233.53293413173654
Amalner,Sorgum(Jawar),2014,1300,1690,390,30.0
Lasalgaon,Bajri,2015,1067,1457,390,36.55107778819119
Barshi-Vairag,Wheat(Husked),2015,2072,2462,390,18.822393822393824
Manmad,Kanda Pat,2016,272,662,390,143.38235294117646
Pune-Pimpri,Green Chilli,2015,2300,2690,390,16.956521739130434
Parshiwani,Soybean,2014,2801,3191,390,13.923598714744735
Nagpur,Math (Bhaji),2016,2060,2450,390,18.932038834951456
Nandurbar,Gram,2014,2310,2700,390,16.883116883116884
Shevgaon,Gram,2016,5165,5555,390,7.55082284607938
Mumbai,Snake Gourd,2016,2140,2530,390,18.22429906542056
Pune-Pimpri,Cucumber,2015,1035,1425,390,37.68115942028985
Khamgaon,Lemon,2014,139,529,390,280.57553956834533
Manchar,Shepu,2016,2048,2438,390,19.04296875
Wardha,Soybean,2016,3450,3840,390,11.304347826086957
Murtizapur,Green Gram,2016,4000,4390,390,9.75
Nashik-Devlali,METHI (BHAJI),2016,568,958,390,68.66197183098592
Amarawati-Fruit And Vegetables,Papai,2016,1600,1990,390,24.375
Umarga,Gram,2015,3448,3838,390,11.310904872389791
Jintur,Sorgum(Jawar),2014,1339,1729,390,29.12621359223301
Pune-Manjri,Tomato,2015,621,1011,390,62.80193236714976
Satana,Onion,2016,426,816,390,91.54929577464789
Pune-Pimpri,Cucumber,2015,947,1337,390,41.18268215417107
Sangali,Soybean,2016,3625,4015,390,10.758620689655173
Malegaon,Onion,2016,148,538,390,263.5135135135135
Kej,Wheat(Husked),2016,1950,2340,390,20.0
Rahata,Green Chilli,2016,800,1190,390,48.75
Balapur,Pigeon Pea (Tur),2016,6130,6520,390,6.362153344208809
Malegaon,Wheat(Husked),2016,1499,1889,390,26.01734489659773
Balapur,Sorgum(Jawar),2016,1420,1810,390,27.464788732394368
Mumbai,Cucumber,2016,1227,1617,390,31.78484107579462
Kolhapur,Cabbage,2016,225,615,390,173.33333333333334
Jintur,Gram,2014,2083,2473,390,18.72299567930869
Manchar,Walvad,2016,1140,1530,390,34.21052631578947
Manchar,Onion,2016,375,765,390,104.0
Nagpur,Raddish,2016,1120,1510,390,34.82142857142857
Akluj,Banana,2015,300,690,390,130.0
Dound,Green Gram,2016,6532,6921,389,5.95529699938763
Savner,Gram,2016,4878,5267,389,7.974579745797458
Bhokar,Gram,2015,3936,4325,389,9.883130081300813
Rahata,Shevga,2015,3333,3722,389,11.671167116711672
Manchar,Ladies Finger,2015,1421,1810,389,27.37508796622097
Arvi,Soybean,2016,3315,3704,389,11.734539969834087
Nagpur,BITTER GOURD,2016,1500,1889,389,25.933333333333334
Jalgaon,Amla,2016,1000,1389,389,38.9
Shrigonda,Sorgum(Jawar),2016,1711,2100,389,22.735242548217418
Rahata,Carrot,2015,2333,2722,389,16.67381054436348
Dudhani,Green Gram,2015,7358,7747,389,5.286762707257407
Ausa,Pigeon Pea (Tur),2014,4265,4654,389,9.120750293083235
Baramati,Jaggery,2016,3792,4181,389,10.2584388185654
Nandurbar,Bajri,2016,1446,1835,389,26.90179806362379
Dhamangaon-Rly,Pigeon Pea (Tur),2014,4558,4947,389,8.534444931987714
Chandur Rly.,Pigeon Pea (Tur),2016,8336,8725,389,4.666506717850288
Pune-Manjri,Cucumber,2016,679,1068,389,57.29013254786451
Umrane,Onion,2016,359,748,389,108.35654596100278
Rahata,Ginger (Fresh),2015,3611,4000,389,10.772639158127943
Sengaon,Black Gram,2016,6511,6900,389,5.974504684380279
Barshi,Bitter Gourd,2016,498,887,389,78.11244979919678
Kalyan,Brinjal,2016,3088,3477,389,12.597150259067357
Nagpur,Bor,2015,411,800,389,94.64720194647202
Nandura,Wheat(Husked),2016,1497,1886,389,25.985303941215765
Ambad(Vadi Godri),Bajri,2015,1277,1666,389,30.462020360219263
Murbad,Capsicum,2016,3600,3989,389,10.805555555555555
Akluj,Carrot,2015,789,1178,389,49.30291508238276
Mumbai,Tomato,2015,1619,2008,389,24.027177269919704
Khed (Shel Pimpalgaon),Farshi,2016,1233,1622,389,31.549067315490674
Varora,Pigeon Pea (Tur),2016,5386,5775,389,7.222428518380988
Mumbai,Capsicum,2015,792,1181,389,49.11616161616162
Navapur,PIGEN-PEA (BHAJI),2016,2333,2722,389,16.67381054436348
Sinner,Pigeon Pea (Tur),2014,2919,3308,389,13.326481671805412
Dondaicha,Wheat(Husked),2016,1559,1948,389,24.951892238614498
Kalvan,Maize,2016,1092,1480,388,35.53113553113553
Bhokar,Pigeon Pea (Tur),2015,6332,6720,388,6.127605811749842
Karanja,Wheat(Husked),2016,1556,1944,388,24.93573264781491
Chandur Rly.,Pigeon Pea (Tur),2015,7018,7406,388,5.528640638358507
Shegaon,Sunflower,2015,3091,3479,388,12.552571983176966
Katol,Gram,2015,2943,3331,388,13.183826027862725
Mumbai,Bitter Gourd,2015,704,1092,388,55.11363636363637
Dhule,Wheat(Husked),2016,1613,2001,388,24.054556726596406
Karad,Chikoo,2016,1588,1976,388,24.43324937027708
Mumbai,FLOWER,2016,512,900,388,75.78125
Mumbai,Shevga,2015,1558,1946,388,24.90372272143774
Kalyan,Capsicum,2015,1981,2369,388,19.586067642604746
Vai,Ladies Finger,2015,1275,1663,388,30.431372549019606
Pathari,Wheat(Husked),2015,1517,1905,388,25.576796308503624
Shegaon,Gram,2015,3896,4284,388,9.958932238193018
Mumbai,Bottle Gourd,2016,1027,1415,388,37.77994157740993
Mohol,Gram,2014,2050,2438,388,18.926829268292682
Nashik-Devlali,Spinach,2016,213,601,388,182.15962441314554
Sailu,Soybean,2015,3320,3708,388,11.686746987951807
Mohol,Wheat(Unhusked),2014,1925,2313,388,20.155844155844157
Indapur,Gram,2016,3867,4255,388,10.033617791569693
Murtizapur,Pigeon Pea (Tur),2016,8438,8826,388,4.598246029864897
Dound,Green Gram,2016,6559,6947,388,5.915535904863546
Shrirampur,Chikoo,2015,925,1313,388,41.945945945945944
Satara,Cabbage,2016,800,1188,388,48.5
Rahata,Walvad,2014,2250,2638,388,17.244444444444444
Chandur Bajar,Soybean,2016,3150,3538,388,12.317460317460318
Bhandara,Gram,2016,4940,5328,388,7.854251012145749
Sangali,Soybean,2015,3033,3421,388,12.792614573030002
Barshi,TOMATO,2016,500,888,388,77.6
Koregaon,Sorgum(Jawar),2015,1650,2038,388,23.515151515151516
Sangali,Bajri,2015,1436,1824,388,27.01949860724234
Manora,Soybean,2014,3002,3390,388,12.924716855429713
Nagpur,Mosambi,2016,2523,2911,388,15.378517637732857
Aarni,SOYBEAN,2016,2463,2851,388,15.753146569224523
Pune,Sweet Potato,2015,1100,1488,388,35.27272727272727
Pandharpur,Tomato,2016,170,558,388,228.23529411764707
Jalgaon,Onion,2016,305,693,388,127.21311475409836
Shirpur,Sorgum(Jawar),2015,1170,1558,388,33.162393162393165
Jalgaon,Carrot,2016,665,1053,388,58.34586466165413
Kada,Bajri,2016,1400,1788,388,27.714285714285715
Mehkar,Soybean,2015,2950,3338,388,13.152542372881356
Wardha,Pigeon Pea (Tur),2016,8401,8789,388,4.618497797881204
Rahata,Small Gourd,2015,1575,1963,388,24.634920634920636
Chandur Bajar,Soybean,2015,3150,3538,388,12.317460317460318
Aurangabad,Capsicum,2015,2138,2525,387,18.101028999064546
Digras,Pigeon Pea (Tur),2015,5254,5641,387,7.365816520746098
Yeotmal,SOYBEAN,2016,2459,2846,387,15.738104920699472
Manchar,Shepu,2015,354,741,387,109.32203389830508
Bhandara,Green Gram,2016,5072,5459,387,7.6301261829652995
Satara,CUCUMBER,2016,800,1187,387,48.375
Mangrulpeer,Pigeon Pea (Tur),2016,8177,8564,387,4.732787085728262
Chalisgaon,Bajri,2016,1350,1737,387,28.666666666666668
Kolhapur-Laxmipuri,Lentil,2014,6200,6587,387,6.241935483870968
Vai,Bottle Gourd,2014,1438,1825,387,26.91237830319889
Indapur,Gram,2015,3538,3925,387,10.938383267382703
Anajngaon Surji,Soybean,2016,2986,3373,387,12.960482250502345
Akluj,Banana,2015,225,612,387,172.0
Sangali,Green Peas (Dry),2016,2713,3100,387,14.26465167711021
Solapur,Goosefoot,2016,488,875,387,79.30327868852459
Ambejogai,Soybean,2014,3005,3392,387,12.878535773710482
Yeotmal,Ground Nut Pods (Dry),2014,3148,3535,387,12.293519695044473
Bhandara,Gram,2016,4118,4505,387,9.397765905779504
Kurdwadi,Maize,2016,1101,1488,387,35.14986376021798
Nashik-Devlali,Kanda Pat,2016,617,1004,387,62.72285251215559
Dhule,Bajri,2016,1524,1911,387,25.393700787401574
Mehkar,SOYBEAN,2016,2570,2957,387,15.058365758754864
Akot,PIGEON PEA (TUR),2016,5176,5563,387,7.476816074188562
Rajura,Pigeon Pea (Tur),2015,4995,5382,387,7.747747747747748
Kille Dharur,Wheat(Husked),2015,2111,2498,387,18.33254381809569
Dound,Bajri,2015,1375,1762,387,28.145454545454545
Sillod,Gram,2016,4513,4900,387,8.57522712164857
Majalgaon,Gram,2015,3802,4189,387,10.1788532351394
Karad,Banana,2015,563,950,387,68.73889875666075
Mohol,Gram,2014,2072,2459,387,18.677606177606176
Barshi,Spinach,2016,363,750,387,106.61157024793388
Bhusaval,Black Gram,2016,6369,6756,387,6.076307112576543
Taloda,Green Gram,2016,5927,6314,387,6.529441538721107
Sinner,Bajri,2014,1152,1539,387,33.59375
Aurangabad,Bottle Gourd,2014,517,904,387,74.85493230174082
Karad,Bottle Gourd,2014,813,1200,387,47.601476014760145
Zarijamini,Soybean,2014,2692,3078,386,14.338781575037148
Koregaon,Gram,2015,4100,4486,386,9.414634146341463
Rahata,Potato,2016,1021,1407,386,37.80607247796278
Nandurbar,Sorgum(Jawar),2016,1350,1736,386,28.59259259259259
Raver,Gram,2015,3646,4032,386,10.586944596818432
Kamthi,Raddish,2015,390,776,386,98.97435897435898
Karad,Green Chilli,2015,947,1333,386,40.76029567053854
Kalyan,Chikoo,2016,1243,1629,386,31.053901850362028
Shrirampur,Ladies Finger,2016,1091,1477,386,35.38038496791934
Paithan,Wheat(Husked),2015,1643,2029,386,23.493609251369445
Amarawati,Bitter Gourd,2016,3800,4186,386,10.157894736842104
Manora,Gram,2016,5972,6358,386,6.463496316141996
Barshi,Wheat(Husked),2016,1715,2101,386,22.50728862973761
Vadgaon Peth,Cabbage,2016,395,781,386,97.72151898734177
Nagpur,MATH (BHAJI),2016,1167,1553,386,33.07626392459297
Vai,Flower,2016,1400,1786,386,27.571428571428573
Ulhasnagar,Banana,2015,625,1011,386,61.76
Sangamner,Soybean,2016,3050,3436,386,12.655737704918034
Sangamner,Wheat(Husked),2016,1626,2012,386,23.739237392373923
Dondaicha-Sindkheda,Pigeon Pea (Tur),2016,5615,6001,386,6.874443455031167
Rahata,Ground Nut Pods (Dry),2015,2271,2657,386,16.99691765741964
Yeola,Gram,2015,2480,2866,386,15.564516129032258
Akluj,Potato,2015,967,1353,386,39.917269906928645
Barshi,Other Pulses,2014,2571,2957,386,15.01361338000778
Amalner,Sesamum,2016,5693,6079,386,6.780256455295977
Rahata,Flower,2016,400,786,386,96.5
Dhamangaon-Rly,Soybean,2016,3551,3937,386,10.870177414812728
Wardha,Soybean,2016,3324,3710,386,11.61251504211793
Amarawati-Fruit And Vegetables,Potato,2016,657,1043,386,58.75190258751903
Chikhali,Green Gram,2016,4540,4926,386,8.502202643171806
Jalgaon,Jaggery,2014,3115,3501,386,12.391653290529694
Mangrulpeer,Pigeon Pea (Tur),2016,8482,8868,386,4.55081348738505
Gangapur,Sorgum(Jawar),2014,1420,1806,386,27.183098591549296
Amarawati,Coriander  ,2016,1907,2293,386,20.241216570529627
Hingoli,Gram,2015,4812,5197,385,8.000831255195346
Akola,Soybean,2015,3306,3691,385,11.645493042952207
Pusad,Pigeon Pea (Tur),2016,6063,6448,385,6.349991753257464
Lasalgaon-Niphad,Wheat(Husked),2016,1505,1890,385,25.58139534883721
Pune-Pimpri,Ghosali(Bhaji),2016,2365,2750,385,16.27906976744186
Digras,Soybean,2014,2749,3134,385,14.005092761004
Osmanabad,Soybean,2015,3260,3645,385,11.809815950920246
Mumbai,Ridge Gourd,2015,3326,3711,385,11.575466025255562
Partur,Gram,2014,2053,2438,385,18.753044325377495
Mumbai,Water Melon,2015,638,1023,385,60.3448275862069
Solapur,Cabbage,2014,378,763,385,101.85185185185185
Udgir,Pigeon Pea (Tur),2015,9741,10126,385,3.952366286828868
Sindi (Selu),SOYBEAN,2016,2484,2869,385,15.499194847020934
Chandrapur-Ganjwad,Carrot,2015,568,953,385,67.78169014084507
Akluj,TOMATO,2016,470,855,385,81.91489361702128
Yeola,Gram,2015,3475,3860,385,11.079136690647482
Aarni,Soybean,2014,2761,3146,385,13.944223107569721
Balapur,Sorgum(Jawar),2016,1365,1750,385,28.205128205128204
Amarawati-Fruit And Vegetables,Kharbuj,2016,1800,2185,385,21.38888888888889
Rahata,Ginger (Fresh),2016,2346,2731,385,16.41091219096334
Pune,Gr.Nut Kernels,2015,9085,9470,385,4.237754540451293
Amarawati-Fruit And Vegetables,Orange,2016,529,914,385,72.77882797731569
Dhamangaon-Rly,Soybean,2015,3302,3687,385,11.659600242277408
Mumbai,Potato,2015,841,1226,385,45.77883472057075
Devala,Pigeon Pea (Tur),2016,6597,6982,385,5.835986054267091
Baramati,Sunflower,2016,3185,3570,385,12.087912087912088
Nagpur,Math (Bhaji),2014,2769,3154,385,13.903936439147706
Mantha,Green Gram,2016,4466,4851,385,8.620689655172415
Mumbai,Snake Gourd,2015,1310,1695,385,29.389312977099237
Jamkhed,Pigeon Pea (Tur),2016,6587,6972,385,5.844845908607864
Kalyan,Capsicum,2016,3293,3678,385,11.691466747646523
Mumbai,Ridge Gourd,2015,2769,3154,385,13.903936439147706
Nagpur,Carrot,2015,1600,1985,385,24.0625
Manora,Pigeon Pea (Tur),2016,8686,9071,385,4.432419986184665
Gevrai,Cotton,2016,4011,4396,385,9.598603839441536
Sonpeth,Soybean,2016,3481,3865,384,11.031312841137604
Lasalgaon-Vinchur,Wheat(Husked),2016,1591,1975,384,24.135763670647393
Khed-Chakan,Flower,2016,992,1376,384,38.70967741935484
Lasalgaon-Vinchur,Sorgum(Jawar),2016,1538,1922,384,24.96749024707412
Karad,Flower,2016,884,1268,384,43.43891402714932
Buldhana,Gram,2015,4183,4567,384,9.180014343772411
Khamgaon,Soybean,2015,3468,3852,384,11.07266435986159
Sindi,Soybean,2016,3333,3717,384,11.521152115211521
Aheri,Sesamum,2016,5033,5417,384,7.629644347307769
Pune-Moshi,FLOWER,2016,563,947,384,68.20603907637656
Chalisgaon,Wheat(Husked),2016,1447,1831,384,26.53766413268832
Vani,Soybean,2015,2881,3265,384,13.328705310656023
Akluj,Banana,2015,260,644,384,147.69230769230768
Patur,Wheat(Husked),2014,1346,1730,384,28.528974739970284
Rahata,Capsicum,2015,854,1238,384,44.96487119437939
Chandur Bajar,Soybean,2016,2900,3284,384,13.241379310344827
Vaijapur,Gram,2014,1982,2366,384,19.374369323915236
Mumbai,Capsicum,2016,1354,1738,384,28.360413589364846
Devala,Gram,2015,3853,4237,384,9.966260057098365
Sillod,Gram,2016,3783,4167,384,10.15067406819984
Karad,Bottle Gourd,2016,872,1256,384,44.03669724770642
Jalgaon,Cabbage,2015,637,1021,384,60.28257456828885
Ratanagari,Bottle Gourd,2015,708,1092,384,54.23728813559322
Devala,Gram,2014,3072,3456,384,12.5
Pune-Pimpri,Brinjal,2016,2333,2717,384,16.459494213459067
Kada,Pigeon Pea (Tur),2016,6583,6967,384,5.833206744645299
Dound,Bajri,2016,1500,1884,384,25.6
Nagpur,Cluster Bean,2016,1554,1938,384,24.71042471042471
Kada,Sunflower,2014,2643,3027,384,14.52894438138479
Kalyan,Ladies Finger,2015,2278,2662,384,16.856892010535557
Shirpur,Maize,2014,888,1272,384,43.24324324324324
Patan,Brinjal,2016,1194,1578,384,32.1608040201005
Washim,Pigeon Pea (Tur),2015,6891,7275,384,5.572485851110144
Balapur,Black Gram,2015,5183,5567,384,7.408836581130619
Umarkhed-Danki,Soybean,2015,3233,3617,384,11.877513145685123
Aurangabad,Bor,2014,1383,1767,384,27.765726681127983
Achalpur,Ground Nut Pods (Dry),2016,4072,4456,384,9.430255402750491
Vadgaon Peth,Cucumber,2015,591,975,384,64.9746192893401
Nagbhid,Paddy-Unhusked,2016,1755,2139,384,21.88034188034188
Ambad(Vadi Godri),Bajri,2015,1027,1411,384,37.3904576436222
Savner,Gram,2016,3200,3584,384,12.0
Nandurbar,Wheat(Husked),2014,1407,1791,384,27.292110874200425
Panvel,Bottle Gourd,2016,2283,2667,384,16.819973718791065
Yeotmal,Soybean,2016,3661,4045,384,10.488937448784485
Karad,Brinjal,2014,1031,1415,384,37.245392822502424
Baramati,Wheat(Husked),2015,1600,1983,383,23.9375
Dondaicha,Pigeon Pea (Tur),2015,4682,5065,383,8.180264844083725
Akola,Soybean,2016,3328,3711,383,11.508413461538462
Shevgaon,Sorgum(Jawar),2015,1365,1748,383,28.05860805860806
Kej,SOYBEAN,2016,2406,2789,383,15.918536990856193
Khamgaon,Lemon,2014,170,553,383,225.2941176470588
Shevgaon,Sorgum(Jawar),2016,1723,2106,383,22.228670922809055
Umarga,Wheat(Unhusked),2015,2646,3029,383,14.474678760393045
Akola,Soybean,2016,3294,3677,383,11.627200971463267
Tumsar,Pigeon Pea (Tur),2015,6261,6644,383,6.117233668743013
Chandur Bajar,Wheat(Husked),2016,1450,1833,383,26.413793103448278
Satara,Bottle Gourd,2015,725,1108,383,52.827586206896555
Pachora,Black Gram,2015,7745,8128,383,4.945125887669464
Chandrapur-Ganjwad,Tomato,2015,490,873,383,78.16326530612245
Ratanagari,Tomato,2015,568,951,383,67.42957746478874
Ahmednagar,Sorgum(Jawar),2015,1631,2014,383,23.482526057633354
Lasalgaon,Sorgum(Jawar),2014,2214,2597,383,17.29900632339657
Ahmednagar,Cowpea,2015,5817,6200,383,6.584149905449545
Ahmednagar,Wheat(Husked),2015,1686,2069,383,22.716488730723608
Murbad,Ghevda,2016,1317,1700,383,29.08124525436598
Lonand,Bajri,2015,1363,1746,383,28.0997798972854
Solapur,Cabbage,2014,253,636,383,151.38339920948616
Washim,Turmeric,2016,8000,8383,383,4.7875
Dhamangaon-Rly,Soybean,2016,3512,3895,383,10.905466970387243
Akkolkot,Gram,2016,4360,4743,383,8.784403669724771
Kolhapur,Melon,2015,2030,2413,383,18.866995073891626
Paithan,Sorgum(Jawar),2014,1550,1933,383,24.70967741935484
Chopda,Sesamum,2014,9553,9936,383,4.009211765937402
Junnar (Narayangaon),Math (Bhaji),2016,168,551,383,227.97619047619048
Dound,Wheat(Husked),2016,1690,2073,383,22.662721893491124
Shrirampur,Cucumber,2015,989,1372,383,38.72598584428716
Gangakhed,Cotton,2016,4100,4483,383,9.341463414634147
Nagpur,Parwar,2016,1417,1800,383,27.02893436838391
Nandura,Black Gram,2015,5500,5883,383,6.963636363636364
Sindi (Selu),Wheat(Husked),2016,1329,1712,383,28.818660647103084
Osmanabad,Cabbage,2015,625,1008,383,61.28
Karad,Carrot,2015,1130,1513,383,33.89380530973451
Tuljapur,Soybean,2015,3443,3826,383,11.124019750217833
Kolhapur,Snake Gourd,2016,525,908,383,72.95238095238095
Jintur-Bori,Green Gram,2014,6486,6869,383,5.905026210299106
Kamthi,Flower,2016,438,821,383,87.44292237442923
Karanja,Black Gram,2015,5250,5633,383,7.295238095238095
Lasalgaon-Niphad,Onion,2016,357,740,383,107.28291316526611
Yeotmal,Gram,2015,3804,4187,383,10.068349106203996
Dound,Wheat(Husked),2015,1527,1910,383,25.081859855926652
Kalyan,Gram,2015,4850,5233,383,7.896907216494846
Nira,Jaggery,2014,3267,3650,383,11.72329354147536
Shirpur,Ground Nut Pods (Dry),2015,5599,5982,383,6.840507233434542
Shrirampur,Soybean,2015,3204,3587,383,11.953807740324594
Mantha,Wheat(Husked),2016,1767,2150,383,21.675155631013016
Sindkhed Raja,Wheat(Husked),2016,1600,1983,383,23.9375
Nandgaon,Soybean,2015,3420,3802,382,11.169590643274853
Kada,Bajri,2016,1332,1714,382,28.67867867867868
Amarawati,Cluster Bean,2016,4118,4500,382,9.276347741622146
Baramati,Sunflower,2015,2900,3282,382,13.172413793103448
Barshi,Capsicum,2016,557,939,382,68.58168761220826
Amarawati-Fruit And Vegetables,Maize(Corn.),2016,736,1118,382,51.90217391304348
Gevrai,Sorgum(Jawar),2015,1644,2026,382,23.2360097323601
Jamkhed,Soybean,2016,3084,3466,382,12.38651102464332
Akola,Gram,2014,2477,2859,382,15.421881308033912
Akluj,Cabbage,2014,300,682,382,127.33333333333333
Phaltan,Wheat(Husked),2015,1610,1992,382,23.726708074534162
Ambejogai,Sorgum(Jawar),2015,1926,2308,382,19.833852544132917
Kinwat,Cotton,2014,3591,3973,382,10.63770537454748
Chalisgaon,Bajri,2016,1371,1753,382,27.86287381473377
Panvel,Bitter Gourd,2016,4661,5043,382,8.195666166058786
Barshi,Coriander (Dry),2016,6169,6551,382,6.1922515804830605
Malkapur,Soybean,2014,2873,3255,382,13.296206056387051
Malegaon,Bajri,2016,1355,1737,382,28.19188191881919
Tumsar,Other Pulses,2015,2329,2711,382,16.40188922284242
Dhule,Black Gram,2014,4785,5167,382,7.983281086729362
Kalyan,Carrot,2015,1745,2127,382,21.89111747851003
Devala,Bajri,2016,1391,1773,382,27.462257368799424
Shirpur,Wheat(Husked),2015,1273,1655,382,30.007855459544384
Patan,Green Chilli,2016,1576,1958,382,24.238578680203045
Buldhana-Dhad,SOYBEAN,2016,2265,2647,382,16.865342163355407
Jalgaon,Coriander (Dry),2015,9700,10082,382,3.9381443298969074
Shahapur,Cucumber,2014,1312,1694,382,29.115853658536587
Purna,Soybean,2014,3001,3383,382,12.729090303232256
Daryapur,Black Gram,2015,6738,7120,382,5.669338082517068
Majalgaon,Wheat(Husked),2015,1464,1846,382,26.092896174863387
Satara,Carrot,2015,953,1335,382,40.083945435466944
Shrirampur,Brinjal,2015,922,1304,382,41.431670281995665
Ghoti,Cucumber,2016,1373,1755,382,27.822286962855063
Ahmednagar,Gram,2016,5928,6310,382,6.443994601889338
Pulgaon,Pigeon Pea (Tur),2016,8354,8736,382,4.572659803686856
Rahata,BOTTLE GOURD,2016,427,809,382,89.46135831381733
Sailu,Gram,2015,2605,2987,382,14.664107485604607
Pune,Squash Gourd,2015,477,859,382,80.083857442348
Malkapur,Soybean,2016,3239,3621,382,11.793763507255326
Akot,Gram,2016,7606,7988,382,5.0223507757033925
Tasgaon,Gram,2014,2526,2908,382,15.122723673792557
Malkapur,ONION,2016,546,928,382,69.96336996336996
Akole,Wheat(Husked),2014,1494,1875,381,25.502008032128515
Akluj,Cabbage,2016,475,856,381,80.21052631578948
Sangamner,Wheat(Husked),2015,1517,1898,381,25.115359261700725
Malegaon (Washim),Soybean,2015,3511,3892,381,10.85160922814013
Osmanabad,Wheat(Husked),2016,1972,2353,381,19.320486815415823
Katol,SOYBEAN,2016,2468,2849,381,15.437601296596434
Katol,Soybean,2015,3204,3585,381,11.891385767790263
Ahmedpur,Gram,2014,1977,2358,381,19.271623672230653
Vaijapur,Gram,2014,1950,2331,381,19.53846153846154
Sinner,Soybean,2015,2886,3267,381,13.201663201663202
Dudhani,Bajri,2014,1130,1511,381,33.716814159292035
Ramtek,Flower,2016,1138,1519,381,33.479789103690685
Jawala-Bajar,Turmeric,2016,7363,7744,381,5.174521254923265
Yeola,Pigeon Pea (Tur),2016,6727,7108,381,5.663743124721273
Basmat,Pigeon Pea (Tur),2015,4488,4869,381,8.489304812834225
Kada,Gram,2016,4188,4569,381,9.097421203438396
Vai,Cucumber,2015,1705,2086,381,22.346041055718477
Latur,Sorgum(Jawar),2015,2102,2483,381,18.125594671741197
Baramati,Bajri,2015,1400,1781,381,27.214285714285715
Shrirampur,Sorgum(Jawar),2015,1495,1876,381,25.48494983277592
Nagpur,Pumpkin,2015,781,1162,381,48.78361075544174
Pune,Lentil,2016,6319,6700,381,6.029435037189429
Dondaicha,BAJRI,2016,1179,1560,381,32.31552162849873
Sindi (Selu),Soybean,2016,3217,3598,381,11.843332297171278
Khamgaon,Lemon,2015,188,569,381,202.6595744680851
Tumsar,Rice(Paddy-Hus),2015,2721,3102,381,14.002205071664829
Sengaon,Pigeon Pea (Tur),2016,6496,6877,381,5.865147783251231
Pusad,Wheat(Husked),2016,1744,2125,381,21.84633027522936
Ratanagari,Cabbage,2016,605,986,381,62.97520661157025
Ghoti,Brinjal,2016,2000,2381,381,19.05
Sinner,Soybean,2016,3337,3718,381,11.417440815103387
Nandgaon Khandeshwar,Soybean,2015,3025,3406,381,12.59504132231405
Jamkhed,Pigeon Pea (Tur),2016,7544,7925,381,5.050371155885472
Jintur,Soybean,2014,2928,3309,381,13.012295081967213
Morshi,Pigeon Pea (Tur),2016,8070,8451,381,4.721189591078067
Aurangabad,Bitter Gourd,2016,804,1184,380,47.2636815920398
Hingoli,Green Gram,2014,6888,7268,380,5.516840882694542
Lasur Station,SOYBEAN,2016,2338,2718,380,16.253207869974336
Barshi,Wheat(Husked),2016,1753,2133,380,21.67712492869367
Nagpur,Small Gourd,2016,1320,1700,380,28.78787878787879
Ambad(Vadi Godri),Bajri,2016,1582,1962,380,24.020227560050568
Panvel,Tomato,2014,1920,2300,380,19.791666666666668
Aurangabad,Papai,2015,940,1320,380,40.42553191489362
Vani,Cotton,2016,4145,4525,380,9.16767189384801
Anajngaon Surji,Wheat(Husked),2015,1414,1794,380,26.874115983026876
Manchar,Onion,2016,513,893,380,74.07407407407408
Pune,Sweet Potato,2015,1030,1410,380,36.89320388349515
Mantha,Wheat(Husked),2016,1730,2110,380,21.965317919075144
Jalgaon,Maize(Corn.),2015,760,1140,380,50.0
Barshi-Vairag,Maize,2015,1077,1457,380,35.283194057567314
Jalna,Soybean,2016,3549,3929,380,10.707241476472246
Pandharpur,Banana,2014,835,1215,380,45.50898203592814
Jalgaon,Black Gram,2016,10730,11110,380,3.5414725069897486
Lasalgaon,Wheat(Husked),2015,1602,1982,380,23.72034956304619
Sakri,Wheat(Husked),2016,1325,1705,380,28.67924528301887
Nagpur,Cabbage,2015,535,915,380,71.02803738317758
Jalgaon,Potato,2016,741,1121,380,51.282051282051285
Manora,Soybean,2015,3190,3570,380,11.912225705329154
Dound,Cowpea,2016,8379,8759,380,4.535147392290249
Jintur,Cotton,2015,3827,4207,380,9.929448654298406
Rahata,Cabbage,2016,900,1280,380,42.22222222222222
Baramati,Wheat(Husked),2014,1626,2006,380,23.370233702337025
Amarawati,Papai,2016,1647,2027,380,23.0722525804493
Parola,Bajri,2016,963,1343,380,39.46002076843198
Ramtek,Cucumber,2015,1590,1970,380,23.89937106918239
Ramtek,Cabbage,2015,1240,1620,380,30.64516129032258
Ramtek,Cabbage,2015,1520,1900,380,25.0
Mumbai,Cucumber,2016,1420,1800,380,26.760563380281692
Lonand,Bajri,2015,1290,1670,380,29.45736434108527
Rahata,Cabbage,2016,250,630,380,152.0
Morshi,Soybean,2014,2767,3147,380,13.733285146367907
Pachora,Ground Nut Pods (Dry),2015,5000,5380,380,7.6
Dhule,Black Gram,2014,4313,4693,380,8.810572687224669
Majalgaon,Bajri,2015,1060,1440,380,35.84905660377358
Chikhali,Soybean,2015,2958,3338,380,12.846517917511832
Akole,Wheat(Husked),2014,1460,1840,380,26.027397260273972
Mahagaon,Cotton,2016,4033,4413,380,9.422266303000248
Amalner,Gram,2015,3445,3825,380,11.030478955007258
Pathardi,Wheat(Husked),2015,1372,1752,380,27.696793002915452
Khed-Chakan,Flower,2016,688,1068,380,55.23255813953488
Mumbai,Shevga,2016,2108,2488,380,18.026565464895636
Sillod,Pigeon Pea (Tur),2016,6675,7055,380,5.692883895131086
Amarawati-Fruit And Vegetables,Spinach,2016,2508,2888,380,15.151515151515152
Sillod,Gram,2016,6680,7060,380,5.688622754491018
Ahmednagar,Pigeon Pea (Tur),2015,4993,5373,380,7.610654916883637
Kada,Gram,2015,3769,4148,379,10.055717697001857
Kamthi,Cabbage,2016,366,745,379,103.55191256830601
Manchar,Brinjal,2015,769,1148,379,49.28478543563069
Pune,Gr.Nut Kernels,2016,7347,7726,379,5.158568123043419
Jalgaon,Squash Gourd,2014,679,1058,379,55.81737849779087
Pune,Sorgum(Jawar),2015,2463,2842,379,15.387738530247665
Devala,Horse Gram,2016,3070,3449,379,12.345276872964169
Satara,Bottle Gourd,2014,817,1196,379,46.38922888616891
Mumbai,Sweet Potato,2016,991,1370,379,38.24419778002018
Kalmeshwar,Gram,2015,3978,4357,379,9.527400703871292
Chikhali,Soybean,2015,3363,3742,379,11.269699672911091
Majalgaon,Soybean,2015,3239,3618,379,11.701142327878975
Kurdwadi,Gram,2016,3415,3794,379,11.09809663250366
Ahmedpur,Pigeon Pea (Tur),2016,8084,8463,379,4.6882731321128155
Kalvan,Wheat(Husked),2016,1522,1901,379,24.90144546649146
Nashik,Tomato,2016,501,880,379,75.64870259481037
Pune,Lentil,2016,5200,5579,379,7.288461538461538
Chalisgaon,Wheat(Husked),2016,1410,1789,379,26.879432624113477
Barshi-Vairag,Gram,2016,4007,4386,379,9.458447716496131
Kalamb (Os),Pigeon Pea (Tur),2015,8307,8686,379,4.562417238473577
Rahuri-Vambori,Gram,2015,3581,3960,379,10.583635855906172
Wardha,Pigeon Pea (Tur),2015,6659,7038,379,5.691545277068629
Murtizapur,Gram,2014,2391,2770,379,15.851108322877456
Nandgaon Khandeshwar,Pigeon Pea (Tur),2016,5853,6232,379,6.475311805911498
Sailu,Gram,2016,3790,4169,379,10.0
Karad,Onion,2016,475,854,379,79.78947368421052
Nandura,Wheat(Husked),2016,1517,1896,379,24.983520105471325
Kopargaon,Soybean,2016,3373,3752,379,11.236288170767862
Chopda,Green Gram,2016,5653,6032,379,6.704404740845569
Pachora,Soybean,2016,3202,3581,379,11.836352279825109
Dondaicha-Sindkheda,Sorgum(Jawar),2016,1566,1945,379,24.201787994891443
Vadgaon Peth,Tomato,2016,400,779,379,94.75
Bhokar,Green Gram,2014,5782,6161,379,6.554825319958492
Nagpur,Soybean,2016,2588,2967,379,14.64451313755796
Sangrampur-Varvatbakal,Green Gram,2016,4375,4754,379,8.662857142857144
Pathari,Sorgum(Jawar),2015,1581,1959,378,23.908918406072107
Dhule,Bajri,2015,1058,1436,378,35.72778827977316
Satara,Potato,2015,611,989,378,61.8657937806874
Hingoli,Gram,2016,4697,5075,378,8.04769001490313
Shrirampur,Potato,2016,1000,1378,378,37.8
Manwat,SOYBEAN,2016,2394,2772,378,15.789473684210526
Nagpur,Cluster Bean,2016,1870,2248,378,20.21390374331551
Patan,BRINJAL,2016,1294,1672,378,29.21174652241113
Ramtek,Green Chilli,2016,1148,1526,378,32.926829268292686
Nagpur,Green Chilli,2016,1983,2361,378,19.062027231467475
Sakri,Pigeon Pea (Tur),2016,4346,4724,378,8.697653014265992
Umared,Soybean,2016,3243,3621,378,11.655874190564292
Jalgaon,Jaggery,2015,2433,2811,378,15.536374845869297
Lasalgaon-Vinchur,Wheat(Husked),2015,1507,1885,378,25.082946250829462
Lonand,Bajri,2016,1450,1828,378,26.06896551724138
Risod,Soybean,2015,2931,3309,378,12.896622313203684
Arvi,Pigeon Pea (Tur),2016,8357,8735,378,4.523154241952854
Umarga,Gram,2014,1961,2339,378,19.275879653238142
Kamthi,Raddish,2015,511,889,378,73.97260273972603
Varora,Pigeon Pea (Tur),2015,5725,6103,378,6.602620087336245
Pune,Wheat(Husked),2014,2250,2628,378,16.8
Mumbai,Cucumber,2015,1062,1440,378,35.59322033898305
Satara,Onion,2016,443,821,378,85.3273137697517
Tumsar,Gram,2015,2750,3128,378,13.745454545454546
Jalkot,Pigeon Pea (Tur),2016,8236,8614,378,4.589606605148131
Sillod,Green Gram,2016,4311,4689,378,8.768267223382045
Chandrapur-Ganjwad,Cabbage,2015,315,693,378,120.0
Amarawati,Gram,2016,8935,9313,378,4.230554001119194
Murbad,Ladies Finger,2016,936,1314,378,40.38461538461539
Panvel,Bitter Gourd,2015,3389,3767,378,11.153732664502803
Satara,Potato,2016,922,1300,378,40.99783080260303
Gangapur,Pigeon Pea (Tur),2015,5434,5812,378,6.956201693043798
Achalpur,Pigeon Pea (Tur),2016,7425,7803,378,5.090909090909091
Shirpur,Green Gram,2016,6316,6694,378,5.984800506649778
Chandur Bajar,Wheat(Husked),2016,1520,1898,378,24.86842105263158
Shrirampur,Sorgum(Jawar),2015,1566,1944,378,24.137931034482758
Khed-Chakan,Onion,2016,544,922,378,69.48529411764706
Washim,PIGEON PEA (TUR),2016,5550,5928,378,6.8108108108108105
Jamkhed,Soybean,2015,3364,3742,378,11.236623067776456
Mumbai,Elephant Root,2016,2886,3264,378,13.097713097713097
Tumsar,Other Pulses,2016,3675,4053,378,10.285714285714286
Shrirampur,Papai,2015,976,1353,377,38.627049180327866
Khed-Chakan,Cabbage,2016,513,890,377,73.48927875243665
Kada,Pigeon Pea (Tur),2015,4672,5049,377,8.069349315068493
Lasur Station,Thymol/Lovage,2015,10450,10827,377,3.6076555023923444
Kada,Wheat(Husked),2015,1551,1928,377,24.306898774983882
Khed-Chakan,Bottle Gourd,2016,600,977,377,62.833333333333336
Rahata,Cucumber,2014,769,1146,377,49.02470741222367
Pachora,Soybean,2016,3329,3706,377,11.324722138780414
Karad,Cucumber,2015,1100,1477,377,34.27272727272727
Telhara,Green Gram,2015,7500,7877,377,5.026666666666666
Nagpur,Cabbage,2015,565,942,377,66.72566371681415
Buldhana,Wheat(Husked),2016,1477,1854,377,25.524712254570076
Khed (Shel Pimpalgaon),Ladies Finger,2015,1316,1693,377,28.64741641337386
Deglur,Black Gram,2014,5219,5596,377,7.22360605479977
Nagpur,Math (Bhaji),2015,1000,1377,377,37.7
Kalvan,Maize,2015,1081,1458,377,34.87511563367253
Dudhani,Black Gram,2014,4783,5160,377,7.882082375078403
Jalgaon,Tomato,2016,543,920,377,69.42909760589319
Dound,Bajri,2016,1764,2141,377,21.3718820861678
Mumbai,Capsicum,2016,1954,2331,377,19.293756397134082
Patan,Green Chilli,2015,1227,1604,377,30.725346373268135
Ramtek,Onion,2016,1438,1815,377,26.216968011126564
Nagpur,Potato,2015,615,992,377,61.300813008130085
Nagpur,Wal Bhaji,2015,2669,3046,377,14.125140502060697
Mumbai,Bottle Gourd,2016,615,992,377,61.300813008130085
Nagpur,Bitter Gourd,2014,2235,2612,377,16.86800894854586
Ambad(Vadi Godri),Bajri,2014,1229,1606,377,30.675345809601303
Akola,Soybean,2015,3417,3794,377,11.033069944395669
Mul,Paddy-Unhusked,2014,2207,2584,377,17.08201178069778
Kalyan,Brinjal,2016,2573,2950,377,14.652157015157403
Washim,Gram,2014,2727,3104,377,13.824715804913824
Pune-Manjri,Cucumber,2016,683,1060,377,55.19765739385066
Jalgaon,Cucumber,2015,550,927,377,68.54545454545455
Amalner,Gram,2015,3729,4106,377,10.109949048002145
Kopargaon,Bajri,2015,1119,1496,377,33.690795352993746
Bhivandi,Onion,2015,1517,1894,377,24.851680949241924
Udgir,Jaggery,2015,1800,2177,377,20.944444444444443
Varora,Pigeon Pea (Tur),2016,5867,6244,377,6.42577126299642
Yeola,Bajri,2016,1404,1781,377,26.85185185185185
Achalpur,Pigeon Pea (Tur),2016,6264,6641,377,6.018518518518518
Satana,Bajri,2016,1463,1839,376,25.700615174299386
Nandgaon,Bajri,2014,1234,1610,376,30.47001620745543
Kopargaon,Sorgum(Jawar),2015,1239,1615,376,30.347054075867636
Chandrapur-Ganjwad,Cabbage,2015,497,873,376,75.65392354124748
Aurangabad,Potato,2014,2176,2552,376,17.279411764705884
Dound,Sorgum(Jawar),2015,1563,1939,376,24.056301983365323
Latur,Soybean,2016,3531,3907,376,10.648541489662986
Washim,Sorgum(Jawar),2016,1165,1541,376,32.27467811158798
Lasur Station,Wheat(Husked),2014,1682,2058,376,22.35434007134364
Manmad,Gram,2016,5611,5987,376,6.701122794510782
Amalner,Green Gram,2015,5375,5751,376,6.995348837209303
Jamner-Neri,Maize,2015,2272,2648,376,16.549295774647888
Pune,Cabbage,2014,295,671,376,127.45762711864407
Tumsar,Other Pulses,2016,3640,4016,376,10.32967032967033
Rahuri-Vambori,Pigeon Pea (Tur),2015,4542,4918,376,8.27829150154117
Beed,Sorgum(Jawar),2016,1676,2052,376,22.43436754176611
Nashik-Devlali,Methi (Bhaji),2016,1171,1547,376,32.10930828351836
Ahmednagar,Wheat(Husked),2016,1639,2015,376,22.940817571690054
Shirpur,Wheat(Husked),2016,1480,1856,376,25.405405405405407
Akluj,Tomato,2015,724,1100,376,51.93370165745856
Pune,Beet Root,2015,305,681,376,123.27868852459017
Shrirampur,GREEN CHILLI,2016,938,1314,376,40.085287846481876
Khed-Chakan,Bottle Gourd,2016,680,1056,376,55.294117647058826
Nandura,Soybean,2015,2891,3267,376,13.005880318228986
Nandgaon,Bajri,2015,1344,1720,376,27.976190476190474
Latur,Gram,2016,4352,4728,376,8.639705882352942
Pune,Beet Root,2016,370,746,376,101.62162162162163
Nagpur,Jack Fruit,2015,1012,1388,376,37.15415019762846
Kille Dharur,BLACK GRAM,2016,5917,6293,376,6.354571573432483
Shirur,Green Gram,2016,4512,4888,376,8.333333333333334
Dound,Sorgum(Jawar),2016,1830,2206,376,20.546448087431695
Pandharpur,Banana,2016,1016,1392,376,37.00787401574803
Vasai,Paddy-Unhusked,2015,1427,1803,376,26.3489838822705
Jalgaon,Gram,2015,3698,4074,376,10.167658193618172
Partur,Sorgum(Jawar),2015,1168,1544,376,32.19178082191781
Murtizapur,Gram,2015,3888,4263,375,9.645061728395062
Ghansawangi,Pigeon Pea (Tur),2015,4900,5275,375,7.653061224489796
Amalner,Sorgum(Jawar),2016,1453,1828,375,25.8086717136958
Pathari,Sorgum(Jawar),2016,1435,1810,375,26.13240418118467
Jamkhed,Black Gram,2015,4990,5365,375,7.515030060120241
Morshi,Pigeon Pea (Tur),2015,4740,5115,375,7.9113924050632916
Shahapur,Cucumber,2016,1633,2008,375,22.963870177587264
Mahur,Ground Nut Pods (Dry),2016,4654,5029,375,8.05758487322733
Aurangabad,Flower,2015,850,1225,375,44.11764705882353
Morshi,Gram,2016,4800,5175,375,7.8125
Mahur,Gram,2016,4400,4775,375,8.522727272727273
Pune-Manjri,Kardai,2016,600,975,375,62.5
Loha,Wheat(Husked),2015,1550,1925,375,24.193548387096776
Dhamangaon-Rly,Gram,2015,3797,4172,375,9.876218066894918
Balapur,Sorgum(Jawar),2015,1175,1550,375,31.914893617021278
Nashik,Melon,2016,300,675,375,125.0
Buldhana,Wheat(Husked),2015,1425,1800,375,26.31578947368421
Ramtek,Harbara(Pendi),2016,1775,2150,375,21.12676056338028
Achalpur,Wheat(Husked),2015,1400,1775,375,26.785714285714285
Jintur,Green Gram,2015,7025,7400,375,5.338078291814947
Shirur,Gram,2016,6438,6813,375,5.824790307548929
Nagbhid,Paddy-Unhusked,2015,1673,2048,375,22.414823670053796
Balapur,Wheat(Husked),2015,1400,1775,375,26.785714285714285
Amarawati-Fruit And Vegetables,Cluster Bean,2016,3525,3900,375,10.638297872340425
Ambad(Vadi Godri),Bajri,2015,1106,1481,375,33.90596745027125
Shegaon,Mustard,2015,3214,3589,375,11.667703795892969
Indapur-Bhigwan,Horse Gram,2014,2976,3351,375,12.600806451612904
Parli-Vaijnath,Pigeon Pea (Tur),2015,6950,7325,375,5.39568345323741
Patan,Ladies Finger,2016,1375,1750,375,27.272727272727273
Karanja,Wheat(Husked),2015,1407,1782,375,26.652452025586353
Sillod-Bharadi,SOYBEAN,2016,2300,2675,375,16.304347826086957
Paranda,Black Gram,2016,7150,7525,375,5.244755244755245
Lonand,Gram,2016,7925,8300,375,4.73186119873817
Kalyan,Cucumber,2016,1633,2008,375,22.963870177587264
Nandura,Black Gram,2015,6588,6963,375,5.692167577413479
Indapur-Bhigwan,Bajri,2015,1425,1800,375,26.31578947368421
Rahata,Mango(Raw),2016,3125,3500,375,12.0
Akole,Bajri,2015,1425,1800,375,26.31578947368421
Akole,Bajri,2015,1375,1750,375,27.272727272727273
Amarawati,Sunflower,2016,5500,5875,375,6.818181818181818
Akole,Bajri,2014,1375,1750,375,27.272727272727273
Lonand,Sorgum(Jawar),2015,1563,1938,375,23.99232245681382
Nandura,Wheat(Husked),2016,1463,1838,375,25.63226247436774
Shrirampur,Tomato,2014,996,1371,375,37.65060240963855
Vai,GREEN CHILLI,2016,1355,1730,375,27.675276752767527
Khed-Chakan,POTATO,2016,763,1138,375,49.1480996068152
Karad,Pavtta,2015,1850,2225,375,20.27027027027027
Solapur,Jaggery,2015,2067,2442,375,18.1422351233672
Mumbai,Ladies Finger,2016,1315,1690,375,28.517110266159698
Tumsar,Sarsav,2016,3061,3436,375,12.250898399215943
Latur,Green Gram,2016,6548,6923,375,5.726939523518632
Kolhapur,Orange,2016,1100,1475,375,34.09090909090909
Purna,Green Gram,2016,4606,4981,375,8.14155449413808
Kolhapur-Laxmipuri,Green Gram,2016,7865,8240,375,4.767959313413859
Khed-Chakan,Potato,2016,1117,1492,375,33.572068039391226
Sinner,Sorgum(Jawar),2016,1418,1793,375,26.445698166431594
Pune-Pimpri,Wheat(Husked),2016,1825,2200,375,20.54794520547945
Kalamb (Os),Soybean,2016,3386,3761,375,11.075014766686355
Amarawati,Green Chilli,2016,3833,4208,375,9.783459431254892
Vani,Gram,2014,1900,2275,375,19.736842105263158
Telhara,Gram,2016,6256,6631,375,5.994245524296675
Akkolkot,Pigeon Pea (Tur),2016,5956,6331,375,6.2961719274681
Sinner,Pigeon Pea (Tur),2015,7574,7949,375,4.951148666490626
Mantha,Pigeon Pea (Tur),2016,7975,8350,375,4.702194357366771
Nagpur,Brinjal,2016,1350,1725,375,27.77777777777778
Sinner,Bajri,2015,1000,1375,375,37.5
Chalisgaon,SOYBEAN,2016,2195,2570,375,17.084282460136674
Kopargaon,Wheat(Husked),2016,1486,1861,375,25.235531628532975
Majalgaon,Sorgum(Jawar),2016,1369,1744,375,27.39225712198685
Aarni,Gram,2015,2942,3317,375,12.746430999320191
Aurad Shahajani,Pigeon Pea (Tur),2016,8991,9366,375,4.170837504170837
Baramati,Jaggery,2015,2280,2655,375,16.44736842105263
Hadgaon,Pigeon Pea (Tur),2016,7955,8330,375,4.714016341923319
Vai,Cucumber,2015,1425,1800,375,26.31578947368421
Indapur,Bajri,2016,1600,1975,375,23.4375
Jalgaon Jamod-Aasalgaon,Wheat(Husked),2016,1425,1800,375,26.31578947368421
Kalyan,Onion,2014,850,1225,375,44.11764705882353
Lonar,Pigeon Pea (Tur),2016,6463,6838,375,5.802259012842334
Bhor,Rice(Paddy-Hus),2015,3625,4000,375,10.344827586206897
Amarawati,Sorgum(Jawar),2016,1763,2138,375,21.27056154282473
Rahuri-Vambori,Gram,2014,2285,2660,375,16.411378555798688
Ghatanji,Pigeon Pea (Tur),2015,4670,5045,375,8.029978586723768
Amarawati,Ground Nut Pods (Dry),2015,3925,4300,375,9.554140127388536
Buldhana-Dhad,Gram,2016,5250,5625,375,7.142857142857143
Kalvan,Ground Nut Pods (Dry),2015,5350,5725,375,7.009345794392523
Shevgaon-Bodhegaon,Bajri,2016,995,1370,375,37.688442211055275
Nagpur,Parwar,2015,675,1050,375,55.55555555555556
Udgir,Pigeon Pea (Tur),2015,6680,7055,375,5.61377245508982
Shevgaon,Gram,2014,2070,2445,375,18.115942028985508
Barshi,Cucumber,2016,283,658,375,132.5088339222615
Rahata,Bor,2014,2250,2625,375,16.666666666666668
Kinwat,Pigeon Pea (Tur),2016,8513,8888,375,4.405027604839657
Jalgaon Jamod,Ground Nut Pods (Dry),2015,4775,5150,375,7.853403141361256
Pune-Moshi,Cucumber,2016,633,1007,374,59.08372827804107
Aurangabad,Lemon,2014,883,1257,374,42.355605889014726
Phaltan,Tomato,2016,394,768,374,94.9238578680203
Manora,Gram,2016,4793,5167,374,7.803046108908825
Raver,Gram,2014,2147,2521,374,17.419655333022824
Pune-Moshi,Flower,2016,803,1177,374,46.57534246575342
Barshi,Tomato,2016,253,627,374,147.82608695652175
Shrirampur,Chikoo,2015,1461,1835,374,25.598904859685145
Jalna,Bajri,2015,1008,1382,374,37.1031746031746
Mumbai,Capsicum,2015,2904,3278,374,12.878787878787879
Jalgaon,Jaggery,2015,2063,2437,374,18.128938439166262
Kopargaon,Soybean,2015,2820,3194,374,13.26241134751773
Latur,Soybean,2016,3457,3831,374,10.818628868961527
Babhulgaon,Soybean,2016,3406,3780,374,10.980622431004111
Malkapur,Onion,2016,350,724,374,106.85714285714286
Jamkhed,Wheat(Husked),2015,1850,2224,374,20.216216216216218
Manmad,Bajri,2014,1170,1544,374,31.965811965811966
Nanded,Safflower,2016,2001,2375,374,18.69065467266367
Chandrapur-Ganjwad,Brinjal,2014,404,778,374,92.57425742574257
Jamkhed,Wheat(Husked),2014,1918,2292,374,19.499478623566215
Mehkar,Soybean,2016,3481,3855,374,10.74403906923298
Pathari,Wheat(Husked),2016,1851,2225,374,20.2052944354403
Akluj,Banana,2016,460,834,374,81.30434782608695
Malkapur,Soybean,2015,2931,3305,374,12.76015011941317
Partur,Sorgum(Jawar),2015,1329,1703,374,28.141459744168547
Shrirampur,Wheat(Husked),2014,1371,1745,374,27.279358132749817
Baramati,Sunflower,2014,2875,3249,374,13.008695652173913
Nandurbar,Sorgum(Jawar),2015,1277,1651,374,29.28739232576351
Baramati,Bajri,2016,1602,1976,374,23.3458177278402
Kalyan,Onion,2016,663,1037,374,56.41025641025641
Parola,Maize,2016,886,1260,374,42.21218961625282
Savner,Ground Nut Pods (Dry),2015,4413,4787,374,8.47496034443689
Umarkhed,Soybean,2016,3213,3587,374,11.640211640211641
Nagpur,Tomato,2016,1852,2226,374,20.194384449244062
Sinner,Bajri,2016,1434,1808,374,26.08089260808926
Shrirampur,Sorgum(Jawar),2014,1544,1918,374,24.22279792746114
Kalyan,Bitter Gourd,2015,2911,3285,374,12.84781861903126
Devala,Maize,2016,1041,1415,374,35.92699327569645
Bhokar,Bajri,2014,1261,1635,374,29.659000793021413
Digras,Soybean,2016,2535,2909,374,14.7534516765286
Ramtek,Flower,2016,1648,2022,374,22.694174757281555
Kalmeshwar,Coriander  ,2016,5064,5438,374,7.385466034755134
Vai,Flower,2016,1793,2167,374,20.858895705521473
Baramati,Wheat(Husked),2014,1626,2000,374,23.001230012300123
Murtizapur,Gram,2014,2394,2767,373,15.580618212197159
Karanja,Soybean,2015,3271,3644,373,11.403240599205136
Satara,Bottle Gourd,2016,854,1227,373,43.676814988290396
Amarawati,Green Chilli,2016,3440,3813,373,10.843023255813954
Dondaicha,Pigeon Pea (Tur),2015,5007,5380,373,7.449570601158379
Kada,Gram,2014,2317,2690,373,16.098403107466552
Tumsar,Pigeon Pea (Tur),2015,5537,5910,373,6.736499909698392
Aurangabad,Lemon,2015,845,1218,373,44.142011834319526
Anajngaon Surji,Gram,2014,2525,2898,373,14.772277227722773
Pune,Lentil,2016,6236,6609,373,5.981398332264272
Rahata,Carrot,2014,1282,1655,373,29.09516380655226
Ausa,Sorgum(Jawar),2015,1686,2059,373,22.123368920521944
Chandur Bajar,Sorgum(Jawar),2015,1250,1623,373,29.84
Jalgaon,Jaggery,2016,2526,2899,373,14.766429136975455
Pune-Moshi,Tomato,2016,687,1060,373,54.29403202328967
Risod,Pigeon Pea (Tur),2015,7121,7494,373,5.238028366802415
Umarkhed-Danki,Soybean,2016,3200,3573,373,11.65625
Umared,Soybean,2016,3263,3636,373,11.431198283787925
Mumbai,Bottle Gourd,2015,796,1169,373,46.85929648241206
Navapur,Tomato,2016,610,983,373,61.14754098360656
Karad,Bitter Gourd,2016,970,1343,373,38.45360824742268
Kurdwadi-Modnimb,Maize,2016,1720,2093,373,21.686046511627907
Nandurbar,Wheat(Husked),2014,1424,1797,373,26.1938202247191
Satara,Cabbage,2015,452,825,373,82.52212389380531
Ramtek,Coriander  ,2016,874,1247,373,42.67734553775744
Latur,Bajri,2014,1171,1544,373,31.853116994022205
Karad,Bottle Gourd,2016,815,1188,373,45.76687116564417
Rahata,Bor,2014,1119,1492,373,33.333333333333336
Bhivandi,Wheat(Husked),2016,1858,2231,373,20.07534983853606
Mohol,Sorgum(Jawar),2015,1568,1941,373,23.788265306122447
Vadgaon Peth,Tomato,2015,433,806,373,86.14318706697459
Lasalgaon-Vinchur,Wheat(Husked),2016,1661,2034,373,22.456351595424444
Anajngaon Surji,Soybean,2016,3075,3448,373,12.130081300813009
Nagpur,Flower,2016,953,1326,373,39.1395592864638
Jalna,Wheat(Husked),2015,1806,2179,373,20.653377630121817
Dondaicha-Sindkheda,Gram,2016,5330,5703,373,6.99812382739212
Jalgaon,Black Gram,2014,5122,5495,373,7.282311597032409
Kannad,Wheat(Husked),2016,1635,2008,373,22.813455657492355
Ramtek,Cabbage,2016,1357,1729,372,27.413411938098747
Manwat,Sorgum(Jawar),2015,1374,1746,372,27.074235807860262
Jamkhed,Soybean,2015,3302,3674,372,11.265899454875832
Sangali,Soybean,2015,3057,3429,372,12.168792934249264
Raver,Wheat(Husked),2015,1134,1506,372,32.804232804232804
Satara,Cucumber,2015,972,1344,372,38.27160493827161
Achalpur,Pigeon Pea (Tur),2016,6007,6379,372,6.192775095721658
Amarawati,Ladies Finger,2016,2771,3143,372,13.424756405629736
Mul,Paddy-Unhusked,2014,2210,2582,372,16.832579185520363
Kolhapur-Laxmipuri,Bajri,2016,1938,2310,372,19.195046439628484
Mudkhed,Pigeon Pea (Tur),2016,7928,8300,372,4.692230070635722
Parola,Sorgum(Jawar),2016,964,1336,372,38.58921161825726
Morshi,Pigeon Pea (Tur),2015,5481,5853,372,6.787082649151615
Bhokar,Sesamum,2014,8956,9328,372,4.1536400178651185
Pandharkawada,SOYBEAN,2016,2386,2758,372,15.59094719195306
Pune-Pimpri,Capsicum,2015,2214,2586,372,16.802168021680217
Babhulgaon,Soybean,2016,3486,3858,372,10.671256454388985
Pune,Sorgum(Jawar),2015,2476,2848,372,15.024232633279484
Majalgaon,Bajri,2016,1411,1783,372,26.364280652019843
Mahagaon,Cotton,2016,4038,4410,372,9.212481426448736
Shrirampur,Papai,2015,914,1286,372,40.70021881838074
Kannad,Wheat(Husked),2016,1661,2033,372,22.39614689945816
Aurangabad,Brinjal,2015,1039,1411,372,35.803657362848895
Nandura,Soybean,2016,2855,3227,372,13.029772329246935
Kopargaon,Sorgum(Jawar),2015,1309,1681,372,28.418640183346067
Mumbai,Elephant Root,2015,2488,2860,372,14.95176848874598
Karad,Flower,2016,1032,1404,372,36.04651162790697
Lasur Station,Wheat(Husked),2015,1468,1840,372,25.340599455040874
Manchar,Methi (Bhaji),2016,151,523,372,246.35761589403972
Pune,Gr.Nut Kernels,2016,8202,8574,372,4.535479151426482
Nandurbar,Bajri,2016,1184,1555,371,31.33445945945946
Amarawati,Papai,2014,1600,1971,371,23.1875
Ghoti,BRINJAL,2016,983,1354,371,37.741607324516785
Malegaon (Washim),Black Gram,2016,6850,7221,371,5.416058394160584
Kannad,Pigeon Pea (Tur),2016,7229,7600,371,5.132106792087425
Nagpur,Ginger (Fresh),2015,2746,3117,371,13.510560815731974
Nandurbar,Cluster Bean,2016,2692,3063,371,13.781575037147103
Digras,Gram,2016,7413,7784,371,5.004721435316336
Ausa,Sorgum(Jawar),2016,1472,1843,371,25.203804347826086
Nagbhid,Paddy-Unhusked,2015,1638,2009,371,22.64957264957265
Amarawati,Bajri,2016,1640,2011,371,22.621951219512194
Umarkhed-Danki,Gram,2015,3800,4171,371,9.763157894736842
Nandurbar,Wheat(Husked),2016,1494,1865,371,24.832663989290495
Jalna,Bajri,2015,1056,1427,371,35.13257575757576
Majalgaon,Wheat(Husked),2014,1237,1608,371,29.991915925626515
Majalgaon,Bajri,2016,1468,1839,371,25.272479564032697
Karad,Potato,2015,1000,1371,371,37.1
Sengaon,Green Gram,2015,6036,6407,371,6.146454605699138
Parli-Vaijnath,Pigeon Pea (Tur),2014,3899,4270,371,9.515260323159785
Nagpur,Small Gourd,2016,1050,1421,371,35.333333333333336
Manora,Soybean,2014,3043,3414,371,12.19191587249425
Kurdwadi-Modnimb,Maize,2016,1687,2058,371,21.991701244813278
Kille Dharur,Bajri,2016,1637,2008,371,22.663408674404398
Kille Dharur,Black Gram,2016,5972,6343,371,6.212324179504353
Ahmedpur,Pigeon Pea (Tur),2015,6666,7037,371,5.565556555655566
Chakur,Sorgum(Jawar),2016,1923,2294,371,19.292771710868436
Kalamb (Os),Sorgum(Jawar),2015,1553,1924,371,23.889246619446233
Shirur,Green Gram,2016,4315,4686,371,8.597914252607184
Lasur Station,BAJRI,2016,1159,1530,371,32.01035375323555
Pusad,Wheat(Husked),2016,1753,2124,371,21.16371933827724
Patan,Flower,2014,1543,1914,371,24.04406999351912
Shrirampur,Soybean,2014,2889,3260,371,12.841813776393217
Nandura,Soybean,2014,2950,3321,371,12.576271186440678
Washim,Green Gram,2015,6779,7150,371,5.4727835964006495
Washim,Pigeon Pea (Tur),2015,4793,5164,371,7.740454829960359
Latur,Sorgum(Jawar),2016,1568,1939,371,23.660714285714285
Vani,Gram,2016,5232,5603,371,7.090978593272172
Sinner,Bajri,2015,1029,1400,371,36.054421768707485
Umared,Soybean,2016,2528,2899,371,14.675632911392405
Mumbai,SUGAR,2016,3561,3932,371,10.418421791631564
Aarni,Black Gram,2015,8165,8536,371,4.543784445805266
Risod,Green Gram,2015,6610,6981,371,5.612708018154311
Shrirampur,CUCUMBER,2016,924,1295,371,40.15151515151515
Pusad,Pigeon Pea (Tur),2014,5046,5417,371,7.352358303606818
Kada,Bajri,2015,1250,1621,371,29.68
Navapur,Brinjal,2016,1629,2000,371,22.774708410067525
Kalyan,Papai,2016,1088,1459,371,34.099264705882355
Sakri,Sesamum,2016,6203,6574,371,5.980976946638723
Vaduj,Green Gram,2014,6429,6800,371,5.770726396018043
Ausa,Soybean,2015,3368,3739,371,11.01543942992874
Murtizapur,Gram,2016,3968,4339,371,9.349798387096774
Kille Dharur,Wheat(Husked),2016,2106,2477,371,17.61633428300095
Lasur Station,Sorgum(Jawar),2016,1551,1921,370,23.855577047066408
Kolhapur-Laxmipuri,Spilt Gerrn Gram,2016,9205,9575,370,4.019554589896795
Akluj,Water Melon,2015,320,690,370,115.625
Purna,Turmeric,2015,7163,7533,370,5.165433477593187
Akluj,Banana,2015,475,845,370,77.89473684210526
Beed,Soybean,2016,2573,2943,370,14.380101049358725
Amarawati,Onion,2016,366,736,370,101.09289617486338
Nagpur,Wheat(Husked),2015,1628,1998,370,22.727272727272727
Ramtek,Chavli (Shenga ),2015,1039,1409,370,35.6111645813282
Mumbai,Green Chilli,2016,3166,3536,370,11.686670878079596
Umarga,Bajri,2016,900,1270,370,41.111111111111114
Ramtek,Coriander  ,2015,1052,1422,370,35.17110266159696
Ramtek,Cluster Bean,2015,1180,1550,370,31.35593220338983
Udgir,Pigeon Pea (Tur),2016,9019,9389,370,4.102450382525779
Manchar,Bottle Gourd,2016,910,1280,370,40.65934065934066
Akluj,Cabbage,2015,420,790,370,88.0952380952381
Pathardi,Chino,2015,4130,4500,370,8.958837772397095
Pune-Pimpri,Bottle Gourd,2016,1170,1540,370,31.623931623931625
Kalyan,Papai,2016,1023,1393,370,36.168132942326494
Osmanabad,Cabbage,2015,648,1018,370,57.098765432098766
Kada,Gram,2015,4110,4480,370,9.002433090024331
Varora,Cotton,2015,3799,4169,370,9.739405106607002
Karanja,Wheat(Husked),2016,1545,1915,370,23.948220064724918
Shegaon,Green Gram,2014,5542,5912,370,6.676290147961025
Washim,Gram,2015,3287,3657,370,11.256464861575905
Kalyan,Papai,2015,1213,1583,370,30.50288540807914
Pathari,Green Gram,2016,4289,4659,370,8.62671951503847
Gangapur,Soybean,2014,2950,3320,370,12.542372881355933
Nagpur,Raddish,2016,1215,1585,370,30.45267489711934
Parbhani,Wheat(Husked),2015,1480,1850,370,25.0
Mumbai,Carrot,2015,1400,1770,370,26.428571428571427
Aurangabad,Papai,2015,1000,1370,370,37.0
Palus,Squash Gourd,2016,1280,1650,370,28.90625
Gevrai,Black Gram,2016,5804,6174,370,6.3749138525155065
Dound,SORGUM(JAWAR),2016,2237,2607,370,16.540008940545373
Umared,Gram,2015,2920,3290,370,12.67123287671233
Washim,Gram,2016,7918,8288,370,4.672897196261682
Parli-Vaijnath,Pigeon Pea (Tur),2014,4000,4370,370,9.25
Aurangabad,Cucumber,2015,630,1000,370,58.73015873015873
Nilanga,Black Gram,2016,6450,6820,370,5.736434108527132
Jalna,Banana,2015,280,650,370,132.14285714285714
Jintur,Wheat(Husked),2015,1371,1741,370,26.98760029175784
Karad,Bottle Gourd,2014,1015,1385,370,36.45320197044335
Bhandara,Other Cereals,2015,3400,3770,370,10.882352941176471
Kalyan,Tomato,2016,1465,1835,370,25.255972696245735
Jalgaon,Cluster Bean,2015,2762,3131,369,13.359884141926141
Pusad,Wheat(Husked),2016,1516,1885,369,24.34036939313984
Nagpur,Ground Nut Pods (Dry),2014,2977,3346,369,12.395028552233793
Kalamb (Yawatmal),Pigeon Pea (Tur),2016,7526,7895,369,4.903002923199574
Kopargaon,Soybean,2015,2898,3267,369,12.732919254658386
Beed,Wheat(Husked),2015,1634,2003,369,22.582619339045287
Balapur,Gram,2015,3694,4063,369,9.989171629669734
Nandura,Soybean,2014,2967,3336,369,12.43680485338726
Karanja,Soybean,2014,2960,3329,369,12.466216216216216
Nagpur,Cluster Bean,2016,1284,1653,369,28.738317757009344
Ramtek,Bitter Gourd,2015,1554,1923,369,23.745173745173744
Jalgaon,Carrot,2015,881,1250,369,41.88422247446084
Shirpur,Sorgum(Jawar),2014,1347,1716,369,27.394209354120267
Mumbai,Shevga,2016,1631,2000,369,22.624156958920906
Himayatnagar,Soybean,2015,3165,3534,369,11.658767772511847
Pune,Gram,2015,4796,5165,369,7.693911592994162
Lasalgaon,Wheat(Husked),2015,1517,1886,369,24.324324324324323
Jintur,Soybean,2014,2820,3189,369,13.085106382978724
Nagpur,Bitter Gourd,2014,2158,2527,369,17.099165894346616
Lasur Station,Bajri,2016,1129,1498,369,32.683790965456154
Savner,Gram,2016,6302,6671,369,5.85528403681371
Pune,Sorgum(Jawar),2015,2327,2696,369,15.857327030511389
Dhule,Wheat(Husked),2016,1609,1978,369,22.93349906774394
Malkapur,Wheat(Husked),2016,1540,1909,369,23.961038961038962
Shrigonda,Green Gram,2016,5029,5398,369,7.337442831576854
Umared,Mustard,2015,2642,3011,369,13.9666919000757
Kalyan,Ghevda,2015,2369,2738,369,15.576192486281132
Chandur Rly.,Soybean,2016,3309,3678,369,11.15140525838622
Beed,Sorgum(Jawar),2015,1569,1938,369,23.518164435946463
Pune-Manjri,Onion,2016,600,969,369,61.5
Jalgaon,Onion,2016,212,581,369,174.0566037735849
Mukhed,Pigeon Pea (Tur),2016,8625,8994,369,4.278260869565218
Kada,Soybean,2015,3388,3757,369,10.891381345926801
Ramtek,Green Chilli,2015,1745,2114,369,21.146131805157594
Jalgaon,Cucumber,2016,1206,1575,369,30.597014925373134
Panvel,Cabbage,2016,2495,2864,369,14.789579158316633
Shrirampur,Tomato,2016,869,1238,369,42.462600690448795
Kolhapur-Laxmipuri,Split Black Gram,2016,15335,15704,369,2.4062601891098794
Latur,Bajri,2015,1366,1735,369,27.013177159590043
Nagpur,Wal Bhaji,2014,2156,2525,369,17.115027829313544
Nagpur,Mosambi,2016,1685,2054,369,21.899109792284868
Kille Dharur,Sorgum(Jawar),2015,2070,2439,369,17.82608695652174
Tumsar,Wheat(Husked),2016,1476,1845,369,25.0
Ghoti,Cucumber,2014,969,1338,369,38.080495356037154
Ambad(Vadi Godri),Bajri,2015,1170,1538,368,31.45299145299145
Pune,Cabbage,2015,350,718,368,105.14285714285714
Dhule,Wheat(Husked),2014,1347,1715,368,27.319970304380103
Shrirampur,Sorgum(Jawar),2015,1613,1981,368,22.81463112213267
Vita,GREEN CHILLI,2016,852,1220,368,43.1924882629108
Dhule,Sorgum(Jawar),2014,1433,1801,368,25.680390788555478
Sangli-Phale Bhajipalam,Potato,2015,614,982,368,59.93485342019544
Varud,Cotton,2015,3716,4084,368,9.903121636167922
Nandura,Soybean,2015,3209,3577,368,11.467746961670302
Jintur-Bori,Soybean,2015,3334,3702,368,11.037792441511698
Karad,Banana,2016,632,1000,368,58.22784810126582
Nandura,Gram,2014,2208,2576,368,16.666666666666668
Kalyan,Capsicum,2015,2491,2859,368,14.773183460457648
Mumbai-Fruit Market,Mosambi,2016,1420,1788,368,25.91549295774648
Khamgaon,Lemon,2014,90,458,368,408.8888888888889
Ambejogai,Gram,2015,3146,3514,368,11.697393515575333
Vai,Flower,2016,1636,2004,368,22.493887530562347
Murtizapur,Pigeon Pea (Tur),2016,7776,8144,368,4.732510288065844
Parbhani,Pigeon Pea (Tur),2015,5196,5564,368,7.082371054657429
Kalamb (Os),SORGUM(JAWAR),2016,1599,1967,368,23.014383989993746
Amarawati,Dhemse,2016,3723,4091,368,9.88450174590384
Kalyan,Cabbage,2016,2120,2488,368,17.358490566037737
Manchar,Flower,2016,233,601,368,157.93991416309012
Nagpur,Bottle Gourd,2015,540,908,368,68.14814814814815
Malkapur,Gram,2014,2192,2560,368,16.78832116788321
Arvi,Gram,2016,5433,5801,368,6.773421682311798
Vaijapur,Bajri,2014,1117,1485,368,32.945389435989256
Karanja,Sorgum(Jawar),2015,1200,1568,368,30.666666666666668
Mumbai,Snake Gourd,2016,784,1152,368,46.93877551020408
Pune-Pimpri,Flower,2015,1100,1468,368,33.45454545454545
Nanded,Ground Nut Pods (Dry),2016,4922,5290,368,7.4766355140186915
Gevrai,Pigeon Pea (Tur),2014,4744,5112,368,7.75716694772344
Lasur Station,Wheat(Husked),2015,1529,1897,368,24.06801831262263
Mangaon(Bhadav),Paddy-Unhusked,2014,1345,1713,368,27.360594795539033
Lasalgaon-Vinchur,Wheat(Husked),2016,1573,1941,368,23.394787031150667
Taloda,Maize,2016,1160,1528,368,31.724137931034484
Korpana,Soybean,2014,2853,3220,367,12.863652295828953
Vai,Tomato,2015,1504,1871,367,24.40159574468085
Karad,Potato,2015,733,1100,367,50.068212824010914
Paithan,Pigeon Pea (Tur),2016,5933,6300,367,6.185740771953481
Nashik,Cabbage,2016,441,808,367,83.21995464852608
Pune-Moshi,SWEET POTATO,2016,1300,1667,367,28.23076923076923
Karad,Bottle Gourd,2016,848,1215,367,43.278301886792455
Karad,Brinjal,2016,637,1004,367,57.6138147566719
Balapur,Wheat(Husked),2015,1300,1667,367,28.23076923076923
Barshi,Methi (Bhaji),2016,300,667,367,122.33333333333333
Mandhal,Soybean,2015,3112,3479,367,11.79305912596401
Hingoli,Gram,2015,3158,3525,367,11.62127929069031
Ramtek,Squash Gourd,2016,794,1161,367,46.221662468513856
Palus,Flower,2016,700,1067,367,52.42857142857143
Akhadabalapur,Pigeon Pea (Tur),2015,5300,5667,367,6.9245283018867925
Dhule,Wheat(Husked),2015,1480,1847,367,24.7972972972973
Shahapur,Brinjal,2014,1433,1800,367,25.610607117934403
Phaltan,Bajri,2016,1450,1817,367,25.310344827586206
Shahapur,Brinjal,2014,933,1300,367,39.335476956055736
Rahata,Bitter Gourd,2015,1483,1850,367,24.747134187457856
Lasalgaon-Niphad,Onion,2016,105,472,367,349.5238095238095
Amarawati-Fruit And Vegetables,Onion,2016,317,684,367,115.77287066246056
Shrigonda,Gram,2016,5589,5956,367,6.5664698514940065
Murtizapur,Soybean,2015,3369,3736,367,10.893440189967349
Kada,Bajri,2016,1579,1946,367,23.24255858138062
Buldhana,Gram,2015,4300,4667,367,8.534883720930232
Kada,Green Gram,2015,7233,7600,367,5.0739665422369695
Kalyan,Cucumber,2015,1133,1500,367,32.3918799646955
Dound,Gram,2015,3522,3889,367,10.420215786484953
Pusad,Gram,2014,2054,2421,367,17.86757546251217
Amalner,Gram,2015,3717,4084,367,9.87355394135055
Pune-Pimpri,Walvad,2015,2322,2689,367,15.805340223944874
Kalyan,Brinjal,2015,2481,2848,367,14.79242241031842
Nagpur,SORGUM(JAWAR),2016,1500,1867,367,24.466666666666665
Achalpur,Green Gram,2016,5800,6167,367,6.327586206896552
Kalyan,Ladies Finger,2016,2233,2600,367,16.435288849081953
Kalyan,Bajri,2015,1500,1867,367,24.466666666666665
Ahmednagar,Potato,2015,500,867,367,73.4
Kalyan,Wheat(Husked),2016,1933,2300,367,18.986032074495604
Umarga,Gram,2015,3349,3716,367,10.958495073156167
Nandgaon Khandeshwar,Pigeon Pea (Tur),2016,6300,6667,367,5.825396825396825
Akhadabalapur,Ground Nut Pods (Dry),2015,4550,4917,367,8.065934065934066
Shevgaon-Bodhegaon,Sorgum(Jawar),2014,1548,1915,367,23.70801033591731
Akluj,Water Melon,2015,573,940,367,64.04886561954625
Panvel,Brinjal,2016,2233,2600,367,16.435288849081953
Pune,Sweet Potato,2016,1633,2000,367,22.473974280465402
Satara,Potato,2015,700,1067,367,52.42857142857143
Panvel,Ladies Finger,2016,2333,2700,367,15.730818688384055
Shevgaon,Green Gram,2015,5433,5800,367,6.7550156451316035
Pune,Nolkol,2016,500,867,367,73.4
Nagpur,LADIES FINGER,2016,1193,1560,367,30.762782900251466
Shirpur,Matki,2016,5300,5667,367,6.9245283018867925
Rahata,Cucumber,2015,800,1167,367,45.875
Aurangabad,Kharbuj,2014,1800,2167,367,20.38888888888889
Patur,Pigeon Pea (Tur),2016,8531,8898,367,4.301957566522096
Latur,Sorgum(Jawar),2015,1835,2202,367,20.0
Sinner,Sorgum(Jawar),2016,1386,1753,367,26.47907647907648
Pune-Pimpri,Bottle Gourd,2015,1133,1500,367,32.3918799646955
Partur,Pigeon Pea (Tur),2015,4909,5276,367,7.476064371562436
Chandrapur-Ganjwad,Pumpkin,2014,800,1167,367,45.875
Akluj,Cabbage,2015,475,842,367,77.26315789473684
Nagpur,Raddish,2015,554,921,367,66.24548736462094
Akluj,Potato,2016,1361,1728,367,26.965466568699487
Devala,Onion,2016,462,829,367,79.43722943722943
Nagpur,Cucumber,2016,1579,1946,367,23.24255858138062
Sillod-Bharadi,Black Gram,2016,6200,6567,367,5.919354838709677
Chandrapur-Ganjwad,Ladies Finger,2016,1033,1400,367,35.52758954501452
Ahmednagar,Jaggery,2016,2333,2700,367,15.730818688384055
Telhara,Gram,2016,6513,6880,367,5.63488407799785
Panvel,Ghosali(Bhaji),2016,3581,3948,367,10.248533929070092
Kalyan,Potato,2015,1787,2153,366,20.481253497481813
Manchar,Farshi,2015,2617,2983,366,13.985479556744364
Shrirampur,POTATO,2016,929,1295,366,39.39720129171152
Nagpur,Cluster Bean,2015,1330,1696,366,27.518796992481203
Aurangabad,Bottle Gourd,2016,607,973,366,60.29654036243822
Kalyan,LEMON,2016,1717,2083,366,21.31624927198602
Chandvad,BITTER GOURD,2016,579,945,366,63.21243523316062
Kej,Bajri,2016,1383,1749,366,26.464208242950107
Dound,Wheat(Husked),2015,1510,1876,366,24.23841059602649
Shirpur,Chillies(Red),2016,1224,1590,366,29.901960784313726
Nashik-Devlali,Shepu,2016,397,763,366,92.19143576826197
Pune-Moshi,Walvad,2016,1617,1983,366,22.634508348794064
Loha,GREEN GRAM,2016,4150,4516,366,8.819277108433734
Panvel,Flower,2016,1667,2033,366,21.955608878224353
Akluj,Potato,2016,1405,1771,366,26.04982206405694
Pune,Sorgum(Jawar),2015,2390,2756,366,15.313807531380753
Kej,Gram,2015,4084,4450,366,8.961802154750245
Barshi,Kanda Pat,2016,417,783,366,87.76978417266187
Manchar,Onion,2016,290,656,366,126.20689655172414
Khed-Chakan,Coriander  ,2016,567,933,366,64.55026455026454
Panvel,Cabbage,2016,1367,1733,366,26.77395757132407
Karanja,Wheat(Husked),2016,1496,1862,366,24.46524064171123
Buldhana,Wheat(Husked),2016,1392,1758,366,26.29310344827586
Lonand,Wheat(Husked),2015,1470,1836,366,24.897959183673468
Mantha,Pigeon Pea (Tur),2015,5267,5633,366,6.948927283083349
Nagpur,Chavli (Pala),2016,1067,1433,366,34.301780693533274
Jawala-Bajar,Pigeon Pea (Tur),2015,8367,8733,366,4.37432771602725
Shegaon,Soybean,2015,3049,3415,366,12.003935716628403
Risod,Pigeon Pea (Tur),2015,6368,6734,366,5.74748743718593
Latur-Murud,Wheat(Husked),2016,1467,1833,366,24.948875255623722
Amarawati-Fruit And Vegetables,Chavli (Shenga ),2016,3067,3433,366,11.933485490707533
Chandrapur-Ganjwad,Ladies Finger,2015,967,1333,366,37.849017580144775
Chandrapur-Ganjwad,Ladies Finger,2015,767,1133,366,47.71838331160365
Akola,Sorgum(Jawar),2015,1164,1530,366,31.443298969072163
Jalgaon,Maize(Corn.),2016,867,1233,366,42.21453287197232
Majalgaon,Gram,2015,3672,4038,366,9.967320261437909
Murbad,Ghosali(Bhaji),2016,3867,4233,366,9.464701318851823
Sillod,Gram,2015,3767,4133,366,9.715954340323865
Nandurbar,Cluster Bean,2016,3050,3416,366,12.0
Shevgaon,Gram,2015,3685,4051,366,9.932157394843962
Shevgaon,Sorgum(Jawar),2015,1179,1545,366,31.043256997455472
Chakur,Green Gram,2016,5103,5469,366,7.1722516166960615
Shrigonda,Wheat(Husked),2015,1509,1875,366,24.254473161033797
Rahuri-Vambori,Sorgum(Jawar),2016,1384,1750,366,26.44508670520231
Wardha,Gram,2016,3749,4115,366,9.76260336089624
Paithan,Wheat(Husked),2016,1639,2005,366,22.330689444783406
Lasalgaon,Wheat(Husked),2014,1570,1935,365,23.248407643312103
Kamthi,Bottle Gourd,2016,262,627,365,139.31297709923663
Vai,Flower,2015,1535,1900,365,23.778501628664497
Kamthi,Tomato,2015,483,848,365,75.56935817805383
Pathardi,Bajri,2016,1285,1650,365,28.404669260700388
Tumsar,Pigeon Pea (Tur),2015,6062,6427,365,6.021115143516991
Mohol,Gram,2014,2075,2440,365,17.59036144578313
Pathardi,Sorgum(Jawar),2014,1535,1900,365,23.778501628664497
Lasur Station,Bajri,2016,1442,1807,365,25.312066574202497
Jalgaon,Cabbage,2014,700,1065,365,52.142857142857146
Jalgaon,Cabbage,2014,694,1059,365,52.59365994236311
Sakri,Gram,2016,3604,3969,365,10.127635960044396
Narkhed,Orange,2015,318,683,365,114.77987421383648
Pusad,Bajri,2015,1100,1465,365,33.18181818181818
Karad,Potato,2016,1481,1846,365,24.64550979068197
Bhokar,Gram,2015,3267,3632,365,11.172329354147536
Nagpur,Cucumber,2016,1805,2170,365,20.221606648199447
Amarawati,Sorgum(Jawar),2016,1718,2083,365,21.245634458672875
Kolhapur-Laxmipuri,Split Black Gram,2016,14205,14570,365,2.569517775431186
Savner,Gram,2015,3868,4233,365,9.436401240951396
Indapur (Nimgaon Ketki),Maize,2016,1374,1739,365,26.564774381368267
Jintur,Turmeric,2015,7297,7662,365,5.002055639303824
Hadgaon-Tamsa,Pigeon Pea (Tur),2016,7965,8330,365,4.58254865034526
Pandharpur,Cabbage,2016,270,635,365,135.1851851851852
Ashti (Jalna),Pigeon Pea (Tur),2016,8012,8377,365,4.555666500249625
Mumbai,Bottle Gourd,2015,1025,1390,365,35.609756097560975
Nandurbar,Wheat(Husked),2016,1500,1865,365,24.333333333333332
Shahada,Sorgum(Jawar),2015,1503,1868,365,24.28476380572189
Kalyan,Rice(Paddy-Hus),2016,2645,3010,365,13.799621928166351
Mumbai,Arvi,2015,929,1294,365,39.28955866523143
Dound,Wheat(Husked),2016,1631,1996,365,22.378908645003065
Nilanga,Soybean,2016,3587,3952,365,10.175634234736549
Kada (Ashti),Bajri,2016,1154,1519,365,31.629116117850952
Shirpur,Bajri,2016,1442,1807,365,25.312066574202497
Shegaon,Soybean,2014,2937,3302,365,12.427647259107934
Navapur,Tomato,2016,536,901,365,68.09701492537313
Solapur,Green Peas (Dry),2015,3321,3686,365,10.990665462210178
Junnar-Otur,Onion,2016,740,1105,365,49.32432432432432
Nagpur,Flower,2016,1085,1450,365,33.64055299539171
Satara,Bitter Gourd,2015,1745,2110,365,20.916905444126076
Satara,Bottle Gourd,2015,577,942,365,63.258232235701904
Sangrampur,Sorgum(Jawar),2015,1025,1390,365,35.609756097560975
Dhule,Bajri,2015,1064,1428,364,34.21052631578947
Karad,Shevga,2016,1024,1388,364,35.546875
Jalgaon,Green Gram,2015,6443,6807,364,5.649542138755238
Pulgaon,Soybean,2014,2937,3301,364,12.393598910452843
Dhule,SOYBEAN,2016,2326,2690,364,15.649183147033535
Nagpur,Potato,2015,674,1038,364,54.00593471810089
Sillod,Gram,2016,3636,4000,364,10.011001100110011
Mumbai,Capsicum,2016,1516,1880,364,24.010554089709764
Panvel,Cabbage,2016,2618,2982,364,13.903743315508022
Nandura,Soybean,2015,3097,3461,364,11.75330965450436
Aurangabad,Ladies Finger,2015,1052,1416,364,34.60076045627376
Kolhapur,Raddish,2016,405,769,364,89.87654320987654
Shevgaon,Sorgum(Jawar),2014,1380,1744,364,26.3768115942029
Manwat,Green Gram,2015,6937,7301,364,5.247225025227044
Manmad,Bajri,2016,1193,1557,364,30.511316010058675
Washim,Soybean,2016,3476,3840,364,10.47180667433832
Chandrapur-Ganjwad,Cabbage,2015,529,893,364,68.80907372400756
Pandharpur,Cabbage,2016,286,650,364,127.27272727272727
Jalgaon,Papai,2016,442,806,364,82.3529411764706
Murtizapur,Gram,2015,4186,4550,364,8.695652173913043
Malkapur,Onion,2016,306,670,364,118.95424836601308
Bhandara,Indian Bean,2016,2394,2758,364,15.2046783625731
Wardha,Soybean,2015,2891,3255,364,12.590799031476998
Vadgaon Peth,Bottle Gourd,2015,533,897,364,68.29268292682927
Manchar,Walvad,2016,700,1064,364,52.0
Lasalgaon-Vinchur,Wheat(Husked),2016,1540,1904,364,23.636363636363637
Tuljapur,SOYBEAN,2016,2276,2640,364,15.992970123022847
Manora,Soybean,2015,3050,3414,364,11.934426229508198
Satara,Flower,2016,436,800,364,83.4862385321101
Mumbai,Ladies Finger,2015,1744,2108,364,20.871559633027523
Rahata,GINGER (FRESH),2016,1227,1591,364,29.665851670741645
Kamthi,Chavli (Pala),2016,313,677,364,116.29392971246007
Malkapur,Soybean,2015,2840,3204,364,12.816901408450704
Yeotmal,Pigeon Pea (Tur),2014,4641,5005,364,7.8431372549019605
Rahata,Brinjal,2015,693,1057,364,52.525252525252526
Junnar,Onion,2016,443,807,364,82.16704288939052
Vasai,Paddy-Unhusked,2015,1423,1787,364,25.579761068165848
Satana,Wheat(Husked),2015,1423,1786,363,25.50948699929726
Lonand,Sorgum(Jawar),2015,1600,1963,363,22.6875
Anajngaon Surji,Gram,2015,3788,4151,363,9.582893347412883
Nagpur,Flower,2015,879,1242,363,41.29692832764505
Kej,Sorgum(Jawar),2016,1700,2063,363,21.352941176470587
Shrirampur,Tamarind,2015,1316,1679,363,27.583586626139816
Kalvan,Maize,2014,858,1221,363,42.30769230769231
Solapur,Soybean,2015,3471,3834,363,10.458081244598098
Amarawati,Mosambi,2015,1750,2113,363,20.742857142857144
Bhivandi,Wheat(Husked),2015,1706,2069,363,21.277842907385697
Panvel,Snake Gourd,2016,2682,3045,363,13.534675615212528
Kej,Sorgum(Jawar),2015,1799,2162,363,20.17787659811006
Jamner,Cotton,2016,3860,4223,363,9.404145077720207
Mumbai,Cabbage,2015,1015,1378,363,35.76354679802956
Sinner,BAJRI,2016,1409,1772,363,25.762952448545068
Ratanagari,Bottle Gourd,2015,500,863,363,72.6
Jalna,Soybean,2016,3286,3649,363,11.046865489957394
Pune,Flower,2016,328,691,363,110.67073170731707
Risod,Gram,2016,4114,4477,363,8.823529411764707
Pune-Moshi,POTATO,2016,1070,1433,363,33.925233644859816
Jintur,Sorgum(Jawar),2016,1374,1737,363,26.419213973799128
Malkapur,Onion,2016,289,652,363,125.60553633217994
Vai,Flower,2016,1478,1841,363,24.56021650879567
Kalyan,Ridge Gourd,2015,1875,2238,363,19.36
Kada,Bajri,2016,1525,1888,363,23.80327868852459
Barshi,Flower,2016,598,961,363,60.702341137123746
Mumbai,Shevga,2015,2129,2492,363,17.050258337247534
Nagpur,Tomato,2015,1788,2151,363,20.302013422818792
Chalisgaon,Wheat(Husked),2015,1500,1863,363,24.2
Daryapur,Green Gram,2016,6440,6803,363,5.636645962732919
Beed,Bajri,2014,1330,1693,363,27.293233082706767
Kannad,Maize,2016,1578,1941,363,23.00380228136882
Varud-Rajura Bazar,Pigeon Pea (Tur),2015,4736,5099,363,7.664695945945946
Jintur-Bori,Gram,2015,3695,4058,363,9.824086603518268
Chandrapur,Water Melon,2015,225,588,363,161.33333333333334
Mangrulpeer,Wheat(Husked),2015,1184,1547,363,30.658783783783782
Pusad,Pigeon Pea (Tur),2016,6290,6653,363,5.771065182829889
Khed-Chakan,Brinjal,2016,754,1117,363,48.143236074270554
Pune,Cabbage,2014,379,742,363,95.77836411609499
Pune,Gr.Nut Kernels,2016,9187,9550,363,3.951235441384565
Kalamb (Os),Sorgum(Jawar),2014,1322,1685,363,27.45839636913767
Rahuri-Vambori,Pigeon Pea (Tur),2015,4535,4898,363,8.004410143329658
Rahata,Tomato,2016,425,788,363,85.41176470588235
Mumbai,Flower,2015,796,1159,363,45.60301507537689
Pathardi,Gram,2015,3300,3663,363,11.0
Kille Dharur,Soybean,2016,3413,3775,362,10.606504541459127
Pathari,GREEN GRAM,2016,4190,4552,362,8.63961813842482
Nashik-Devlali,Shepu,2016,648,1010,362,55.864197530864196
Nandgaon Khandeshwar,Soybean,2015,3186,3548,362,11.362209667294414
Jalna,Bajri,2015,1087,1449,362,33.302667893284266
Ghoti,Flower,2016,1032,1394,362,35.07751937984496
Baramati,Ground Nut Pods (Dry),2016,3538,3900,362,10.231769361221028
Nagpur,Mango(Raw),2015,2895,3257,362,12.504317789291882
Satara,Potato,2016,1613,1975,362,22.442653440793553
Anajngaon Surji,Wheat(Husked),2016,1438,1800,362,25.17385257301808
Osmanabad,Onion,2016,656,1018,362,55.18292682926829
Ghoti,Brinjal,2015,1163,1525,362,31.12639724849527
Kalamb (Os),SESAMUM,2016,4659,5021,362,7.769907705516205
Akluj,Tomato,2015,700,1062,362,51.714285714285715
Tumsar,Pigeon Pea (Tur),2014,3605,3967,362,10.041608876560334
Loha,Wheat(Husked),2016,1500,1862,362,24.133333333333333
Malkapur,Wheat(Husked),2015,1368,1730,362,26.461988304093566
Washim,Gram,2015,2950,3312,362,12.271186440677965
Kada,Wheat(Husked),2015,1513,1875,362,23.92597488433576
Kej,Bajri,2015,1489,1851,362,24.311618535930155
Murbad,Capsicum,2016,1238,1600,362,29.24071082390953
Pathardi,Sorgum(Jawar),2016,1573,1935,362,23.013350286077557
Satara,Tomato,2015,638,1000,362,56.739811912225704
Balapur,Wheat(Husked),2016,1588,1950,362,22.79596977329975
Shrirampur,Cucumber,2015,996,1358,362,36.34538152610442
Nagpur,Parwar,2016,1092,1454,362,33.15018315018315
Pathardi,BAJRI,2016,1350,1712,362,26.814814814814813
Murbad,Brinjal,2016,913,1275,362,39.64950711938664
Dondaicha,Wheat(Husked),2016,1561,1923,362,23.19026265214606
Akkolkot,Pigeon Pea (Tur),2014,5001,5363,362,7.238552289542092
Malegaon,Wheat(Husked),2015,1482,1844,362,24.426450742240217
Karad,Ladies Finger,2015,913,1275,362,39.64950711938664
Majalgaon,Green Gram,2014,6444,6806,362,5.617628801986344
Kannad,Onion,2015,363,725,362,99.72451790633609
Mumbai,Ladies Finger,2015,2273,2635,362,15.926088869335679
Karmala,Wheat(Husked),2016,1701,2063,362,21.281599059376838
Nandurbar,Bajri,2015,1198,1560,362,30.21702838063439
Nandura,Wheat(Husked),2016,1526,1888,362,23.722149410222805
Malegaon (Washim),Gram,2015,4267,4629,362,8.483712209983596
Bhandara,Gram,2016,6774,7136,362,5.343962208444051
Kalamb (Os),Soybean,2015,3415,3777,362,10.600292825768667
Barshi,SOYBEAN,2016,2329,2691,362,15.543151567196222
Pandharpur,Coriander  ,2016,251,613,362,144.22310756972112
Mohol,Gram,2016,5157,5518,361,7.000193911188676
Lasalgaon,Wheat(Husked),2016,1756,2117,361,20.558086560364465
Yeotmal,Soybean,2016,3513,3874,361,10.276117278679191
Khed-Chakan,Flower,2016,600,961,361,60.166666666666664
Mumbai,Arvi,2016,908,1269,361,39.757709251101325
Bhandara,Green Gram,2016,5232,5593,361,6.899847094801223
Ahmednagar,Soybean,2014,2856,3217,361,12.640056022408963
Jintur,Cotton,2016,4177,4538,361,8.642566435240603
Rahata,Cabbage,2016,1654,2015,361,21.825876662636034
Jintur,Cotton,2016,4298,4659,361,8.399255467659376
Nagpur,Pumpkin,2015,527,888,361,68.50094876660341
Pusad,Wheat(Husked),2014,1480,1841,361,24.39189189189189
Malegaon,Wheat(Husked),2015,1448,1809,361,24.930939226519335
Kalyan,Ghevda,2016,1467,1828,361,24.608043626448534
Manchar,Shepu,2014,334,695,361,108.08383233532935
Baramati,Wheat(Husked),2015,1566,1927,361,23.05236270753512
Vani,Soybean,2016,3479,3840,361,10.37654498419086
Ausa,Gram,2016,4057,4418,361,8.898200640867636
Dhule,Bajri,2014,1055,1416,361,34.21800947867298
Mumbai,CARROT,2016,1008,1369,361,35.81349206349206
Kalmeshwar,Cotton,2015,3965,4326,361,9.104665825977301
Kille Dharur,Wheat(Husked),2016,1667,2028,361,21.655668866226755
Varud,Cotton,2016,4177,4538,361,8.642566435240603
Sinner,Soybean,2015,3373,3734,361,10.702638600652238
Malkapur,Wheat(Husked),2016,1708,2069,361,21.13583138173302
Dhule,Onion,2016,130,491,361,277.6923076923077
Nagpur,Flower,2014,1681,2042,361,21.47531231409875
Nagpur,Cucumber,2014,1562,1923,361,23.111395646606915
Chikhali,Soybean,2016,3580,3941,361,10.083798882681565
Mumbai,Bottle Gourd,2015,762,1123,361,47.3753280839895
Akola,Black Gram,2014,4275,4636,361,8.444444444444445
Akluj,Cabbage,2015,331,692,361,109.06344410876133
Mumbai,Ridge Gourd,2015,3100,3461,361,11.64516129032258
Gadhinglaj,Jaggery,2015,1582,1943,361,22.81921618204804
Nandurbar,Wheat(Husked),2015,1482,1843,361,24.358974358974358
Kej,Wheat(Husked),2015,1776,2137,361,20.326576576576578
Majalgaon,Wheat(Husked),2015,1589,1950,361,22.718691000629327
Taloda,Green Gram,2015,6510,6871,361,5.54531490015361
Umarga,Gram,2016,3889,4250,361,9.282591925944972
Mumbai,Sweet Potato,2015,917,1278,361,39.36750272628135
Dindori,Onion,2016,437,798,361,82.6086956521739
Kalyan,Ladies Finger,2015,2440,2800,360,14.754098360655737
Nagpur,Raddish,2016,944,1304,360,38.13559322033898
Kalyan,Indian Bean,2016,7960,8320,360,4.522613065326633
Akluj,Water Melon,2015,390,750,360,92.3076923076923
Paithan,Maize,2016,1731,2091,360,20.797227036395146
Jalgaon Jamod,Ground Nut Pods (Dry),2015,4860,5220,360,7.407407407407407
Kalyan,Ghevda,2016,2655,3015,360,13.559322033898304
Jalgaon Jamod,Ground Nut Pods (Dry),2014,2910,3270,360,12.371134020618557
Murtizapur,WHEAT(HUSKED),2016,1610,1970,360,22.36024844720497
Shirpur,Bajri,2016,1410,1770,360,25.53191489361702
Majalgaon,Bajri,2016,1290,1650,360,27.906976744186046
Kalyan,Carrot,2015,1720,2080,360,20.930232558139537
Kalyan,Elephant Root,2016,3172,3532,360,11.349306431273645
Digras,Wheat(Husked),2016,1492,1852,360,24.128686327077748
Kalyan,Ladies Finger,2015,1320,1680,360,27.272727272727273
Samudrapur,Soybean,2015,3000,3360,360,12.0
Indapur,Cowpea,2015,3740,4100,360,9.62566844919786
Kalyan,Elephant Root,2016,2240,2600,360,16.071428571428573
Akola,Sunflower,2016,3340,3700,360,10.778443113772456
Lasur Station,Bajri,2016,1367,1727,360,26.335040234089245
Dhule,Maize,2015,1003,1363,360,35.89232303090728
Dhule,Matki,2016,4460,4820,360,8.071748878923767
Kalmeshwar,Green Chilli,2016,4036,4396,360,8.919722497522299
Shegaon,Green Gram,2015,7050,7410,360,5.1063829787234045
Lonand,BAJRI,2016,1415,1775,360,25.441696113074205
Balapur,Sorgum(Jawar),2015,1315,1675,360,27.376425855513308
Mumbai,Arvi,2015,2627,2987,360,13.703844689760183
Amarawati,Green Gram,2015,7560,7920,360,4.761904761904762
Mumbai,Bitter Gourd,2014,2496,2856,360,14.423076923076923
Kalyan,Sorgum(Jawar),2016,1960,2320,360,18.367346938775512
Solapur,Cabbage,2016,199,559,360,180.90452261306532
Shirur,Gram,2014,2029,2389,360,17.742730409068507
Palus,Flower,2016,1020,1380,360,35.294117647058826
Sengaon,Black Gram,2016,6723,7083,360,5.35475234270415
Shahada,Wheat(Husked),2016,1471,1831,360,24.473147518694766
Mumbai,Flower,2016,812,1172,360,44.33497536945813
Jamkhed,Wheat(Husked),2015,1915,2275,360,18.798955613577025
Hingoli,Ground Nut Pods (Dry),2014,3503,3863,360,10.276905509563232
Gevrai,Gram,2016,4084,4444,360,8.81488736532811
Parbhani,Pigeon Pea (Tur),2016,8357,8717,360,4.307765944717004
Umarga,Green Gram,2015,6238,6598,360,5.771080474511061
Pune,Sorgum(Jawar),2016,2628,2988,360,13.698630136986301
Balapur,Sorgum(Jawar),2016,1240,1600,360,29.032258064516128
Solapur,Cabbage,2015,295,655,360,122.03389830508475
Nandura,GREEN GRAM,2016,4393,4753,360,8.194855451855224
Pathardi,Cotton,2015,4030,4390,360,8.933002481389579
Ahmednagar,Pigeon Pea (Tur),2016,6387,6747,360,5.6364490371066225
Malegaon,Matki,2015,7700,8060,360,4.675324675324675
Chandrapur-Ganjwad,Spinach,2015,920,1280,360,39.130434782608695
Aurangabad,Cucumber,2015,508,868,360,70.86614173228347
Amarawati-Fruit And Vegetables,Potato,2016,667,1027,360,53.973013493253376
Akot,Gram,2016,3986,4346,360,9.031610637230306
Lasalgaon,Sorgum(Jawar),2016,1254,1614,360,28.708133971291865
Nandgaon,Bajri,2016,1522,1882,360,23.653088042049934
Pune,Nolkol,2015,700,1060,360,51.42857142857143
Panvel,Brinjal,2016,1490,1850,360,24.161073825503355
Nagpur,Jack Fruit,2015,1224,1584,360,29.41176470588235
Akole,Soybean,2015,2880,3240,360,12.5
Udgir,Pigeon Pea (Tur),2016,8758,9118,360,4.110527517698104
Chandrapur,Gram,2016,5353,5713,360,6.725200821968989
Chalisgaon,Wheat(Husked),2016,1440,1800,360,25.0
Manchar,Cabbage,2016,340,700,360,105.88235294117646
Pandharpur,Cabbage,2014,360,720,360,100.0
Chalisgaon,Flower,2016,1190,1550,360,30.252100840336134
Barshi-Vairag,Gram,2015,3775,4135,360,9.536423841059603
Bhivandi,Wheat(Husked),2015,1840,2200,360,19.565217391304348
Satara,Tomato,2015,428,788,360,84.11214953271028
Latur,BAJRI,2016,1250,1610,360,28.8
Hadgaon,Wheat(Husked),2015,1360,1720,360,26.470588235294116
Nagpur,Flower,2016,960,1320,360,37.5
Shahapur,Cucumber,2015,1285,1645,360,28.01556420233463
Jalgaon,Black Gram,2016,9740,10100,360,3.696098562628337
Vasai,Wheat(Husked),2016,1901,2260,359,18.88479747501315
Vaijapur,Sorgum(Jawar),2014,1250,1609,359,28.72
Ramtek,Flower,2015,1233,1592,359,29.115977291159773
Latur,Gram,2016,4216,4575,359,8.51518026565465
Umared,Soybean,2014,2917,3276,359,12.307164895440522
Satana,Soybean,2015,3227,3586,359,11.124883792996592
Manmad,Bajri,2016,1592,1951,359,22.550251256281406
Pandharpur,Cabbage,2014,482,841,359,74.48132780082987
Jalgaon,Carrot,2015,908,1267,359,39.5374449339207
Karad,Cucumber,2015,741,1100,359,48.44804318488529
Akot,Green Gram,2015,7457,7816,359,4.814268472576103
Pusad,Sorgum(Jawar),2015,1050,1409,359,34.19047619047619
Karad,Shevga,2015,2058,2417,359,17.444120505344994
Kalvan,Bajri,2014,1101,1460,359,32.606721162579476
Khed-Chakan,Potato,2016,611,970,359,58.756137479541735
Amarawati,Pigeon Pea (Tur),2016,8837,9196,359,4.062464637320358
Washim,Soybean,2014,2807,3166,359,12.789454934093339
Rahata,Gram,2015,3335,3694,359,10.764617691154422
Buldhana,Wheat(Husked),2016,1505,1864,359,23.853820598006646
Chandrapur-Ganjwad,Tomato,2016,180,539,359,199.44444444444446
Khed-Chakan,Chavli (Shenga ),2015,1944,2303,359,18.467078189300413
Karad,Tomato,2015,806,1165,359,44.540942928039705
Latur-Murud,Wheat(Husked),2015,1416,1775,359,25.353107344632768
Nandurbar,Bajri,2015,1093,1452,359,32.845379688929555
Jintur,Gram,2015,3743,4102,359,9.59123697568795
Osmanabad,Onion,2016,640,999,359,56.09375
Aurangabad,Cabbage,2015,658,1017,359,54.559270516717326
Mul,Paddy-Unhusked,2015,1908,2267,359,18.81551362683438
Vai,Green Chilli,2016,1605,1964,359,22.36760124610592
Washim,Green Gram,2015,5534,5893,359,6.487170220455367
Washim,Green Gram,2014,6078,6436,358,5.890095426127015
Washim,Pigeon Pea (Tur),2016,8450,8808,358,4.236686390532545
Jalna,Soybean,2014,2942,3300,358,12.168592794017675
Korpana,Soybean,2015,3327,3685,358,10.76044484520589
Latur-Murud,Wheat(Husked),2016,2071,2429,358,17.286335103814583
Akot,Gram,2016,5459,5817,358,6.557977651584539
Nagpur,Ladies Finger,2015,1350,1708,358,26.51851851851852
Tumsar,Jaggery,2015,2351,2709,358,15.22756273925989
Kalyan,Capsicum,2015,1869,2227,358,19.154628143392188
Akluj,Cabbage,2015,584,942,358,61.3013698630137
Dondaicha,Wheat(Husked),2015,1452,1810,358,24.65564738292011
Pune-Pimpri,Flower,2015,1388,1746,358,25.792507204610953
Nagpur,Jack Fruit,2015,1192,1550,358,30.033557046979865
Chandrapur,Soybean,2014,2832,3190,358,12.641242937853107
Vai,Brinjal,2014,1476,1834,358,24.254742547425476
Shahada,GREEN GRAM,2016,3910,4268,358,9.156010230179028
Shrirampur,Wheat(Husked),2015,1416,1774,358,25.282485875706215
Manora,Soybean,2015,3418,3776,358,10.473961380924518
Pachora,SOYBEAN,2016,2480,2838,358,14.435483870967742
Kamthi,Raddish,2015,321,679,358,111.52647975077882
Panvel,Carrot,2016,1667,2025,358,21.475704859028195
Barshi,Capsicum,2016,547,905,358,65.44789762340037
Rahuri-Vambori,GREEN GRAM,2016,4522,4880,358,7.916850950906679
Chandrapur-Ganjwad,Carrot,2016,371,729,358,96.49595687331536
Shegaon,Wheat(Husked),2016,1493,1851,358,23.978566644340255
Nagpur,Dhemse,2015,1473,1831,358,24.304141208418194
Shahada,Sorgum(Jawar),2015,1703,2061,358,21.021726365237814
Mumbai,Flower,2016,1654,2012,358,21.644498186215237
Pune-Pimpri,Ghosali(Bhaji),2015,2975,3333,358,12.033613445378151
Yeola,Maize,2016,1130,1488,358,31.68141592920354
Mumbai,Ridge Gourd,2015,2525,2883,358,14.178217821782178
Karanja,Soybean,2015,3573,3931,358,10.01959137979289
Shegaon,Black Gram,2015,6700,7058,358,5.343283582089552
Akola,Wheat(Husked),2015,1418,1776,358,25.24682651622003
Samudrapur,Soybean,2015,3017,3375,358,11.866092144514418
Ramtek,CLUSTER BEAN,2016,1450,1808,358,24.689655172413794
Kalvan,Maize,2015,1186,1544,358,30.18549747048904
Ambad(Vadi Godri),Green Gram,2016,4628,4986,358,7.73552290406223
Mumbai,Arvi,2015,1074,1432,358,33.333333333333336
Chalisgaon,Sunflower,2015,2750,3108,358,13.018181818181818
Achalpur,Gram,2015,4060,4418,358,8.817733990147783
Junnar (Narayangaon),Tomato,2016,84,442,358,426.1904761904762
Mohol,Pigeon Pea (Tur),2015,5000,5358,358,7.16
Shrirampur,Sorgum(Jawar),2015,1405,1763,358,25.480427046263344
Shirpur,Wheat(Husked),2015,1449,1807,358,24.706694271911662
Pune-Moshi,Carrot,2016,1652,2010,358,21.670702179176754
Tasgaon,Soybean,2015,3317,3675,358,10.792885137172144
Jintur-Bori,Gram,2014,1993,2351,358,17.962870045158052
Chandrapur-Ganjwad,Onion,2016,509,867,358,70.33398821218074
Pulgaon,SOYBEAN,2016,2485,2843,358,14.406438631790744
Achalpur,Pigeon Pea (Tur),2016,8426,8784,358,4.248753857108949
Partur,Pigeon Pea (Tur),2016,5499,5857,358,6.510274595380978
Pune-Moshi,Small Gourd,2016,2429,2786,357,14.697406340057636
Bhiwapur,Pigeon Pea (Tur),2016,6814,7171,357,5.239213384208981
Pandharpur,Banana,2016,961,1318,357,37.14880332986473
Tumsar,Other Pulses,2016,3221,3578,357,11.0835144365104
Ghoti,Tomato,2014,1119,1476,357,31.903485254691688
Sangli-Phale Bhajipalam,Potato,2015,700,1057,357,51.0
Umarkhed,Gram,2015,3814,4171,357,9.36025170424751
Lasalgaon-Vinchur,Wheat(Husked),2016,1519,1876,357,23.502304147465438
Ahmednagar,BAJRI,2016,1453,1810,357,24.5698554714384
Mumbai,Cabbage,2016,1826,2183,357,19.55093099671413
Rahuri,Melon,2016,143,500,357,249.65034965034965
Lonand,Bajri,2015,1281,1638,357,27.868852459016395
Baramati,Bajri,2015,1444,1801,357,24.722991689750693
Manora,Pigeon Pea (Tur),2016,8528,8885,357,4.186210131332083
Yeola,Bajri,2016,1551,1908,357,23.017408123791103
Kurdwadi-Modnimb,Maize,2016,1477,1834,357,24.170616113744074
Chandrapur-Ganjwad,Capsicum,2015,793,1150,357,45.01891551071879
Rahata,Lemon,2014,2214,2571,357,16.124661246612465
Bhokar,Gram,2016,4679,5036,357,7.629835434921992
Dhule,Wheat(Husked),2015,1268,1625,357,28.154574132492115
Gondpimpri,Pigeon Pea (Tur),2015,6300,6657,357,5.666666666666667
Kalmeshwar,Green Chilli,2015,2434,2791,357,14.66721446179129
Kamthi,Bottle Gourd,2016,312,669,357,114.42307692307692
Shrirampur,Wheat(Husked),2015,1401,1758,357,25.481798715203425
Bhivandi,Other Vegetables,2015,840,1197,357,42.5
Karad,Banana,2016,991,1348,357,36.02421796165489
Nagpur,Capsicum,2015,1885,2242,357,18.93899204244032
Sangali,Bajri,2016,1444,1801,357,24.722991689750693
Akot,SORGUM(JAWAR),2016,1213,1570,357,29.43116240725474
Mangalwedha,SORGUM(JAWAR),2016,2180,2537,357,16.376146788990827
Udgir,Black Gram,2015,10000,10357,357,3.57
Nandurbar,Wheat(Husked),2016,1516,1873,357,23.54881266490765
Rahata,Ground Nut Pods (Dry),2016,3500,3857,357,10.2
Nashik-Devlali,Methi (Bhaji),2016,544,901,357,65.625
Latur,Safflower,2014,2374,2731,357,15.037910699241786
Panvel,Ridge Gourd,2016,5914,6271,357,6.036523503550896
Sangrampur-Varvatbakal,GREEN GRAM,2016,4254,4611,357,8.392101551480959
Dound,Gram,2015,3610,3967,357,9.889196675900276
Pune-Pimpri,Cucumber,2016,1664,2021,357,21.454326923076923
Mumbai,Sugar,2015,2149,2506,357,16.612377850162865
Sindi (Selu),Wheat(Husked),2016,1430,1787,357,24.965034965034967
Manora,Pigeon Pea (Tur),2016,8568,8925,357,4.166666666666667
Mumbai,SQUASH GOURD,2016,1000,1357,357,35.7
Morshi,Gram,2015,4057,4414,357,8.799605619916194
Vai,Tomato,2014,1673,2030,357,21.338912133891213
Karad,Flower,2014,986,1343,357,36.206896551724135
Chandrapur-Ganjwad,Green Chilli,2016,391,748,357,91.30434782608695
Mumbai,Ladies Finger,2015,1862,2219,357,19.172932330827066
Navapur,Coriander  ,2016,1500,1857,357,23.8
Satara,Tomato,2016,535,892,357,66.72897196261682
Sangali,Wheat(Unhusked),2016,3757,4114,357,9.502262443438914
Jalgaon,Pigeon Pea (Tur),2016,7357,7714,357,4.8525214081826835
Mumbai,Snake Gourd,2015,711,1068,357,50.21097046413502
Aurangabad,Wal Bhaji,2016,981,1338,357,36.391437308868504
Murbad,BOTTLE GOURD,2016,1514,1871,357,23.57992073976222
Navapur,Brinjal,2016,1006,1363,357,35.487077534791254
Kalamb (Os),Green Gram,2016,4621,4978,357,7.725600519368102
Dound,Gram,2015,3942,4299,357,9.056316590563165
Jalgaon,Sorgum(Jawar),2016,1641,1997,356,21.694088970140157
Shahada,Wheat(Husked),2015,1551,1907,356,22.952933591231464
Kalyan,Shevga,2016,1438,1794,356,24.756606397774686
Junnar,Onion,2016,572,928,356,62.23776223776224
Gangapur,Gram,2016,5266,5622,356,6.760349411317888
Nagpur,Carrot,2014,2111,2467,356,16.86404547607769
Karad,Brinjal,2015,813,1169,356,43.788437884378844
Khed-Chakan,Onion,2016,469,825,356,75.90618336886993
Jalna,Banana,2015,411,767,356,86.61800486618004
Washim,Gram,2015,2668,3024,356,13.343328335832084
Solapur,Cabbage,2015,346,702,356,102.89017341040463
Nandurbar,Wheat(Husked),2015,1369,1725,356,26.004382761139517
Murtizapur,Gram,2014,2582,2938,356,13.787761425251743
Gevrai,Wheat(Husked),2015,1416,1772,356,25.141242937853107
Manchar,Shepu,2015,602,958,356,59.136212624584715
Panvel,Bitter Gourd,2016,4360,4716,356,8.1651376146789
Pune-Pimpri,Cucumber,2014,2200,2556,356,16.181818181818183
Patan,Tomato,2016,1161,1517,356,30.66322136089578
Varora,Soybean,2015,2850,3206,356,12.491228070175438
Umarga,Soybean,2016,2851,3207,356,12.486846720448966
Khed (Shel Pimpalgaon),GREEN CHILLI,2016,855,1211,356,41.63742690058479
Akluj,Tomato,2015,775,1131,356,45.935483870967744
Jintur,Gram,2014,2263,2619,356,15.731330092797172
Ambejogai,Black Gram,2015,11289,11645,356,3.153512268580034
Jalgaon,Black Gram,2015,7200,7556,356,4.944444444444445
Akluj,Brinjal,2015,525,881,356,67.80952380952381
Shegaon,Gram,2016,4089,4445,356,8.706285155294694
Pune,Gr.Nut Kernels,2015,7163,7519,356,4.969984643305877
Nagpur,CARROT,2016,1344,1700,356,26.488095238095237
Akola,Sorgum(Jawar),2014,1316,1672,356,27.051671732522795
Dhamangaon-Rly,Pigeon Pea (Tur),2014,4650,5006,356,7.655913978494624
Sinner,Bajri,2014,1137,1493,356,31.31046613896218
Telhara,PIGEON PEA (TUR),2016,5125,5481,356,6.946341463414634
Jalgaon,Tomato,2016,538,894,356,66.17100371747212
Vai,Flower,2016,1848,2204,356,19.264069264069263
Washim,Pigeon Pea (Tur),2016,6714,7070,356,5.302353291629431
Karad,Flower,2015,748,1104,356,47.593582887700535
Lasur Station,Wheat(Husked),2015,1517,1873,356,23.467369808833222
Shahada,Soybean,2014,2965,3320,355,11.97301854974705
Kille Dharur,BAJRI,2016,1219,1574,355,29.122231337161608
Dhule,Pigeon Pea (Tur),2016,4168,4523,355,8.517274472168905
Katol,Soybean,2014,2960,3315,355,11.993243243243244
Jalgaon,Cabbage,2016,650,1005,355,54.61538461538461
Anajngaon Surji,Wheat(Husked),2015,1335,1690,355,26.591760299625467
Khamgaon,Ground Nut Pods (Dry),2015,4902,5257,355,7.241942064463484
Mumbai-Fruit Market,Chikoo,2016,1130,1485,355,31.41592920353982
Varud-Rajura Bazar,Soybean,2016,3138,3493,355,11.31293817718292
Chandrapur,Gram,2014,2283,2638,355,15.549715286903197
Vaijapur,Wheat(Husked),2015,1604,1959,355,22.13216957605985
Rahata,Bitter Gourd,2016,656,1011,355,54.11585365853659
Malegaon (Washim),Soybean,2015,3433,3788,355,10.340809787357996
Digras,Pigeon Pea (Tur),2016,6229,6584,355,5.699149141114144
Chikhali,Soybean,2015,3126,3481,355,11.356365962891875
Murbad,Tomato,2016,1267,1622,355,28.01894238358327
Kolhapur-Laxmipuri,Green Gram,2016,8083,8438,355,4.391933687987134
Gangapur,Sorgum(Jawar),2015,1279,1634,355,27.756059421422986
Malegaon (Washim),Pigeon Pea (Tur),2016,8408,8763,355,4.2221693625118935
Gangapur,Sorgum(Jawar),2015,1335,1690,355,26.591760299625467
Pandharkawada,Soybean,2015,3244,3599,355,10.94327990135635
Vani,Cotton,2015,3655,4010,355,9.712722298221614
Indapur (Nimgaon Ketki),Gram,2016,4609,4964,355,7.702321544803645
Nilanga,Soybean,2015,3413,3768,355,10.401406387342513
Nira,Jaggery,2016,2974,3329,355,11.936785474108945
Osmanabad,Tomato,2016,456,811,355,77.85087719298245
Mumbai,Sugar,2015,2302,2657,355,15.421372719374457
Risod,Gram,2015,4105,4460,355,8.647990255785627
Nagpur,Potato,2015,752,1107,355,47.20744680851064
Aurangabad,Flower,2015,895,1250,355,39.66480446927374
Pune-Pimpri,Sorgum(Jawar),2015,2475,2830,355,14.343434343434344
Sengaon,PIGEON PEA (TUR),2016,5730,6085,355,6.195462478184991
Nagpur,Small Gourd,2016,1305,1660,355,27.203065134099617
Shegaon,Soybean,2015,3045,3400,355,11.658456486042693
Nagpur,Wal Bhaji,2016,1290,1645,355,27.51937984496124
Karad,Onion,2016,675,1030,355,52.592592592592595
Ghoti,Brinjal,2016,1216,1571,355,29.19407894736842
Indapur (Nimgaon Ketki),Sorgum(Jawar),2016,1504,1859,355,23.60372340425532
Sonpeth,Wheat(Husked),2016,1790,2145,355,19.83240223463687
Umared,Coriander (Dry),2015,10101,10456,355,3.5145035145035144
Solapur,Gram,2015,4276,4631,355,8.302151543498598
Vai,Cucumber,2016,1927,2282,355,18.42241826673586
Vai,Flower,2014,1617,1972,355,21.954236239950525
Pusad,Soybean,2014,2832,3187,355,12.535310734463277
Malkapur,Sorgum(Jawar),2016,1289,1644,355,27.540729247478666
Manchar,Cucumber,2016,518,873,355,68.53281853281854
Lonand,Sorgum(Jawar),2016,1710,2065,355,20.760233918128655
Telhara,Soybean,2015,3192,3546,354,11.090225563909774
Bhivandi,Rice(Paddy-Hus),2016,2029,2383,354,17.447018235584032
Chandvad,Onion,2016,185,539,354,191.35135135135135
Aurangabad,Capsicum,2016,863,1217,354,41.01969872537659
Vadgaon Peth,Cabbage,2014,369,723,354,95.9349593495935
Shevgaon,Sorgum(Jawar),2016,1764,2118,354,20.068027210884352
Savner,Pigeon Pea (Tur),2014,4233,4587,354,8.362863217576187
Karanja,Wheat(Husked),2015,1341,1695,354,26.39821029082774
Mumbai,Cucumber,2015,1467,1821,354,24.130879345603272
Murtizapur,Soybean,2014,2884,3238,354,12.274618585298198
Sangamner,Wheat(Husked),2015,1570,1924,354,22.547770700636942
Jalna,Bajri,2014,1134,1488,354,31.21693121693122
Arvi,Pigeon Pea (Tur),2015,5617,5971,354,6.302296599608332
Katol,Cotton,2016,4134,4488,354,8.563134978229318
Nagpur,Carrot,2016,1279,1633,354,27.677873338545737
Washim,Soybean,2014,3117,3471,354,11.357074109720886
Nandura,Wheat(Husked),2015,1385,1739,354,25.55956678700361
Amarawati-Fruit And Vegetables,Cabbage,2016,2446,2800,354,14.472608340147179
Mumbai,SNAKE GOURD,2016,667,1021,354,53.07346326836582
Kolhapur-Laxmipuri,Bajri,2016,1700,2054,354,20.823529411764707
Vani,Gram,2016,3799,4153,354,9.31824164253751
Beed,Wheat(Husked),2014,1497,1851,354,23.647294589178358
Satara,Bitter Gourd,2015,1054,1408,354,33.586337760910816
Satana,Bajri,2016,1669,2023,354,21.210305572198923
Khed-Chakan,Flower,2016,781,1135,354,45.32650448143406
Rahata,Bottle Gourd,2015,467,821,354,75.80299785867237
Kej,Green Gram,2015,7212,7566,354,4.908485856905158
Kopargaon,Wheat(Husked),2016,1455,1809,354,24.329896907216494
Kurdwadi,Green Gram,2016,4233,4587,354,8.362863217576187
Jintur,Sorgum(Jawar),2015,1109,1463,354,31.920649233543735
Kopargaon,Bajri,2015,1037,1391,354,34.13693346190935
Baramati,Wheat(Unhusked),2016,3200,3554,354,11.0625
Jalgaon,Wal Papdi,2015,1969,2323,354,17.97866937531742
Kille Dharur,Soybean,2015,3401,3755,354,10.40870332255219
Jamkhed,Wheat(Husked),2015,1899,2253,354,18.64139020537125
Babhulgaon,Gram,2015,2925,3279,354,12.102564102564102
Osmanabad,Soybean,2014,2940,3294,354,12.040816326530612
Sindkhed Raja,Sorgum(Jawar),2016,1291,1645,354,27.420604182804027
Jalgaon,Amla,2015,1091,1445,354,32.44729605866178
Baramati,Jaggery,2014,2437,2791,354,14.526056627000411
Shirpur,Sorgum(Jawar),2015,1227,1581,354,28.850855745721272
Mumbai,Bitter Gourd,2016,2608,2962,354,13.57361963190184
Sindi (Selu),Soybean,2016,3144,3498,354,11.259541984732824
Khamgaon,Soybean,2015,2926,3280,354,12.098427887901572
Karanja,Soybean,2015,3135,3489,354,11.291866028708133
Karad,Flower,2016,831,1185,354,42.59927797833935
Patur,Gram,2016,3853,4207,354,9.187645990137556
Varora,Gram,2016,3808,4162,354,9.296218487394958
Katol,Orange,2014,673,1027,354,52.600297176820206
Patan,Brinjal,2015,1450,1804,354,24.413793103448278
Bhokar,Pigeon Pea (Tur),2015,4715,5068,353,7.486744432661718
Murtizapur,Soybean,2015,3486,3839,353,10.126219162363741
Mumbai,Sweet Potato,2015,1212,1565,353,29.125412541254125
Mumbai,Carrot,2016,1285,1638,353,27.470817120622566
Amarawati,Potato,2016,658,1011,353,53.64741641337386
Mumbai,Ladies Finger,2016,1862,2215,353,18.95810955961332
Solapur,Sorgum(Jawar),2016,1939,2292,353,18.205260443527592
Parola,Bajri,2016,1379,1732,353,25.598259608411894
Digras,Pigeon Pea (Tur),2016,6576,6929,353,5.368004866180049
Baramati,Wheat(Husked),2015,1610,1963,353,21.925465838509318
Mehkar,Black Gram,2015,4579,4932,353,7.709106791875955
Yeotmal,Soybean,2016,3378,3731,353,10.449970396684428
Chandrapur,Soybean,2015,2881,3234,353,12.252690038181187
Partur,Soybean,2016,3328,3681,353,10.606971153846153
Aarni,Soybean,2015,2800,3153,353,12.607142857142858
Murtizapur,Pigeon Pea (Tur),2014,4674,5027,353,7.552417629439453
Kalyan,Carrot,2016,2135,2488,353,16.533957845433257
Yeotmal,Soybean,2016,3463,3816,353,10.193473866589661
Sonpeth,Gram,2016,4955,5308,353,7.124117053481332
Ausa,Sorgum(Jawar),2016,1495,1848,353,23.612040133779264
Wardha,Wheat(Husked),2016,1428,1781,353,24.719887955182074
Nandurbar,Bajri,2016,1347,1700,353,26.206384558277655
Katol,Gram,2015,3969,4322,353,8.89392794154699
Bhandara,Gram,2014,2367,2720,353,14.913392479932403
Hingoli,Soybean,2015,3212,3565,353,10.990037359900374
Loha,Pigeon Pea (Tur),2014,4534,4887,353,7.785619761799735
Vaijapur,Wheat(Husked),2015,1572,1925,353,22.455470737913487
Lasalgaon-Niphad,Soybean,2016,3704,4057,353,9.530237580993521
Kalyan,Elephant Root,2016,1800,2153,353,19.61111111111111
Manora,Gram,2016,3872,4225,353,9.116735537190083
Gadhinglaj,Jaggery,2016,3150,3502,352,11.174603174603174
Yeotmal,Green Gram,2015,6588,6940,352,5.343047965998785
Umarga,Gram,2015,4202,4554,352,8.37696335078534
Pune-Pimpri,Brinjal,2016,1924,2276,352,18.295218295218294
Osmanabad,Soybean,2014,2998,3350,352,11.741160773849233
Buldhana,Soybean,2014,2976,3328,352,11.827956989247312
Beed,Sorgum(Jawar),2015,1643,1995,352,21.424223980523433
Jalgaon,Gram,2016,4995,5347,352,7.047047047047047
Pune-Moshi,Ghosali(Bhaji),2016,1674,2026,352,21.02747909199522
Kamthi,Spinach,2016,348,700,352,101.14942528735632
Jalna,Pigeon Pea (Tur),2014,4626,4978,352,7.609165585819282
Ramtek,Capsicum,2015,1410,1762,352,24.9645390070922
Barshi,Tomato,2016,425,777,352,82.82352941176471
Sakri,Wheat(Husked),2016,1438,1790,352,24.478442280945757
Nagpur,Mosambi,2016,2511,2863,352,14.01831939466348
Arvi,Pigeon Pea (Tur),2016,8383,8735,352,4.198974114278898
Sangali,Bajri,2016,1498,1850,352,23.497997329773032
Katol,Soybean,2015,2923,3275,352,12.042422169004448
Ramtek,Tomato,2015,1729,2081,352,20.358588779641412
Aurangabad,Bottle Gourd,2014,537,889,352,65.54934823091247
Jamkhed,Wheat(Husked),2014,1879,2231,352,18.73336881319851
Bhivandi,Potato,2015,1101,1453,352,31.970935513169845
Jintur,Green Gram,2016,4558,4910,352,7.722685388328214
Aurangabad,Potato,2016,764,1116,352,46.07329842931937
Solapur,SORGUM(JAWAR),2016,2335,2687,352,15.074946466809422
Mehkar,Soybean,2016,3635,3987,352,9.68363136176066
Umared,Soybean,2015,3260,3612,352,10.797546012269938
Yeola,Pigeon Pea (Tur),2015,4979,5331,352,7.069692709379393
Mumbai,Ridge Gourd,2014,2568,2920,352,13.707165109034268
Kalamb (Os),Black Gram,2015,6932,7284,352,5.077899596076168
Vaijapur,Wheat(Husked),2015,1600,1952,352,22.0
Satara,Bottle Gourd,2016,861,1213,352,40.882694541231125
Ashti-Karanja,Pigeon Pea (Tur),2015,6550,6901,351,5.358778625954199
Lohara,Green Gram,2016,4700,5051,351,7.468085106382978
Tumsar,Jaggery,2016,3533,3884,351,9.934899518822531
Varud-Rajura Bazar,Gram,2015,4666,5017,351,7.5225032147449635
Nilanga,Soybean,2016,3515,3866,351,9.985775248933143
Khed,Methi (Bhaji),2016,1000,1351,351,35.1
Shevgaon,Wheat(Husked),2015,1280,1631,351,27.421875
Vita,Green Chilli,2016,763,1114,351,46.00262123197903
Sengaon,Pigeon Pea (Tur),2016,7994,8345,351,4.390793094821116
Khamgaon,Black Gram,2015,5353,5704,351,6.557070801419765
Nandgaon,Green Gram,2016,4200,4551,351,8.357142857142858
Nandgaon Khandeshwar,Green Gram,2016,4584,4935,351,7.657068062827225
Barshi-Vairag,Wheat(Husked),2015,1782,2133,351,19.696969696969695
Shevgaon,Bajri,2015,1141,1492,351,30.762489044697634
Khed (Shel Pimpalgaon),Cluster Bean,2014,3713,4064,351,9.453272286560733
Gangapur,Wheat(Husked),2016,1661,2012,351,21.131848284166164
Udgir,Green Gram,2016,4872,5223,351,7.204433497536946
Murum,Black Gram,2016,9273,9624,351,3.7851827887415075
Telhara,Green Gram,2016,4429,4780,351,7.92503951230526
Latur,Sorgum(Jawar),2016,1633,1984,351,21.49418248622168
Shirpur,Black Gram,2016,9629,9980,351,3.6452383425070103
Sangrampur-Varvatbakal,SOYBEAN,2016,2450,2801,351,14.326530612244898
Kalmeshwar,Tomato,2016,769,1120,351,45.64369310793238
Kalmeshwar,Cotton,2016,4273,4624,351,8.214369295576878
Vaijapur,Wheat(Husked),2014,1343,1694,351,26.135517498138498
Kille Dharur,Wheat(Husked),2015,1500,1851,351,23.4
Kopargaon,Sorgum(Jawar),2015,1070,1421,351,32.80373831775701
Nagpur,Wheat(Husked),2015,1678,2029,351,20.917759237187127
Pulgaon,Cotton,2016,4270,4621,351,8.220140515222482
Sinner,Soybean,2014,3014,3365,351,11.645653616456537
Baramati,Jaggery,2015,2178,2529,351,16.115702479338843
Katol,Pigeon Pea (Tur),2015,6515,6866,351,5.387567152724482
Dondaicha,Wheat(Husked),2016,1582,1933,351,22.18710493046776
Satana,Bajri,2016,1653,2004,351,21.234119782214155
Kopargaon,Bajri,2016,1520,1871,351,23.092105263157894
Pusad,Bajri,2015,1236,1587,351,28.398058252427184
Naigaon,Green Gram,2015,6850,7201,351,5.124087591240876
Chikhali,Green Gram,2015,5000,5351,351,7.02
Amarawati,Papai,2015,825,1175,350,42.42424242424242
Kurdwadi,Lemon,2015,100,450,350,350.0
Indapur (Nimgaon Ketki),Gram,2015,3350,3700,350,10.447761194029852
Indapur (Nimgaon Ketki),Bajri,2015,1288,1638,350,27.17391304347826
Nagpur,Parwar,2016,2450,2800,350,14.285714285714286
Kalyan,Mango,2015,3250,3600,350,10.76923076923077
Pune-Manjri,Cabbage,2016,650,1000,350,53.84615384615385
Yawal,Wheat(Husked),2016,1650,2000,350,21.21212121212121
Sangali,Wheat(Unhusked),2016,3258,3608,350,10.742786985880908
Babhulgaon,Gram,2014,2025,2375,350,17.28395061728395
Karad,Sweet Potato,2014,800,1150,350,43.75
Pune-Manjri,Cabbage,2016,650,1000,350,53.84615384615385
Anajngaon Surji,Black Gram,2014,4842,5192,350,7.228418009087154
Kalyan,Tomato,2015,1968,2318,350,17.784552845528456
Amarawati,Orange,2016,725,1075,350,48.275862068965516
Koregaon,Onion,2015,1500,1850,350,23.333333333333332
Aarni,Gram,2014,2225,2575,350,15.730337078651685
Aurangabad,Cucumber,2016,579,929,350,60.44905008635578
Palus,Tomato,2015,1100,1450,350,31.818181818181817
Vai,Pavata,2015,1792,2142,350,19.53125
Nagpur,Soybean,2016,3100,3450,350,11.290322580645162
Murbad,Capsicum,2015,3900,4250,350,8.974358974358974
Balapur,Sorgum(Jawar),2016,1300,1650,350,26.923076923076923
Bhokar,Black Gram,2016,8300,8650,350,4.216867469879518
Bhoom,Soybean,2016,3350,3700,350,10.447761194029852
Buldhana,Soybean,2014,2850,3200,350,12.280701754385966
Ramtek,Cluster Bean,2015,1525,1875,350,22.950819672131146
Shrigonda,SORGUM(JAWAR),2016,1767,2117,350,19.807583474816074
Karad,Cucumber,2015,900,1250,350,38.888888888888886
Karad,Brinjal,2015,1090,1440,350,32.11009174311926
Nira-Saswad,Gram,2016,3650,4000,350,9.58904109589041
Manchar,Wal Bhaji,2016,475,825,350,73.6842105263158
Parli-Vaijnath,Sorgum(Jawar),2014,1285,1635,350,27.237354085603112
Vai,Onion,2015,2250,2600,350,15.555555555555555
Malkapur,Chillies(Red),2014,1900,2250,350,18.42105263157895
Mumbai,Horse Gram,2015,3000,3350,350,11.666666666666666
Vaijapur,Gram,2015,3100,3450,350,11.290322580645162
Karad,Bottle Gourd,2015,800,1150,350,43.75
Shahada,Black Gram,2014,4974,5324,350,7.036590269400884
Atpadi,Sorgum(Jawar),2014,1700,2050,350,20.58823529411765
Achalpur,Pigeon Pea (Tur),2015,9167,9517,350,3.8180429802552633
Achalpur,Soybean,2015,3550,3900,350,9.859154929577464
Kamthi,Squash Gourd,2016,350,700,350,100.0
Karad,Bottle Gourd,2015,1000,1350,350,35.0
Raver,Pigeon Pea (Tur),2015,4442,4792,350,7.879333633498424
Phaltan,Jaggery,2015,2383,2733,350,14.68736886277801
Amarawati-Fruit And Vegetables,Onion,2016,341,691,350,102.63929618768329
Kalyan,Wheat(Husked),2015,1650,2000,350,21.21212121212121
Rahata,Potato,2016,1192,1542,350,29.36241610738255
Bhokardan-Pimpalgaon Renu,Pigeon Pea (Tur),2016,6950,7300,350,5.0359712230215825
Baramati,Bajri,2014,1450,1800,350,24.137931034482758
Vai,Tomato,2016,1542,1892,350,22.69779507133593
Karmala,Green Gram,2016,4556,4906,350,7.6821773485513605
Akhadabalapur,Pigeon Pea (Tur),2015,5525,5875,350,6.334841628959276
Bhivandi,Potato,2015,983,1333,350,35.60528992878942
Nagpur,Soybean,2016,2925,3275,350,11.965811965811966
Katol,Mosambi,2015,1271,1621,350,27.53737214791503
Jalgaon,Cabbage,2015,711,1061,350,49.226441631504926
Parbhani,Gram,2015,4140,4490,350,8.454106280193237
Solapur,Sorgum(Jawar),2016,1884,2234,350,18.577494692144374
Parli-Vaijnath,Soybean,2015,3449,3799,350,10.14786894752102
Nagpur,Bor,2016,436,786,350,80.27522935779817
Vai,Ridge Gourd,2016,1710,2060,350,20.46783625730994
Manchar,Bitter Gourd,2015,1750,2100,350,20.0
Jalgaon,Pigeon Pea (Tur),2015,4750,5100,350,7.368421052631579
Rahata,Ginger (Fresh),2016,2983,3333,350,11.733154542406973
Vai,Green Chilli,2016,1261,1611,350,27.755749405233942
Jafrabad,Soybean,2015,3000,3350,350,11.666666666666666
Lonand,Gram,2015,3575,3925,350,9.79020979020979
Pune-Manjri,Flower,2016,550,900,350,63.63636363636363
Akole,Paddy-Unhusked,2014,1450,1800,350,24.137931034482758
Navapur,METHI (BHAJI),2016,650,1000,350,53.84615384615385
Shrirampur,Fenugreek,2015,5201,5551,350,6.7294751009421265
Pune-Manjri,Flower,2016,550,900,350,63.63636363636363
Parbhani,Gram,2014,2150,2500,350,16.27906976744186
Ahmednagar,Bajri,2014,1400,1750,350,25.0
Aarni,Gram,2015,3700,4050,350,9.45945945945946
Aurangabad,Wal Bhaji,2015,1075,1425,350,32.55813953488372
Nandura,Sesamum,2016,4250,4600,350,8.235294117647058
Akole,Paddy-Unhusked,2015,1475,1825,350,23.728813559322035
Amarawati,Potato,2015,689,1039,350,50.79825834542816
Nandurbar,Chillies(Red),2015,7700,8050,350,4.545454545454546
Ratanagari,Bottle Gourd,2014,900,1250,350,38.888888888888886
Junnar,Potato,2015,750,1100,350,46.666666666666664
Shahapur,Brinjal,2015,950,1300,350,36.8421052631579
Aarni,Gram,2014,2225,2575,350,15.730337078651685
Taloda,Maize,2016,1000,1350,350,35.0
Ramtek,Chavli (Pala),2015,1650,2000,350,21.21212121212121
Manchar,Wal Papdi,2015,2500,2850,350,14.0
Ramtek,CUSTARD APPLE,2016,1000,1350,350,35.0
Dound,Green Gram,2016,4920,5270,350,7.1138211382113825
Kalyan,Ladies Finger,2016,1886,2236,350,18.55779427359491
Kalyan,Ladies Finger,2016,2300,2650,350,15.217391304347826
Aarni,Gram,2015,3800,4150,350,9.210526315789474
Shrirampur,Water Melon,2014,920,1270,350,38.04347826086956
Ramtek,Capsicum,2015,1625,1975,350,21.53846153846154
Kalyan,Bajri,2016,1650,2000,350,21.21212121212121
Jawala-Bajar,Pigeon Pea (Tur),2016,5525,5875,350,6.334841628959276
Osmanabad,Beet Root,2016,1000,1350,350,35.0
Kalyan,Guava,2016,2250,2600,350,15.555555555555555
Satana,Pigeon Pea (Tur),2016,7400,7750,350,4.72972972972973
Ahmednagar,Jaggery,2016,2325,2675,350,15.053763440860216
Malegaon (Washim),Pigeon Pea (Tur),2016,8546,8896,350,4.095483267025509
Junnar-Otur,Ghosali(Bhaji),2016,425,775,350,82.3529411764706
Ahmednagar,Bajri,2015,1350,1700,350,25.925925925925927
Mantha,Cotton,2016,4550,4900,350,7.6923076923076925
Amarawati,Green Gram,2016,4800,5150,350,7.291666666666667
Mumbai,Beet Root,2015,950,1300,350,36.8421052631579
Ambejogai,SORGUM(JAWAR),2016,1829,2179,350,19.136139967195188
Aurangabad,Awala,2016,1000,1350,350,35.0
Shrirampur,Brinjal,2015,917,1267,350,38.16793893129771
Kalyan,Ghevda,2015,2321,2671,350,15.079707022834985
Vai,Wal Papdi,2015,2500,2850,350,14.0
Vadgaon Peth,Tomato,2015,362,712,350,96.68508287292818
Shevgaon-Bodhegaon,Gram,2015,3783,4133,350,9.251916468411315
Ghansawangi,Cotton,2016,4500,4850,350,7.777777777777778
Gevrai,Mustard,2016,3050,3400,350,11.475409836065573
Manchar,Cabbage,2016,175,525,350,200.0
Kalyan,Flower,2015,950,1300,350,36.8421052631579
Nagpur,Linseed,2015,4100,4450,350,8.536585365853659
Amarawati,Sorgum(Jawar),2014,1500,1850,350,23.333333333333332
Kada,GRAM,2016,6675,7025,350,5.2434456928838955
Manchar,Cabbage,2015,563,913,350,62.16696269982238
Chandrapur-Ganjwad,Brinjal,2015,710,1060,350,49.29577464788732
Pune-Manjri,Onion,2016,650,1000,350,53.84615384615385
Amarawati,SORGUM(JAWAR),2016,1771,2121,350,19.76284584980237
Vai,Bottle Gourd,2016,1400,1750,350,25.0
Solapur,Coriander  ,2014,150,500,350,233.33333333333334
Kalyan,Potato,2014,2000,2350,350,17.5
Amarawati,Capsicum,2016,3580,3930,350,9.776536312849162
Patan,Cabbage,2016,1346,1696,350,26.00297176820208
Morshi,Gram,2016,5857,6207,350,5.9757555062318595
Jalgaon,Green Chilli,2016,455,805,350,76.92307692307692
Murbad,Ghosali(Bhaji),2016,1075,1425,350,32.55813953488372
Kalyan,Gr.Nut Kernels,2015,8000,8350,350,4.375
Solapur,Pigeon Pea (Tur),2015,8594,8944,350,4.072608796835001
Barshi,TURMERIC,2016,5905,6255,350,5.927180355630822
Ratanagari,Cabbage,2015,1075,1425,350,32.55813953488372
Dhule,Bajri,2015,1253,1603,350,27.932960893854748
Jalgaon Jamod-Aasalgaon,Soybean,2016,3167,3517,350,11.051468266498263
Manmad,Sorgum(Jawar),2016,1401,1751,350,24.982155603140615
Ghansawangi,Soybean,2016,3500,3850,350,10.0
Kurdwadi,Lemon,2016,100,450,350,350.0
Murbad,Bottle Gourd,2016,925,1275,350,37.83783783783784
Kalamnuri,SOYBEAN,2016,2442,2792,350,14.332514332514332
Ratanagari,Bottle Gourd,2016,500,850,350,70.0
Buldhana,Wheat(Husked),2016,1525,1875,350,22.950819672131146
Jalna,Bajri,2015,1216,1566,350,28.782894736842106
Murbad,Brinjal,2016,1875,2225,350,18.666666666666668
Khed-Chakan,Onion,2016,572,922,350,61.18881118881119
Ahmednagar,Soybean,2016,3300,3650,350,10.606060606060606
Kalvan,Gram,2016,3788,4138,350,9.239704329461457
Chalisgaon,Sorgum(Jawar),2014,1142,1492,350,30.64798598949212
Washim,Soybean,2016,3726,4076,350,9.39345142243693
Barshi-Vairag,Gram,2015,2500,2850,350,14.0
Pune-Pimpri,Wal Papdi,2016,2114,2464,350,16.556291390728475
Kalyan,Brinjal,2014,2300,2650,350,15.217391304347826
Shrigonda,Soybean,2016,2910,3260,350,12.027491408934708
Ghansawangi,Wheat(Husked),2014,1500,1850,350,23.333333333333332
Khed-Chakan,Cucumber,2016,523,873,350,66.92160611854685
Malkapur,Black Gram,2015,4975,5325,350,7.035175879396985
Vadgaon Peth,Carrot,2015,750,1100,350,46.666666666666664
Dindori-Vani,Onion,2016,535,885,350,65.42056074766356
Kada (Ashti),Gram,2015,3500,3850,350,10.0
Buldhana,WHEAT(HUSKED),2016,1438,1788,350,24.339360222531294
Ratanagari,Carrot,2015,1750,2100,350,20.0
Kalyan,Flower,2014,850,1200,350,41.1764705882353
Nashik,Cabbage,2014,251,601,350,139.4422310756972
Vadgaon Peth,Sweet Potato,2014,750,1100,350,46.666666666666664
Yawal,Ground Nut Pods (Dry),2016,4975,5325,350,7.035175879396985
Shrirampur,Tomato,2016,868,1218,350,40.32258064516129
Kurdwadi,Lemon,2016,100,450,350,350.0
Pune-Manjri,Tomato,2016,650,1000,350,53.84615384615385
Kada (Ashti),Pigeon Pea (Tur),2015,4600,4950,350,7.608695652173913
Panvel,Flower,2016,1230,1580,350,28.45528455284553
Patur,Soybean,2015,3192,3542,350,10.964912280701755
Vai,Cucumber,2015,1521,1871,350,23.011176857330703
Ramtek,Bottle Gourd,2015,650,1000,350,53.84615384615385
Sangamner,Bajri,2016,1440,1790,350,24.305555555555557
Mumbai,SHEVGA,2016,2504,2854,350,13.977635782747603
Umared,Sorgum(Jawar),2015,1567,1917,350,22.335673261008296
Yawal,Maize,2016,1118,1468,350,31.305903398926656
Nagpur,Nolkol,2015,750,1100,350,46.666666666666664
Barshi,Coriander  ,2014,450,800,350,77.77777777777777
Sangamner,Sorgum(Jawar),2015,1717,2067,350,20.3843913803145
Umared,Sorgum(Jawar),2015,1600,1950,350,21.875
Beed,Sorgum(Jawar),2016,1706,2056,350,20.5158264947245
Barshi,Coriander  ,2016,167,517,350,209.5808383233533
Amalner,Soybean,2016,2550,2900,350,13.72549019607843
Jalgaon Jamod-Aasalgaon,Gram,2016,7250,7600,350,4.827586206896552
Chandrapur-Ganjwad,Capsicum,2015,1200,1550,350,29.166666666666668
Indapur-Bhigwan,Sunflower,2015,2750,3100,350,12.727272727272727
Majalgaon,Cotton,2015,3850,4200,350,9.090909090909092
Kille Dharur,Sesamum,2016,5000,5350,350,7.0
Chandur Bajar,Sorgum(Jawar),2015,1200,1550,350,29.166666666666668
Rahata,Bitter Gourd,2015,1900,2250,350,18.42105263157895
Mohol,Maize,2015,1400,1750,350,25.0
Solapur,Matki,2016,6780,7130,350,5.162241887905605
Chandur Bajar,Wheat(Husked),2015,1300,1650,350,26.923076923076923
Barshi,Shepu,2016,400,750,350,87.5
Manora,Gram,2014,2250,2600,350,15.555555555555555
Mangalwedha,Gram,2016,5908,6258,350,5.924170616113744
Chandrapur-Ganjwad,Chavli (Pala),2015,790,1140,350,44.30379746835443
Manwat,Black Gram,2016,5900,6250,350,5.932203389830509
Satara,FLOWER,2016,814,1164,350,42.997542997543
Jalgaon,Melon,2014,500,850,350,70.0
Amarawati,Sunflower,2015,6300,6650,350,5.555555555555555
Umari,Green Gram,2015,6600,6950,350,5.303030303030303
Amarawati,Ginger (Fresh),2015,2900,3250,350,12.068965517241379
Manora,Green Gram,2016,4200,4550,350,8.333333333333334
Akluj,Banana,2015,250,600,350,140.0
Malegaon,Wheat(Husked),2016,1651,2000,349,21.13870381586917
Dhamangaon-Rly,Soybean,2016,2943,3292,349,11.858647638464152
Jalna,Green Gram,2015,7352,7701,349,4.747007616974972
Mantha,Pigeon Pea (Tur),2014,4301,4650,349,8.114392001860033
Manwat,Pigeon Pea (Tur),2016,7601,7950,349,4.591501118273912
Umarga,Paddy-Unhusked,2014,876,1225,349,39.84018264840183
Yeotmal,Soybean,2016,3089,3438,349,11.298154742635157
Majalgaon,Wheat(Husked),2016,1588,1937,349,21.977329974811084
Gevrai,Gram,2015,2957,3306,349,11.802502536354414
Aarni,Soybean,2014,2888,3237,349,12.084487534626039
Rahuri-Vambori,Bajri,2014,1262,1611,349,27.654516640253565
Nandurbar,Cluster Bean,2015,4044,4393,349,8.630069238377844
Shegaon,Sunflower,2014,2889,3238,349,12.08030460366909
Devala,Cowpea,2015,4218,4567,349,8.274063537221432
Akola,Soybean,2016,3123,3472,349,11.175152097342298
Majalgaon,Bajri,2015,1186,1535,349,29.42664418212479
Dondaicha,Wheat(Husked),2016,1432,1781,349,24.37150837988827
Nandgaon,Pigeon Pea (Tur),2016,6351,6700,349,5.495197606676114
Pusad,Wheat(Husked),2015,1518,1867,349,22.990777338603426
Dudhani,Pigeon Pea (Tur),2015,7265,7614,349,4.803854094975912
Kille Dharur,Soybean,2015,3508,3857,349,9.948688711516533
Nandurbar,Soybean,2014,2952,3301,349,11.822493224932249
Chandur Rly.,Pigeon Pea (Tur),2015,7086,7435,349,4.925204628845611
Mohol,Sorgum(Jawar),2015,1581,1930,349,22.074636306135357
Umarga,Black Gram,2015,5256,5605,349,6.640030441400304
Mehkar,Soybean,2016,3512,3861,349,9.937357630979498
Vadgaon Peth,Cabbage,2016,463,811,348,75.16198704103672
Satana,Bajri,2015,1403,1751,348,24.803991446899502
Karad,Potato,2015,938,1286,348,37.10021321961621
Pune-Moshi,Potato,2016,1538,1886,348,22.62678803641092
Sindi,Gram,2015,2978,3326,348,11.685695097380792
Mumbai,Capsicum,2015,2430,2778,348,14.320987654320987
Dound,Bajri,2014,1291,1639,348,26.955848179705654
Jalgaon,Cabbage,2014,576,924,348,60.416666666666664
Ramtek,Brinjal,2016,1333,1681,348,26.106526631657914
Khed-Chakan,Bottle Gourd,2016,737,1085,348,47.21845318860244
Babhulgaon,Soybean,2016,3079,3427,348,11.30237089964274
Devala,Bajri,2016,1607,1955,348,21.65525824517735
Shahada,Wheat(Husked),2016,1537,1885,348,22.641509433962263
Beed,Wheat(Husked),2016,1680,2028,348,20.714285714285715
Chandur Rly.,Soybean,2016,3287,3635,348,10.587161545482203
Karad,Capsicum,2016,830,1178,348,41.9277108433735
Amarawati,Sorgum(Jawar),2016,1810,2158,348,19.226519337016576
Osmanabad,Soybean,2015,2979,3327,348,11.681772406847935
Jalna,Black Gram,2014,4973,5321,348,6.997788055499698
Nandura,Soybean,2015,2971,3319,348,11.71322786940424
Parli-Vaijnath,Pigeon Pea (Tur),2016,8078,8426,348,4.307997028967566
Mumbai,Capsicum,2014,2815,3163,348,12.36234458259325
Katol,Gram,2016,3703,4051,348,9.39778557926006
Mumbai,Bottle Gourd,2015,1339,1687,348,25.989544436146378
Shrirampur,Carrot,2015,809,1157,348,43.016069221260814
Murtizapur,Green Gram,2015,6848,7196,348,5.081775700934579
Gangapur,Wheat(Husked),2016,1663,2011,348,20.926037282020445
Lasur Station,Wheat(Husked),2014,1491,1839,348,23.34004024144869
Karad,Banana,2016,871,1219,348,39.954075774971294
Ulhasnagar,Banana,2016,387,735,348,89.92248062015504
Lasalgaon-Vinchur,Maize,2015,1131,1479,348,30.76923076923077
Arvi,Soybean,2016,3501,3849,348,9.940017137960583
Karad,Bor,2015,1048,1396,348,33.20610687022901
Vita,Green Chilli,2016,852,1200,348,40.84507042253521
Sonpeth,Pigeon Pea (Tur),2014,4375,4723,348,7.954285714285715
Nagpur,Jack Fruit,2016,965,1313,348,36.06217616580311
Akluj,Cabbage,2016,325,673,348,107.07692307692308
Jalna,Bajri,2016,1670,2018,348,20.838323353293415
Murtizapur,Soybean,2016,3354,3702,348,10.37567084078712
Pune,Wheat(Husked),2016,1926,2274,348,18.068535825545172
Karad,Cabbage,2015,700,1048,348,49.714285714285715
Sonpeth,Sorgum(Jawar),2016,1590,1938,348,21.88679245283019
Loha,Sorgum(Jawar),2014,1340,1688,348,25.970149253731343
Nagpur,Chavli (Shenga ),2016,1053,1400,347,32.95346628679962
Mumbai,Bottle Gourd,2015,1015,1362,347,34.1871921182266
Barshi-Vairag,Green Gram,2016,4263,4610,347,8.13980764719681
Sinner,Bajri,2015,1133,1480,347,30.62665489849956
Nira,Jaggery,2015,2825,3172,347,12.283185840707965
Lasur Station,Wheat(Husked),2015,1432,1779,347,24.231843575418996
Panvel,Bottle Gourd,2016,2312,2659,347,15.008650519031141
Ratanagari,Cabbage,2014,1042,1389,347,33.30134357005758
Lasalgaon,Wheat(Husked),2016,1723,2070,347,20.139291932675565
Ahmedpur,Pigeon Pea (Tur),2015,8727,9074,347,3.9761659218517247
Bhokar,Sesamum,2015,7187,7534,347,4.828161959092807
Pune-Moshi,Ghosali(Bhaji),2016,2260,2607,347,15.353982300884956
Ausa,Wheat(Husked),2014,1439,1786,347,24.113968033356496
Aurad Shahajani,Pigeon Pea (Tur),2016,8961,9308,347,3.872335676821783
Kada,Wheat(Husked),2015,1491,1838,347,23.272971160295103
Shegaon,Green Gram,2015,7158,7505,347,4.847722827605477
Gevrai,Soybean,2016,2474,2821,347,14.02586903799515
Tumsar,Jaggery,2014,2888,3235,347,12.015235457063712
Dhule,Wheat(Husked),2016,1679,2026,347,20.66706372840977
Malegaon,Bajri,2014,1251,1598,347,27.737809752198242
Nagpur,Brinjal,2016,1074,1421,347,32.30912476722533
Ausa,Wheat(Husked),2014,1442,1789,347,24.06380027739251
Pune-Moshi,Bottle Gourd,2016,930,1277,347,37.31182795698925
Amarawati,Onion,2015,1113,1460,347,31.176999101527404
Phaltan,Maize,2016,1600,1947,347,21.6875
Nagpur,Orange,2016,1906,2253,347,18.205666316894018
Sangamner,Wheat(Husked),2015,1564,1911,347,22.186700767263428
Dondaicha,Bajri,2016,1119,1466,347,31.009830205540663
Barshi-Vairag,Gram,2016,5078,5425,347,6.833398975974793
Umared,Soybean,2015,3144,3491,347,11.036895674300254
Kalamb (Os),Sorgum(Jawar),2015,1896,2243,347,18.30168776371308
Chalisgaon,Soybean,2016,3062,3409,347,11.332462442847811
Vaijapur,Bajri,2014,1128,1475,347,30.76241134751773
Kalamb (Yawatmal),Pigeon Pea (Tur),2016,8255,8602,347,4.20351302241066
Vaijapur,Wheat(Husked),2016,1677,2024,347,20.69171138938581
Pandharpur,Banana,2015,303,650,347,114.52145214521452
Aurangabad,Awala,2014,653,1000,347,53.13935681470138
Aurangabad,Maize(Corn.),2016,540,887,347,64.25925925925925
Karanja,Wheat(Husked),2016,1590,1937,347,21.82389937106918
Dudhani,Pigeon Pea (Tur),2016,6298,6645,347,5.509685614480787
Dhamangaon-Rly,Ground Nut Pods (Dry),2016,5172,5519,347,6.709203402938901
Chandur Rly.,Pigeon Pea (Tur),2015,8615,8962,347,4.027858386535113
Baramati,Wheat(Husked),2016,1645,1992,347,21.09422492401216
Mehkar,Soybean,2015,3084,3431,347,11.251621271076525
Rahata,Carrot,2015,2038,2385,347,17.026496565260057
Nandura,Sorgum(Jawar),2014,1120,1466,346,30.892857142857142
Mumbai,Green Chilli,2016,3264,3610,346,10.60049019607843
Baramati,Sunflower,2015,3113,3459,346,11.114680372630902
Karad,Carrot,2016,978,1324,346,35.37832310838446
Lasalgaon,Maize,2015,1101,1447,346,31.425976385104452
Satara,Tomato,2015,585,931,346,59.14529914529915
Malegaon,HORSE GRAM,2016,3880,4226,346,8.917525773195877
Varud-Rajura Bazar,Soybean,2015,3388,3734,346,10.212514757969304
Mumbai,Bitter Gourd,2015,2131,2477,346,16.23650868137025
Gangapur,Gram,2015,3742,4088,346,9.246392303580972
Dhule,Pigeon Pea (Tur),2016,4948,5294,346,6.992724333063864
Mehkar,Soybean,2016,3539,3885,346,9.776773099745691
Dindori-Vani,Onion,2016,514,860,346,67.31517509727627
Kada,Black Gram,2014,4800,5146,346,7.208333333333333
Pandharpur,Cabbage,2015,329,675,346,105.16717325227964
Lasur Station,Wheat(Husked),2016,1660,2006,346,20.843373493975903
Sonpeth,Soybean,2016,3297,3643,346,10.494388838337883
Raver,Wheat(Husked),2016,1421,1767,346,24.34904996481351
Latur,Sorgum(Jawar),2016,1543,1889,346,22.423849643551524
Amarawati,Wheat(Husked),2016,1799,2145,346,19.23290717065036
Dound,Wheat(Husked),2015,1582,1928,346,21.871049304677623
Raver,Sorgum(Jawar),2014,1125,1471,346,30.755555555555556
Armori-Desaiganj,Paddy-Unhusked,2016,1706,2052,346,20.281359906213364
Panvel,Snake Gourd,2016,2127,2473,346,16.267042783262813
Kannad,Wheat(Husked),2016,1688,2034,346,20.497630331753555
Ramtek,Capsicum,2016,945,1291,346,36.613756613756614
Mumbai,Flower,2015,858,1204,346,40.32634032634033
Kalyan,Ridge Gourd,2015,2877,3223,346,12.02641640597845
Nandurbar,Maize,2014,1177,1523,346,29.39677145284622
Ahmednagar,Sorgum(Jawar),2015,1575,1921,346,21.96825396825397
Kopargaon,Soybean,2015,3244,3590,346,10.665844636251542
Nagpur,Bor,2015,435,781,346,79.54022988505747
Karad,Cabbage,2015,627,973,346,55.18341307814992
Solapur,Cabbage,2015,245,591,346,141.22448979591837
Ausa,Soybean,2016,3402,3748,346,10.170487948265727
Mumbai,Tomato,2016,1771,2117,346,19.536984754376057
Chalisgaon,Sorgum(Jawar),2014,1140,1486,346,30.350877192982455
Ramtek,Flower,2015,1069,1415,346,32.3666978484565
Tumsar,Jaggery,2016,2950,3296,346,11.728813559322035
Rahata,Ladies Finger,2015,1900,2246,346,18.210526315789473
Ahmedpur,Black Gram,2015,8042,8388,346,4.30241233523999
Kurdwadi,Gram,2014,2082,2428,346,16.618635926993274
Panvel,Ghosali(Bhaji),2016,3317,3663,346,10.431112451009948
Lasalgaon-Vinchur,Wheat(Husked),2015,1272,1618,346,27.20125786163522
Kolhapur,CABBAGE,2016,200,546,346,173.0
Nagpur,Flower,2015,1262,1608,346,27.416798732171156
Yeotmal,Soybean,2016,3402,3748,346,10.170487948265727
Amarawati,Orange,2016,595,941,346,58.15126050420168
Ramtek,Brinjal,2015,1159,1505,346,29.85332182916307
Amarawati-Fruit And Vegetables,Melon,2016,1040,1385,345,33.17307692307692
Hingna,Soybean,2014,2895,3240,345,11.917098445595855
Latur,Bajri,2016,1629,1974,345,21.17863720073665
Mangaon(Bhadav),Paddy-Unhusked,2015,1200,1545,345,28.75
Rahata,Tomato,2016,455,800,345,75.82417582417582
Katol,Cotton,2015,3590,3935,345,9.610027855153204
Shahada,Wheat(Husked),2015,1564,1909,345,22.058823529411764
Sinner,Bajri,2016,1597,1942,345,21.60300563556669
Akluj,Cabbage,2015,482,827,345,71.57676348547717
Barshi-Vairag,Gram,2014,2292,2637,345,15.052356020942408
Pune,Flower,2015,320,665,345,107.8125
Ramtek,Ladies Finger,2015,1060,1405,345,32.54716981132076
Pune-Pimpri,Wal Papdi,2015,1622,1967,345,21.27003699136868
Kalyan,Elephant Root,2016,2125,2470,345,16.235294117647058
Akkolkot,Green Gram,2015,7658,8003,345,4.50509271350222
Ratanagari,Cabbage,2015,855,1200,345,40.35087719298246
Shrirampur,Wheat(Husked),2015,1427,1772,345,24.176594253679045
Lasalgaon-Niphad,Onion,2016,391,736,345,88.23529411764706
Devala,Sorgum(Jawar),2015,2154,2499,345,16.016713091922007
Pusad,Bajri,2014,1452,1797,345,23.760330578512395
Aurangabad,Papai,2014,1000,1345,345,34.5
Satana,Maize,2015,1071,1416,345,32.212885154061624
Kalyan,Brinjal,2016,2150,2495,345,16.046511627906977
Pune,Sorgum(Jawar),2016,2513,2858,345,13.728611221647434
Savner,Soybean,2016,3232,3577,345,10.674504950495049
Jamkhed,Soybean,2015,3000,3345,345,11.5
Mohol,Sorgum(Jawar),2015,1643,1988,345,20.998174071819843
Kannad,Wheat(Husked),2016,1734,2079,345,19.896193771626297
Manchar,FLOWER,2016,145,490,345,237.93103448275863
Jalgaon,Onion,2016,351,696,345,98.2905982905983
Jawala-Bajar,Turmeric,2016,8095,8440,345,4.261890055589871
Patan,Tomato,2015,1130,1475,345,30.530973451327434
Akot,Gram,2015,3476,3821,345,9.925201380897583
Barshi,FODDER,2016,723,1068,345,47.71784232365145
Amarawati-Fruit And Vegetables,Melon,2016,522,867,345,66.0919540229885
Kalyan,Brinjal,2016,2685,3030,345,12.849162011173185
Barshi Takli,Cotton,2016,4180,4525,345,8.253588516746412
Kalyan,Bitter Gourd,2015,2044,2389,345,16.87866927592955
Kej,Soybean,2016,3456,3801,345,9.98263888888889
Kalvan,Ground Nut Pods (Dry),2014,3200,3545,345,10.78125
Bhiwapur,Cotton,2016,4105,4450,345,8.404384896467722
Akluj,Potato,2016,1133,1478,345,30.450132391879965
Satara,Potato,2016,1422,1767,345,24.261603375527425
Jalgaon,Bitter Gourd,2016,3564,3909,345,9.68013468013468
Pune,Cabbage,2015,1030,1375,345,33.49514563106796
Akkolkot,Gram,2016,6250,6595,345,5.52
Barshi,Methi (Bhaji),2015,400,745,345,86.25
Gangapur,Wheat(Husked),2015,1400,1745,345,24.642857142857142
Nandurbar,Bajri,2015,1140,1485,345,30.263157894736842
Morshi,Gram,2016,4150,4494,344,8.289156626506024
Hadgaon,Gram,2016,4078,4422,344,8.435507601765572
Jalgaon,Cabbage,2015,681,1025,344,50.51395007342144
Satara,Bottle Gourd,2015,726,1070,344,47.382920110192835
Gevrai,Soybean,2015,3277,3621,344,10.49740616417455
Khed,FLOWER,2016,300,644,344,114.66666666666667
Lonand,Wheat(Husked),2016,1575,1919,344,21.841269841269842
Shevgaon,Gram,2015,3525,3869,344,9.75886524822695
Nagpur,Math (Bhaji),2016,1417,1761,344,24.276640790402258
Ausa,Soybean,2016,3451,3795,344,9.968125181106926
Tuljapur,Maize,2015,931,1275,344,36.94951664876477
Manmad,Bajri,2016,1474,1818,344,23.337856173677068
Shrirampur,Sorgum(Jawar),2016,1553,1897,344,22.15067611075338
Baramati,Wheat(Husked),2016,1665,2009,344,20.66066066066066
Bhivandi,Other Vegetables,2016,902,1246,344,38.13747228381375
Morshi,Pigeon Pea (Tur),2016,6375,6719,344,5.396078431372549
Umared,Wheat(Husked),2014,1500,1844,344,22.933333333333334
Pune-Moshi,Carrot,2016,1330,1674,344,25.86466165413534
Pune,Gr.Nut Kernels,2016,8267,8611,344,4.1611225353816375
Karad,Potato,2016,1417,1761,344,24.276640790402258
Akluj,Gram,2015,3200,3544,344,10.75
Malegaon (Washim),Pigeon Pea (Tur),2016,8443,8787,344,4.074381144143077
Jalgaon,Melon,2015,419,763,344,82.10023866348449
Nandgaon,Maize,2015,1651,1995,344,20.8358570563295
Parbhani,Soybean,2016,2510,2854,344,13.705179282868526
Nagpur,Wheat(Husked),2014,1622,1966,344,21.208384710234277
Nagpur,Spinach,2016,900,1244,344,38.22222222222222
Mumbai,Shevga,2016,2312,2656,344,14.878892733564014
Karad,Cucumber,2016,936,1280,344,36.75213675213675
Lonand,Bajri,2015,1344,1688,344,25.595238095238095
Mangrulpeer,Wheat(Husked),2015,1259,1603,344,27.323272438443208
Mandhal,Pigeon Pea (Tur),2016,6887,7231,344,4.9949179613765065
Indapur-Bhigwan,Bajri,2015,1232,1576,344,27.92207792207792
Lasur Station,Wheat(Husked),2015,1482,1826,344,23.21187584345479
Jamkhed,Wheat(Husked),2015,1895,2239,344,18.153034300791557
Chopda,Soybean,2016,3017,3361,344,11.40205502154458
Lasur Station,Pigeon Pea (Tur),2014,4355,4699,344,7.898966704936854
Kej,Black Gram,2014,4440,4784,344,7.747747747747748
Basmat,Ground Nut Pods (Dry),2014,4090,4434,344,8.41075794621027
Mumbai,Ladies Finger,2016,1936,2280,344,17.768595041322314
Akola,Sorgum(Jawar),2016,1585,1929,344,21.70347003154574
Sonpeth,Soybean,2016,3484,3828,344,9.873708381171067
Dondaicha,Sorgum(Jawar),2016,1448,1791,343,23.6878453038674
Wardha,Gram,2015,4150,4493,343,8.265060240963855
Dhule,Sorgum(Jawar),2014,1598,1941,343,21.46433041301627
Nagpur,Mosambi,2016,2128,2471,343,16.11842105263158
Kalvan,Soybean,2016,3457,3800,343,9.921897599074342
Khed-Chakan,Carrot,2016,1000,1343,343,34.3
Dondaicha,Sorgum(Jawar),2016,1543,1886,343,22.229423201555413
Jalgaon,Papai,2016,457,800,343,75.054704595186
Pune-Moshi,Cabbage,2016,657,1000,343,52.207001522070016
Nagpur,Beet Root,2016,1057,1400,343,32.450331125827816
Pathardi,Gram,2016,4013,4356,343,8.54722153002741
Anajngaon Surji,Soybean,2015,3189,3532,343,10.755722797115084
Amarawati-Fruit And Vegetables,Chikoo,2016,1286,1629,343,26.67185069984448
Murtizapur,Soybean,2015,2944,3287,343,11.650815217391305
Parola,Gram,2016,4272,4615,343,8.029026217228465
Kurdwadi,Pigeon Pea (Tur),2016,5857,6200,343,5.856240396107222
Patan,Cucumber,2015,1071,1414,343,32.02614379084967
Chandrapur-Ganjwad,Spinach,2015,743,1086,343,46.16419919246299
Washim,Black Gram,2016,6467,6810,343,5.3038503169939695
Ghoti,Brinjal,2016,1045,1388,343,32.822966507177036
Akluj,Cabbage,2014,543,886,343,63.16758747697974
Nagpur,Brinjal,2016,1492,1835,343,22.989276139410187
Kalamb (Os),Coriander (Dry),2014,9501,9844,343,3.6101463003894327
Lasur Station,Thymol/Lovage,2015,9128,9471,343,3.7576687116564416
Chopda,Sunflower,2015,2646,2989,343,12.962962962962964
Bhivandi,Potato,2016,1069,1412,343,32.08606173994387
Nandurbar,Sorgum(Jawar),2016,1216,1559,343,28.207236842105264
Mohol,Wheat(Husked),2015,1470,1813,343,23.333333333333332
Aurangabad,Bottle Gourd,2016,800,1143,343,42.875
Karad,Cucumber,2015,886,1229,343,38.71331828442438
Amarawati,Green Chilli,2016,3113,3456,343,11.018310311596531
Savner,PIGEON PEA (TUR),2016,4730,5073,343,7.251585623678647
Pathari,Sorgum(Jawar),2015,1607,1950,343,21.34411947728687
Rahuri-Vambori,Soybean,2015,2923,3266,343,11.734519329456038
Rahata,Cucumber,2014,471,814,343,72.82377919320595
Anajngaon Surji,Sorgum(Jawar),2016,1200,1543,343,28.583333333333332
Savner,Soybean,2015,3135,3478,343,10.940988835725678
Nanded,Ground Nut Pods (Dry),2016,4947,5290,343,6.933495047503538
Kolhapur-Laxmipuri,Gr.Nut Kernels,2016,8489,8832,343,4.040523029803275
Shevgaon,Sorgum(Jawar),2016,1590,1933,343,21.572327044025158
Mumbai,Arvi,2015,870,1213,343,39.42528735632184
Karad,Potato,2015,1043,1386,343,32.88590604026846
Majalgaon,Soybean,2015,3514,3857,343,9.760956175298805
Kille Dharur,Soybean,2014,2706,3049,343,12.675535846267554
Pune-Pimpri,Bajri,2016,1836,2179,343,18.681917211328976
Akluj,Water Melon,2016,336,679,343,102.08333333333333
Sangamner,Bajri,2015,1350,1693,343,25.40740740740741
Baramati,Maize,2016,1294,1637,343,26.506955177743432
Amarawati,Dhemse,2016,2900,3243,343,11.827586206896552
Mehkar,Wheat(Husked),2015,1346,1688,342,25.40861812778603
Mumbai,Ladies Finger,2015,1202,1544,342,28.452579034941763
Mumbai,Carrot,2016,1248,1590,342,27.403846153846153
Karad,Flower,2014,925,1267,342,36.972972972972975
Jintur,Ground Nut Pods (Dry),2015,5197,5539,342,6.5807196459495865
Ramtek,Onion,2015,2979,3321,342,11.48036253776435
Sonpeth,Gram,2016,5897,6239,342,5.7995590978463625
Washim,Wheat(Husked),2016,1793,2135,342,19.074177356385945
Nagbhid,Paddy-Unhusked,2016,1723,2065,342,19.849100406268136
Jalgaon,Gram,2015,3526,3868,342,9.699376063528078
Nagpur,Wheat(Husked),2016,1967,2309,342,17.3868835790544
Amarawati,Pigeon Pea (Tur),2016,7989,8331,342,4.280886218550507
Chopda,Maize,2016,1339,1681,342,25.541448842419715
Karad,Brinjal,2015,729,1071,342,46.91358024691358
Bhiwapur,Paddy-Unhusked,2014,2225,2567,342,15.370786516853933
Shirpur,Bajri,2015,1124,1466,342,30.427046263345197
Balapur,Gram,2015,2800,3142,342,12.214285714285714
Vai,Brinjal,2015,1296,1638,342,26.38888888888889
Tumsar,JAGGERY,2016,3681,4023,342,9.290953545232274
Sangamner,Soybean,2016,3578,3920,342,9.558412520961431
Shirpur,Wheat(Husked),2016,1560,1902,342,21.923076923076923
Parbhani,Pigeon Pea (Tur),2015,7916,8258,342,4.320363820111167
Buldhana,Gram,2015,3407,3749,342,10.038156736131494
Karmala,Sunflower,2015,3032,3374,342,11.279683377308707
Panvel,Cluster Bean,2016,2258,2600,342,15.146147032772365
Manwat,Wheat(Husked),2015,1541,1883,342,22.19338092147956
Satana,Bajri,2016,1394,1736,342,24.53371592539455
Panvel,Cucumber,2016,2648,2990,342,12.915407854984894
Kej,Bajri,2016,1287,1629,342,26.573426573426573
Shrirampur,PAPAI,2016,1029,1371,342,33.23615160349854
Chimur,Cotton,2016,4277,4619,342,7.996259060088847
Shirpur,Bajri,2015,1243,1585,342,27.514078841512468
Rahata,Gram,2015,3669,4011,342,9.321340964840555
Nagpur,SOYBEAN,2016,2554,2896,342,13.390759592795614
Patur,Soybean,2015,3125,3467,342,10.944
Pune,Cabbage,2016,290,632,342,117.93103448275862
Kalyan,Papai,2015,1183,1525,342,28.909551986475062
Sengaon,Pigeon Pea (Tur),2016,6387,6729,342,5.3546265852512915
Latur,Sorgum(Jawar),2016,1526,1868,342,22.411533420707734
Yeotmal,Gram,2015,3075,3417,342,11.121951219512194
Gangapur,Gram,2016,3993,4335,342,8.564988730277987
Kopargaon,Pigeon Pea (Tur),2016,7147,7488,341,4.771232685042675
Mohol,Sorgum(Jawar),2016,1685,2026,341,20.237388724035608
Kalvan,Maize,2015,1188,1529,341,28.703703703703702
Nandurbar,Maize,2014,1106,1447,341,30.831826401446655
Dhule,Soybean,2016,3092,3433,341,11.028460543337646
Barshi,Green Gram,2015,6119,6460,341,5.572806014054584
Malegaon,Bajri,2016,1432,1773,341,23.812849162011172
Mumbai,Snake Gourd,2016,668,1009,341,51.047904191616766
Murtizapur,Pigeon Pea (Tur),2016,8515,8856,341,4.004697592483852
Dhule,Pigeon Pea (Tur),2014,3569,3910,341,9.55449705799944
Kej,Sorgum(Jawar),2015,1811,2152,341,18.829376035339592
Yeotmal,Cotton,2016,4209,4550,341,8.10168686148729
Nagpur,Spinach,2016,1267,1608,341,26.91397000789266
Latur,Bajri,2016,1286,1627,341,26.51632970451011
Kalyan,Capsicum,2016,1312,1653,341,25.990853658536587
Dondaicha,Wheat(Husked),2014,1400,1741,341,24.357142857142858
Pune,Bajri,2015,1668,2009,341,20.443645083932854
Amarawati,Coriander  ,2016,2506,2847,341,13.607342378292099
Mehkar,Wheat(Husked),2015,1277,1618,341,26.703210649960845
Hadgaon,Wheat(Husked),2016,1524,1865,341,22.3753280839895
Amarawati,Papai,2016,1692,2033,341,20.153664302600472
Nandurbar,Wheat(Husked),2015,1422,1763,341,23.980309423347396
Pune-Manjri,Rajgira,2014,417,758,341,81.77458033573141
Murtizapur,Gram,2015,3871,4212,341,8.809093257556187
Amarawati,Bitter Gourd,2016,3318,3659,341,10.277275467148884
Rahuri-Vambori,Sorgum(Jawar),2016,1449,1790,341,23.533471359558316
Barshi,Capsicum,2016,659,1000,341,51.74506828528073
Purna,Turmeric,2016,6950,7291,341,4.906474820143885
Karanja,Soybean,2015,3256,3597,341,10.472972972972974
Sinner,Black Gram,2014,4842,5183,341,7.042544403139199
Kalamb (Yawatmal),Soybean,2015,3355,3696,341,10.163934426229508
Partur,Wheat(Husked),2016,1736,2077,341,19.642857142857142
Aurangabad,Cucumber,2016,511,852,341,66.73189823874755
Ashti-Karanja,Gram,2016,3878,4219,341,8.793192367199588
Karanja,Soybean,2014,2763,3104,341,12.341657618530583
Shevgaon,Sorgum(Jawar),2014,1474,1815,341,23.134328358208954
Karanja,Wheat(Husked),2015,1344,1685,341,25.37202380952381
Chandrapur,Pigeon Pea (Tur),2015,5049,5390,341,6.753812636165577
Aurangabad,Capsicum,2015,1274,1615,341,26.766091051805336
Malkapur,Wheat(Husked),2015,1280,1621,341,26.640625
Hingoli,Pigeon Pea (Tur),2016,8160,8500,340,4.166666666666667
Hinganghat,Soybean,2015,2943,3283,340,11.552837240910636
Ratanagari,Bottle Gourd,2015,1060,1400,340,32.075471698113205
Latur,Gram,2015,3881,4221,340,8.760628703942283
Koregaon,Ghevda Seed,2016,3625,3965,340,9.379310344827585
Rahata,Bor,2015,960,1300,340,35.416666666666664
Karad,Bottle Gourd,2016,732,1072,340,46.44808743169399
Nandgaon Khandeshwar,Wheat(Husked),2015,1161,1501,340,29.285099052540914
Aurangabad,Cucumber,2016,640,980,340,53.125
Ahmedpur,Black Gram,2014,5036,5376,340,6.751389992057188
Ratanagari,Cabbage,2014,905,1245,340,37.569060773480665
Kurdwadi,Pigeon Pea (Tur),2015,4442,4782,340,7.6542098153984695
Hadgaon-Tamsa,Cotton,2016,4221,4561,340,8.054963278843875
Mumbai,Flower,2015,630,970,340,53.96825396825397
Chandrapur-Ganjwad,Pumpkin,2014,840,1180,340,40.476190476190474
Khed-Chakan,Carrot,2015,873,1213,340,38.94616265750286
Sinner,Green Gram,2015,6860,7200,340,4.956268221574344
Bhusaval,Green Gram,2016,4542,4882,340,7.485689123734038
Kalyan,Black Gram,2016,12960,13300,340,2.623456790123457
Mumbai,Snake Gourd,2015,1676,2016,340,20.286396181384248
Jalna,Soybean,2015,3268,3608,340,10.40391676866585
Vai,Pavtta,2015,2020,2360,340,16.831683168316832
Nagpur,Small Gourd,2016,1104,1444,340,30.797101449275363
Akluj,Water Melon,2016,335,675,340,101.49253731343283
Akluj,Cabbage,2015,400,740,340,85.0
Panvel,Carrot,2016,1600,1940,340,21.25
Nanded,Pigeon Pea (Tur),2015,5119,5459,340,6.6419222504395385
Ratanagari,Cabbage,2015,598,938,340,56.8561872909699
Dondaicha,Wheat(Husked),2015,1355,1695,340,25.092250922509226
Rahata,Bottle Gourd,2015,521,861,340,65.25911708253359
Sangrampur,Sorgum(Jawar),2014,1021,1361,340,33.30068560235064
Mumbai-Onion And Potato Mkt,Onion,2016,698,1038,340,48.710601719197705
Chandrapur-Ganjwad,Raddish,2014,656,996,340,51.829268292682926
Savner,Wheat(Husked),2016,1472,1812,340,23.097826086956523
Bhokar,Sorgum(Jawar),2014,1240,1580,340,27.419354838709676
Ghatanji,Pigeon Pea (Tur),2016,8146,8486,340,4.173827645470169
Kada,Bajri,2014,1250,1590,340,27.2
Kalamb (Os),Sorgum(Jawar),2016,1619,1959,340,21.000617665225448
Mumbai,CUCUMBER,2016,1079,1419,340,31.510658016682115
Chalisgaon,Wheat(Husked),2015,1340,1680,340,25.37313432835821
Kalmeshwar,Ladies Finger,2016,2490,2830,340,13.654618473895582
Kille Dharur,Soybean,2015,3316,3656,340,10.253317249698432
Ramtek,Spinach,2016,1890,2230,340,17.98941798941799
Satara,Bottle Gourd,2015,835,1175,340,40.7185628742515
Balapur,Sorgum(Jawar),2015,1160,1500,340,29.310344827586206
Kille Dharur,Soybean,2015,2857,3197,340,11.900595029751488
Solapur,Green Gram,2015,8177,8517,340,4.158004158004158
Amarawati,Sorgum(Jawar),2015,1514,1854,340,22.457067371202115
Dondaicha,Wheat(Husked),2016,1644,1984,340,20.68126520681265
Hingoli,Gram,2015,3980,4320,340,8.542713567839195
Pandharpur,Banana,2016,818,1158,340,41.56479217603912
Amarawati,Bajri,2016,1605,1945,340,21.18380062305296
Gangakhed,Cotton,2016,4100,4440,340,8.292682926829269
Murbad,Bitter Gourd,2014,2700,3040,340,12.592592592592593
Ambad(Vadi Godri),Bajri,2015,1230,1570,340,27.642276422764226
Satara,GREEN CHILLI,2016,943,1283,340,36.05514316012725
Shrirampur,BAJRI,2016,1176,1516,340,28.91156462585034
Shrirampur,Wheat(Husked),2016,1591,1931,340,21.370207416719044
Karad,Water Melon,2016,665,1005,340,51.12781954887218
Pune-Pimpri,Chavli (Shenga ),2016,1430,1770,340,23.776223776223777
Umared,Other Pulses,2014,3756,4096,340,9.052183173588924
Shevgaon,Gram,2016,5830,6170,340,5.831903945111493
Katol,Soybean,2015,2893,3233,340,11.752506049083996
Ausa,Black Gram,2014,4464,4803,339,7.594086021505376
Amarawati-Fruit And Vegetables,Papai,2016,871,1210,339,38.920780711825486
Rahata,Gram,2015,2943,3282,339,11.518858307849133
Nandurbar,Ground Nut Pods (Dry),2014,3077,3416,339,11.017224569385766
Parola,Bajri,2016,1445,1784,339,23.46020761245675
Sindi,Gram,2016,3836,4175,339,8.83733055265902
Akkolkot,Pigeon Pea (Tur),2016,9033,9372,339,3.7529060112919295
Umarkhed,Gram,2016,3828,4167,339,8.855799373040753
Jalgaon,Cabbage,2015,617,956,339,54.94327390599676
Shrirampur,Wheat(Husked),2015,1416,1755,339,23.940677966101696
Solapur,CABBAGE,2016,269,608,339,126.02230483271376
Digras,Gram,2015,3628,3967,339,9.34399117971334
Ahmednagar,Wheat(Husked),2015,1511,1850,339,22.435473196558572
Ramtek,Onion,2015,2138,2477,339,15.855940130963518
Pune,Lentil,2016,6336,6675,339,5.350378787878788
Karad,Brinjal,2016,852,1191,339,39.7887323943662
Sakri,Pigeon Pea (Tur),2015,6411,6750,339,5.287786616752457
Anajngaon Surji,Soybean,2016,3186,3525,339,10.64030131826742
Yeola,Green Gram,2016,5089,5428,339,6.661426606405974
Kalamb (Yawatmal),Pigeon Pea (Tur),2016,8547,8886,339,3.966303966303966
Satara,Bottle Gourd,2015,546,885,339,62.08791208791209
Washim,Gram,2014,2675,3014,339,12.672897196261681
Nagpur,Math (Bhaji),2016,1609,1948,339,21.068986948415166
Nandurbar,Sunflower,2015,2859,3198,339,11.85729275970619
Mantha,Soybean,2016,3298,3637,339,10.278956943602184
Vaijapur,Wheat(Husked),2015,1570,1909,339,21.59235668789809
Kalmeshwar,Green Chilli,2016,5142,5481,339,6.592765460910152
Partur,Pigeon Pea (Tur),2016,8351,8690,339,4.059394084540774
Kolhapur-Laxmipuri,Bajri,2016,1987,2326,339,17.060895822848515
Bhokardan,Soybean,2015,3044,3383,339,11.136662286465178
Akluj,Cabbage,2016,338,677,339,100.29585798816568
Chalisgaon,Bajri,2016,1358,1697,339,24.96318114874816
Devala,Pigeon Pea (Tur),2015,8813,9152,339,3.846590264382163
Ghoti,Cabbage,2016,1083,1422,339,31.301939058171744
Nagpur,Bottle Gourd,2016,896,1235,339,37.83482142857143
Ramtek,Cabbage,2015,1669,2008,339,20.31156381066507
Shirpur,Maize,2014,928,1266,338,36.422413793103445
Nagpur,Wheat(Husked),2015,1762,2100,338,19.182746878547107
Pusad,Sorgum(Jawar),2014,1332,1670,338,25.375375375375377
Dhamangaon-Rly,Green Gram,2016,4451,4789,338,7.5937991462592676
Nagpur,Bottle Gourd,2016,1050,1388,338,32.19047619047619
Kopargaon,Sorgum(Jawar),2015,1058,1396,338,31.947069943289225
Akola,Soybean,2015,3132,3470,338,10.79182630906769
Partur,Wheat(Husked),2016,1801,2139,338,18.767351471404776
Kille Dharur,Bajri,2016,1713,2051,338,19.731465265615878
Kalyan,Tomato,2015,1462,1800,338,23.119015047879618
Mangrulpeer,Black Gram,2014,4231,4569,338,7.9886551642637675
Zarijamini,Pigeon Pea (Tur),2016,7890,8228,338,4.283903675538657
Mul,Paddy-Unhusked,2016,2055,2393,338,16.447688564476884
Lonand,Bajri,2015,1288,1626,338,26.242236024844722
Chikhali,Gram,2015,3881,4219,338,8.709095593919093
Murum,Wheat(Husked),2015,2003,2341,338,16.87468796804793
Kalamb (Os),Sorgum(Jawar),2015,1868,2206,338,18.094218415417558
Nampur,Green Gram,2016,4253,4591,338,7.947331295556078
Dhamangaon-Rly,Soybean,2016,3450,3788,338,9.797101449275363
Ambejogai,Wheat(Husked),2014,1517,1855,338,22.280817402768623
Nagpur,Beet Root,2016,1085,1423,338,31.152073732718893
Murbad,Tomato,2015,3425,3763,338,9.86861313868613
Nandgaon Khandeshwar,Pigeon Pea (Tur),2015,5750,6088,338,5.878260869565217
Jintur,Turmeric,2016,7758,8096,338,4.356792987883475
Nashik-Devlali,Methi (Bhaji),2016,350,688,338,96.57142857142857
Jalgaon Jamod-Aasalgaon,Soybean,2015,3231,3569,338,10.46115753636645
Vaijapur,Wheat(Husked),2014,1356,1694,338,24.926253687315633
Kalyan,Capsicum,2016,2095,2433,338,16.13365155131265
Chandur Bajar,Wheat(Husked),2016,1550,1888,338,21.806451612903224
Kalyan,Bitter Gourd,2015,2525,2863,338,13.386138613861386
Morshi,Gram,2016,7250,7588,338,4.662068965517242
Amarawati,Sorgum(Jawar),2015,1500,1838,338,22.533333333333335
Junnar-Otur,Green Chilli,2016,300,638,338,112.66666666666667
Pandharpur,Banana,2015,442,780,338,76.47058823529412
Lasalgaon-Vinchur,Sorgum(Jawar),2016,1276,1614,338,26.489028213166144
Hingoli,Sorgum(Jawar),2015,1280,1618,338,26.40625
Vai,Flower,2015,1054,1392,338,32.06831119544592
Purna,Sorgum(Jawar),2015,1309,1647,338,25.821237585943468
Chandrapur-Ganjwad,Potato,2015,675,1013,338,50.074074074074076
Kalyan,Bitter Gourd,2016,3756,4094,338,8.998935037273695
Pune,Potato,2016,1450,1788,338,23.310344827586206
Lonar,Wheat(Husked),2016,1654,1992,338,20.435308343409915
Shegaon,Pigeon Pea (Tur),2014,4290,4628,338,7.878787878787879
Jalgaon,Potato,2015,750,1088,338,45.06666666666667
Karad,Tomato,2015,900,1238,338,37.55555555555556
Pune-Moshi,Cucumber,2016,824,1162,338,41.019417475728154
Pune-Pimpri,Green Chilli,2016,1133,1471,338,29.832303618711386
Sengaon,Pigeon Pea (Tur),2016,8783,9121,338,3.848343390641011
Chikhali,Soybean,2016,3378,3716,338,10.005920663114269
Shirpur,Wheat(Husked),2015,1507,1845,338,22.428666224286662
Buldhana-Dhad,Maize,2016,1275,1613,338,26.50980392156863
Bhokar,Sesamum,2016,6025,6363,338,5.609958506224066
Gevrai,Cotton,2016,4025,4363,338,8.397515527950311
Panvel,Cucumber,2016,2608,2946,338,12.960122699386503
Murbad,Cabbage,2016,1438,1775,337,23.435326842837274
Kada,Soybean,2015,3113,3450,337,10.825570189527786
Akhadabalapur,Gram,2015,3463,3800,337,9.731446722494947
Amarawati,Cluster Bean,2015,2988,3325,337,11.278447121820616
Pune,Sorgum(Jawar),2014,2535,2872,337,13.293885601577909
Paithan,Wheat(Husked),2016,1701,2038,337,19.811875367430922
Malegaon,Sorgum(Jawar),2014,1747,2084,337,19.290211791642815
Pune-Pimpri,Brinjal,2015,1344,1681,337,25.074404761904763
Kalyan,Flower,2016,836,1173,337,40.311004784689
Amarawati,Orange,2015,813,1150,337,41.45141451414514
Umari,Ground Nut Pods (Dry),2016,4738,5075,337,7.1127057830308145
Jintur-Bori,Soybean,2016,3313,3650,337,10.172049501961968
Karmala,Ground Nut Pods (Dry),2014,3288,3625,337,10.249391727493917
Washim-Ansing,Soybean,2016,2696,3033,337,12.5
Chopda,Sorgum(Jawar),2015,1193,1530,337,28.248113998323554
Chandrapur-Ganjwad,Cabbage,2014,500,837,337,67.4
Gondpimpri,Pigeon Pea (Tur),2016,7688,8025,337,4.383454734651405
Karad,Banana,2016,663,1000,337,50.829562594268474
Pune-Pimpri,Tomato,2015,1488,1825,337,22.647849462365592
Jalna-Badnapur,Sorgum(Jawar),2016,1563,1900,337,21.561100447856685
Raver,Gram,2016,3686,4023,337,9.14270211611503
Partur,Wheat(Husked),2015,1476,1813,337,22.831978319783197
Karanja,Gram,2016,5084,5421,337,6.628638867033832
Satara,Potato,2016,1338,1675,337,25.186846038863976
Nagbhid,Paddy-Unhusked,2015,1592,1929,337,21.168341708542712
Jalgaon,Cabbage,2016,708,1045,337,47.59887005649718
Aurangabad,Chavli (Shenga ),2016,789,1126,337,42.71229404309252
Bhokardan,Pigeon Pea (Tur),2016,7813,8150,337,4.313323947267375
Kille Dharur,Pigeon Pea (Tur),2015,4906,5243,337,6.869139828781084
Tumsar,Green Gram,2015,5361,5698,337,6.286140645401977
Karad,Banana,2016,715,1052,337,47.13286713286713
Gevrai,Green Gram,2014,6521,6858,337,5.1679190308234935
Manchar,Maize(Corn.),2015,438,775,337,76.94063926940639
Sangamner,Wheat(Husked),2015,1541,1878,337,21.868916288124595
Nagpur,Carrot,2016,1217,1554,337,27.691043549712408
Sonpeth,Black Gram,2016,6404,6741,337,5.262336039975016
Akole,Bajri,2015,1014,1351,337,33.234714003944774
Karad,Banana,2015,1484,1821,337,22.7088948787062
Rahata,Bor,2015,818,1155,337,41.19804400977995
Beed,Wheat(Husked),2016,1922,2259,337,17.53381893860562
Jawala-Bajar,Green Gram,2016,4738,5075,337,7.1127057830308145
Jintur,Sorgum(Jawar),2016,1556,1893,337,21.65809768637532
Telhara,Gram,2016,4083,4419,336,8.229243203526819
Amarawati,Sorgum(Jawar),2015,1510,1846,336,22.251655629139073
Kalamb (Os),Sesamum,2015,8146,8482,336,4.124723790817579
Washim,Soybean,2015,3628,3964,336,9.26130099228225
Dudhani,Wheat(Husked),2015,1494,1830,336,22.48995983935743
Bhokar,Sesamum,2015,6013,6349,336,5.587892898719441
Kalyan,Cucumber,2015,1164,1500,336,28.8659793814433
Dudhani,Wheat(Husked),2015,1379,1715,336,24.365482233502537
Kalamb (Yawatmal),Soybean,2015,3298,3634,336,10.18799272286234
Mangalwedha,Gram,2015,3459,3795,336,9.713790112749349
Umarga,Gram,2014,2169,2505,336,15.491009681881051
Mul,Paddy-Unhusked,2016,2055,2391,336,16.35036496350365
Solapur,Black Gram,2015,8232,8568,336,4.081632653061225
Nandgaon Khandeshwar,Soybean,2014,2817,3153,336,11.927582534611288
Korpana,Pigeon Pea (Tur),2016,6964,7300,336,4.824813325674899
Shrirampur,Bitter Gourd,2016,873,1209,336,38.487972508591064
Pathari,WHEAT(HUSKED),2016,1976,2312,336,17.004048582995953
Nagpur,Brinjal,2016,784,1120,336,42.857142857142854
Umared,Sorgum(Jawar),2015,1400,1736,336,24.0
Sinner,Bajri,2015,1338,1674,336,25.112107623318387
Aurangabad,Lemon,2015,676,1012,336,49.70414201183432
Telhara,Soybean,2016,3179,3515,336,10.569361434413338
Satana,Wheat(Husked),2016,1604,1940,336,20.947630922693268
Aurangabad,Shevga,2016,620,956,336,54.193548387096776
Jalgaon,Carrot,2014,1743,2079,336,19.27710843373494
Rajura,Soybean,2015,2956,3292,336,11.366711772665765
Shirpur,Maize,2016,1031,1367,336,32.58971871968962
Amarawati-Fruit And Vegetables,Potato,2016,2070,2406,336,16.231884057971016
Dudhani,Black Gram,2015,10126,10462,336,3.3181907959707684
Jintur,Pigeon Pea (Tur),2016,8083,8419,336,4.156872448348386
Amarawati,Pigeon Pea (Tur),2015,5850,6186,336,5.743589743589744
Karad,Carrot,2015,864,1200,336,38.888888888888886
Kannad,Wheat(Husked),2016,1626,1962,336,20.66420664206642
Dhule,Wheat(Husked),2014,1363,1699,336,24.651504035216433
Malegaon,Bajri,2014,1253,1589,336,26.81564245810056
Jalgaon,Cabbage,2015,570,905,335,58.771929824561404
Karanja,Gram,2014,2378,2713,335,14.087468460891506
Indapur-Bhigwan,Horse Gram,2016,3078,3413,335,10.883690708252113
Yeotmal,Soybean,2015,3365,3700,335,9.955423476968797
Kalmeshwar,Soybean,2015,3265,3600,335,10.260336906584993
Shevgaon,Sorgum(Jawar),2015,1383,1718,335,24.222704266088215
Nagpur,Flower,2015,665,1000,335,50.37593984962406
Vai,Tomato,2015,1119,1454,335,29.93744414655943
Karanja,Ground Nut Pods (Dry),2015,5615,5950,335,5.966162065894924
Dondaicha,Sorgum(Jawar),2015,1234,1569,335,27.147487844408428
Umared,Green Gram,2015,5750,6085,335,5.826086956521739
Pune,WHEAT(HUSKED),2016,2497,2832,335,13.41609931918302
Pune-Moshi,Carrot,2016,1511,1846,335,22.17074784910655
Amarawati,Sorgum(Jawar),2016,1768,2103,335,18.947963800904976
Patur,Soybean,2016,3079,3414,335,10.880155894771029
Vaijapur,Bajri,2016,1642,1977,335,20.401948842874543
Shevgaon-Bodhegaon,Green Gram,2016,4581,4916,335,7.312813796114385
Malegaon,Soybean,2014,3088,3423,335,10.848445595854923
Dondaicha,Wheat(Husked),2015,1448,1783,335,23.135359116022098
Balapur,Soybean,2015,2800,3135,335,11.964285714285714
Digras,Black Gram,2015,7239,7574,335,4.627711009807984
Ausa,Sorgum(Jawar),2016,1600,1935,335,20.9375
Taloda,Wheat(Husked),2015,1283,1618,335,26.110678098207327
Amarawati,Papai,2016,1525,1860,335,21.9672131147541
Kille Dharur,Sorgum(Jawar),2015,1908,2243,335,17.557651991614257
Murum,Pigeon Pea (Tur),2015,6865,7200,335,4.879825200291333
Wardha,Soybean,2016,3374,3709,335,9.92886781268524
Nagpur,Soybean,2015,3139,3474,335,10.67218859509398
Pune,Bajri,2014,1727,2062,335,19.397799652576722
Satara,Brinjal,2015,635,970,335,52.75590551181102
Nagpur,Small Gourd,2016,1422,1757,335,23.558368495077357
Pune-Pimpri,Bottle Gourd,2016,995,1330,335,33.66834170854271
Kej,Bhagar/Vari,2016,1466,1801,335,22.85129604365621
Kille Dharur,Sorgum(Jawar),2016,1687,2022,335,19.85773562537048
Loha,Pigeon Pea (Tur),2014,4581,4916,335,7.312813796114385
Baramati,Wheat(Husked),2014,1601,1936,335,20.924422236102437
Latur,Gram,2016,5141,5476,335,6.5162419762692085
Dindori,Onion,2016,518,853,335,64.67181467181467
Amarawati,Sorgum(Jawar),2015,1509,1844,335,22.200132538104704
Vadgaon Peth,Cabbage,2016,387,722,335,86.56330749354005
Pune-Manjri,CABBAGE,2016,634,969,335,52.8391167192429
Kej,Soybean,2016,3183,3518,335,10.524662268300345
Sengaon,Turmeric,2016,8315,8650,335,4.028863499699338
Chakur,Pigeon Pea (Tur),2016,8573,8907,334,3.895952408725067
Partur,Wheat(Husked),2016,1720,2054,334,19.41860465116279
Palus,Cucumber,2016,933,1267,334,35.79849946409432
Khamgaon,Soybean,2015,2912,3246,334,11.469780219780219
Sillod,Gram,2016,3613,3947,334,9.24439523941323
Malegaon (Washim),Gram,2016,6733,7067,334,4.96064161592158
Jalgaon Jamod,Pigeon Pea (Tur),2015,4233,4567,334,7.890385069690526
Kej,Wheat(Husked),2015,1583,1917,334,21.099178774478837
Nashik-Devlali,Kanda Pat,2016,680,1014,334,49.11764705882353
Kalyan,Capsicum,2016,2483,2817,334,13.451469995972614
Kalyan,Sorgum(Jawar),2015,1733,2067,334,19.272937103289095
Kalyan,Brinjal,2016,1644,1978,334,20.316301703163017
Patan,Flower,2015,1283,1617,334,26.03273577552611
Kalvan,Ground Nut Pods (Dry),2016,3858,4192,334,8.657335406946604
Nandgaon,Pigeon Pea (Tur),2014,3367,3701,334,9.91980991980992
Aarni,Soybean,2016,2933,3267,334,11.387657688373679
Kalvan,Gram,2015,2233,2567,334,14.95745633676668
Loha,Sorgum(Jawar),2014,1216,1550,334,27.467105263157894
Baramati,Sunflower,2015,3088,3422,334,10.816062176165802
Jalna,Banana,2015,336,670,334,99.4047619047619
Sailu,Pigeon Pea (Tur),2014,4567,4901,334,7.313334793080797
Pusad,Wheat(Husked),2016,1778,2112,334,18.785151856017997
Latur,Bajri,2016,1573,1907,334,21.23331214240305
Sengaon,Pigeon Pea (Tur),2016,6291,6625,334,5.309171832776983
Solapur,Jaggery,2015,2280,2614,334,14.649122807017545
Jalkot,Wheat(Husked),2014,1233,1567,334,27.08840227088402
Sonpeth,Green Gram,2016,4448,4782,334,7.508992805755396
Sillod,Castor Seed,2016,2133,2467,334,15.6586966713549
Rahata,Ginger (Fresh),2015,3833,4167,334,8.713801200104356
Majalgaon,Wheat(Husked),2014,1300,1634,334,25.692307692307693
Manmad,Green Gram,2015,7900,8234,334,4.227848101265823
Ahmednagar,Matki,2015,7333,7667,334,4.554752488749489
Patur,Sorgum(Jawar),2015,1233,1567,334,27.08840227088402
Karmala,Bajri,2016,1404,1738,334,23.789173789173788
Barshi,Green Gram,2016,5610,5944,334,5.953654188948307
Chandur Bajar,Sorgum(Jawar),2015,1233,1567,334,27.08840227088402
Sengaon,Ground Nut Pods (Dry),2016,4341,4675,334,7.6940797051370655
Hingoli,Ground Nut Pods (Dry),2016,5392,5726,334,6.1943620178041545
Kalamb (Os),Sunflower,2014,2606,2940,334,12.81657712970069
Kalyan,Papai,2015,1733,2067,334,19.272937103289095
Risod,Gram,2015,4894,5228,334,6.824683285655905
Ahmedpur,Black Gram,2014,4171,4505,334,8.007672021098058
Nagpur,Cluster Bean,2015,1558,1892,334,21.437740693196407
Jalna,Soybean,2015,3517,3851,334,9.496730167756612
Kalyan,Onion,2014,1533,1867,334,21.787345075016308
Pune,Sorgum(Jawar),2015,2672,3006,334,12.5
Manmad,Bajri,2015,1239,1573,334,26.957223567393058
Akluj,Tomato,2015,573,907,334,58.289703315881326
Rahata,Mango(Raw),2015,1333,1667,334,25.056264066016503
Digras,Black Gram,2016,7168,7502,334,4.659598214285714
Buldhana,Green Gram,2015,7433,7767,334,4.493475043723934
Pune-Pimpri,Shevga,2014,5533,5867,334,6.036508223386951
Hingoli,Wheat(Husked),2015,1499,1833,334,22.28152101400934
Karad,Shevga,2016,996,1330,334,33.53413654618474
Mangrulpeer,GREEN GRAM,2016,4385,4719,334,7.6168757126567845
Achalpur,GRAM,2016,8033,8367,334,4.157848873397237
Pune-Pimpri,Ghosali(Bhaji),2015,2833,3167,334,11.789622308506884
Dudhani,Gram,2015,4161,4495,334,8.026916606584956
Rahuri-Vambori,Sorgum(Jawar),2015,1314,1648,334,25.41856925418569
Balapur,Green Gram,2016,5133,5467,334,6.506916033508669
Jalgaon,Jaggery,2015,2258,2592,334,14.79185119574845
Akole,Soybean,2015,2833,3167,334,11.789622308506884
Chopda,Gram,2015,3399,3733,334,9.826419535157399
Aurad Shahajani,Pigeon Pea (Tur),2016,8288,8622,334,4.02992277992278
Akkolkot,Gram,2015,4505,4839,334,7.413984461709212
Mumbai,Green Chilli,2015,1396,1730,334,23.925501432664756
Pathardi,Gram,2014,2483,2817,334,13.451469995972614
Rahata,Walvad,2016,1833,2167,334,18.2214948172395
Amarawati-Fruit And Vegetables,Kharbuj,2016,1233,1567,334,27.08840227088402
Parbhani,Cotton,2016,4532,4865,333,7.3477493380406
Shrirampur,Sweet Potato,2015,1300,1633,333,25.615384615384617
Sindkhed Raja,Green Gram,2016,3917,4250,333,8.501404135818229
Nandgaon Khandeshwar,GREEN GRAM,2016,4400,4733,333,7.568181818181818
Amalner,Green Gram,2016,5834,6167,333,5.707919094960576
Chandrapur-Ganjwad,Pumpkin,2015,800,1133,333,41.625
Aurangabad,Awala,2016,1011,1344,333,32.93768545994065
Rahuri-Vambori,Gram,2015,3080,3413,333,10.811688311688311
Rahata,Mango(Raw),2016,1667,2000,333,19.976004799040194
Panvel,Ridge Gourd,2015,3950,4283,333,8.430379746835444
Chakur,Gram,2016,6337,6670,333,5.2548524538425125
Kalvan,Wheat(Husked),2015,1330,1663,333,25.037593984962406
Jalgaon Jamod-Aasalgaon,WHEAT(HUSKED),2016,1500,1833,333,22.2
Kalyan,Wheat(Husked),2016,2000,2333,333,16.65
Nagpur,Small Gourd,2016,1346,1679,333,24.73997028231798
Amarawati,Green Gram,2016,4850,5183,333,6.865979381443299
Shirpur,Soybean,2016,3276,3609,333,10.164835164835164
Sailu,Wheat(Husked),2015,1400,1733,333,23.785714285714285
Aurangabad,AWALA,2016,800,1133,333,41.625
Sakri,Bajri,2016,1367,1700,333,24.359912216532553
Shevgaon-Bodhegaon,Pigeon Pea (Tur),2015,4920,5253,333,6.7682926829268295
Sinner,Wheat(Husked),2015,1612,1945,333,20.6575682382134
Karanja,Sesamum,2015,5952,6285,333,5.594758064516129
Murtizapur,Soybean,2015,3295,3628,333,10.106221547799697
Dhule,Pigeon Pea (Tur),2015,3936,4269,333,8.460365853658537
Dondaicha,Bajri,2015,1184,1517,333,28.125
Umared,Green Gram,2015,5095,5428,333,6.535819430814524
Indapur-Bhigwan,Horse Gram,2016,3068,3401,333,10.853976531942633
Rahata,Lemon,2015,6278,6611,333,5.304237018158649
Rahata,Lemon,2015,1667,2000,333,19.976004799040194
Ausa,Sorgum(Jawar),2016,1566,1899,333,21.264367816091955
Rahata,Lemon,2015,4000,4333,333,8.325
Manchar,Brinjal,2015,1167,1500,333,28.53470437017995
Pune-Manjri,GROUNDNUT PODS (WET),2016,4167,4500,333,7.991360691144709
Indapur-Bhigwan,Green Peas (Dry),2016,2400,2733,333,13.875
Patur,Soybean,2014,2867,3200,333,11.614928496686431
Karanja,Pigeon Pea (Tur),2014,4757,5090,333,7.000210216523019
Sangamner,Bajri,2015,1381,1714,333,24.112961622013035
Patan,Brinjal,2016,1232,1565,333,27.02922077922078
Ratanagari,TOMATO,2016,381,714,333,87.4015748031496
Kamthi,Cabbage,2015,300,633,333,111.0
Pulgaon,Gram,2016,3872,4205,333,8.600206611570249
Pune-Pimpri,Shevga,2016,5500,5833,333,6.054545454545455
Amarawati-Fruit And Vegetables,Spinach,2016,2067,2400,333,16.11030478955007
Chandrapur-Ganjwad,CARROT,2016,1000,1333,333,33.3
Chandrapur-Ganjwad,Wal Bhaji,2015,700,1033,333,47.57142857142857
Khed (Shel Pimpalgaon),Brinjal,2014,881,1214,333,37.79795686719637
Digras,Wheat(Husked),2015,1450,1783,333,22.96551724137931
Gevrai,Soybean,2015,3362,3695,333,9.904818560380726
Amarawati,Gram,2014,2517,2850,333,13.230035756853397
Dondaicha,Ground Nut Pods (Dry),2015,4239,4572,333,7.855626326963907
Panvel,Snake Gourd,2016,1340,1673,333,24.850746268656717
Mul,Paddy-Unhusked,2016,2090,2423,333,15.933014354066986
Baramati,Wheat(Husked),2016,1693,2026,333,19.66922622563497
Jalna,Green Gram,2016,6137,6470,333,5.426103959589376
Nilanga,Wheat(Husked),2015,1450,1783,333,22.96551724137931
Patan,Cucumber,2015,900,1233,333,37.0
Ramtek,Cucumber,2015,1200,1533,333,27.75
Latur-Murud,Sorgum(Jawar),2015,1679,2012,333,19.833234067897557
Rahata,Ground Nut Pods (Dry),2016,4067,4400,333,8.187853454634865
Jalgaon,Orange,2016,1067,1400,333,31.208997188378632
Mantha,Pigeon Pea (Tur),2016,5400,5733,333,6.166666666666667
Bhivandi,Other Vegetables,2015,851,1184,333,39.130434782608695
Shegaon,Soybean,2014,2686,3019,333,12.397617274758005
Phaltan,Green-Peas,2016,5000,5333,333,6.66
Murum,Wheat(Husked),2015,2251,2584,333,14.793425144380276
Udgir,Pigeon Pea (Tur),2015,9167,9500,333,3.6325951783571506
Kolhapur,Chavli (Shenga ),2015,3067,3400,333,10.857515487447017
Akluj,Carrot,2015,640,973,333,52.03125
Dhule,Wheat(Husked),2016,1641,1974,333,20.29250457038391
Rahata,Garlic,2014,3000,3333,333,11.1
Mumbai,Ladies Finger,2016,1989,2322,333,16.742081447963802
Kalyan,Carrot,2016,2056,2389,333,16.19649805447471
Kolhapur,Carrot,2016,2000,2333,333,16.65
Lasur Station,Safflower,2015,2434,2767,333,13.681183237469186
Chandrapur-Ganjwad,Small Gourd,2014,727,1060,333,45.804676753782665
Dudhani,Gram,2015,4021,4354,333,8.281522009450386
Umarga,Pigeon Pea (Tur),2016,7967,8300,333,4.179741433412828
Shirur,Indian Bean,2015,3467,3800,333,9.604845687914624
Malegaon,Wheat(Husked),2016,1507,1840,333,22.09688122096881
Mangrulpeer,Sorgum(Jawar),2015,925,1258,333,36.0
Sakri,Wheat(Husked),2016,1325,1658,333,25.132075471698112
Pune-Pimpri,Squash Gourd,2016,6000,6333,333,5.55
Tumsar,Other Cereals,2015,2100,2433,333,15.857142857142858
Risod,Soybean,2015,2966,3299,333,11.227242076871207
Pune-Moshi,Potato,2016,1406,1739,333,23.68421052631579
Pune,Sorgum(Jawar),2015,2560,2893,333,13.0078125
Bhokar,Gram,2016,6367,6700,333,5.230092665305482
Navapur,Tomato,2016,943,1276,333,35.31283138918346
Chandrapur-Ganjwad,Small Gourd,2014,778,1111,333,42.80205655526992
Rahata,LEMON,2016,2000,2333,333,16.65
Kolhapur,SWEET POTATO,2016,586,918,332,56.65529010238908
Nagbhid,Paddy-Unhusked,2016,1917,2249,332,17.318727177882106
Nashik,Cucumber,2016,530,862,332,62.64150943396226
Kolhapur,Cabbage,2016,220,552,332,150.9090909090909
Katol,Soybean,2015,3026,3358,332,10.971579643093193
Ramtek,Raddish,2016,468,800,332,70.94017094017094
Yeotmal,Gram,2014,2300,2632,332,14.434782608695652
Pune-Pimpri,Onion,2015,1142,1474,332,29.071803852889666
Ramtek,Tomato,2015,1059,1391,332,31.350330500472143
Solapur,BANANA,2016,343,675,332,96.7930029154519
Nagpur,Math (Bhaji),2014,2252,2584,332,14.742451154529308
Jintur,Soybean,2016,3410,3742,332,9.736070381231672
Sinner,Bajri,2016,1605,1937,332,20.685358255451714
Chandrapur,Banana,2015,809,1141,332,41.03831891223733
Barshi,Fodder,2016,484,816,332,68.59504132231405
Kada,Wheat(Husked),2015,1509,1841,332,22.00132538104705
Solapur,Banana,2015,265,597,332,125.28301886792453
Manora,Soybean,2016,3764,4096,332,8.820403825717323
Karad,GREEN CHILLI,2016,744,1076,332,44.623655913978496
Nagpur,Wheat(Husked),2015,1812,2144,332,18.322295805739515
Amarawati,Chikoo,2016,1163,1495,332,28.546861564918316
Hingna,Pigeon Pea (Tur),2015,5200,5532,332,6.384615384615385
Aurangabad,Flower,2015,809,1141,332,41.03831891223733
Kalamb (Yawatmal),Soybean,2015,3109,3441,332,10.678674815053071
Pune-Pimpri,Flower,2016,1352,1684,332,24.556213017751478
Babhulgaon,Soybean,2016,3376,3708,332,9.834123222748815
Baramati,Jaggery,2016,2643,2975,332,12.561483163072266
Ausa,Sunflower,2014,2581,2913,332,12.863231305695466
Chopda,Sunflower,2015,2584,2916,332,12.84829721362229
Tumsar,Jaggery,2015,2318,2650,332,14.322691975841243
Raver,Gram,2016,6587,6919,332,5.040230757552756
Kille Dharur,Wheat(Husked),2015,1535,1867,332,21.628664495114005
Satana,Bajri,2016,1434,1766,332,23.15202231520223
Bhivandi,Onion,2015,1548,1880,332,21.44702842377261
Shrirampur,Cucumber,2016,1000,1332,332,33.2
Chalisgaon,Soybean,2015,3074,3406,332,10.800260247234872
Barshi,Black Gram,2016,10763,11095,332,3.0846418284864816
Pune-Manjri,Tomato,2016,643,975,332,51.632970451010884
Kamthi,Spinach,2016,281,613,332,118.14946619217082
Gadhinglaj,Jaggery,2015,2158,2490,332,15.384615384615385
Jintur,Sorgum(Jawar),2015,1138,1470,332,29.173989455184536
Sailu,Sorgum(Jawar),2016,1609,1941,332,20.633934120571784
Kolhapur-Laxmipuri,Cowpea,2016,4897,5228,331,6.759240351235451
Rahuri-Vambori,Gram,2016,4061,4392,331,8.150701797586802
Mantha,Sorgum(Jawar),2015,1130,1461,331,29.292035398230087
Ahmednagar,Maize,2015,1688,2019,331,19.60900473933649
Kannad,Wheat(Husked),2014,1476,1807,331,22.425474254742547
Dondaicha-Sindkheda,Pigeon Pea (Tur),2016,7669,8000,331,4.316077715477898
Pune-Pimpri,Cucumber,2016,1097,1428,331,30.173199635369187
Aurangabad,Bottle Gourd,2015,563,894,331,58.792184724689164
Lasalgaon-Niphad,WHEAT(HUSKED),2016,1842,2173,331,17.969598262757874
Partur,Pigeon Pea (Tur),2016,8249,8580,331,4.012607588798642
Sailu,Sorgum(Jawar),2016,1550,1881,331,21.35483870967742
Anajngaon Surji,Wheat(Husked),2015,1380,1711,331,23.985507246376812
Nashik,Bottle Gourd,2016,371,702,331,89.21832884097034
Patur,Wheat(Husked),2016,1469,1800,331,22.532334921715453
Murum,Pigeon Pea (Tur),2016,6036,6367,331,5.483764082173625
Bhokar,Pigeon Pea (Tur),2014,4140,4471,331,7.995169082125604
Nagpur,Green Chilli,2015,1073,1404,331,30.848089468779126
Washim,Soybean,2016,3493,3824,331,9.476095047237331
Amarawati-Fruit And Vegetables,Flower,2016,2369,2700,331,13.972140143520473
Koregaon,Sorgum(Jawar),2015,1594,1925,331,20.765370138017566
Jalgaon,Carrot,2016,538,869,331,61.52416356877323
Mangalwedha,Onion,2016,415,746,331,79.75903614457832
Telhara,Green Gram,2015,7100,7431,331,4.661971830985915
Shirpur,Sorgum(Jawar),2016,1365,1696,331,24.249084249084248
Aurangabad,Wheat(Husked),2014,1531,1862,331,21.619856303069888
Kolhapur-Malkapur,Flower,2016,190,521,331,174.21052631578948
Vai,Brinjal,2015,1475,1806,331,22.440677966101696
Gadhinglaj,Jaggery,2016,2774,3105,331,11.932227829848594
Satara,Bottle Gourd,2014,727,1058,331,45.529573590096284
Akkolkot,Wheat(Unhusked),2016,2900,3231,331,11.413793103448276
Malegaon,Maize,2016,1437,1768,331,23.034098816979817
Kopargaon,Bajri,2015,1086,1417,331,30.478821362799263
Umared,Soybean,2015,3000,3331,331,11.033333333333333
Vai,Brinjal,2015,1231,1562,331,26.888708367181152
Gevrai,Cotton,2015,3580,3911,331,9.245810055865922
Lonand,Wheat(Husked),2015,1519,1850,331,21.790651744568795
Katol,Soybean,2015,3026,3357,331,10.93853271645737
Jalgaon,Gram,2014,2723,3054,331,12.155710613294161
Vai,Brinjal,2015,1430,1761,331,23.146853146853147
Jamkhed,Wheat(Husked),2015,1872,2203,331,17.681623931623932
Nagpur,Cucumber,2016,1491,1822,331,22.199865861837694
Yeotmal,Soybean,2015,3009,3340,331,11.00033233632436
Kalmeshwar,Green Chilli,2016,3791,4121,330,8.704827222368769
Nagpur,JACK FRUIT,2016,1570,1900,330,21.019108280254777
Baramati,Sunflower,2015,3066,3396,330,10.76320939334638
Shrirampur,Potato,2016,1335,1665,330,24.719101123595507
Devala,Bajri,2016,1547,1877,330,21.331609566903683
Gevrai,Wheat(Husked),2014,1446,1776,330,22.821576763485478
Rahata,Potato,2016,1385,1715,330,23.826714801444044
Lonand,Bajri,2016,1325,1655,330,24.90566037735849
Jintur,Green Gram,2015,6676,7006,330,4.943079688436189
Rajura,Soybean,2015,3277,3607,330,10.07018614586512
Achalpur,Gram,2015,3840,4170,330,8.59375
Malegaon,Soybean,2016,3436,3766,330,9.60419091967404
Tumsar,Jaggery,2015,2671,3001,330,12.354923249719207
Shirpur,Sorgum(Jawar),2016,1410,1740,330,23.404255319148938
Vani,Gram,2016,3872,4202,330,8.522727272727273
Balapur,Sorgum(Jawar),2015,1320,1650,330,25.0
Manchar,Green-Peas,2015,3953,4283,330,8.348090058183658
Karad,CUCUMBER,2016,857,1187,330,38.50641773628938
Nandura,SOYBEAN,2016,2490,2820,330,13.25301204819277
Hingoli,Gram,2015,3479,3809,330,9.485484334578903
Lonand,Gram,2015,3230,3560,330,10.21671826625387
Indapur-Bhigwan,Wheat(Husked),2016,1670,2000,330,19.760479041916167
Khamgaon,Sunflower,2015,3071,3401,330,10.745685444480625
Nagpur,Paddy-Unhusked,2015,1755,2085,330,18.803418803418804
Lasalgaon,Wheat(Husked),2014,1519,1849,330,21.724818959842
Khamgaon,Wheat(Husked),2016,1475,1805,330,22.372881355932204
Latur,Bajri,2016,1351,1681,330,24.42635085122132
Solapur,Cabbage,2016,530,860,330,62.264150943396224
Rahata,Bottle Gourd,2015,1170,1500,330,28.205128205128204
Aurangabad,Potato,2015,745,1075,330,44.29530201342282
Mantha,Green Gram,2016,5900,6230,330,5.593220338983051
Karad,Cucumber,2016,558,888,330,59.13978494623656
Manchar,Carrot,2016,400,730,330,82.5
Osmanabad,Sorgum(Jawar),2015,1546,1876,330,21.345407503234153
Patan,Brinjal,2016,1312,1642,330,25.152439024390244
Chopda,Maize,2016,1098,1428,330,30.05464480874317
Amarawati-Fruit And Vegetables,Methi (Bhaji),2016,2376,2706,330,13.88888888888889
Tumsar,Jaggery,2016,2653,2983,330,12.438748586505842
Akole,Soybean,2015,2860,3190,330,11.538461538461538
Shahada,Sorgum(Jawar),2016,1657,1987,330,19.915509957754978
Solapur,Papai,2016,985,1315,330,33.50253807106599
Kolhapur-Laxmipuri,Split Gram,2015,6320,6650,330,5.2215189873417724
Rahuri-Vambori,Pigeon Pea (Tur),2015,4900,5230,330,6.73469387755102
Pathardi,Sorgum(Jawar),2016,1583,1913,330,20.846493998736577
Kej,Bajri,2015,1451,1781,330,22.742935906271537
Ausa,Gram,2015,2530,2860,330,13.043478260869565
Jalgaon,Cabbage,2015,541,871,330,60.99815157116451
Umarga,Soybean,2015,2978,3308,330,11.081262592343855
Risod,Soybean,2015,2973,3303,330,11.099899091826439
Mangrulpeer,Pigeon Pea (Tur),2014,4502,4832,330,7.330075521990227
Panvel,Ladies Finger,2016,2190,2520,330,15.068493150684931
Nandura,Gram,2014,2243,2573,330,14.712438698172091
Panvel,Ghosali(Bhaji),2016,2460,2790,330,13.414634146341463
Vai,Ginger (Fresh),2016,2475,2804,329,13.292929292929292
Kada,Bajri,2015,1297,1626,329,25.366229760986894
Ausa,Sorgum(Jawar),2014,1537,1866,329,21.405335068314898
Kalamb (Os),Tamarind,2016,7160,7489,329,4.594972067039106
Pune-Pimpri,Tomato,2016,1009,1338,329,32.60654112983152
Washim-Ansing,Pigeon Pea (Tur),2016,8803,9132,329,3.7373622628649326
Ratanagari,Sweet Potato,2015,1057,1386,329,31.125827814569536
Mumbai,Ladies Finger,2016,1988,2317,329,16.549295774647888
Majalgaon,Soybean,2016,3363,3692,329,9.782931906036277
Aurad Shahajani,Gram,2016,7202,7531,329,4.568175506803666
Nilanga,Soybean,2016,3665,3994,329,8.97680763983629
Chalisgaon,Wheat(Husked),2015,1379,1708,329,23.85786802030457
Bhivandi,Potato,2016,998,1327,329,32.965931863727455
Kej,Sorgum(Jawar),2016,1696,2025,329,19.39858490566038
Manmad,Bajri,2016,1464,1793,329,22.472677595628415
Vani,Soybean,2015,3322,3651,329,9.903672486453944
Sindi,Soybean,2015,2958,3287,329,11.12237998647735
Anajngaon Surji,Sorgum(Jawar),2016,1250,1579,329,26.32
Lasalgaon,Black Gram,2015,5427,5756,329,6.0622811866592965
Kolhapur-Laxmipuri,Bajri,2016,1819,2148,329,18.086860912589334
Vadgaon Peth,Tomato,2015,471,800,329,69.85138004246285
Mul,Paddy-Unhusked,2016,2123,2452,329,15.496938294865757
Partur,Wheat(Husked),2016,1801,2130,329,18.267629094947253
Nagpur,Cluster Bean,2016,1157,1486,329,28.43560933448574
Pune-Pimpri,Flower,2016,1450,1779,329,22.689655172413794
Manwat,Sorgum(Jawar),2015,1091,1420,329,30.155820348304307
Ausa,Pigeon Pea (Tur),2016,6371,6700,329,5.16402448595197
Wardha,Gram,2015,4150,4479,329,7.927710843373494
Shrirampur,Tamarind,2015,1342,1671,329,24.515648286140088
Taloda,Maize,2016,1330,1659,329,24.736842105263158
Nandgaon,Wheat(Husked),2015,1550,1879,329,21.225806451612904
Aurangabad,Tomato,2014,439,768,329,74.94305239179954
Pune-Pimpri,Flower,2015,1113,1442,329,29.559748427672957
Shevgaon,Wheat(Husked),2016,1538,1867,329,21.39141742522757
Pune-Moshi,Tomato,2016,467,796,329,70.44967880085653
Jintur,Cotton,2015,3864,4193,329,8.514492753623188
Nagpur,Cucumber,2015,1354,1683,329,24.29837518463811
Kada,Gram,2016,4021,4350,329,8.182044267595126
Dhamangaon-Rly,Pigeon Pea (Tur),2014,4133,4462,329,7.96031938059521
Lasalgaon,Bajri,2014,1118,1447,329,29.427549194991055
Ulhasnagar,Potato,2016,1284,1613,329,25.623052959501557
Jalgaon,Wal Papdi,2015,1171,1500,329,28.095644748078566
Palghar(Bevur),Potato,2015,966,1295,329,34.05797101449275
Shahada,Maize,2015,965,1294,329,34.09326424870466
Dudhani,Gram,2014,2048,2377,329,16.064453125
Karad,BITTER GOURD,2016,1042,1371,329,31.573896353166987
Sinner,Wheat(Husked),2015,1438,1767,329,22.878998609179416
Amarawati,Sorgum(Jawar),2015,1509,1837,328,21.736249171636846
Amalner,Soybean,2016,3016,3344,328,10.875331564986737
Karanja,Wheat(Husked),2016,1513,1841,328,21.678783873099803
Kalyan,Carrot,2015,1266,1594,328,25.908372827804108
Mumbai,Ridge Gourd,2015,2072,2400,328,15.83011583011583
Pusad,Wheat(Husked),2015,1529,1857,328,21.45192936559843
Nashik-Devlali,Spinach,2016,275,603,328,119.27272727272727
Nandgaon,Bajri,2014,1066,1394,328,30.76923076923077
Fulambri,Cotton,2015,3894,4222,328,8.42321520287622
Shrirampur,Cucumber,2015,886,1214,328,37.020316027088036
Jamkhed,Bajri,2016,1486,1814,328,22.072678331090174
Ahmednagar,Gram,2016,4443,4771,328,7.382399279765924
Jamner-Neri,COTTON,2016,4461,4789,328,7.3526115220802515
Kej,Wheat(Husked),2014,1583,1911,328,20.720151610865447
Washim,Wheat(Husked),2015,1407,1735,328,23.312011371712863
Kalmeshwar,Pigeon Pea (Tur),2016,6710,7038,328,4.88822652757079
Kalamb (Os),Pigeon Pea (Tur),2015,6129,6457,328,5.351607113721651
Beed,Black Gram,2014,4435,4763,328,7.395715896279595
Sangali,Soybean,2016,3825,4153,328,8.57516339869281
Vaijapur,Sorgum(Jawar),2016,1610,1938,328,20.372670807453417
Khamgaon,Ground Nut Pods (Dry),2015,4865,5193,328,6.742034943473793
Ambejogai,Gram,2015,4255,4583,328,7.708578143360752
Kille Dharur,Soybean,2016,3042,3370,328,10.782380013149243
Chandrapur-Ganjwad,Chavli (Pala),2015,536,864,328,61.19402985074627
Pachora,Bajri,2016,1441,1769,328,22.761970853573906
Lasur Station,Thymol/Lovage,2015,10918,11246,328,3.004213225865543
Nagpur,Pumpkin,2016,756,1084,328,43.386243386243386
Kalyan,Ladies Finger,2015,1413,1741,328,23.21302193913659
Latur,Sorgum(Jawar),2015,2179,2507,328,15.05277650298302
Mumbai,Capsicum,2014,2144,2472,328,15.298507462686567
Chandur Bajar,Wheat(Husked),2016,1429,1757,328,22.953114065780266
Pulgaon,Soybean,2016,2497,2825,328,13.135762915498598
Pandharkawada,Ground Nut Pods (Dry),2016,5099,5427,328,6.432633849774466
Vani,Soybean,2016,3272,3600,328,10.02444987775061
Karad,Bottle Gourd,2016,636,964,328,51.57232704402516
Ambad(Vadi Godri),Bajri,2016,1440,1768,328,22.77777777777778
Mumbai,Bitter Gourd,2015,2160,2488,328,15.185185185185185
Amarawati,Carrot,2015,3986,4314,328,8.228800802809834
Kopargaon,Sorgum(Jawar),2015,1172,1500,328,27.986348122866893
Beed,Sorgum(Jawar),2016,1639,1967,328,20.012202562538132
Mul,Paddy-Unhusked,2016,2157,2485,328,15.20630505331479
Gangapur,Pigeon Pea (Tur),2014,3975,4303,328,8.251572327044025
Kej,Bajri,2016,1365,1693,328,24.02930402930403
Nandurbar,Black Gram,2015,8672,9000,328,3.782287822878229
Aurangabad,Brinjal,2015,689,1017,328,47.60522496371553
Ausa,Sorgum(Jawar),2014,1532,1860,328,21.409921671018278
Washim,Wheat(Husked),2015,1400,1728,328,23.428571428571427
Ambejogai,Pigeon Pea (Tur),2014,5000,5328,328,6.56
Partur,Wheat(Husked),2015,1686,2014,328,19.45432977461447
Kamthi,Raddish,2016,272,600,328,120.58823529411765
Nagpur,Chavli (Shenga ),2016,1444,1772,328,22.714681440443215
Nandura,Onion,2016,312,640,328,105.12820512820512
Beed,Bajri,2016,1580,1908,328,20.759493670886076
Yeotmal,Soybean,2016,3046,3373,327,10.735390676296783
Amarawati,Ladies Finger,2016,3218,3545,327,10.161591050341828
Rajura,Soybean,2015,2899,3226,327,11.279751638496034
Rahuri-Vambori,Wheat(Husked),2015,1347,1674,327,24.276169265033406
Amarawati,Sorgum(Jawar),2015,1506,1833,327,21.713147410358566
Amarawati,Green Gram,2016,6848,7175,327,4.775116822429907
Nagpur,Spinach,2015,915,1242,327,35.73770491803279
Kurdwadi-Modnimb,Wheat(Husked),2015,1354,1681,327,24.150664697193502
Murtizapur,Gram,2014,2685,3012,327,12.17877094972067
Kille Dharur,Wheat(Husked),2016,2053,2380,327,15.927910375060886
Shrirampur,Ginger (Fresh),2015,3169,3496,327,10.318712527611234
Washim,Pigeon Pea (Tur),2014,4770,5097,327,6.855345911949685
Nagpur,Green Chilli,2016,784,1111,327,41.70918367346939
Kalyan,Capsicum,2015,1733,2060,327,18.869013271783036
Nagpur,Onion,2016,486,813,327,67.28395061728395
Navapur,Pigeon Pea (Tur),2016,7391,7718,327,4.424299824110404
Jintur-Bori,Soybean,2015,3264,3591,327,10.018382352941176
Nagpur,CAPSICUM,2016,1105,1432,327,29.592760180995477
Khed,Cucumber,2016,283,610,327,115.54770318021201
Yeotmal,Soybean,2014,3000,3327,327,10.9
Chandrapur,Banana,2015,726,1053,327,45.04132231404959
Lasalgaon-Vinchur,Sorgum(Jawar),2016,1456,1783,327,22.458791208791208
Yeotmal,Soybean,2015,3017,3344,327,10.838581372224064
Ghatanji,SOYBEAN,2016,2391,2718,327,13.676286072772898
Shegaon,Gram,2016,4048,4375,327,8.078063241106719
Latur,Sorgum(Jawar),2015,2382,2709,327,13.727959697732997
Devala,Bajri,2016,1577,1904,327,20.735573874445148
Malegaon,Wheat(Husked),2016,1512,1839,327,21.626984126984127
Nagpur,Jack Fruit,2015,1169,1496,327,27.97262617621899
Jintur-Bori,Green Gram,2014,7201,7528,327,4.541035967226774
Malegaon,Sorgum(Jawar),2016,1685,2012,327,19.40652818991098
Morshi,PIGEON PEA (TUR),2016,5311,5638,327,6.15703257390322
Yawal,Maize,2016,1078,1405,327,30.333951762523192
Tuljapur,Pigeon Pea (Tur),2015,5459,5786,327,5.9901080784026375
Gadhinglaj,Jaggery,2015,2298,2625,327,14.22976501305483
Kille Dharur,Sorgum(Jawar),2015,1946,2273,327,16.803699897225076
Pune,Squash Gourd,2014,547,874,327,59.78062157221206
Ambad(Vadi Godri),Bajri,2016,1470,1797,327,22.244897959183675
Beed,Gram,2015,3426,3753,327,9.544658493870402
Mumbai,Bitter Gourd,2016,782,1109,327,41.81585677749361
Sangali,Gram,2015,3233,3560,327,10.114444788122487
Jalgaon,Jaggery,2015,2325,2651,326,14.021505376344086
Indapur-Bhigwan,Maize,2016,1650,1976,326,19.757575757575758
Khamgaon,Black Gram,2015,5912,6238,326,5.514208389715832
Shirpur,Bajri,2016,1432,1758,326,22.76536312849162
Mangrulpeer,Black Gram,2014,4745,5071,326,6.870389884088514
Beed,WHEAT(HUSKED),2016,2103,2429,326,15.501664289110794
Katol,Cotton,2015,4019,4345,326,8.111470515053496
Karad,Flower,2016,665,991,326,49.02255639097744
Bhiwapur,Cotton,2015,3875,4201,326,8.412903225806451
Pandharpur,Banana,2016,985,1311,326,33.09644670050761
Junnar-Otur,Flower,2016,123,449,326,265.0406504065041
Jamner,COTTON,2016,4481,4807,326,7.275161794242357
Jalgaon,Jaggery,2015,2396,2722,326,13.60601001669449
Pune-Pimpri,Cucumber,2015,1161,1487,326,28.079242032730406
Raver,Wheat(Husked),2016,1353,1679,326,24.09460458240946
Nagpur,Wheat(Husked),2015,1781,2107,326,18.304323413812465
Lonar,Wheat(Husked),2016,1558,1884,326,20.92426187419769
Lasur Station,Wheat(Husked),2016,1675,2001,326,19.46268656716418
Kalamb (Os),Sunflower,2015,2718,3044,326,11.99411331861663
Gangapur,Gram,2014,2401,2727,326,13.577675968346522
Sangali,Bajri,2016,1712,2038,326,19.042056074766354
Malegaon,Soybean,2015,3451,3777,326,9.44653723558389
Shirpur,Wheat(Husked),2014,1467,1793,326,22.22222222222222
Bhokar,Gram,2015,3907,4233,326,8.34399795239314
Khed (Shel Pimpalgaon),Farshi,2016,859,1185,326,37.951105937136205
Shrirampur,Sorgum(Jawar),2015,1405,1731,326,23.202846975088967
Ratanagari,Cabbage,2014,763,1089,326,42.72608125819135
Hadgaon-Tamsa,Cotton,2016,4272,4598,326,7.631086142322097
Chandrapur,Green Gram,2016,5539,5865,326,5.8855389059397005
Mul,Paddy-Unhusked,2016,2109,2435,326,15.457562825983878
Vani,Soybean,2014,2980,3306,326,10.939597315436242
Murbad,Cabbage,2016,847,1173,326,38.488783943329395
Shrirampur,Wheat(Husked),2016,1679,2005,326,19.416319237641453
Bhivandi,Other Vegetables,2016,926,1252,326,35.20518358531317
Murtizapur,Gram,2016,5113,5439,326,6.375904557011539
Shevgaon,Wheat(Husked),2016,1574,1900,326,20.71156289707751
Amarawati,Sorgum(Jawar),2014,1468,1794,326,22.20708446866485
Lasalgaon,Bajri,2014,1289,1615,326,25.290923196276182
Sakri,Soybean,2015,4133,4459,326,7.887732881684006
Kada,Gram,2016,6950,7276,326,4.690647482014389
Satara,Potato,2016,1413,1738,325,23.00070771408351
Shirur,Pigeon Pea (Tur),2015,7263,7588,325,4.474734958006334
Balapur,Sorgum(Jawar),2015,1200,1525,325,27.083333333333332
Jamkhed,Wheat(Husked),2015,1946,2271,325,16.700924974306268
Akole,Wheat(Husked),2015,1076,1401,325,30.20446096654275
Jalkot,Ground Nut Pods (Dry),2014,3550,3875,325,9.154929577464788
Akole,Soybean,2016,3300,3625,325,9.848484848484848
Jalna-Badnapur,Maize,2014,850,1175,325,38.23529411764706
Jawala-Bajar,GREEN GRAM,2016,4250,4575,325,7.647058823529412
Tumsar,Green Gram,2014,4808,5133,325,6.759567387687188
Karmala,Bajri,2014,1417,1742,325,22.93577981651376
Amarawati,Cluster Bean,2016,3075,3400,325,10.56910569105691
Barshi,Cabbage,2016,685,1010,325,47.44525547445255
Akot,Gram,2015,3898,4223,325,8.337609030271935
Pandharkawada,Gram,2015,3175,3500,325,10.236220472440944
Parbhani,Wheat(Husked),2015,1460,1785,325,22.26027397260274
Akot,Black Gram,2015,5175,5500,325,6.280193236714976
Barshi,Methi (Bhaji),2016,525,850,325,61.904761904761905
Solapur,Banana,2015,424,749,325,76.65094339622641
Mantha,Soybean,2016,3550,3875,325,9.154929577464788
Nandurbar,Cowpea,2016,3000,3325,325,10.833333333333334
Lonand,Sorgum(Jawar),2016,1750,2075,325,18.571428571428573
Akluj,Cabbage,2014,400,725,325,81.25
Barshi-Vairag,Gram,2015,4251,4576,325,7.6452599388379205
Koregaon,Sorgum(Jawar),2015,1650,1975,325,19.696969696969695
Lasur Station,Thymol/Lovage,2015,9688,10013,325,3.3546655656482245
Mantha,WHEAT(HUSKED),2016,1888,2213,325,17.213983050847457
Yawal,Maize,2016,1107,1432,325,29.35862691960253
Kille Dharur,Bajri,2016,1731,2056,325,18.77527440785673
Gevrai,Sorgum(Jawar),2016,1713,2038,325,18.972562755399885
Bhivandi,Rice(Paddy-Hus),2015,1473,1798,325,22.063815342837746
Varora,Cotton,2016,4461,4786,325,7.285362026451469
Kolhapur-Malkapur,Cabbage,2016,238,563,325,136.5546218487395
Umared,Wheat(Husked),2015,1500,1825,325,21.666666666666668
Chandrapur,Gram,2015,3000,3325,325,10.833333333333334
Rahata,Cucumber,2016,592,917,325,54.898648648648646
Mantha,Pigeon Pea (Tur),2016,8000,8325,325,4.0625
Aurangabad,Maize(Corn.),2014,675,1000,325,48.148148148148145
Barshi-Vairag,Wheat(Husked),2016,1801,2126,325,18.04553026096613
Solapur,Grapes,2015,152,477,325,213.81578947368422
Sangali,Soybean,2015,3100,3425,325,10.483870967741936
Morshi,Gram,2015,3444,3769,325,9.436701509872242
Barshi,Turmeric,2015,7806,8131,325,4.163464002049706
Amarawati,Sorgum(Jawar),2015,1522,1847,325,21.35348226018397
Jamkhed,Maize,2016,1375,1700,325,23.636363636363637
Malegaon (Washim),Gram,2016,3900,4225,325,8.333333333333334
Majalgaon,GRAM,2016,6500,6825,325,5.0
Varora,Soybean,2014,2900,3225,325,11.206896551724139
Paranda,Wheat(Husked),2015,1325,1650,325,24.528301886792452
Pune,NOLKOL,2016,500,825,325,65.0
Tumsar,Other Pulses,2014,2925,3250,325,11.11111111111111
Ambejogai,Gram,2015,3750,4075,325,8.666666666666666
Buldhana,Wheat(Husked),2015,1400,1725,325,23.214285714285715
Lasur Station,Pigeon Pea (Tur),2016,5775,6100,325,5.627705627705628
Panvel,Brinjal,2016,1563,1888,325,20.793346129238643
Pachora,Bajri,2016,1468,1793,325,22.138964577656676
Kalamb (Os),Soybean,2016,3628,3953,325,8.958103638368247
Kille Dharur,Gram,2014,2150,2475,325,15.116279069767442
Ambejogai,Gram,2015,3931,4256,325,8.267616382599847
Chandur Bajar,Wheat(Husked),2016,1425,1750,325,22.80701754385965
Chandrapur-Ganjwad,Chavli (Pala),2016,900,1225,325,36.111111111111114
Jalkot,Sunflower,2016,2692,3017,325,12.072808320950966
Mangalwedha,Sorgum(Jawar),2015,1608,1933,325,20.21144278606965
Khamgaon,Sesamum,2016,4750,5075,325,6.842105263157895
Ahmednagar,Gram,2015,3200,3525,325,10.15625
Vaijapur,Ground Nut Pods (Dry),2016,6265,6590,325,5.18754988028731
Vai,Bottle Gourd,2014,1175,1500,325,27.659574468085108
Barshi,Fodder,2014,352,677,325,92.32954545454545
Amarawati,Kharbuj,2016,1231,1556,325,26.401299756295696
Karad,Cucumber,2014,775,1100,325,41.935483870967744
Kalyan,Capsicum,2016,1375,1700,325,23.636363636363637
Shahapur,Cucumber,2015,942,1267,325,34.50106157112526
Ghoti,Bitter Gourd,2016,1700,2025,325,19.11764705882353
Jalgaon,GREEN GRAM,2016,4601,4926,325,7.063681808302543
Deglur,Green Gram,2016,6000,6325,325,5.416666666666667
Kalyan,Papai,2016,1600,1925,325,20.3125
Solapur,Green Peas (Dry),2015,3225,3550,325,10.077519379844961
Amarawati-Fruit And Vegetables,Coriander  ,2016,2106,2431,325,15.432098765432098
Dondaicha,GREEN GRAM,2016,4267,4592,325,7.616592453714554
Sangamner,Bajri,2014,1341,1666,325,24.23564504101417
Amarawati,Melon,2016,469,794,325,69.29637526652452
Partur,Wheat(Husked),2015,1487,1812,325,21.856086079354405
Amarawati-Fruit And Vegetables,Kharbuj,2016,1713,2038,325,18.972562755399885
Kannad,Wheat(Husked),2015,1317,1642,325,24.677296886864085
Nagpur,Chavli (Pala),2016,775,1100,325,41.935483870967744
Mumbai,Snake Gourd,2015,1267,1592,325,25.651144435674823
Ahmednagar,Maize(Corn.),2016,1100,1425,325,29.545454545454547
Pune-Pimpri,Wheat(Husked),2015,1895,2220,325,17.150395778364118
Kada (Ashti),Wheat(Husked),2016,1625,1950,325,20.0
Koregaon,Gram,2015,3819,4144,325,8.510081173081959
Dondaicha-Sindkheda,Ground Nut Pods (Dry),2016,4835,5160,325,6.72182006204757
Beed,Sorgum(Jawar),2016,1633,1958,325,19.90202082057563
Nashik-Devlali,Melon,2016,875,1200,325,37.142857142857146
Kurdwadi,Gram,2014,2063,2388,325,15.753756665050897
Mumbai,Bottle Gourd,2016,679,1004,325,47.864506627393226
Manora,PIGEON PEA (TUR),2016,5484,5809,325,5.9263311451495255
Ramtek,Bitter Gourd,2016,1188,1513,325,27.356902356902356
Dondaicha,Sorgum(Jawar),2016,1449,1774,325,22.429261559696343
Dhule,Matki,2015,6327,6652,325,5.1367156630314526
Ahmednagar,Carrot,2016,1350,1675,325,24.074074074074073
Nagpur,Pumpkin,2015,558,883,325,58.24372759856631
Naigaon,Gram,2015,3825,4150,325,8.49673202614379
Baramati,Bajri,2014,1450,1775,325,22.413793103448278
Kolhapur-Laxmipuri,Gr.Nut Kernels,2016,10317,10642,325,3.150140544731996
Sangrampur-Varvatbakal,Soybean,2016,3117,3442,325,10.42669233237087
Ghatanji,Pigeon Pea (Tur),2015,6200,6525,325,5.241935483870968
Akluj,Wheat(Husked),2015,1530,1855,325,21.241830065359476
Rahata,Gram,2014,2156,2481,325,15.074211502782932
Yawal,Gram,2016,4450,4775,325,7.303370786516854
Amarawati,Pigeon Pea (Tur),2015,7350,7675,325,4.421768707482993
Osmanabad,Pigeon Pea (Tur),2016,7500,7825,325,4.333333333333333
Sinner,Soybean,2016,3561,3886,325,9.126649817467003
Kalmeshwar,Methi (Bhaji),2016,875,1200,325,37.142857142857146
Bhokardan,Pigeon Pea (Tur),2016,6000,6325,325,5.416666666666667
Udgir,Pigeon Pea (Tur),2016,7200,7525,325,4.513888888888889
Karad,Capsicum,2015,1525,1850,325,21.311475409836067
Ausa,Soybean,2016,3164,3488,324,10.240202275600506
Parola,Wheat(Husked),2016,1326,1650,324,24.43438914027149
Vaijapur,Green Gram,2016,4440,4764,324,7.297297297297297
Umared,Other Pulses,2015,4725,5049,324,6.857142857142857
Rahuri-Vambori,Sorgum(Jawar),2014,1611,1935,324,20.11173184357542
Amarawati,Onion,2016,341,665,324,95.01466275659824
Sindi (Selu),WHEAT(HUSKED),2016,1461,1785,324,22.17659137577002
Akluj,Gram,2015,3681,4005,324,8.80195599022005
Vaijapur,BAJRI,2016,1406,1730,324,23.044096728307256
Savner,Gram,2015,2798,3122,324,11.579699785561115
Dound,Wheat(Husked),2014,1557,1881,324,20.809248554913296
Karad,SNAKE GOURD,2016,700,1024,324,46.285714285714285
Aurangabad,Tomato,2016,596,920,324,54.36241610738255
Sinner,Wheat(Husked),2016,1639,1963,324,19.768151311775473
Sangamner,Bajri,2015,1328,1652,324,24.397590361445783
Chandur Bajar,Gram,2016,3931,4255,324,8.242177562961079
Sailu,GREEN GRAM,2016,4363,4687,324,7.426082970433188
Vai,Flower,2015,1328,1652,324,24.397590361445783
Wardha,Gram,2016,5399,5723,324,6.001111316910539
Mehkar,Sorgum(Jawar),2014,1105,1429,324,29.32126696832579
Akluj,Potato,2016,1668,1992,324,19.424460431654676
Parli-Vaijnath,Soybean,2014,3119,3443,324,10.38794485411991
Shrirampur,Mango(Raw),2015,833,1157,324,38.895558223289314
Aurangabad,Sorgum(Jawar),2014,1674,1998,324,19.35483870967742
Vadgaon Peth,Cabbage,2016,381,705,324,85.03937007874016
Kamthi,Chavli (Pala),2016,297,621,324,109.0909090909091
Dhule,Bajri,2016,1324,1648,324,24.47129909365559
Lasalgaon,Maize,2015,1161,1485,324,27.906976744186046
Kamthi,Bottle Gourd,2016,286,610,324,113.2867132867133
Latur,Sorgum(Jawar),2016,1602,1926,324,20.224719101123597
Manwat,Sorgum(Jawar),2015,1260,1584,324,25.714285714285715
Jintur,Pigeon Pea (Tur),2016,6006,6330,324,5.394605394605395
Kopargaon,Wheat(Husked),2015,1373,1697,324,23.59796067006555
Sillod,Green Gram,2015,6680,7004,324,4.850299401197605
Pathardi,Bajri,2015,1306,1630,324,24.808575803981622
Mangalwedha,Gram,2016,3786,4109,323,8.531431590068674
Dhamangaon-Rly,Soybean,2016,3515,3838,323,9.18918918918919
Pune-Moshi,TOMATO,2016,540,863,323,59.81481481481482
Sillod,Black Gram,2016,5815,6138,323,5.554600171969046
Kamthi,Tomato,2016,174,497,323,185.632183908046
Nandgaon Khandeshwar,Pigeon Pea (Tur),2015,5560,5883,323,5.809352517985611
Nanded,Pigeon Pea (Tur),2016,7920,8243,323,4.078282828282828
Ramtek,Tomato,2015,1527,1850,323,21.152586771447282
Vai,Flower,2015,1296,1619,323,24.92283950617284
Nagpur,Cucumber,2016,1000,1323,323,32.3
Arvi,Gram,2016,7400,7723,323,4.364864864864865
Rajura,Cotton,2015,3667,3990,323,8.808290155440414
Vani,Soybean,2016,3465,3788,323,9.321789321789321
Rahuri-Vambori,Green Gram,2016,7033,7356,323,4.592634722024741
Partur,Wheat(Husked),2015,1407,1730,323,22.956645344705045
Jalgaon,Cucumber,2015,1223,1546,323,26.41046606704824
Varud-Rajura Bazar,Soybean,2014,2900,3223,323,11.137931034482758
Anajngaon Surji,Sorgum(Jawar),2016,1294,1617,323,24.961360123647605
Digras,Pigeon Pea (Tur),2016,7849,8172,323,4.115173907504141
Gangapur,Green Gram,2015,7464,7787,323,4.327438370846731
Varud-Rajura Bazar,Soybean,2015,2906,3229,323,11.11493461803166
Manora,Gram,2015,3300,3623,323,9.787878787878787
Dhule,Bajri,2015,1188,1511,323,27.188552188552187
Amarawati,Math (Bhaji),2016,2433,2756,323,13.275791204274558
Jalgaon,Green Chilli,2016,341,664,323,94.72140762463343
Mumbai,Capsicum,2015,2254,2577,323,14.33007985803017
Pachora,Bajri,2016,1542,1865,323,20.946822308690013
Shirpur,Wheat(Husked),2016,1579,1902,323,20.45598480050665
Yeotmal,Soybean,2014,2906,3229,323,11.11493461803166
Shevgaon,Sorgum(Jawar),2015,1300,1623,323,24.846153846153847
Mumbai,Snake Gourd,2016,1686,2009,323,19.157769869513643
Latur,Soybean,2016,3763,4086,323,8.5835769332979
Mumbai,Elephant Root,2015,3454,3777,323,9.351476548928778
Digras,Pigeon Pea (Tur),2014,4495,4818,323,7.185761957730812
Shahada,Wheat(Husked),2014,1473,1796,323,21.92803801765105
Murtizapur,Soybean,2016,3450,3773,323,9.36231884057971
Kalmeshwar,CORIANDER ,2016,1939,2262,323,16.65807117070655
Dondaicha,Ground Nut Pods (Dry),2014,3791,4114,323,8.52017937219731
Jamkhed,Gram,2016,3810,4133,323,8.47769028871391
Deglur,Green Gram,2015,7172,7495,323,4.503625209146682
Jalgaon,Jaggery,2015,2238,2561,323,14.432529043789097
Ahmedpur,Gram,2015,3434,3757,323,9.405940594059405
Wardha,Gram,2014,2540,2863,323,12.716535433070867
Amarawati-Fruit And Vegetables,Orange,2016,685,1008,323,47.153284671532845
Anajngaon Surji,Wheat(Husked),2016,1436,1759,323,22.493036211699163
Shrirampur,Gram,2015,3008,3331,323,10.738031914893616
Malegaon,Sorgum(Jawar),2014,1565,1888,323,20.638977635782748
Paithan,Bajri,2016,1433,1756,323,22.540125610607117
Anajngaon Surji,Soybean,2015,3183,3506,323,10.147659440779139
Pune-Moshi,SMALL GOURD,2016,1508,1831,323,21.419098143236074
Mangalwedha,Wheat(Husked),2016,1919,2242,323,16.831683168316832
Jalkot,Soybean,2015,3408,3730,322,9.448356807511738
Latur,Sorgum(Jawar),2015,2117,2439,322,15.210203117619272
Partur,Sorgum(Jawar),2015,1232,1554,322,26.136363636363637
Nagpur,Soybean,2015,2915,3237,322,11.04631217838765
Patur,Sorgum(Jawar),2016,1403,1725,322,22.950819672131146
Kille Dharur,Cotton,2016,4605,4927,322,6.992399565689468
Umared,Green Gram,2014,5126,5448,322,6.281701131486539
Anajngaon Surji,Wheat(Husked),2015,1328,1650,322,24.246987951807228
Shirpur,Wheat(Husked),2015,1418,1740,322,22.708039492242595
Chikhali,Maize,2016,1237,1559,322,26.03071948261924
Katol,Soybean,2016,3094,3416,322,10.407239819004525
Palghar(Bevur),Wheat(Husked),2016,1985,2307,322,16.221662468513856
Tumsar,Gram,2016,7192,7514,322,4.477196885428254
Sindi,Soybean,2015,2909,3231,322,11.069095909247164
Ramtek,Ladies Finger,2016,1005,1327,322,32.039800995024876
Beed,Wheat(Husked),2015,1660,1982,322,19.397590361445783
Shirur,Gram,2015,3363,3685,322,9.574784418673802
Pune,Wheat(Husked),2016,2299,2621,322,14.00608960417573
Pune,Sorgum(Jawar),2016,2602,2924,322,12.375096079938508
Kamthi,Spinach,2015,232,554,322,138.79310344827587
Nagpur,Ginger (Fresh),2016,2400,2722,322,13.416666666666666
Ahmedpur,Sorgum(Jawar),2015,1522,1844,322,21.156373193166885
Satana,Bajri,2015,1162,1484,322,27.710843373493976
Rahata,Potato,2016,1314,1636,322,24.505327245053273
Chalisgaon,Wheat(Husked),2016,1426,1748,322,22.580645161290324
Nashik,FLOWER,2016,366,688,322,87.97814207650273
Karanja,Gram,2015,4245,4567,322,7.585394581861013
Ramtek,Green Peas (Dry),2016,2189,2511,322,14.709913202375514
Sindkhed Raja,Sorgum(Jawar),2016,1461,1783,322,22.039698836413415
Malegaon,Wheat(Husked),2015,1446,1768,322,22.26832641770401
Shirur,Tamarind,2015,1706,2028,322,18.87456037514654
Ramtek,Wal Bhaji,2016,978,1300,322,32.92433537832311
Dhule,Maize,2016,1087,1409,322,29.622815087396503
Satara,Cabbage,2015,382,704,322,84.29319371727749
Kalmeshwar,Walvad,2015,4170,4492,322,7.721822541966427
Pune-Pimpri,Mango(Raw),2016,1422,1744,322,22.644163150492265
Anajngaon Surji,Green Gram,2014,7547,7869,322,4.266595998409964
Jalgaon,Coriander (Dry),2014,11178,11500,322,2.880658436213992
Udgir,Pigeon Pea (Tur),2015,7297,7619,322,4.4127723722077565
Mumbai,Arvi,2016,1678,2000,322,19.189511323003575
Koregaon,Green Gram,2014,6289,6611,322,5.120050882493242
Umared,Pigeon Pea (Tur),2014,4161,4483,322,7.738524393174718
Jamkhed,Soybean,2015,3014,3336,322,10.68347710683477
Yeola,Bajri,2016,1543,1865,322,20.86843810758263
Amarawati,Sorgum(Jawar),2016,1544,1866,322,20.854922279792746
Malegaon (Washim),Black Gram,2016,6714,7036,322,4.795948763777182
Nagpur,Wheat(Husked),2014,1583,1905,322,20.341124447252053
Dhamangaon-Rly,Soybean,2015,3193,3515,322,10.084559974945192
Barshi-Vairag,Gram,2015,3112,3433,321,10.314910025706942
Hingoli,Ground Nut Pods (Dry),2015,5106,5427,321,6.286721504112808
Mumbai,Flower,2015,854,1175,321,37.587822014051525
Ratanagari,Cabbage,2016,505,826,321,63.56435643564357
Jintur-Bori,Soybean,2014,3002,3323,321,10.692871419053963
Dudhani,Pigeon Pea (Tur),2014,4829,5150,321,6.647338993580451
Aurangabad,CARROT,2016,974,1295,321,32.95687885010267
Kolhapur-Laxmipuri,Bajri,2016,1927,2248,321,16.65801764400623
Jalgaon,Coriander (Dry),2016,8975,9296,321,3.5766016713091924
Nanded,Pigeon Pea (Tur),2016,7604,7925,321,4.221462388216728
Amarawati-Fruit And Vegetables,Coriander  ,2016,1379,1700,321,23.27773749093546
Kopargaon,Wheat(Husked),2016,1478,1799,321,21.718538565629228
Dindori,Onion,2016,528,849,321,60.79545454545455
Kinwat,Gram,2016,5550,5871,321,5.783783783783784
Ulhasnagar,Onion,2016,853,1174,321,37.63188745603752
Aurangabad,Papai,2014,1047,1368,321,30.659025787965614
Pune-Moshi,Onion,2016,329,650,321,97.56838905775076
Osmanabad,Wheat(Husked),2014,1288,1609,321,24.922360248447205
Tumsar,Gram,2015,3979,4300,321,8.067353606433777
Lonand,Bajri,2016,1375,1696,321,23.345454545454544
Jalna,Green Gram,2015,6263,6584,321,5.125339294267922
Jalgaon,Potato,2015,395,716,321,81.26582278481013
Khed-Chakan,Onion,2016,329,650,321,97.56838905775076
Digras,Pigeon Pea (Tur),2015,4635,4956,321,6.925566343042071
Malegaon (Washim),Pigeon Pea (Tur),2015,5587,5908,321,5.745480579917666
Rahuri-Vambori,Gram,2014,2200,2521,321,14.590909090909092
Purna,Sorgum(Jawar),2015,1144,1465,321,28.05944055944056
Rahuri-Vambori,Wheat(Husked),2015,1574,1895,321,20.393900889453622
Beed,Wheat(Husked),2015,1651,1972,321,19.442761962447
Risod,Soybean,2015,3296,3617,321,9.739077669902912
Nandurbar,Green Gram,2016,6214,6535,321,5.165754747344706
Mumbai,Shevga,2016,1575,1896,321,20.38095238095238
Malegaon,Bajri,2016,1330,1651,321,24.13533834586466
Kille Dharur,Bajri,2016,1696,2017,321,18.92688679245283
Kille Dharur,Sorgum(Jawar),2015,2264,2585,321,14.178445229681978
Hingoli,Gram,2015,3932,4253,321,8.163784333672432
Bhivandi,Wheat(Husked),2015,1600,1920,320,20.0
Kalamb (Yawatmal),Gram,2016,4600,4920,320,6.956521739130435
Baramati,Wheat(Husked),2014,1596,1916,320,20.050125313283207
Manchar,Kanda Pat,2015,654,974,320,48.92966360856269
Sonpeth,Sorgum(Jawar),2014,1648,1968,320,19.41747572815534
Yeotmal,Soybean,2016,3361,3681,320,9.520975900029754
Ausa,Soybean,2016,3429,3749,320,9.332166812481773
Shahada,Maize,2014,1059,1379,320,30.217186024551463
Umarkhed,Gram,2015,3800,4120,320,8.421052631578947
Umarkhed,Soybean,2015,3000,3320,320,10.666666666666666
Nagpur,Beet Root,2016,1240,1560,320,25.806451612903224
Jintur,Wheat(Husked),2014,1298,1618,320,24.65331278890601
Babhulgaon,Soybean,2015,3475,3795,320,9.20863309352518
Hadgaon,Soybean,2015,3200,3520,320,10.0
Jawala-Bajar,Turmeric,2016,7938,8258,320,4.031242126480222
Panvel,Bitter Gourd,2015,3920,4240,320,8.16326530612245
Ambad(Vadi Godri),Bajri,2016,1595,1915,320,20.062695924764892
Balapur,Sorgum(Jawar),2015,1100,1420,320,29.09090909090909
Kalamb (Os),Sesamum,2016,4940,5260,320,6.477732793522267
Shirpur,Black Gram,2014,5060,5380,320,6.324110671936759
Murum,Sesamum,2014,8960,9280,320,3.5714285714285716
Umarkhed,Soybean,2015,3100,3420,320,10.32258064516129
Sindkhed Raja,Soybean,2016,3700,4020,320,8.64864864864865
Parli-Vaijnath,Soybean,2015,3384,3704,320,9.456264775413711
Sangali,Bajri,2016,1747,2067,320,18.317115054378935
Malkapur,Soybean,2015,2978,3298,320,10.745466756212222
Jamkhed,Wheat(Husked),2016,1660,1980,320,19.27710843373494
Majalgaon,Gram,2016,8236,8556,320,3.885381253035454
Shrigonda,Wheat(Husked),2016,1605,1925,320,19.937694704049843
Vani,Pigeon Pea (Tur),2015,6105,6425,320,5.241605241605241
Akhadabalapur,Gram,2016,6520,6840,320,4.9079754601226995
Dhamangaon-Rly,Soybean,2015,3200,3520,320,10.0
Ahmedpur,Sunflower,2015,3407,3727,320,9.392427355444672
Khamgaon,Sunflower,2014,2628,2948,320,12.1765601217656
Barshi,Shepu,2015,380,700,320,84.21052631578948
Kille Dharur,Soybean,2014,2941,3261,320,10.88065283917035
Mumbai,Arvi,2016,960,1280,320,33.333333333333336
Rahuri,Potato,2016,1480,1800,320,21.62162162162162
Sangrampur,Wheat(Husked),2015,1180,1500,320,27.11864406779661
Udgir,Tamarind Seed,2015,1501,1821,320,21.319120586275815
Pune-Moshi,CHAVLI (SHENGA ),2016,1715,2035,320,18.658892128279884
Nashik,Shepu,2015,140,460,320,228.57142857142858
Tumsar,Other Cereals,2014,1858,2178,320,17.222820236813778
Solapur,Flower,2015,240,560,320,133.33333333333334
Latur,Gram,2015,3410,3730,320,9.3841642228739
Chandrapur-Ganjwad,Cabbage,2015,415,735,320,77.10843373493977
Latur,Soybean,2015,3248,3568,320,9.852216748768473
Vai,Cucumber,2016,1220,1540,320,26.229508196721312
Yawal,Wheat(Husked),2016,1600,1920,320,20.0
Solapur,Banana,2015,274,594,320,116.78832116788321
Mantha,Sorgum(Jawar),2016,1560,1880,320,20.512820512820515
Mumbai,Arvi,2014,2480,2800,320,12.903225806451612
Khed (Shel Pimpalgaon),Cabbage,2016,1942,2262,320,16.4778578784758
Khed (Shel Pimpalgaon),Brinjal,2016,602,922,320,53.15614617940199
Lasalgaon,Maize,2016,1460,1780,320,21.91780821917808
Amalner,GREEN GRAM,2016,4360,4680,320,7.339449541284404
Pune,Sorgum(Jawar),2016,2390,2710,320,13.389121338912133
Mumbai,Snake Gourd,2016,1360,1680,320,23.529411764705884
Dharmabad,Soybean,2016,3650,3970,320,8.767123287671232
Shrirampur,Papai,2015,880,1200,320,36.36363636363637
Kopargaon,Green Gram,2015,8306,8626,320,3.852636648206116
Mumbai,Arvi,2015,2547,2867,320,12.563800549666274
Patan,Green Chilli,2014,1710,2030,320,18.71345029239766
Chandrapur,Gram,2016,4750,5070,320,6.7368421052631575
Mumbai,Flower,2016,1138,1458,320,28.1195079086116
Chopda,Gram,2016,4103,4423,320,7.7991713380453325
Pune,Lentil,2016,6175,6495,320,5.182186234817814
Amarawati,Orange,2015,800,1120,320,40.0
Mumbai,Elephant Root,2016,3336,3656,320,9.59232613908873
Mehkar,Sorgum(Jawar),2015,1050,1370,320,30.476190476190474
Amarawati,Potato,2015,580,900,320,55.172413793103445
Kolhapur,Strawberi,2016,669,989,320,47.832585949177876
Lasur Station,Bajri,2015,1301,1621,320,24.596464258262873
Mangalwedha,Matki,2015,6710,7030,320,4.769001490312966
Patur,SOYBEAN,2016,2483,2803,320,12.887635924285139
Kej,Gram,2015,3449,3769,320,9.278051609162077
Barshi,Coriander  ,2016,280,600,320,114.28571428571429
Akluj,Water Melon,2015,333,653,320,96.09609609609609
Mudkhed,Wheat(Husked),2016,1476,1795,319,21.612466124661246
Mangrulpeer,Black Gram,2014,4579,4898,319,6.966586590958725
Pathari,Soybean,2016,2967,3286,319,10.75160094371419
Vaduj,Green Gram,2014,6225,6544,319,5.124497991967871
Lasur Station,Bajri,2015,1080,1399,319,29.537037037037038
Vaijapur,Gram,2016,5605,5924,319,5.691347011596789
Ramtek,Onion,2015,1894,2213,319,16.842661034846884
Pune-Manjri,Cabbage,2015,795,1114,319,40.125786163522015
Malkapur,Onion,2016,475,794,319,67.15789473684211
Mumbai,Flower,2016,523,842,319,60.994263862332694
Pune-Pimpri,Bitter Gourd,2015,2950,3269,319,10.813559322033898
Baramati,Jaggery,2015,2401,2720,319,13.28613077884215
Mumbai,Water Melon,2015,686,1005,319,46.501457725947525
Kalmeshwar,Chavli (Shenga ),2016,2550,2869,319,12.509803921568627
Ramtek,Tomato,2015,1186,1505,319,26.897133220910625
Panvel,Bottle Gourd,2016,2069,2388,319,15.41807636539391
Amarawati,Wheat(Husked),2016,1834,2153,319,17.393675027262812
Vai,Bottle Gourd,2015,1331,1650,319,23.96694214876033
Shrirampur,Ladies Finger,2015,1138,1457,319,28.031634446397188
Kolhapur-Laxmipuri,Split Gram,2016,5221,5540,319,6.109940624401456
Kopargaon,Wheat(Husked),2015,1322,1641,319,24.130105900151285
Nilanga,Soybean,2014,3189,3508,319,10.003135779241141
Chopda,Wheat(Husked),2015,1130,1449,319,28.23008849557522
Lasalgaon,Sorgum(Jawar),2015,1781,2100,319,17.911285794497473
Partur,Cotton,2016,4274,4593,319,7.463734206832007
Sangamner,Bajri,2016,1610,1929,319,19.81366459627329
Nashik-Devlali,TANDULJA,2016,308,627,319,103.57142857142857
Shrigonda,Wheat(Husked),2016,1606,1925,319,19.863013698630137
Nagpur,Brinjal,2016,1081,1400,319,29.50971322849214
Satara,Cabbage,2015,550,869,319,58.0
Manmad,Bajri,2016,1605,1924,319,19.87538940809969
Akot,Gram,2016,4030,4349,319,7.915632754342432
Nandura,Maize,2016,1242,1561,319,25.684380032206118
Malegaon (Washim),Gram,2015,3374,3693,319,9.45465323058684
Chopda,Sorgum(Jawar),2015,1213,1532,319,26.29843363561418
Jintur,Black Gram,2015,7844,8163,319,4.066802651708312
Bhivandi,Onion,2016,1219,1538,319,26.168990976210008
Ner Parasopant,Pigeon Pea (Tur),2015,7669,7988,319,4.159603598904681
Nagpur,Ladies Finger,2016,956,1275,319,33.36820083682009
Pathardi,Green Gram,2016,5131,5450,319,6.217111674137595
Kopargaon,Wheat(Husked),2015,1350,1669,319,23.62962962962963
Mandhal,Chillies(Red),2014,3692,4011,319,8.640303358613219
Malegaon,Bajri,2015,1260,1579,319,25.317460317460316
Vaijapur,Bajri,2016,1586,1905,319,20.113493064312735
Ausa,Sunflower,2016,2541,2860,319,12.554112554112555
Barshi-Vairag,Soybean,2014,2838,3157,319,11.24031007751938
Mantha,Sorgum(Jawar),2016,1525,1844,319,20.918032786885245
Mumbai,Bottle Gourd,2014,1311,1630,319,24.332570556826848
Nashik-Devlali,Spinach,2016,483,802,319,66.0455486542443
Kalyan,Papai,2016,910,1229,319,35.05494505494506
Deglur,Green Gram,2014,7238,7557,319,4.407294832826747
Lasur Station,Bajri,2016,1480,1799,319,21.554054054054053
Yawal,Gram,2016,3944,4263,319,8.088235294117647
Kalyan,ELEPHANT ROOT,2016,1800,2118,318,17.666666666666668
Nandura,Soybean,2015,2987,3305,318,10.646133244057582
Shegaon,Wheat(Husked),2015,1220,1538,318,26.065573770491802
Sangrampur,Pigeon Pea (Tur),2014,4075,4393,318,7.803680981595092
Amarawati,Orange,2015,479,797,318,66.38830897703549
Shahada,Soybean,2016,3402,3720,318,9.347442680776014
Rahata,Lemon,2016,5773,6091,318,5.508401177897107
Hadgaon-Tamsa,Gram,2016,4088,4406,318,7.778864970645793
Aurangabad,Cucumber,2015,627,945,318,50.717703349282296
Mumbai,Water Melon,2014,719,1037,318,44.22809457579972
Malegaon,Wheat(Husked),2015,1451,1769,318,21.91592005513439
Nandura,Wheat(Husked),2016,1444,1762,318,22.022160664819946
Pune-Pimpri,Cucumber,2014,1863,2181,318,17.06924315619968
Vita,Tomato,2016,415,733,318,76.62650602409639
Mumbai,Arvi,2015,2300,2618,318,13.826086956521738
Ner Parasopant,Pigeon Pea (Tur),2015,5405,5723,318,5.883441258094357
Mukhed,Green Gram,2015,7405,7723,318,4.294395678595544
Malkapur,Onion,2016,225,543,318,141.33333333333334
Nagpur,Rice(Paddy-Hus),2015,2626,2944,318,12.10967250571211
Shirpur,Maize,2016,1143,1461,318,27.821522309711288
Chandrapur-Ganjwad,Cabbage,2014,256,574,318,124.21875
Dhule,Green Gram,2015,5508,5826,318,5.773420479302832
Zarijamini,Pigeon Pea (Tur),2015,5150,5468,318,6.174757281553398
Tumsar,Other Pulses,2014,2625,2943,318,12.114285714285714
Nagpur,Green Chilli,2015,2039,2357,318,15.595880333496812
Dhamangaon-Rly,Gram,2015,3050,3368,318,10.426229508196721
Beed,Soybean,2014,3019,3337,318,10.533289168598873
Kalyan,Bor,2015,1291,1609,318,24.632068164213788
Raver,Gram,2014,2166,2484,318,14.681440443213296
Ahmednagar,Wheat(Husked),2015,1572,1890,318,20.229007633587788
Mumbai,Sweet Potato,2015,882,1200,318,36.054421768707485
Umari,Pigeon Pea (Tur),2016,8241,8559,318,3.858755005460502
Umared,Cotton,2015,4129,4447,318,7.701622668927101
Ghatanji,Cotton,2016,4265,4583,318,7.456037514654162
Rahata,FLOWER,2016,282,600,318,112.76595744680851
Akluj,Water Melon,2015,341,659,318,93.25513196480938
Lonar,Gram,2016,3994,4312,318,7.961942914371558
Solapur,JAGGERY,2016,3131,3449,318,10.156499520919834
Manchar,Cucumber,2015,973,1291,318,32.68242548818088
Umarkhed-Danki,Gram,2016,4064,4382,318,7.824803149606299
Paithan,Gram,2016,4754,5072,318,6.689103912494741
Dondaicha,Bajri,2015,1101,1419,318,28.88283378746594
Amarawati,Coriander  ,2016,2143,2461,318,14.839010732617826
Sinner,Bajri,2015,1300,1618,318,24.46153846153846
Mantha,Soybean,2015,3300,3618,318,9.636363636363637
Mumbai,Squash Gourd,2016,739,1057,318,43.031123139377534
Sangamner,Wheat(Husked),2015,1566,1884,318,20.306513409961685
Washim-Ansing,GREEN GRAM,2016,4833,5150,317,6.559073039519967
Amarawati,Wheat(Husked),2016,1839,2156,317,17.23762914627515
Ramtek,Flower,2016,1109,1426,317,28.584310189359783
Ramtek,Flower,2016,1613,1930,317,19.652820830750155
Panvel,Bitter Gourd,2016,4718,5035,317,6.718948707079271
Aurangabad,Potato,2016,1021,1338,317,31.047992164544564
Nagpur,Wheat(Husked),2016,1958,2275,317,16.189989785495403
Umarga,Pigeon Pea (Tur),2016,6360,6677,317,4.984276729559748
Dondaicha,Bajri,2016,1424,1741,317,22.26123595505618
Risod,Soybean,2015,3027,3344,317,10.47241493227618
Nagbhid,Paddy-Unhusked,2015,1563,1880,317,20.281509916826614
Chandrapur-Ganjwad,Tomato,2015,350,667,317,90.57142857142857
Kalyan,Cucumber,2015,1287,1604,317,24.630924630924632
Chandrapur-Ganjwad,Bitter Gourd,2016,733,1050,317,43.24693042291951
Kannad,Sorgum(Jawar),2016,1427,1744,317,22.214435879467413
Hingoli,Green Gram,2016,4908,5225,317,6.458842705786471
Jalgaon Jamod-Aasalgaon,Soybean,2016,2783,3100,317,11.390585698886094
Pune,Gr.Nut Kernels,2015,7933,8250,317,3.995966217067944
Dhule,Black Gram,2014,5171,5488,317,6.13034229356024
Murbad,Cabbage,2015,2618,2935,317,12.108479755538578
Patan,Flower,2015,1246,1563,317,25.441412520064205
Kille Dharur,Soybean,2016,3300,3617,317,9.606060606060606
Gangapur,Pigeon Pea (Tur),2016,7903,8220,317,4.011135012020752
Sangrampur-Varvatbakal,Sorgum(Jawar),2015,1083,1400,317,29.270544783010155
Mumbai,Flower,2015,871,1188,317,36.394948335246845
Mumbai,Onion,2016,704,1021,317,45.02840909090909
Pandharpur,Banana,2015,572,889,317,55.41958041958042
Partur,Wheat(Husked),2015,1319,1636,317,24.03335860500379
Sinner,Sorgum(Jawar),2016,1376,1693,317,23.037790697674417
Vai,Bottle Gourd,2015,1208,1525,317,26.241721854304636
Akluj,Potato,2015,672,989,317,47.17261904761905
Manchar,Onion,2016,550,867,317,57.63636363636363
Kalmeshwar,Chavli (Shenga ),2016,1915,2232,317,16.553524804177545
Pune-Pimpri,Bottle Gourd,2016,1577,1894,317,20.10145846544071
Tumsar,Gram,2014,2290,2607,317,13.842794759825328
Buldhana,Wheat(Husked),2016,1500,1817,317,21.133333333333333
Nampur,Ground Nut Pods (Dry),2016,2650,2967,317,11.962264150943396
Sangamner,Sorgum(Jawar),2014,1533,1850,317,20.678408349641227
Mumbai,Bottle Gourd,2015,1075,1392,317,29.488372093023255
Khed,Cabbage,2016,344,661,317,92.15116279069767
Kolhapur-Laxmipuri,Paddy-Unhusked,2015,1600,1917,317,19.8125
Chalisgaon,Sunflower,2015,2578,2895,317,12.296353762606671
Mahur,Soybean,2015,3279,3596,317,9.667581579749923
Kolhapur-Laxmipuri,Paddy-Unhusked,2015,1663,1980,317,19.061936259771496
Palus,Cabbage,2016,500,817,317,63.4
Chakur,Pigeon Pea (Tur),2016,6537,6854,317,4.849319259599205
Akola,Soybean,2015,3182,3499,317,9.962287869264614
Pune-Moshi,ONION,2016,573,890,317,55.32286212914485
Nanded,Gram,2016,5894,6211,317,5.378350865286732
Vasai,Onion,2016,809,1126,317,39.18417799752781
Mumbai,Snake Gourd,2015,822,1139,317,38.564476885644766
Jalna,Maize,2015,1016,1333,317,31.200787401574804
Satana,Bajri,2015,1166,1483,317,27.18696397941681
Pulgaon,Cotton,2015,4102,4419,317,7.72793759141882
Tuljapur,Gram,2015,3092,3408,316,10.219922380336351
Kille Dharur,Sorgum(Jawar),2016,1651,1967,316,19.13991520290733
Chandrapur-Ganjwad,Tomato,2016,128,444,316,246.875
Hadgaon,Sorgum(Jawar),2015,1117,1433,316,28.29006266786034
Mudkhed,Pigeon Pea (Tur),2015,7999,8315,316,3.950493811726466
Babhulgaon,Pigeon Pea (Tur),2014,4676,4992,316,6.757912745936698
Karad,Cucumber,2015,1017,1333,316,31.071779744346117
Mumbai,Flower,2015,1142,1458,316,27.6707530647986
Kille Dharur,Gram,2016,4746,5062,316,6.658238516645596
Nagpur,CHAVLI (SHENGA ),2016,958,1274,316,32.98538622129436
Gevrai,Sorgum(Jawar),2015,1440,1756,316,21.944444444444443
Amarawati-Fruit And Vegetables,Papai,2016,1532,1848,316,20.626631853785902
Sailu,Cotton,2015,3764,4080,316,8.395324123273113
Chalisgaon,Wheat(Husked),2014,1392,1708,316,22.701149425287355
Mehkar,Soybean,2015,3625,3941,316,8.717241379310344
Dhule,Horse Gram,2014,3026,3342,316,10.442828816920027
Mumbai,CABBAGE,2016,365,681,316,86.57534246575342
Ghansawangi,Wheat(Husked),2016,1867,2183,316,16.925549009105517
Mohol,Gram,2015,3908,4224,316,8.085977482088024
Aurangabad,Carrot,2016,779,1095,316,40.564826700898585
Lasalgaon-Niphad,Soybean,2016,3183,3499,316,9.927741124725102
Amarawati,Black Gram,2014,5056,5372,316,6.25
Chakur,Pigeon Pea (Tur),2016,8144,8460,316,3.880157170923379
Yeotmal,Soybean,2014,3063,3379,316,10.316682990532158
Satara,Cabbage,2015,742,1058,316,42.58760107816712
Kolhapur-Laxmipuri,Split Lentil,2016,7180,7496,316,4.401114206128134
Amarawati,WHEAT(HUSKED),2016,1843,2159,316,17.145957677699403
Jamkhed,Soybean,2016,3195,3511,316,9.890453834115807
Buldhana,Sorgum(Jawar),2015,1217,1533,316,25.965488907148725
Digras,Cotton,2016,4425,4741,316,7.141242937853107
Mangalwedha,Wheat(Unhusked),2014,2467,2783,316,12.809079854073774
Kalmeshwar,Brinjal,2016,1804,2120,316,17.516629711751662
Yawal,Cotton,2016,4006,4322,316,7.888167748377434
Lonar,PIGEON PEA (TUR),2016,5317,5633,316,5.943201053225503
Jalgaon Jamod-Aasalgaon,Soybean,2016,3042,3358,316,10.387902695595002
Ausa,Sunflower,2016,3184,3500,316,9.924623115577889
Barshi,WHEAT(HUSKED),2016,1901,2217,316,16.622830089426618
Kalyan,Flower,2015,667,983,316,47.37631184407796
Nagpur,Coriander  ,2015,1692,2008,316,18.67612293144208
Jalgaon Jamod-Aasalgaon,Gram,2016,3817,4133,316,8.278752947340843
Umared,Pigeon Pea (Tur),2015,8021,8337,316,3.93965839670864
Nandgaon Khandeshwar,Chino,2015,3760,4076,316,8.404255319148936
Pandharpur,Sorgum(Jawar),2015,1757,2073,316,17.98520204894707
Vaijapur,Wheat(Husked),2016,1690,2006,316,18.698224852071007
Amarawati-Fruit And Vegetables,Tomato,2016,2696,3012,316,11.72106824925816
Chikhali,Sorgum(Jawar),2016,1260,1576,316,25.07936507936508
Mumbai,Sugar,2016,3563,3879,316,8.868930676396296
Arvi,Cotton,2016,5117,5433,316,6.175493453195232
Nagpur,Small Gourd,2015,892,1208,316,35.426008968609864
Dondaicha,Bajri,2016,1391,1707,316,22.71746944644141
Shirpur,Sorgum(Jawar),2015,1251,1567,316,25.259792166266987
Mumbai,Arvi,2015,2726,3042,316,11.592076302274394
Ghoti,Flower,2016,2142,2458,316,14.752567693744165
Washim,Soybean,2015,3448,3764,316,9.164733178654293
Jintur,Sorgum(Jawar),2015,1197,1513,316,26.39933166248956
Sinner,Soybean,2014,3089,3405,316,10.229847847199741
Kalmeshwar,Soybean,2016,3205,3521,316,9.85959438377535
Karmala,Sunflower,2014,3012,3328,316,10.49136786188579
Ulhasnagar,Banana,2016,300,616,316,105.33333333333333
Kalmeshwar,Spinach,2015,1777,2092,315,17.726505346088913
Chandrapur-Ganjwad,Onion,2016,650,965,315,48.46153846153846
Nandura,Gram,2014,2220,2535,315,14.18918918918919
Mangrulpeer,Pigeon Pea (Tur),2014,4537,4852,315,6.942913819704651
Aurangabad,Bottle Gourd,2015,500,815,315,63.0
Pusad,Bajri,2015,1493,1808,315,21.098459477561956
Karad,Brinjal,2015,614,929,315,51.302931596091206
Manwat,Green Gram,2016,4743,5058,315,6.641366223908919
Pune,Sorgum(Jawar),2016,2541,2856,315,12.396694214876034
Pulgaon,Soybean,2014,2937,3252,315,10.725229826353422
Pune,Cabbage,2016,263,578,315,119.77186311787072
Loha,Pigeon Pea (Tur),2015,6934,7249,315,4.542832419959619
Patur,Soybean,2014,2707,3022,315,11.636497968230513
Nandgaon,Maize,2014,866,1181,315,36.37413394919169
Bhokar,Sesamum,2016,5980,6295,315,5.2675585284280935
Pathari,Sorgum(Jawar),2015,1661,1976,315,18.96447922937989
Malegaon,Wheat(Husked),2015,1451,1766,315,21.709166092350102
Pusad,Bajri,2014,1575,1890,315,20.0
Ahmednagar,Soybean,2015,3410,3725,315,9.237536656891496
Amarawati,Wheat(Husked),2015,1530,1845,315,20.58823529411765
Mantha,Wheat(Husked),2016,1620,1935,315,19.444444444444443
Malegaon,Wheat(Husked),2015,1456,1771,315,21.634615384615383
Karad,Cabbage,2014,714,1029,315,44.11764705882353
Shevgaon,Gram,2015,4003,4318,315,7.869098176367724
Kada (Ashti),Bajri,2015,1000,1315,315,31.5
Himayatnagar,Soybean,2015,3132,3447,315,10.057471264367816
Kille Dharur,Bajri,2015,1311,1626,315,24.02745995423341
Karad,Onion,2016,685,1000,315,45.98540145985402
Kolhapur-Laxmipuri,Bajri,2016,1715,2030,315,18.367346938775512
Mehkar,Gram,2015,3244,3559,315,9.710234278668311
Kalmeshwar,Coriander  ,2016,2127,2442,315,14.809590973201692
Paithan,Wheat(Husked),2015,1473,1788,315,21.384928716904277
Mumbai,Capsicum,2015,1785,2100,315,17.647058823529413
Karad,Ridge Gourd,2015,1614,1929,315,19.516728624535315
Bhokar,Cotton,2016,4240,4555,315,7.429245283018868
Indapur-Bhigwan,Sunflower,2015,2888,3203,315,10.907202216066482
Chopda,Wheat(Husked),2015,1231,1546,315,25.588952071486595
Vai,Tomato,2015,1152,1467,315,27.34375
Nandurbar,Ground Nut Pods (Dry),2014,2678,2993,315,11.76250933532487
Amarawati,Coriander  ,2016,1480,1795,315,21.283783783783782
Khed-Chakan,Cucumber,2015,961,1276,315,32.778355879292405
Dudhani,Pigeon Pea (Tur),2015,7142,7457,315,4.410529263511622
Pune-Moshi,Wal Papdi,2016,2571,2886,315,12.252042007001167
Shegaon,Gram,2015,3921,4236,315,8.033664881407804
Nagpur,Wheat(Husked),2016,1836,2151,315,17.15686274509804
Parli-Vaijnath,Gram,2014,1928,2243,315,16.33817427385892
Pune-Pimpri,Bottle Gourd,2016,1146,1461,315,27.486910994764397
Jalgaon,Wal Papdi,2015,1571,1886,315,20.050922978994272
Mumbai,Carrot,2015,1208,1523,315,26.076158940397352
Tumsar,Wheat(Husked),2016,1471,1785,314,21.34602311352821
Telhara,Soybean,2015,3288,3602,314,9.549878345498783
Latur,Safflower,2015,2501,2815,314,12.554978008796482
Aurangabad,Potato,2016,705,1019,314,44.53900709219858
Chandur Rly.,Gram,2016,6286,6600,314,4.995227489659561
Aurangabad,Maize(Corn.),2014,668,982,314,47.0059880239521
Beed,Bajri,2014,1330,1644,314,23.60902255639098
Sangamner,Bajri,2015,1313,1627,314,23.914699162223915
Pune-Pimpri,Wal Papdi,2015,2300,2614,314,13.652173913043478
Aurangabad,Bottle Gourd,2015,581,895,314,54.0447504302926
Anajngaon Surji,Wheat(Husked),2015,1329,1643,314,23.626787057938298
Latur,Sorgum(Jawar),2015,2044,2358,314,15.362035225048924
Satana,Wheat(Husked),2016,1537,1851,314,20.429407937540663
Pulgaon,Soybean,2016,3429,3743,314,9.157188684747739
Chandrapur,Banana,2015,700,1014,314,44.857142857142854
Kada (Ashti),Sorgum(Jawar),2016,1600,1914,314,19.625
Akluj,Cabbage,2016,333,647,314,94.29429429429429
Ahmedpur,Gram,2016,4547,4861,314,6.905652078293381
Malegaon,Soybean,2015,3347,3661,314,9.381535703615178
Nagpur,PADDY-UNHUSKED,2016,1508,1822,314,20.822281167108752
Umared,Wheat(Husked),2014,1500,1814,314,20.933333333333334
Akkolkot,Gram,2015,3495,3809,314,8.984263233190271
Sinner,Soybean,2016,2612,2926,314,12.021439509954059
Tumsar,Rice(Paddy-Hus),2015,3274,3588,314,9.590714722052535
Akluj,Cabbage,2015,553,867,314,56.78119349005425
Sangli-Phale Bhajipalam,Water Melon,2015,53,367,314,592.4528301886793
Kalamb (Os),Sorgum(Jawar),2016,1501,1815,314,20.919387075283144
Mehkar,Wheat(Husked),2015,1250,1564,314,25.12
Aurangabad,Tomato,2016,338,652,314,92.89940828402366
Lasur Station,Bajri,2016,1372,1686,314,22.886297376093296
Majalgaon,Cotton,2015,3658,3972,314,8.583925642427555
Rahata,Sorgum(Jawar),2015,1200,1514,314,26.166666666666668
Devala,Bajri,2016,1542,1856,314,20.363164721141374
Patur,Green Gram,2016,4393,4707,314,7.147735033007057
Kalyan,Bor,2016,2300,2614,314,13.652173913043478
Taloda,Black Gram,2014,3200,3514,314,9.8125
Shegaon,Black Gram,2015,5425,5739,314,5.788018433179723
Kille Dharur,Wheat(Husked),2015,1703,2017,314,18.4380504991192
Kamthi,Methi (Bhaji),2015,504,818,314,62.301587301587304
Malkapur,Soybean,2015,2963,3277,314,10.597367532905839
Pune-Moshi,Potato,2016,1243,1557,314,25.261464199517295
Manora,Soybean,2015,2985,3299,314,10.51926298157454
Satara,Sweet Potato,2015,943,1257,314,33.29798515376458
Sangali,Soybean,2016,2854,3168,314,11.002102312543798
Patan,Tomato,2016,1068,1382,314,29.40074906367041
Shevgaon,Bajri,2016,1532,1846,314,20.496083550913838
Panvel,Ridge Gourd,2016,2829,3143,314,11.099328384588194
Mahagaon,Cotton,2016,4340,4654,314,7.235023041474655
Rahata,Ground Nut Pods (Dry),2015,2929,3243,314,10.720382383065893
Kalvan,Bajri,2016,1417,1731,314,22.159491884262525
Buldhana,SOYBEAN,2016,2494,2808,314,12.590216519647154
Ratanagari,Cabbage,2016,476,790,314,65.96638655462185
Pathardi,Sorgum(Jawar),2016,1569,1883,314,20.01274697259401
Dound,Bajri,2016,1520,1834,314,20.657894736842106
Satara,Potato,2014,2175,2488,313,14.39080459770115
Chandrapur-Ganjwad,Cabbage,2016,257,570,313,121.78988326848248
Shirpur,Maize,2015,1006,1319,313,31.11332007952286
Wardha,Soybean,2015,2813,3126,313,11.126910771418414
Umarga,MAIZE,2016,945,1258,313,33.12169312169312
Jalgaon,SORGUM(JAWAR),2016,1692,2005,313,18.498817966903072
Nira,Bajri,2015,1550,1863,313,20.193548387096776
Balapur,Wheat(Husked),2015,1375,1688,313,22.763636363636362
Umared,Coriander (Dry),2016,7233,7546,313,4.327388358910549
Kolhapur-Laxmipuri,Cowpea,2014,4600,4913,313,6.804347826086956
Yeola,Soybean,2014,2857,3170,313,10.955547777388869
Dhamangaon-Rly,Soybean,2015,3038,3351,313,10.302830809743252
Washim,Soybean,2016,3609,3922,313,8.672762538099196
Bhokar,Gram,2016,5808,6121,313,5.389118457300276
Mumbai,Elephant Root,2015,1774,2087,313,17.643742953776776
Akole,Soybean,2015,2825,3138,313,11.079646017699115
Kalmeshwar,Tomato,2016,3129,3442,313,10.003195909236178
Parbhani,Gram,2014,2137,2450,313,14.646700982686008
Hingoli,Pigeon Pea (Tur),2016,8672,8985,313,3.609317343173432
Bhandara,Wheat(Husked),2016,1519,1832,313,20.605661619486504
Pachora,Sunflower,2016,3363,3676,313,9.307166220636336
Umarkhed-Danki,Soybean,2014,2880,3193,313,10.868055555555555
Lasur Station,Bajri,2014,1161,1474,313,26.959517657192077
Nagpur,Capsicum,2016,1375,1688,313,22.763636363636362
Bhivandi,Onion,2015,1510,1823,313,20.728476821192054
Shirur,Gram,2015,3641,3954,313,8.596539412249381
Amarawati,Green Chilli,2015,2525,2838,313,12.396039603960396
Ramtek,Brinjal,2015,955,1268,313,32.774869109947645
Manmad,Bajri,2014,1163,1476,313,26.913155631986243
Shegaon,Thymol/Lovage,2014,7175,7488,313,4.362369337979094
Rahata,Bottle Gourd,2014,538,851,313,58.17843866171004
Amarawati-Fruit And Vegetables,Spinach,2016,1917,2230,313,16.327595200834637
Chandrapur,Pineapple,2016,255,568,313,122.74509803921569
Kej,Bajri,2016,1295,1608,313,24.16988416988417
Jintur,Turmeric,2016,6116,6429,313,5.117724002616089
Shrirampur,Cucumber,2014,1264,1577,313,24.7626582278481
Jalgaon,Potato,2015,875,1188,313,35.77142857142857
Junnar-Otur,Cabbage,2016,300,613,313,104.33333333333333
Achalpur,Gram,2014,2425,2738,313,12.907216494845361
Amarawati,Sorgum(Jawar),2014,1475,1788,313,21.220338983050848
Nagpur,Rice(Paddy-Hus),2015,2684,2997,313,11.661698956780924
Kannad,Bajri,2016,1271,1584,313,24.626278520849723
Lasalgaon,Maize,2016,1408,1721,313,22.230113636363637
Pusad,WHEAT(HUSKED),2016,1863,2176,313,16.800858829844337
Wardha,Soybean,2016,3450,3763,313,9.072463768115941
Umared,Coriander (Dry),2015,10496,10809,313,2.982088414634146
Savner,Gram,2015,4547,4860,313,6.883659555751045
Yawal,Maize,2016,981,1294,313,31.906218144750255
Hingoli,Gram,2016,5433,5746,313,5.761089637401067
Aurangabad,Maize(Corn.),2015,775,1088,313,40.38709677419355
Patan,Flower,2016,1325,1638,313,23.62264150943396
Umared,Wheat(Husked),2014,1500,1813,313,20.866666666666667
Kolhapur,Beet Root,2015,1750,2063,313,17.885714285714286
Malegaon,Bajri,2015,1280,1592,312,24.375
Nagpur,Small Gourd,2016,2038,2350,312,15.309126594700688
Amarawati,Green Gram,2016,6693,7005,312,4.661586732406993
Akluj,Water Melon,2016,253,565,312,123.3201581027668
Shrirampur,Wheat(Husked),2014,1413,1725,312,22.08067940552017
Pusad,Sorgum(Jawar),2015,1290,1602,312,24.186046511627907
Lonar,Gram,2014,2446,2758,312,12.755519215044972
Akluj,Potato,2016,994,1306,312,31.388329979879277
Kalyan,Ladies Finger,2016,1894,2206,312,16.473072861668427
Majalgaon,Wheat(Husked),2016,1620,1932,312,19.25925925925926
Amalner,Maize,2015,1188,1500,312,26.262626262626263
Kurdwadi,Gram,2014,2453,2765,312,12.719119445576844
Osmanabad,Soybean,2016,3360,3672,312,9.285714285714286
Osmanabad,Soybean,2016,2982,3294,312,10.462776659959758
Ralegaon,Cotton,2016,4302,4614,312,7.252440725244073
Ramtek,Bottle Gourd,2015,988,1300,312,31.57894736842105
Hingoli,Gram,2015,3037,3349,312,10.273296015805071
Lasur Station,Pigeon Pea (Tur),2014,4045,4357,312,7.713226205191595
Chopda,Soybean,2016,3073,3385,312,10.152945004881223
Daryapur,Soybean,2015,2951,3263,312,10.572687224669604
Pusad,Gram,2016,3927,4239,312,7.944996180290298
Kalyan,Banana,2015,1688,2000,312,18.48341232227488
Solapur,Sorgum(Jawar),2016,1905,2217,312,16.37795275590551
Amarawati,Sorgum(Jawar),2016,1613,1925,312,19.34283942963422
Osmanabad,Sorgum(Jawar),2015,1783,2095,312,17.498597868760516
Bhandara,Gram,2014,2234,2546,312,13.96598030438675
Chikhali,Soybean,2014,3000,3312,312,10.4
Rahata,Mango(Raw),2016,2063,2375,312,15.12360639844886
Kopargaon,Soybean,2015,2996,3308,312,10.413885180240321
Satara,Potato,2015,863,1175,312,36.15295480880649
Akluj,Water Melon,2015,444,756,312,70.27027027027027
Ashti-Karanja,Gram,2015,4050,4362,312,7.703703703703703
Amarawati,Potato,2016,947,1259,312,32.946145723336855
Chandrapur,Soybean,2015,2914,3226,312,10.706932052161976
Barshi,Ghevda,2016,1700,2012,312,18.352941176470587
Kalvan,MAIZE,2016,994,1306,312,31.388329979879277
Ambejogai,Soybean,2015,3501,3813,312,8.911739502999144
Kolhapur-Laxmipuri,Gr.Nut Kernels,2016,9088,9400,312,3.433098591549296
Aurangabad,Ladies Finger,2016,720,1032,312,43.333333333333336
Nagpur,Parwar,2015,819,1131,312,38.095238095238095
Sinner,Soybean,2015,3175,3487,312,9.826771653543307
Pathardi,Sorgum(Jawar),2015,1559,1871,312,20.012828736369467
Koregaon,Green Gram,2014,6394,6706,312,4.879574601188614
Malkapur,Maize,2016,1139,1451,312,27.39244951712028
Dudhani,Sorgum(Jawar),2015,1582,1894,312,19.721871049304678
Katol,Mosambi,2016,1513,1825,312,20.62128222075347
Kalamb (Os),Soybean,2016,3447,3759,312,9.051348999129678
Gangapur,Sorgum(Jawar),2016,1449,1761,312,21.532091097308488
Karad,Flower,2016,752,1064,312,41.48936170212766
Pune,Gr.Nut Kernels,2015,7063,7375,312,4.417386379725329
Dondaicha,Sorgum(Jawar),2014,1488,1800,312,20.967741935483872
Dondaicha,Sorgum(Jawar),2014,1547,1859,312,20.168067226890756
Chandrapur-Ganjwad,Brinjal,2016,241,553,312,129.46058091286307
Kolhapur-Laxmipuri,Split Lentil,2016,6988,7300,312,4.464796794504865
Nagpur,PARWAR,2016,1144,1456,312,27.272727272727273
Nampur,BAJRI,2016,1270,1582,312,24.566929133858267
Raver,Sorgum(Jawar),2014,1230,1542,312,25.365853658536587
Satara,Tomato,2016,542,854,312,57.564575645756456
Kalvan,Bajri,2014,1056,1368,312,29.545454545454547
Kalmeshwar,Chavli (Shenga ),2014,2261,2573,312,13.799203892083149
Barshi,Brinjal,2016,190,502,312,164.21052631578948
Indapur,Ground Nut Pods (Dry),2015,4338,4650,312,7.19225449515906
Patur,Sorgum(Jawar),2015,1288,1600,312,24.22360248447205
Vai,Brinjal,2014,1771,2082,311,17.560700169395822
Murum,Gram,2016,4237,4548,311,7.340099126740618
Satana,Sorgum(Jawar),2015,1580,1891,311,19.68354430379747
Nandurbar,Soybean,2015,3385,3696,311,9.187592319054653
Shirur,Gram,2015,3575,3886,311,8.6993006993007
Pune-Pimpri,Cucumber,2016,915,1226,311,33.98907103825137
Akot,Soybean,2015,3293,3604,311,9.444275736410567
Hinganghat,Gram,2015,3922,4233,311,7.929627740948495
Shrirampur,Sorgum(Jawar),2016,1524,1835,311,20.406824146981627
Malegaon (Washim),SOYBEAN,2016,2527,2838,311,12.307083498219232
Rahata,Ladies Finger,2016,633,944,311,49.13112164296999
Amarawati,Bitter Gourd,2016,3400,3711,311,9.147058823529411
Sangrampur-Varvatbakal,Sorgum(Jawar),2016,1082,1393,311,28.743068391866913
Pune-Pimpri,Cluster Bean,2016,3811,4122,311,8.160587772238257
Kurdwadi,Maize,2016,1439,1750,311,21.612230715774842
Aurangabad,Cabbage,2015,628,939,311,49.52229299363057
Ramtek,Gram,2016,4219,4530,311,7.371415027257644
Aurangabad,Maize(Corn.),2015,856,1167,311,36.33177570093458
Mumbai,Sugar,2016,3593,3904,311,8.655719454494852
Lonar,Green Gram,2016,5332,5643,311,5.832708177044261
Chalisgaon,Gram,2016,4618,4929,311,6.734517106972715
Mumbai,Green Chilli,2015,2033,2344,311,15.297589768814559
Shirpur,Sorgum(Jawar),2016,1669,1980,311,18.633912522468545
Washim,Soybean,2015,3370,3681,311,9.228486646884273
Solapur,Cabbage,2015,373,684,311,83.37801608579089
Shegaon,Wheat(Husked),2015,1189,1500,311,26.156433978132885
Gangapur,WHEAT(HUSKED),2016,1778,2089,311,17.49156355455568
Manwat,Soybean,2016,3389,3700,311,9.176748303334318
Akluj,Water Melon,2016,242,553,311,128.51239669421489
Mumbai,Elephant Root,2016,3362,3673,311,9.250446162998216
Kalmeshwar,Cluster Bean,2016,2362,2673,311,13.166807790008468
Savner,Soybean,2015,3030,3341,311,10.264026402640264
Ausa,Sorgum(Jawar),2015,1750,2061,311,17.771428571428572
Baramati,Bajri,2016,1581,1892,311,19.671094244149273
Jalgaon,Wheat(Husked),2015,1543,1854,311,20.15554115359689
Pulgaon,Gram,2015,3847,4158,311,8.084221471276319
Sangamner,Bajri,2015,1383,1694,311,22.487346348517715
Murtizapur,Pigeon Pea (Tur),2014,4694,5005,311,6.625479335321687
Mumbai,Carrot,2016,1085,1396,311,28.663594470046082
Kada,Gram,2016,5643,5954,311,5.511252879673933
Nandurbar,MAIZE,2016,1228,1539,311,25.3257328990228
Palghar(Bevur),Wheat(Husked),2015,1741,2052,311,17.863296955772544
Vaijapur,Gram,2016,5514,5825,311,5.64018861080885
Patan,Flower,2015,1056,1367,311,29.450757575757574
Baramati,Soybean,2015,3198,3509,311,9.724828017510944
Barshi,Cluster Bean,2016,416,727,311,74.75961538461539
Amalner,Wheat(Husked),2016,1502,1813,311,20.70572569906791
Nagpur,Mosambi,2015,1851,2162,311,16.801728795245815
Malkapur,Onion,2016,175,486,311,177.71428571428572
Barshi,Tomato,2016,376,687,311,82.7127659574468
Khed-Chakan,Potato,2015,619,930,311,50.24232633279483
Kalmeshwar,Cucumber,2016,729,1040,311,42.661179698216735
Malegaon,Maize,2014,879,1190,311,35.381114903299206
Nagpur,Rice(Paddy-Hus),2016,2510,2821,311,12.390438247011952
Kalyan,Brinjal,2015,1060,1371,311,29.339622641509433
Majalgaon,Soybean,2015,2909,3220,311,10.69095909247164
Indapur,Bajri,2015,1400,1711,311,22.214285714285715
Pimpalgaon (B)-Saykheda,Onion,2016,147,458,311,211.56462585034015
Mohol,Pigeon Pea (Tur),2015,7667,7978,311,4.056345376287988
Kille Dharur,Sorgum(Jawar),2015,2089,2400,311,14.88750598372427
Rahata,Bottle Gourd,2015,522,833,311,59.57854406130268
Jawala-Bajar,Soybean,2015,3350,3660,310,9.253731343283581
Nandurbar,Maize,2015,1003,1313,310,30.907278165503488
Digras,Green Gram,2016,5366,5676,310,5.777115169586284
Pune-Moshi,Potato,2016,1297,1607,310,23.901310717039323
Khamgaon,Sunflower,2014,2794,3104,310,11.095204008589835
Pune-Pimpri,Flower,2015,1300,1610,310,23.846153846153847
Kopargaon,Soybean,2016,3365,3675,310,9.212481426448736
Devala,Tamarind,2016,2623,2933,310,11.81852840259245
Akkolkot,Bajri,2015,1301,1611,310,23.82782475019216
Sindkhed Raja,Sorgum(Jawar),2016,1495,1805,310,20.735785953177256
Partur,Gram,2015,3317,3627,310,9.345794392523365
Akole,Bajri,2014,1390,1700,310,22.302158273381295
Hingna,Soybean,2014,2953,3263,310,10.497798848628513
Pune-Pimpri,Tomato,2016,963,1273,310,32.191069574247145
Pune-Pimpri,Ghevda,2016,3400,3710,310,9.117647058823529
Aurangabad,Carrot,2015,1332,1642,310,23.273273273273272
Chandrapur,Water Melon,2015,370,680,310,83.78378378378379
Ashti-Karanja,Soybean,2015,3300,3610,310,9.393939393939394
Hinganghat,Soybean,2015,2993,3303,310,10.357500835282325
Mumbai,Ladies Finger,2015,1033,1343,310,30.00968054211036
Lasur Station,Potato,2016,1290,1600,310,24.031007751937985
Amarawati-Fruit And Vegetables,Flower,2016,2800,3110,310,11.071428571428571
Malegaon,Bajri,2014,1251,1561,310,24.78017585931255
Kalmeshwar,Soybean,2014,2942,3252,310,10.537049626104691
Risod,Soybean,2015,3437,3747,310,9.019493744544661
Ahmednagar,Sorgum(Jawar),2016,1667,1977,310,18.59628074385123
Shevgaon,Bajri,2016,1544,1854,310,20.077720207253886
Pune,Bajri,2016,1760,2070,310,17.613636363636363
Wardha,Gram,2016,6281,6591,310,4.935519821684445
Pathardi,Sorgum(Jawar),2016,1587,1897,310,19.533711405166983
Bhokar,Turmeric,2016,6655,6965,310,4.658151765589782
Latur-Murud,Wheat(Husked),2016,2144,2454,310,14.458955223880597
Gevrai,Cotton,2015,3930,4240,310,7.888040712468193
Mul,Paddy-Unhusked,2015,1942,2252,310,15.962924819773429
Manwat,Gram,2016,6200,6510,310,5.0
Jawala-Bajar,Pigeon Pea (Tur),2016,8470,8780,310,3.6599763872491144
Kalyan,Flower,2016,902,1212,310,34.368070953436806
Shrirampur,Ginger (Fresh),2015,3215,3525,310,9.64230171073095
Sailu,Gram,2016,6320,6630,310,4.905063291139241
Mahagaon,Sorgum(Jawar),2016,1590,1900,310,19.49685534591195
Purna,Soybean,2015,3401,3711,310,9.11496618641576
Satana,Wheat(Husked),2015,1521,1831,310,20.381328073635768
Umarga,Soybean,2016,3338,3648,310,9.286998202516477
Ramtek,Chavli (Shenga ),2016,1652,1962,310,18.765133171912833
Balapur,Soybean,2015,2915,3225,310,10.634648370497427
Partur,Green Gram,2016,4548,4858,310,6.816182937554969
Nagpur,Soybean,2015,2975,3285,310,10.420168067226891
Pandharpur,Potato,2016,800,1110,310,38.75
Pune-Pimpri,Cabbage,2016,1115,1425,310,27.80269058295964
Mumbai,Cucumber,2016,1302,1612,310,23.80952380952381
Dondaicha-Sindkheda,Bajri,2016,1507,1817,310,20.5706702057067
Chopda,Maize,2016,1040,1350,310,29.807692307692307
Barshi,Fodder,2014,313,623,310,99.04153354632588
Kalmeshwar,Green Chilli,2016,4272,4581,309,7.23314606741573
Jalgaon,Maize,2016,1380,1689,309,22.391304347826086
Akluj,Water Melon,2016,274,583,309,112.77372262773723
Amarawati,Wheat(Husked),2016,1763,2072,309,17.526942711287578
Loha,Gram,2016,5153,5462,309,5.996506889190763
Nandgaon,Bajri,2014,1117,1426,309,27.66338406445837
Gevrai,Bajri,2016,1364,1673,309,22.653958944281523
Nagpur,Pumpkin,2015,491,800,309,62.93279022403259
Vaijapur,Wheat(Husked),2016,1612,1921,309,19.168734491315135
Amarawati-Fruit And Vegetables,Cabbage,2016,2273,2582,309,13.59436867575891
Malegaon,Maize,2016,1123,1432,309,27.515583259127336
Rahata,Bottle Gourd,2015,564,873,309,54.787234042553195
Shirpur,Wheat(Husked),2016,1574,1883,309,19.63151207115629
Jalgaon,Cabbage,2016,622,931,309,49.67845659163987
Bhokar,Soybean,2014,3054,3363,309,10.11787819253438
Umarga,Wheat(Husked),2015,1458,1767,309,21.19341563786008
Jamkhed,Bajri,2016,1508,1817,309,20.490716180371354
Barshi,Fodder,2015,243,552,309,127.1604938271605
Panvel,Flower,2016,2336,2645,309,13.227739726027398
Bhokardan-Pimpalgaon Renu,Sorgum(Jawar),2016,1002,1311,309,30.838323353293415
Ahmednagar,Black Gram,2015,9851,10160,309,3.1367373870673028
Achalpur,Gram,2016,4127,4436,309,7.487278895081173
Karad,Brinjal,2016,636,945,309,48.58490566037736
Mumbai,Elephant Root,2015,1658,1967,309,18.636911942098916
Shahada,WHEAT(HUSKED),2016,1738,2047,309,17.779056386651323
Rahata,Bor,2015,1092,1401,309,28.296703296703296
Sangrampur,Sorgum(Jawar),2015,964,1273,309,32.053941908713696
Vai,Ladies Finger,2015,1218,1527,309,25.36945812807882
Karanja,Pigeon Pea (Tur),2014,4733,5042,309,6.528628776674414
Rahata,Sorgum(Jawar),2015,1194,1503,309,25.87939698492462
Pachora,Bajri,2016,1336,1645,309,23.12874251497006
Nagpur,Papai,2016,558,867,309,55.376344086021504
Kalamb (Os),Pigeon Pea (Tur),2015,8384,8693,309,3.6855916030534353
Khamgaon,Wheat(Husked),2016,1497,1806,309,20.64128256513026
Shevgaon,Sorgum(Jawar),2016,1650,1959,309,18.727272727272727
Yeola,Pigeon Pea (Tur),2015,5449,5758,309,5.6707652780326665
Kalyan,FLOWER,2016,682,991,309,45.30791788856305
Chikhali,Sorgum(Jawar),2016,1237,1546,309,24.97978981406629
Parola,Bajri,2016,1484,1793,309,20.82210242587601
Parli-Vaijnath,Soybean,2016,3441,3749,308,8.950886370241209
Manwat,Wheat(Husked),2015,1522,1830,308,20.2365308804205
Paithan,Wheat(Husked),2016,1807,2115,308,17.044825677919203
Chandrapur,Soybean,2015,2988,3296,308,10.307898259705489
Kalmeshwar,Chavli (Shenga ),2016,2140,2448,308,14.392523364485982
Beed,Sorgum(Jawar),2015,1606,1914,308,19.17808219178082
Sailu,Pigeon Pea (Tur),2015,5035,5343,308,6.117179741807348
Amarawati,Dhemse,2016,3092,3400,308,9.961190168175937
Amarawati,Cabbage,2016,2075,2383,308,14.843373493975903
Satara,Cabbage,2014,596,904,308,51.67785234899329
Tumsar,Wheat(Husked),2015,1235,1543,308,24.939271255060728
Patan,Flower,2015,1046,1354,308,29.445506692160613
Pune-Moshi,Flower,2016,648,956,308,47.53086419753087
Dhule,Maize,2014,886,1194,308,34.762979683972915
Varora,Soybean,2016,2948,3256,308,10.447761194029852
Jalna,Bajri,2016,1567,1875,308,19.6553924696873
Devani,Pigeon Pea (Tur),2016,8087,8395,308,3.8085816742920735
Nagpur,Chavli (Pala),2015,715,1023,308,43.07692307692308
Khed-Chakan,Bottle Gourd,2016,959,1267,308,32.11678832116788
Nampur,Pigeon Pea (Tur),2016,6792,7100,308,4.534746760895171
Karad,Cabbage,2016,652,960,308,47.239263803680984
Karanja,WHEAT(HUSKED),2016,1781,2089,308,17.29365524985963
Aurangabad,GREEN CHILLI,2016,700,1008,308,44.0
Devala,Black Gram,2016,6786,7094,308,4.538756262894194
Manwat,Sorgum(Jawar),2016,1611,1919,308,19.118559900682804
Vita,TOMATO,2016,292,600,308,105.47945205479452
Lonar,Gram,2014,2450,2758,308,12.571428571428571
Malegaon,Bajri,2015,1251,1559,308,24.620303756994403
Balapur,Soybean,2015,3282,3590,308,9.384521633150518
Morshi,Pigeon Pea (Tur),2016,6222,6530,308,4.950176792028286
Nandurbar,Maize,2015,1233,1541,308,24.979724249797243
Kalmeshwar,Cluster Bean,2016,2700,3008,308,11.407407407407407
Sangamner,Wheat(Husked),2015,1612,1920,308,19.106699751861044
Nagpur,Potato,2015,783,1091,308,39.33588761174968
Pune,Wheat(Husked),2016,2084,2392,308,14.779270633397314
Ahmedpur,Sorgum(Jawar),2015,1538,1846,308,20.0260078023407
Mumbai,Snake Gourd,2016,1021,1329,308,30.166503428011755
Shahapur,Brinjal,2015,917,1225,308,33.587786259541986
Sinner,Bajri,2015,1091,1399,308,28.230980751604033
Sangrampur,Wheat(Husked),2015,1182,1490,308,26.057529610829103
Kalmeshwar,Spinach,2016,1742,2050,308,17.680826636050515
Indapur,Bajri,2015,1442,1750,308,21.359223300970875
Malkapur,Sorgum(Jawar),2014,1190,1498,308,25.88235294117647
Nagpur,Green Chilli,2015,2323,2631,308,13.258717176065433
Nagpur,Green-Peas,2015,2192,2500,308,14.05109489051095
Aheri,Soybean,2015,3162,3470,308,9.74067046173308
Akluj,Cabbage,2015,377,685,308,81.6976127320955
Kalmeshwar,Brinjal,2016,1346,1654,308,22.88261515601783
Buldhana,Gram,2014,2264,2571,307,13.560070671378092
Vani,COTTON,2016,4620,4927,307,6.645021645021645
Karanja,Wheat(Husked),2016,1624,1931,307,18.90394088669951
Sangamner,TOMATO,2016,261,568,307,117.62452107279694
Chopda,Gram,2014,2301,2608,307,13.342025206431986
Kalmeshwar,Coriander  ,2016,2551,2858,307,12.034496275970207
Shevgaon,Black Gram,2016,6057,6364,307,5.068515766881294
Sangrampur-Varvatbakal,Wheat(Husked),2016,1318,1625,307,23.292867981790593
Pombhurni,Paddy-Unhusked,2016,2000,2307,307,15.35
Pune-Pimpri,Flower,2014,1108,1415,307,27.707581227436823
Mumbai,Onion,2016,713,1020,307,43.05750350631136
Shirpur,Wheat(Husked),2015,1403,1710,307,21.88168210976479
Lasalgaon-Vinchur,Wheat(Husked),2016,1667,1974,307,18.416316736652668
Tuljapur,Gram,2014,2418,2725,307,12.696443341604631
Nagpur,Rice(Paddy-Hus),2015,2667,2974,307,11.51106111736033
Chandur Bajar,Soybean,2015,3000,3307,307,10.233333333333333
Kolhapur-Laxmipuri,Maize,2016,1883,2190,307,16.303770578863517
Indapur (Nimgaon Ketki),Bajri,2016,1438,1745,307,21.349095966620308
Aurangabad,Papai,2014,857,1164,307,35.82263710618437
Aarni,Wheat(Husked),2014,1238,1545,307,24.79806138933764
Kalyan,Jaggery,2015,3280,3587,307,9.359756097560975
Pune-Moshi,Potato,2016,1289,1596,307,23.81691233514352
Akluj,Cabbage,2014,480,787,307,63.958333333333336
Barshi,Ladies Finger,2016,379,686,307,81.00263852242745
Ambejogai,Wheat(Husked),2015,1774,2081,307,17.30552423900789
Gevrai,Sorgum(Jawar),2016,1713,2020,307,17.921774664331583
Yeola,Gram,2015,3134,3441,307,9.795788130185066
Osmanabad,Sorgum(Jawar),2014,1566,1873,307,19.604086845466156
Nandgaon,Maize,2014,895,1202,307,34.30167597765363
Khamgaon,Wheat(Husked),2014,1328,1635,307,23.117469879518072
Sangali,Wheat(Unhusked),2016,3256,3563,307,9.428746928746929
Sangali,Wheat(Unhusked),2016,3286,3593,307,9.34266585514303
Nandgaon,Bajri,2016,1460,1767,307,21.027397260273972
Kalyan,Bottle Gourd,2015,1220,1527,307,25.16393442622951
Savner,Sorgum(Jawar),2015,1133,1440,307,27.09620476610768
Ausa,Sorgum(Jawar),2016,1544,1851,307,19.883419689119172
Satana,Wheat(Husked),2015,1405,1712,307,21.85053380782918
Yawal,Cotton,2016,4082,4389,307,7.5208231259186675
Amarawati,Wheat(Husked),2015,1532,1839,307,20.03916449086162
Jalna,Bajri,2016,1548,1855,307,19.83204134366925
Nagpur,Wheat(Husked),2016,1993,2299,306,15.353738083291521
Jalna,Bajri,2015,1184,1490,306,25.844594594594593
Yeola,Pigeon Pea (Tur),2016,6977,7283,306,4.3858391858965176
Panvel,Ghosali(Bhaji),2016,2700,3006,306,11.333333333333334
Ulhasnagar,Sugarcane,2015,866,1172,306,35.33487297921478
Nandurbar,Sorgum(Jawar),2014,1349,1655,306,22.68346923647146
Ahmednagar,Bajri,2016,1254,1560,306,24.401913875598087
Sonpeth,Sorgum(Jawar),2016,1579,1885,306,19.379354021532617
Pusad,Sorgum(Jawar),2015,1346,1652,306,22.73402674591382
Lasalgaon,Sorgum(Jawar),2015,1413,1719,306,21.656050955414013
Ramtek,Cabbage,2016,1706,2012,306,17.936694021101992
Vaijapur,Sorgum(Jawar),2016,1643,1949,306,18.624467437614122
Nagpur,Rice(Paddy-Hus),2015,2467,2773,306,12.4037292257803
Lasur Station,Soybean,2014,3056,3362,306,10.013089005235603
Patan,Brinjal,2016,1056,1362,306,28.977272727272727
Jalgaon,Potato,2015,488,794,306,62.704918032786885
Jintur,Gram,2014,2231,2537,306,13.715822501120574
Risod,Soybean,2015,3610,3916,306,8.476454293628809
Sonpeth,Soybean,2016,3360,3666,306,9.107142857142858
Pune-Moshi,Onion,2016,461,767,306,66.37744034707158
Manmad,Tomato,2016,238,544,306,128.57142857142858
Manchar,CABBAGE,2016,124,430,306,246.7741935483871
Devani,Pigeon Pea (Tur),2016,8356,8662,306,3.662039253231211
Kalyan,Papai,2015,1612,1918,306,18.982630272952854
Barshi,CUCUMBER,2016,544,850,306,56.25
Nashik,MINT,2016,210,516,306,145.71428571428572
Ambad(Vadi Godri),Bajri,2016,1511,1817,306,20.251489080079416
Basmat,Pigeon Pea (Tur),2015,4897,5203,306,6.248723708392894
Ahmednagar,Sorgum(Jawar),2016,1659,1965,306,18.44484629294756
Nashik,Cabbage,2016,634,940,306,48.26498422712934
Mumbai,Cucumber,2016,1369,1675,306,22.35208181154127
Rajura,Soybean,2015,3395,3701,306,9.013254786450663
Sailu,Gram,2014,2192,2498,306,13.959854014598541
Kille Dharur,Wheat(Husked),2015,1724,2030,306,17.749419953596288
Anajngaon Surji,Wheat(Husked),2016,1394,1700,306,21.951219512195124
Pusad,Black Gram,2014,4717,5023,306,6.4871740513037945
Kopargaon,Bajri,2016,1209,1515,306,25.31017369727047
Amarawati,Sorgum(Jawar),2015,1515,1821,306,20.198019801980198
Rahuri-Vambori,Sorgum(Jawar),2014,1683,1989,306,18.181818181818183
Amarawati,Bajri,2016,1944,2250,306,15.74074074074074
Kalamb (Os),Sorgum(Jawar),2015,1945,2251,306,15.732647814910026
Nandurbar,Bajri,2016,1482,1787,305,20.58029689608637
Sangrampur-Varvatbakal,Wheat(Husked),2016,1438,1743,305,21.21001390820584
Akot,Sunflower,2016,2952,3257,305,10.331978319783198
Jalna,Wheat(Husked),2015,1522,1827,305,20.03942181340342
Kalmeshwar,Methi (Bhaji),2016,1495,1800,305,20.401337792642142
Umared,Green Peas (Dry),2015,1800,2105,305,16.944444444444443
Anajngaon Surji,Green Gram,2014,6828,7133,305,4.4669009958992385
Barshi,Tamarind,2015,2995,3300,305,10.18363939899833
Buldhana,Sorgum(Jawar),2016,1260,1565,305,24.206349206349206
Risod,Soybean,2015,3183,3488,305,9.582155199497329
Manchar,Flower,2015,550,855,305,55.45454545454545
Mehkar,Wheat(Husked),2015,1350,1655,305,22.59259259259259
Chalisgaon,Onion,2016,434,739,305,70.27649769585254
Washim-Ansing,SOYBEAN,2016,2600,2905,305,11.73076923076923
Barshi,Fodder,2016,432,737,305,70.60185185185185
Kopargaon,Bajri,2015,1164,1469,305,26.20274914089347
Chalisgaon,Cabbage,2016,475,780,305,64.21052631578948
Rahata,TOMATO,2016,445,750,305,68.53932584269663
Shegaon,Wheat(Husked),2015,1221,1526,305,24.979524979524978
Amarawati,Potato,2016,765,1070,305,39.869281045751634
Kalvan,Bajri,2016,1292,1597,305,23.606811145510836
Shirpur,Gram,2015,2542,2847,305,11.998426435877262
Balapur,Sorgum(Jawar),2015,1320,1625,305,23.106060606060606
Sindi (Selu),Soybean,2016,2875,3180,305,10.608695652173912
Loha,SORGUM(JAWAR),2016,1151,1456,305,26.498696785403997
Shirpur,SORGUM(JAWAR),2016,1468,1773,305,20.77656675749319
Umared,Other Pulses,2016,9575,9880,305,3.185378590078329
Ramtek,Ladies Finger,2016,1735,2040,305,17.579250720461093
Murtizapur,Green Gram,2014,7477,7782,305,4.079176140163167
Shirpur,Wheat(Husked),2016,1606,1911,305,18.991282689912826
Achalpur,Soybean,2015,3321,3626,305,9.183980728696175
Katol,Cotton,2015,3562,3867,305,8.562605277933745
Mandhal,Soybean,2015,2875,3180,305,10.608695652173912
Kej,SORGUM(JAWAR),2016,1774,2079,305,17.192784667418263
Tuljapur,Soybean,2016,2408,2713,305,12.66611295681063
Phaltan,Maize,2015,1412,1717,305,21.60056657223796
Barshi,Flower,2016,354,659,305,86.15819209039547
Samudrapur,Soybean,2016,3295,3600,305,9.256449165402124
Lonar,Gram,2015,3331,3636,305,9.156409486640648
Jalgaon,Pigeon Pea (Tur),2015,4688,4993,305,6.505972696245734
Nagpur,Jack Fruit,2016,1411,1716,305,21.61587526576896
Mumbai,Green Peas (Dry),2015,2764,3069,305,11.034732272069464
Aurangabad,Flower,2015,959,1264,305,31.803962460896766
Sangamner,Sorgum(Jawar),2016,1633,1938,305,18.677281077770974
Shirur,Gram,2015,3517,3822,305,8.672163775945409
Udgir,Wheat(Husked),2015,1200,1505,305,25.416666666666668
Latur-Murud,Soybean,2016,3489,3794,305,8.74175981656635
Ramtek,Green Chilli,2016,1048,1353,305,29.103053435114504
Kalvan,Maize,2014,999,1304,305,30.53053053053053
Aurangabad,Capsicum,2015,743,1048,305,41.049798115746974
Mehkar,Sorgum(Jawar),2015,1000,1305,305,30.5
Jalgaon,Tomato,2016,578,883,305,52.7681660899654
Nagpur,Coriander  ,2015,1285,1589,304,23.657587548638134
Pathari,Gram,2015,3327,3631,304,9.137360985873158
Chandur Rly.,Pigeon Pea (Tur),2016,6367,6671,304,4.774619129888488
Akola,Black Gram,2014,4885,5189,304,6.223132036847493
Khed (Shel Pimpalgaon),Methi (Bhaji),2014,701,1005,304,43.36661911554921
Panvel,Bitter Gourd,2016,2361,2665,304,12.875900042354935
Khed-Chakan,Bottle Gourd,2016,944,1248,304,32.20338983050848
Shahada,Pigeon Pea (Tur),2015,4652,4956,304,6.534823731728289
Manmad,Pigeon Pea (Tur),2016,7664,7968,304,3.9665970772442587
Yawal,Cotton,2016,4042,4346,304,7.52102919346858
Ausa,Sorgum(Jawar),2016,1552,1856,304,19.587628865979383
Jalgaon-Masawat,Green Gram,2016,4557,4861,304,6.671055518981786
Raver,Wheat(Husked),2016,1493,1797,304,20.361687876758204
Karanja,Soybean,2016,3009,3313,304,10.103024260551678
Kolhapur,Snake Gourd,2016,317,621,304,95.89905362776025
Akluj,CABBAGE,2016,267,571,304,113.85767790262172
Nagpur,Cucumber,2016,1467,1771,304,20.7225630538514
Mumbai,Arvi,2015,1411,1715,304,21.54500354358611
Bhiwapur,Cotton,2015,3983,4287,304,7.632437860908863
Khamgaon,Sorgum(Jawar),2014,1111,1415,304,27.362736273627362
Chimur,Cotton,2016,4540,4844,304,6.6960352422907485
Kada,Gram,2015,4070,4374,304,7.469287469287469
Majalgaon,Wheat(Husked),2015,1426,1730,304,21.31837307152875
Parli-Vaijnath,Soybean,2015,3466,3770,304,8.770917484131564
Bhokar,Sorgum(Jawar),2014,1268,1572,304,23.974763406940063
Sangrampur-Varvatbakal,Sorgum(Jawar),2016,1144,1448,304,26.573426573426573
Hingoli,Ground Nut Pods (Dry),2015,5345,5649,304,5.68755846585594
Shahada,Wheat(Husked),2016,1544,1848,304,19.689119170984455
Tuljapur,Green Gram,2016,4436,4740,304,6.85302073940487
Vai,Tomato,2016,1048,1352,304,29.00763358778626
Karad,Carrot,2016,708,1012,304,42.93785310734463
Dondaicha,Ground Nut Pods (Dry),2015,5246,5550,304,5.794891345787266
Washim,Wheat(Husked),2015,1449,1753,304,20.979986197377503
Umarga,Gram,2016,4658,4962,304,6.526406182911121
Vani,Cotton,2015,3736,4040,304,8.137044967880085
Parli-Vaijnath,Pigeon Pea (Tur),2016,8238,8542,304,3.6902160718621024
Wardha,Pigeon Pea (Tur),2015,8200,8503,303,3.6951219512195124
Partur,Gram,2016,5643,5946,303,5.369484316852738
Raver,Black Gram,2016,11444,11747,303,2.64767563788885
Jalgaon,Potato,2015,436,739,303,69.4954128440367
Washim,Green Gram,2014,5809,6112,303,5.216044069547254
Baramati,Gram,2014,2220,2523,303,13.64864864864865
Patur,Gram,2016,5094,5397,303,5.948174322732626
Khamgaon,Cotton,2015,4100,4403,303,7.390243902439025
Solapur,Black Gram,2014,4628,4931,303,6.547104580812446
Devala,Coriander (Dry),2016,7300,7603,303,4.1506849315068495
Taloda,Wheat(Husked),2016,1517,1820,303,19.97363216875412
Shegaon,Soybean,2016,3090,3393,303,9.805825242718447
Vaijapur,Wheat(Husked),2016,1743,2046,303,17.38382099827883
Hadgaon-Tamsa,Wheat(Husked),2016,1530,1833,303,19.80392156862745
Jintur,Soybean,2016,3355,3658,303,9.031296572280178
Akot,Maize,2016,1070,1373,303,28.317757009345794
Murtizapur,Soybean,2015,2995,3298,303,10.11686143572621
Kalmeshwar,CUCUMBER,2016,1077,1380,303,28.133704735376046
Jamner-Neri,Cotton,2016,3860,4163,303,7.849740932642487
Mohol,Sorgum(Jawar),2015,1527,1830,303,19.842829076620824
Mangalwedha,Wheat(Husked),2015,1722,2025,303,17.59581881533101
Umared,Pigeon Pea (Tur),2016,4568,4871,303,6.633099824868651
Shegaon,Soybean,2015,2934,3237,303,10.32719836400818
Jintur,Wheat(Husked),2015,1444,1747,303,20.98337950138504
Ahmednagar,Wheat(Husked),2015,1664,1967,303,18.209134615384617
Khamgaon,Wheat(Husked),2015,1737,2040,303,17.443868739205527
Vai,Cabbage,2016,1490,1793,303,20.335570469798657
Savner,Wheat(Husked),2015,1406,1709,303,21.55049786628734
Mehkar,Wheat(Husked),2015,1300,1603,303,23.307692307692307
Raver,Wheat(Husked),2014,1279,1582,303,23.6903831118061
Ghoti,Flower,2016,1202,1505,303,25.207986688851914
Pathari,Sorgum(Jawar),2016,1416,1719,303,21.39830508474576
Bhivandi,Wheat(Husked),2015,2021,2324,303,14.992577931716971
Rajura,Soybean,2014,2932,3235,303,10.334242837653479
Nandurbar,Bajri,2016,1341,1643,302,22.520507084265475
Parbhani,Cotton,2016,4380,4682,302,6.894977168949771
Mangrulpeer,Wheat(Husked),2016,1622,1924,302,18.618988902589397
Pune-Pimpri,Cabbage,2015,824,1126,302,36.650485436893206
Mumbai-Onion And Potato Mkt,Onion,2016,604,906,302,50.0
Umarga,Gram,2016,6040,6342,302,5.0
Patur,Wheat(Husked),2016,1790,2092,302,16.87150837988827
Nandurbar,Pigeon Pea (Tur),2015,5050,5352,302,5.98019801980198
Dound,Gram,2016,4852,5154,302,6.224237427864798
Kille Dharur,Sorgum(Jawar),2015,2048,2350,302,14.74609375
Mumbai,Tomato,2016,1351,1653,302,22.35381199111769
Majalgaon,Gram,2016,4004,4306,302,7.542457542457543
Karanja,Soybean,2015,3455,3757,302,8.74095513748191
Jintur-Bori,Gram,2014,2134,2436,302,14.15182755388941
Pune,Bajri,2016,2108,2410,302,14.326375711574952
Baramati,Wheat(Husked),2015,1574,1876,302,19.186785260482846
Hinganghat,Cotton,2015,4076,4378,302,7.409224730127576
Paithan,Bajri,2016,1359,1661,302,22.22222222222222
Shahada,MAIZE,2016,1071,1373,302,28.197945845004668
Mandhal,Soybean,2015,2792,3094,302,10.816618911174785
Mumbai,Cucumber,2015,954,1256,302,31.656184486373167
Solapur,Pigeon Pea (Tur),2015,10181,10483,302,2.966309792751203
Kopargaon,Soybean,2014,2945,3247,302,10.254668930390492
Mumbai,Sugar,2015,2520,2822,302,11.984126984126984
Barshi,Flower,2016,718,1020,302,42.061281337047355
Chandur Rly.,Soybean,2015,3002,3304,302,10.0599600266489
Dudhani,Bajri,2016,1370,1672,302,22.043795620437955
Shrirampur,Wheat(Husked),2015,1420,1722,302,21.267605633802816
Kurdwadi-Modnimb,Onion,2016,263,565,302,114.82889733840304
Babhulgaon,Gram,2014,2050,2351,301,14.682926829268293
Umared,OTHER PULSES,2016,11629,11930,301,2.5883566944707197
Nagpur,Rice(Paddy-Hus),2015,2600,2901,301,11.576923076923077
Washim,Gram,2015,3981,4282,301,7.560914343129867
Risod,Soybean,2015,3417,3718,301,8.808896693005561
Kalmeshwar,CLUSTER BEAN,2016,1283,1584,301,23.460639127045987
Sinner,Wheat(Husked),2016,1641,1942,301,18.34247410115783
Dound,Lemon,2016,300,601,301,100.33333333333333
Sailu,Black Gram,2014,4100,4401,301,7.341463414634147
Shegaon,Bajri,2015,1304,1605,301,23.08282208588957
Kille Dharur,Soybean,2015,3455,3756,301,8.712011577424024
Kille Dharur,Sorgum(Jawar),2016,1688,1989,301,17.83175355450237
Shegaon,Soybean,2015,3002,3303,301,10.026648900732845
Dhule,Matki,2015,5644,5945,301,5.333097094259391
Dondaicha,Sorgum(Jawar),2015,1292,1593,301,23.29721362229102
Pathari,Wheat(Husked),2016,1676,1977,301,17.95942720763723
Murtizapur,SOYBEAN,2016,2581,2882,301,11.662146454862457
Zarijamini,Soybean,2014,2802,3103,301,10.742326909350464
Samudrapur,Soybean,2015,2933,3234,301,10.262529832935561
Amarawati,Sorgum(Jawar),2016,1548,1849,301,19.444444444444443
Washim,Pigeon Pea (Tur),2014,4826,5127,301,6.237049316203896
Varud-Rajura Bazar,SOYBEAN,2016,2600,2901,301,11.576923076923077
Digras,Pigeon Pea (Tur),2016,6292,6593,301,4.783852511125239
Shrirampur,Wheat(Husked),2015,1416,1717,301,21.257062146892654
Ambejogai,Sorgum(Jawar),2014,1723,2024,301,17.46952988972722
Chikhali,Bajri,2016,1300,1601,301,23.153846153846153
Anajngaon Surji,Wheat(Husked),2015,1301,1602,301,23.136049192928517
Devala,Matki,2016,6530,6831,301,4.609494640122511
Tumsar,Green Gram,2015,6059,6360,301,4.967816471364912
Katol,Gram,2015,3874,4175,301,7.769747031491998
Sangamner,Wheat(Husked),2015,1592,1893,301,18.907035175879397
Baramati,Jaggery,2015,2300,2601,301,13.08695652173913
Chandrapur-Ganjwad,Bitter Gourd,2015,1000,1300,300,30.0
Khultabad,Cotton,2016,4050,4350,300,7.407407407407407
Shrirampur,Pigeon Pea (Tur),2014,3577,3877,300,8.386916410399776
Kinwat,Pigeon Pea (Tur),2015,4975,5275,300,6.030150753768845
Chandrapur-Ganjwad,Raddish,2015,200,500,300,150.0
Amarawati,Green Chilli,2015,2213,2513,300,13.556258472661545
Barshi,Coriander  ,2016,100,400,300,300.0
Solapur,Spinach,2016,533,833,300,56.28517823639775
Koregaon,Gram,2015,3688,3988,300,8.134490238611713
Jalgaon Jamod,Soybean,2016,3000,3300,300,10.0
Panvel,Ridge Gourd,2014,3900,4200,300,7.6923076923076925
Aarni,Wheat(Husked),2016,1400,1700,300,21.428571428571427
Koregaon,Potato,2015,500,800,300,60.0
Chandrapur-Ganjwad,Mula Shenga,2015,400,700,300,75.0
Sonpeth,Green Gram,2014,6550,6850,300,4.580152671755725
Ramtek,Lemon,2015,933,1233,300,32.154340836012864
Buldhana,Soybean,2015,3402,3702,300,8.818342151675486
Patan,Cucumber,2015,517,817,300,58.02707930367505
Ghansawangi,Tamarind,2015,950,1250,300,31.57894736842105
Kalvan,Soybean,2016,3440,3740,300,8.720930232558139
Nagpur,Green Gram,2015,6500,6800,300,4.615384615384615
Akhadabalapur,Turmeric,2014,5000,5300,300,6.0
Aurangabad,Maize(Corn.),2016,1000,1300,300,30.0
Barshi,Coriander  ,2016,300,600,300,100.0
Kalvan,Matki,2016,5700,6000,300,5.2631578947368425
Aurangabad,Coriander  ,2014,200,500,300,150.0
Mumbai,Beet Root,2016,700,1000,300,42.857142857142854
Pune-Pimpri,Squash Gourd,2016,700,1000,300,42.857142857142854
Manchar,Small Gourd,2015,800,1100,300,37.5
Khultabad,Cotton,2016,4100,4400,300,7.317073170731708
Nagpur,Paddy-Unhusked,2015,2100,2400,300,14.285714285714286
Barshi,Shepu,2014,200,500,300,150.0
Barshi,Black Gram,2016,6508,6808,300,4.609711124769515
Osmanabad,Gram,2016,4063,4363,300,7.383706620723603
Osmanabad,Bottle Gourd,2015,700,1000,300,42.857142857142854
Manchar,Green Chilli,2015,2500,2800,300,12.0
Ghansawangi,Pigeon Pea (Tur),2015,5125,5425,300,5.853658536585366
Kalyan,Cucumber,2015,1133,1433,300,26.4783759929391
Nagpur,Linseed,2016,4500,4800,300,6.666666666666667
Mumbai,Water Melon,2015,700,1000,300,42.857142857142854
Mohol,Wheat(Husked),2016,1835,2135,300,16.348773841961854
Mumbai,Water Melon,2015,700,1000,300,42.857142857142854
Kinwat,Ground Nut Pods (Dry),2016,5200,5500,300,5.769230769230769
Ghansawangi,Pigeon Pea (Tur),2015,5275,5575,300,5.687203791469194
Armori-Desaiganj,Chillies(Red),2015,13500,13800,300,2.2222222222222223
Barshi,Spinach,2016,200,500,300,150.0
Umarga,Green Gram,2015,6842,7142,300,4.384682841274481
Rahata,Carrot,2015,1210,1510,300,24.793388429752067
Solapur,Green Peas (Dry),2015,2733,3033,300,10.97694840834248
Nashik-Devlali,Banana,2016,700,1000,300,42.857142857142854
Akluj,Tamarind,2015,1500,1800,300,20.0
Aarni,Soybean,2016,3550,3850,300,8.450704225352112
Vita,Green Chilli,2014,2500,2800,300,12.0
Ghoti,Flower,2014,1500,1800,300,20.0
Chandrapur-Ganjwad,Small Gourd,2014,800,1100,300,37.5
Nagpur,Raddish,2016,950,1250,300,31.57894736842105
Mehkar,Green Gram,2016,6500,6800,300,4.615384615384615
Khed-Chakan,Shepu,2016,200,500,300,150.0
Kinwat,Sorgum(Jawar),2015,1000,1300,300,30.0
Vadgaon Peth,Bottle Gourd,2015,200,500,300,150.0
Khed-Chakan,Spinach,2016,500,800,300,60.0
Jalgaon Jamod-Aasalgaon,Gram,2015,3633,3933,300,8.257638315441783
Buldhana,Gram,2014,2200,2500,300,13.636363636363637
Mumbai,Arvi,2016,1200,1500,300,25.0
Nira,Jaggery,2015,2809,3109,300,10.67995728017088
Telhara,Gram,2015,4332,4632,300,6.925207756232687
Jalgaon Jamod-Aasalgaon,Gram,2015,4000,4300,300,7.5
Panvel,Ghosali(Bhaji),2015,1940,2240,300,15.463917525773196
Vai,Bottle Gourd,2015,1114,1414,300,26.929982046678635
Barshi,Mosambi,2014,500,800,300,60.0
Buldhana,Gram,2015,4180,4480,300,7.177033492822966
Barshi,Methi (Bhaji),2014,400,700,300,75.0
Pune-Manjri,Rajgira,2016,300,600,300,100.0
Ghansawangi,Soybean,2016,3400,3700,300,8.823529411764707
Ahmednagar,Potato,2015,620,920,300,48.38709677419355
Taloda,Castor Seed,2016,2700,3000,300,11.11111111111111
Jalgaon-Masawat,Maize,2016,900,1200,300,33.333333333333336
Amarawati,Spinach,2016,1974,2274,300,15.19756838905775
Ghansawangi,Wheat(Husked),2015,1700,2000,300,17.647058823529413
Ahmednagar,Maize(Corn.),2015,525,825,300,57.142857142857146
Barshi,Chikoo,2016,550,850,300,54.54545454545455
Rahata,Gram,2015,3357,3657,300,8.936550491510276
Patan,Ladies Finger,2015,980,1280,300,30.612244897959183
Kalyan,Shevga,2014,2350,2650,300,12.76595744680851
Nandgaon,Sorgum(Jawar),2014,1500,1800,300,20.0
Anajngaon Surji,Wheat(Husked),2015,1454,1754,300,20.63273727647868
Murbad,Ghevda,2016,1367,1667,300,21.945866861741038
Indapur,Green Gram,2016,5000,5300,300,6.0
Ramtek,Raddish,2015,1200,1500,300,25.0
Amarawati,Wheat(Husked),2014,1550,1850,300,19.35483870967742
Koregaon,Wheat(Husked),2015,1567,1867,300,19.14486279514997
Anajngaon Surji,Wheat(Husked),2015,1491,1791,300,20.120724346076457
Mumbai,Bottle Gourd,2016,676,976,300,44.37869822485207
Murbad,Ghevda,2016,4000,4300,300,7.5
Washim,Pigeon Pea (Tur),2014,4641,4941,300,6.464124111182935
Ghansawangi,Cotton,2016,3975,4275,300,7.547169811320755
Nagpur,Lentil,2015,4000,4300,300,7.5
Panvel,Ridge Gourd,2015,2575,2875,300,11.650485436893204
Koregaon,Wheat(Husked),2015,1600,1900,300,18.75
Ratanagari,Green-Peas,2015,1200,1500,300,25.0
Chandrapur-Ganjwad,Potato,2015,768,1068,300,39.0625
Anajngaon Surji,Banana,2016,800,1100,300,37.5
Manora,Gram,2015,3350,3650,300,8.955223880597014
Panvel,Bottle Gourd,2015,2000,2300,300,15.0
Manchar,Small Gourd,2015,1500,1800,300,20.0
Mohol,Sorgum(Jawar),2015,1638,1938,300,18.315018315018314
Koregaon,Sorgum(Jawar),2015,1625,1925,300,18.46153846153846
Chandrapur-Ganjwad,Raddish,2015,440,740,300,68.18181818181819
Chalisgaon,Castor Seed,2014,3000,3300,300,10.0
Akhadabalapur,Turmeric,2014,5000,5300,300,6.0
Patur,Gram,2016,3550,3850,300,8.450704225352112
Ausa,Paddy-Unhusked,2016,700,1000,300,42.857142857142854
Barshi,Cluster Bean,2016,300,600,300,100.0
Kille Dharur,Sorgum(Jawar),2016,1704,2004,300,17.6056338028169
Rahuri,Shevga,2016,1300,1600,300,23.076923076923077
Kalyan,Brinjal,2014,2200,2500,300,13.636363636363637
Chandrapur-Ganjwad,Pumpkin,2015,350,650,300,85.71428571428571
Ramtek,Pigeon Pea (Tur),2015,6450,6750,300,4.651162790697675
Kalyan,Green-Peas,2014,4650,4950,300,6.451612903225806
Kalyan,Capsicum,2014,2000,2300,300,15.0
Murbad,Brinjal,2016,1350,1650,300,22.22222222222222
Chandrapur-Ganjwad,Pumpkin,2015,600,900,300,50.0
Chandrapur-Ganjwad,Chavli (Pala),2015,1000,1300,300,30.0
Lasalgaon-Vinchur,Wheat(Husked),2015,1399,1699,300,21.44388849177984
Umarkhed,Pigeon Pea (Tur),2015,4875,5175,300,6.153846153846154
Anajngaon Surji,Sorgum(Jawar),2016,1213,1513,300,24.7320692497939
Chandrapur-Ganjwad,Chavli (Shenga ),2015,950,1250,300,31.57894736842105
Buldhana,Green Gram,2015,7000,7300,300,4.285714285714286
Ratanagari,Green-Peas,2015,900,1200,300,33.333333333333336
Aurangabad,Math (Bhaji),2016,500,800,300,60.0
Ghansawangi,Tamarind,2016,1900,2200,300,15.789473684210526
Satara,Potato,2015,644,944,300,46.58385093167702
Jafrabad,Sorgum(Jawar),2016,1000,1300,300,30.0
Amarawati,Guava,2015,1200,1500,300,25.0
Sengaon,Turmeric,2016,6822,7122,300,4.397537379067722
Umared,Pigeon Pea (Tur),2014,4050,4350,300,7.407407407407407
Akkalkuwa,Maize,2015,1100,1400,300,27.272727272727273
Amarawati,Sorgum(Jawar),2015,1575,1875,300,19.047619047619047
Tasgaon,Soybean,2015,3500,3800,300,8.571428571428571
Vai,Kanda Pat,2015,500,800,300,60.0
Chandrapur,Potato,2015,600,900,300,50.0
Sindkhed Raja,Maize,2016,1200,1500,300,25.0
Ashti-Karanja,Gram,2015,4500,4800,300,6.666666666666667
Aarni,Soybean,2015,3000,3300,300,10.0
Partur,Wheat(Husked),2016,1878,2178,300,15.97444089456869
Mumbai-Fruit Market,Naspatti ,2016,1100,1400,300,27.272727272727273
Shahapur,Cucumber,2015,1500,1800,300,20.0
Kalamb (Yawatmal),Soybean,2016,3350,3650,300,8.955223880597014
Shrigonda,Onion,2016,300,600,300,100.0
Mantha,Wheat(Husked),2016,1900,2200,300,15.789473684210526
Jalgaon,Squash Gourd,2015,1043,1343,300,28.763183125599234
Barshi,Kanda Pat,2016,500,800,300,60.0
Vai,Flower,2015,1310,1610,300,22.900763358778626
Shrirampur,Ladies Finger,2015,965,1265,300,31.088082901554404
Ahmednagar,Horse Gram,2016,2900,3200,300,10.344827586206897
Yawal,Bajri,2016,1000,1300,300,30.0
Gondpimpri,Pigeon Pea (Tur),2015,6200,6500,300,4.838709677419355
Latur,Bajri,2014,1017,1317,300,29.49852507374631
Chandrapur,BRINJAL,2016,200,500,300,150.0
Mumbai,Horse Gram,2016,3300,3600,300,9.090909090909092
Kalmeshwar,Coriander  ,2016,2516,2816,300,11.92368839427663
Lasur Station,Black Gram,2015,9600,9900,300,3.125
Chalisgaon,Tomato,2015,1200,1500,300,25.0
Shirala,SORGUM(JAWAR),2016,1700,2000,300,17.647058823529413
Chandrapur,Flower,2016,300,600,300,100.0
Parshiwani,Pigeon Pea (Tur),2015,4800,5100,300,6.25
Patan,Cabbage,2014,865,1165,300,34.68208092485549
Solapur,Kanda Pat,2016,500,800,300,60.0
Amarawati,Sorgum(Jawar),2015,1543,1843,300,19.44264419961115
Pombhurni,Cotton,2016,3800,4100,300,7.894736842105263
Pune-Moshi,Bottle Gourd,2016,716,1016,300,41.899441340782126
Manwat,Bajri,2016,1550,1850,300,19.35483870967742
Satara,BRINJAL,2016,726,1026,300,41.32231404958678
Bhokardan-Pimpalgaon Renu,Pigeon Pea (Tur),2016,6450,6750,300,4.651162790697675
Amarawati,Flower,2016,2450,2750,300,12.244897959183673
Parshiwani,Gram,2016,4571,4871,300,6.56311529205863
Vadgaon Peth,Carrot,2015,2250,2550,300,13.333333333333334
Kolhapur-Malkapur,Brinjal,2016,178,478,300,168.53932584269663
Gondpimpri,Gram,2016,4500,4800,300,6.666666666666667
Ausa,Ground Nut Pods (Dry),2015,4200,4500,300,7.142857142857143
Hadgaon,Gram,2016,4098,4398,300,7.320644216691069
Amarawati,Bajri,2016,1814,2114,300,16.5380374862183
Aheri,Sorgum(Jawar),2014,1100,1400,300,27.272727272727273
Osmanabad,Small Gourd,2015,800,1100,300,37.5
Varora,Paddy-Unhusked,2016,1600,1900,300,18.75
Vai,Carrot,2015,1200,1500,300,25.0
Nagpur,CLUSTER BEAN,2016,933,1233,300,32.154340836012864
Hadgaon,Soybean,2015,3075,3375,300,9.75609756097561
Akkalkuwa,Pigeon Pea (Tur),2016,6700,7000,300,4.477611940298507
Sillod,Castor Seed,2015,3200,3500,300,9.375
Chalisgaon,Cluster Bean,2016,3700,4000,300,8.108108108108109
Jalgaon,Maize(Corn.),2015,733,1033,300,40.92769440654843
Hadgaon,Cotton,2016,4275,4575,300,7.017543859649122
Bhusaval,Black Gram,2015,7812,8112,300,3.8402457757296466
Chalisgaon,Rice(Paddy-Hus),2016,1000,1300,300,30.0
Yawal,Wheat(Husked),2015,1500,1800,300,20.0
Sangamner,Wheat(Husked),2015,1622,1922,300,18.49568434032059
Yawal,Wheat(Husked),2015,1500,1800,300,20.0
Yawal,Bajri,2016,1200,1500,300,25.0
Jalgaon,Melon,2015,700,1000,300,42.857142857142854
Amarawati,Cabbage,2016,2973,3273,300,10.090817356205852
Aarni,Soybean,2015,3000,3300,300,10.0
Yawal,Bajri,2016,1200,1500,300,25.0
Aurangabad,Coriander  ,2016,300,600,300,100.0
Mantha,Sorgum(Jawar),2016,1683,1983,300,17.825311942959
Aurangabad,Coriander  ,2016,500,800,300,60.0
Jalgaon,Potato,2015,458,758,300,65.50218340611353
Amarawati,Wheat(Husked),2015,1588,1888,300,18.89168765743073
Akkalkuwa,Wheat(Husked),2015,1200,1500,300,25.0
Aarni,Soybean,2015,3500,3800,300,8.571428571428571
Mumbai-Fruit Market,Banana,2016,1050,1350,300,28.571428571428573
Partur,Cotton,2016,4200,4500,300,7.142857142857143
Barshi,Ladies Finger,2016,867,1167,300,34.602076124567475
Nagpur,Bottle Gourd,2016,895,1195,300,33.5195530726257
Gondpimpri,Pigeon Pea (Tur),2016,6933,7233,300,4.327131112072696
Akkalkuwa,Green Gram,2016,6200,6500,300,4.838709677419355
Atpadi,Gram,2015,3600,3900,300,8.333333333333334
Atpadi,Sorgum(Jawar),2015,1600,1900,300,18.75
Chandrapur,Cucumber,2015,400,700,300,75.0
Pombhurni,Cotton,2016,3800,4100,300,7.894736842105263
Mumbai,Horse Gram,2016,3300,3600,300,9.090909090909092
Mumbai,Horse Gram,2016,3200,3500,300,9.375
Mumbai,Horse Gram,2016,3300,3600,300,9.090909090909092
Amarawati,Maize(Corn.),2016,1000,1300,300,30.0
Manchar,Ground Nut Pods (Dry),2015,5500,5800,300,5.454545454545454
Chalisgaon,Cabbage,2015,600,900,300,50.0
Shahada,COWPEA,2016,3500,3800,300,8.571428571428571
Aarni,Wheat(Husked),2015,975,1275,300,30.76923076923077
Chalisgaon,Flower,2015,1000,1300,300,30.0
Aarni,Wheat(Husked),2015,1100,1400,300,27.272727272727273
Barshi,Shepu,2016,500,800,300,60.0
Pune,Banana(Raw),2015,650,950,300,46.15384615384615
Sengaon,Wheat(Husked),2016,1500,1800,300,20.0
Murbad,Bottle Gourd,2015,4200,4500,300,7.142857142857143
Kolhapur,Melon,2016,2700,3000,300,11.11111111111111
Shrigonda,Black Gram,2016,4900,5200,300,6.122448979591836
Chalisgaon,Sorgum(Jawar),2015,1208,1508,300,24.834437086092716
Pune,Banana(Raw),2015,729,1029,300,41.1522633744856
Kalamb (Os),Coriander (Dry),2016,6011,6311,300,4.990850108135086
Shevgaon,Gram,2014,2200,2500,300,13.636363636363637
Mumbai,Flower,2016,977,1277,300,30.706243602865918
Nagpur,Rice(Paddy-Hus),2015,2521,2821,300,11.90003966679889
Tasgaon,Gram,2015,4050,4350,300,7.407407407407407
Amarawati,Melon,2016,986,1286,300,30.425963488843813
Rahata,Bottle Gourd,2015,363,663,300,82.64462809917356
Latur-Murud,Wheat(Husked),2015,1301,1601,300,23.059185242121444
Jalgaon Jamod,Soybean,2015,3450,3750,300,8.695652173913043
Vadgaon Peth,Bottle Gourd,2015,425,725,300,70.58823529411765
Malkapur,COTTON,2016,4700,5000,300,6.382978723404255
Patan,Cabbage,2015,950,1250,300,31.57894736842105
Jalgaon Jamod,Ground Nut Pods (Dry),2015,2900,3200,300,10.344827586206897
Kalvan,Gram,2015,4401,4701,300,6.81663258350375
Vai,Bottle Gourd,2015,1218,1518,300,24.63054187192118
Jalgaon Jamod,Gram,2015,3475,3775,300,8.633093525179856
Amarawati,Mosambi,2015,1280,1580,300,23.4375
Pombhurni,Paddy-Unhusked,2016,2000,2300,300,15.0
Kolhapur,Squash Gourd,2015,500,800,300,60.0
Vadgaon Peth,Cabbage,2015,660,960,300,45.45454545454545
Dondaicha,Maize,2016,1146,1446,300,26.17801047120419
Bori Arab,Pigeon Pea (Tur),2016,7500,7800,300,4.0
Kolhapur,Wal Papdi,2015,3200,3500,300,9.375
Amarawati,Onion,2015,1032,1332,300,29.069767441860463
Amarawati,Onion,2015,1469,1769,300,20.42205582028591
Manchar,Bottle Gourd,2016,300,600,300,100.0
Amarawati,Papai,2015,1200,1500,300,25.0
Gondpimpri,Gram,2015,3775,4075,300,7.947019867549669
Dhule,Potato,2016,700,1000,300,42.857142857142854
Indapur,Bajri,2016,1638,1938,300,18.315018315018314
Tasgaon,Gram,2016,5200,5500,300,5.769230769230769
Mauda,Pigeon Pea (Tur),2016,6200,6500,300,4.838709677419355
Amarawati,Harbara(Pendi),2016,829,1129,300,36.18817852834741
Jalgaon,Squash Gourd,2014,1000,1300,300,30.0
Vadgaon Peth,Sweet Potato,2016,700,1000,300,42.857142857142854
Manchar,Bottle Gourd,2015,400,700,300,75.0
Patan,Cucumber,2014,875,1175,300,34.285714285714285
Kolhapur-Laxmipuri,Split Lentil,2015,7656,7956,300,3.9184952978056424
Manora,WHEAT(HUSKED),2016,1500,1800,300,20.0
Arvi,Soybean,2016,3350,3650,300,8.955223880597014
Ashti (Jalna),Green Gram,2015,7300,7600,300,4.109589041095891
Mumbai,Horse Gram,2016,3000,3300,300,10.0
Akhadabalapur,Gram,2016,6933,7233,300,4.327131112072696
Akluj,Cabbage,2015,385,685,300,77.92207792207792
Akluj,Cabbage,2015,250,550,300,120.0
Akhadabalapur,Pigeon Pea (Tur),2016,7000,7300,300,4.285714285714286
Samudrapur,Cotton,2015,3855,4155,300,7.782101167315175
Kolhapur-Laxmipuri,Split Black Gram,2014,5900,6200,300,5.084745762711864
Kolhapur-Laxmipuri,Spilt Gerrn Gram,2014,8400,8700,300,3.5714285714285716
Barshi,Bajri,2014,1300,1600,300,23.076923076923077
Akhadabalapur,GRAM,2016,6000,6300,300,5.0
Amarawati,Papai,2015,850,1150,300,35.294117647058826
Pune-Moshi,Small Gourd,2016,1850,2150,300,16.216216216216218
Dhule,Green Peas (Dry),2016,2200,2500,300,13.636363636363637
Pombhurni,Cotton,2016,3800,4100,300,7.894736842105263
Vai,Math (Bhaji),2015,1200,1500,300,25.0
Nandurbar,Maize,2015,1069,1369,300,28.06361085126286
Pavani,Green Gram,2015,6400,6700,300,4.6875
Washim-Ansing,Gram,2016,7850,8150,300,3.821656050955414
Satara,Ghevda,2015,1000,1300,300,30.0
Ahmednagar,Matki,2016,8400,8700,300,3.5714285714285716
Kolhapur-Laxmipuri,Gram,2014,3200,3500,300,9.375
Amarawati,Pigeon Pea (Tur),2015,6391,6691,300,4.694101079643248
Nanded,Green Gram,2016,6467,6767,300,4.63893613731251
Jalgaon,Pigeon Pea (Tur),2016,7600,7900,300,3.9473684210526314
Rahata,Bor,2015,1000,1300,300,30.0
Nagpur,Sorgum(Jawar),2015,1500,1800,300,20.0
Nagpur,Sorgum(Jawar),2015,1500,1800,300,20.0
Koregaon,Green Gram,2016,6500,6800,300,4.615384615384615
Barshi,Shevga,2014,500,800,300,60.0
Sangrampur,Sorgum(Jawar),2015,1000,1300,300,30.0
Umarkhed,Gram,2016,8500,8800,300,3.5294117647058822
Murum,Green Gram,2015,6537,6837,300,4.5892611289582375
Aurangabad,Math (Bhaji),2015,500,800,300,60.0
Amarawati-Fruit And Vegetables,Kharbuj,2016,1200,1500,300,25.0
Tuljapur,Turmeric,2015,7000,7300,300,4.285714285714286
Rahata,Cabbage,2016,500,800,300,60.0
Sangrampur,Wheat(Husked),2015,1170,1470,300,25.641025641025642
Rahata,CARROT,2016,1313,1613,300,22.84843869002285
Achalpur,Gram,2015,4400,4700,300,6.818181818181818
Nandgaon Khandeshwar,Sorgum(Jawar),2016,1200,1500,300,25.0
Jamkhed,Bajri,2016,1620,1920,300,18.51851851851852
Pune,Sweet Potato,2014,1100,1400,300,27.272727272727273
Umarkhed,Soybean,2016,3300,3600,300,9.090909090909092
Aurangabad,Brinjal,2015,583,883,300,51.45797598627787
Rahata,Brinjal,2016,700,1000,300,42.857142857142854
Buldhana-Dhad,Wheat(Husked),2016,1400,1700,300,21.428571428571427
Kamthi,Raddish,2015,346,646,300,86.70520231213872
Bhokar,Maize,2016,1200,1500,300,25.0
Sangrampur,Gram,2016,3800,4100,300,7.894736842105263
Barshi,Coriander  ,2015,200,500,300,150.0
Amarawati-Fruit And Vegetables,Melon,2016,1000,1300,300,30.0
Sinner,Ground Nut Pods (Dry),2014,3252,3552,300,9.22509225092251
Jintur,Sorgum(Jawar),2016,1245,1545,300,24.096385542168676
Akole,Bajri,2014,1400,1700,300,21.428571428571427
Malegaon (Washim),Soybean,2015,3635,3935,300,8.253094910591471
Taloda,Sorgum(Jawar),2016,1875,2175,300,16.0
Karad,Banana,2015,600,900,300,50.0
Karad,Banana,2015,708,1008,300,42.3728813559322
Nandura,Black Gram,2016,7733,8033,300,3.87947756368809
Balapur,SORGUM(JAWAR),2016,1275,1575,300,23.529411764705884
Ahmednagar,Pigeon Pea (Tur),2014,4140,4440,300,7.246376811594203
Jamner,Cotton,2014,3750,4050,300,8.0
Rahata,Cluster Bean,2016,4340,4640,300,6.912442396313364
Amarawati-Fruit And Vegetables,Methi (Bhaji),2016,2331,2631,300,12.87001287001287
Sakri,Gram,2015,3300,3600,300,9.090909090909092
Nampur,Soybean,2016,2878,3178,300,10.423905489923557
Aheri,Soybean,2016,3200,3500,300,9.375
Varud-Rajura Bazar,Orange,2015,1200,1500,300,25.0
Kamthi,Sugarcane,2014,400,700,300,75.0
Darwha,COTTON,2016,4500,4800,300,6.666666666666667
Rahata,Bor,2016,1200,1500,300,25.0
Akola,Mustard,2015,3000,3300,300,10.0
Satara,Sweet Potato,2016,1267,1567,300,23.677979479084453
Osmanabad,Gram,2015,3850,4150,300,7.792207792207792
Nagpur,Cabbage,2015,544,844,300,55.14705882352941
Junnar (Narayangaon),Shepu,2016,101,401,300,297.029702970297
Pune-Pimpri,Ladies Finger,2016,4300,4600,300,6.976744186046512
Ramtek,Chavli (Shenga ),2016,841,1141,300,35.6718192627824
Ahmednagar,Black Gram,2015,5500,5800,300,5.454545454545454
Solapur,Shepu,2016,200,500,300,150.0
Junnar,Potato,2016,1100,1400,300,27.272727272727273
Nandgaon Khandeshwar,Wheat(Husked),2015,1000,1300,300,30.0
Nandgaon Khandeshwar,Wheat(Husked),2015,1133,1433,300,26.4783759929391
Aurangabad,Banana,2015,300,600,300,100.0
Panvel,Snake Gourd,2016,1730,2030,300,17.341040462427745
Aurangabad,Bajri,2015,1250,1550,300,24.0
Kalyan,Gram,2016,6500,6800,300,4.615384615384615
Shrirampur,Water Melon,2015,867,1167,300,34.602076124567475
Amalner,Soybean,2014,3000,3300,300,10.0
Patan,Pavtta,2016,1433,1733,300,20.9351011863224
Kalyan,Wheat(Husked),2016,2300,2600,300,13.043478260869565
Nashik,Shahale ,2015,2400,2700,300,12.5
Akola,BATBATI,2016,3013,3313,300,9.956853634251576
Malegaon (Washim),Pigeon Pea (Tur),2016,6900,7200,300,4.3478260869565215
Amarawati-Fruit And Vegetables,Cucumber,2016,2715,3015,300,11.049723756906078
Umarkhed,Pigeon Pea (Tur),2016,8250,8550,300,3.6363636363636362
Rahata,Bitter Gourd,2016,2700,3000,300,11.11111111111111
Nagpur,Paddy-Unhusked,2016,1850,2150,300,16.216216216216218
Kalyan,SQUASH GOURD,2016,1500,1800,300,20.0
Ahmednagar,Bajri,2015,1500,1800,300,20.0
Kalmeshwar,Bitter Gourd,2015,1726,2026,300,17.381228273464657
Amalner,Pigeon Pea (Tur),2014,3200,3500,300,9.375
Achalpur,Soybean,2014,2863,3163,300,10.478519035976248
Jafrabad,Green Gram,2015,6300,6600,300,4.761904761904762
Aurangabad,Bottle Gourd,2015,510,810,300,58.8235294117647
Khamgaon,Green Gram,2016,4667,4967,300,6.42811227769445
Nagpur,Brinjal,2015,804,1104,300,37.3134328358209
Osmanabad,Gram,2015,3700,4000,300,8.108108108108109
Ramtek,Wal Bhaji,2016,922,1222,300,32.53796095444685
Indapur-Bhigwan,Cowpea,2015,4926,5226,300,6.090133982947624
Raver,Green Gram,2016,3920,4220,300,7.653061224489796
Indapur-Bhigwan,Sunflower,2015,2963,3263,300,10.12487343908201
Barshi,Kanda Pat,2015,300,600,300,100.0
Akole,Soybean,2015,2825,3125,300,10.619469026548673
Barshi,Kanda Pat,2015,167,467,300,179.64071856287424
Lonand,Wheat(Husked),2015,1500,1800,300,20.0
Nagpur,Coriander (Dry),2014,9833,10133,300,3.050950879690837
Palus,CUCUMBER,2016,1300,1600,300,23.076923076923077
Indapur-Bhigwan,Ghevda Seed,2016,7300,7600,300,4.109589041095891
Buldhana-Dhad,Maize,2015,1000,1300,300,30.0
Rahata,Shevga,2016,3700,4000,300,8.108108108108109
Chikhali,Sorgum(Jawar),2016,1282,1582,300,23.400936037441497
Rahata,Small Gourd,2016,2360,2660,300,12.711864406779661
Barshi,Kanda Pat,2015,400,700,300,75.0
Karad,Potato,2016,960,1260,300,31.25
Sindkhed Raja,Sorgum(Jawar),2016,1225,1525,300,24.489795918367346
Palus,Brinjal,2016,1200,1500,300,25.0
Sillod,Pigeon Pea (Tur),2016,7150,7450,300,4.195804195804196
Lonar,Pigeon Pea (Tur),2014,4567,4867,300,6.568863586599519
Buldhana,Sorgum(Jawar),2016,1260,1560,300,23.80952380952381
Palus,Cucumber,2016,1350,1650,300,22.22222222222222
Pune,Nolkol,2016,500,800,300,60.0
Nagpur,Capsicum,2014,2365,2665,300,12.684989429175475
Raver-Sawada,Gram,2016,5000,5300,300,6.0
Akot,Maize,2015,1000,1300,300,30.0
Chalisgaon,Papai,2016,300,600,300,100.0
Pathardi,Cotton,2016,4000,4300,300,7.5
Rahata,Potato,2016,1200,1500,300,25.0
Chimur,Soybean,2015,3200,3500,300,9.375
Barshi,Mango,2015,400,700,300,75.0
Barshi,Kanda Pat,2015,400,700,300,75.0
Gangapur,Sorgum(Jawar),2014,1456,1756,300,20.604395604395606
Varora,Gram,2015,3300,3600,300,9.090909090909092
Ramtek,PUMPKIN,2016,500,800,300,60.0
Manchar,BRINJAL,2016,250,550,300,120.0
Fulambri,Cotton,2015,3924,4224,300,7.6452599388379205
Osmanabad,Chikoo,2016,1200,1500,300,25.0
Bhokar,Turmeric,2016,6425,6725,300,4.669260700389105
Vasai,Paddy-Unhusked,2014,1500,1800,300,20.0
Manchar,Small Gourd,2016,1033,1333,300,29.04162633107454
Sindi,Gram,2016,7000,7300,300,4.285714285714286
Lasalgaon,Black Gram,2015,6500,6800,300,4.615384615384615
Ambejogai,Safflower,2015,2100,2400,300,14.285714285714286
Solapur,Goosefoot,2016,800,1100,300,37.5
Barshi,Mosambi,2015,300,600,300,100.0
Jamner-Neri,Cotton,2014,3750,4050,300,8.0
Barshi,Mosambi,2015,300,600,300,100.0
Umarga,Pigeon Pea (Tur),2014,4238,4538,300,7.078810759792355
Akole,Soybean,2014,2825,3125,300,10.619469026548673
Akole,Soybean,2014,2825,3125,300,10.619469026548673
Pathardi,Sorgum(Jawar),2015,1571,1871,300,19.096117122851687
Vadgaon Peth,Cabbage,2016,353,653,300,84.98583569405099
Rahata,GREEN CHILLI,2016,918,1218,300,32.6797385620915
Udgir,Gram,2015,4178,4478,300,7.180469123982767
Tuljapur,Gram,2015,3348,3648,300,8.960573476702509
Karad,Brinjal,2015,822,1122,300,36.496350364963504
Vai,Cucumber,2014,1500,1800,300,20.0
Shirur,Indian Bean,2014,2450,2750,300,12.244897959183673
Amarawati-Fruit And Vegetables,Papai,2016,500,800,300,60.0
Pusad,Black Gram,2016,6669,6969,300,4.49842555105713
Sangali,Soybean,2016,3475,3775,300,8.633093525179856
Karad,Tomato,2015,925,1225,300,32.432432432432435
Sangrampur-Varvatbakal,Sesamum,2016,5700,6000,300,5.2631578947368425
Manchar,Walvad,2015,2050,2350,300,14.634146341463415
Wardha,Gram,2015,3809,4109,300,7.876082961407193
Nagpur,Green Gram,2014,4200,4500,300,7.142857142857143
Umarkhed-Danki,Gram,2015,3800,4100,300,7.894736842105263
Sangrampur-Varvatbakal,Maize,2016,1000,1300,300,30.0
Chikhali,Maize,2016,1017,1317,300,29.49852507374631
Chikhali,Bajri,2016,1300,1600,300,23.076923076923077
Karad,Snake Gourd,2015,1000,1300,300,30.0
Buldhana-Dhad,Gram,2016,4000,4300,300,7.5
Akole,Gram,2015,3200,3500,300,9.375
Jawala-Bajar,Wheat(Husked),2014,1600,1900,300,18.75
Aurangabad,Carrot,2015,960,1260,300,31.25
Akole,Bhagar/Vari,2015,2700,3000,300,11.11111111111111
Karad,Tomato,2015,1400,1700,300,21.428571428571427
Ramtek,Small Gourd,2016,1200,1500,300,25.0
Ahmednagar,Bottle Gourd,2015,700,1000,300,42.857142857142854
Amarawati,Guava,2015,1200,1500,300,25.0
Sindkhed Raja,Wheat(Husked),2016,1500,1800,300,20.0
Pune-Pimpri,Chavli (Shenga ),2015,2700,3000,300,11.11111111111111
Telhara,Pigeon Pea (Tur),2015,6900,7200,300,4.3478260869565215
Chandrapur-Ganjwad,Pumpkin,2016,800,1100,300,37.5
Umarkhed,Gram,2016,6300,6600,300,4.761904761904762
Devala,Green Gram,2016,6771,7071,300,4.430660168365087
Chandrapur-Ganjwad,Potato,2016,926,1226,300,32.39740820734341
Ramtek,Bottle Gourd,2016,700,1000,300,42.857142857142854
Pune-Pimpri,Chavli (Shenga ),2015,1750,2050,300,17.142857142857142
Panvel,Cucumber,2016,2080,2380,300,14.423076923076923
Chandrapur-Ganjwad,Pumpkin,2016,800,1100,300,37.5
Rahata,Mango(Raw),2015,950,1250,300,31.57894736842105
Chandrapur-Ganjwad,PUMPKIN,2016,350,650,300,85.71428571428571
Gevrai,Cotton,2016,3988,4288,300,7.522567703109328
Aurangabad,Potato,2015,868,1168,300,34.56221198156682
Kalyan,Papai,2015,1200,1500,300,25.0
Nagpur,Dhemse,2015,1850,2150,300,16.216216216216218
Jafrabad,Gram,2016,4500,4800,300,6.666666666666667
Hanegaon,Other Cereals,2015,9500,9800,300,3.1578947368421053
Chandrapur-Ganjwad,Pumpkin,2016,400,700,300,75.0
Ausa,Pigeon Pea (Tur),2014,4325,4625,300,6.936416184971098
Pune-Manjri,Harbara(Pendi),2016,1200,1500,300,25.0
Panvel,Ghevda,2016,1700,2000,300,17.647058823529413
Chandur Bajar,Sorgum(Jawar),2015,1200,1500,300,25.0
Nagpur,Cluster Bean,2015,1500,1800,300,20.0
Latur,Maize,2015,1050,1350,300,28.571428571428573
Sangrampur,Green Gram,2014,7000,7300,300,4.285714285714286
Sillod,Gram,2016,5750,6050,300,5.217391304347826
Barshi,Shepu,2015,500,800,300,60.0
Murtizapur,Gram,2016,5492,5792,300,5.462490895848507
Manchar,Cluster Bean,2015,2800,3100,300,10.714285714285714
Kalyan,Bajri,2016,1500,1800,300,20.0
Devala,Black Gram,2016,10700,11000,300,2.803738317757009
Panvel,Flower,2016,1000,1300,300,30.0
Chandrapur-Ganjwad,Raddish,2016,550,850,300,54.54545454545455
Shrirampur,Papai,2016,1033,1333,300,29.04162633107454
Kalyan,Tomato,2015,1653,1953,300,18.148820326678766
Barshi,Spinach,2015,300,600,300,100.0
Chandrapur-Ganjwad,Onion,2016,785,1085,300,38.21656050955414
Basmat,Pigeon Pea (Tur),2016,7800,8100,300,3.8461538461538463
Rahata,Ladies Finger,2015,2250,2550,300,13.333333333333334
Sinner,Soybean,2016,2937,3237,300,10.21450459652707
Solapur,Shepu,2015,200,500,300,150.0
Morshi,Pigeon Pea (Tur),2015,6756,7056,300,4.440497335701599
Khed-Chakan,Carrot,2016,726,1026,300,41.32231404958678
Chandrapur-Ganjwad,Carrot,2016,700,1000,300,42.857142857142854
Khed-Chakan,Coriander  ,2016,350,650,300,85.71428571428571
Malkapur,Maize,2015,887,1187,300,33.82187147688839
Kalyan,Green-Peas,2015,2800,3100,300,10.714285714285714
Kalyan,Ghevda,2015,2740,3040,300,10.94890510948905
Sillod,Castor Seed,2016,2650,2950,300,11.320754716981131
Indapur (Nimgaon Ketki),Bajri,2016,1500,1800,300,20.0
Kalyan,Flower,2015,700,1000,300,42.857142857142854
Koregaon,Onion,2016,300,600,300,100.0
Patur,Sorgum(Jawar),2015,1200,1500,300,25.0
Ghansawangi,Cotton,2015,3900,4200,300,7.6923076923076925
Dhamangaon-Rly,Gram,2015,4500,4800,300,6.666666666666667
Sangali,Castor Seed,2015,3200,3500,300,9.375
Ghansawangi,Bajri,2014,1150,1450,300,26.08695652173913
Achalpur,Lentil,2014,4000,4300,300,7.5
Khed-Chakan,Bottle Gourd,2016,479,779,300,62.63048016701461
Baramati,Gram,2014,2300,2600,300,13.043478260869565
Solapur,Matki,2016,6600,6900,300,4.545454545454546
Panvel,Cabbage,2016,1924,2224,300,15.592515592515593
Solapur,Matki,2016,6950,7250,300,4.316546762589928
Yawal,Wheat(Husked),2016,1625,1925,300,18.46153846153846
Jalna,Bajri,2016,1515,1815,300,19.801980198019802
Aurangabad,Sorgum(Jawar),2016,1600,1900,300,18.75
Loha,Pigeon Pea (Tur),2015,6950,7250,300,4.316546762589928
Akluj,Potato,2016,989,1289,300,30.33367037411527
Vai,Cucumber,2016,1140,1440,300,26.31578947368421
Chandrapur-Ganjwad,Chavli (Pala),2016,1200,1500,300,25.0
Vai,Cluster Bean,2016,2200,2500,300,13.636363636363637
Kalyan,Jaggery,2015,3100,3400,300,9.67741935483871
Khed-Chakan,Math (Bhaji),2015,800,1100,300,37.5
Kalyan,Jaggery,2015,3300,3600,300,9.090909090909092
Kalyan,Jaggery,2015,3200,3500,300,9.375
Chandur Bajar,Sorgum(Jawar),2015,1200,1500,300,25.0
Barshi,Spinach,2015,100,400,300,300.0
Mahagaon,Sorgum(Jawar),2016,1500,1800,300,20.0
Jalna-Badnapur,Pigeon Pea (Tur),2016,7700,8000,300,3.896103896103896
Umarkhed-Danki,Gram,2016,6200,6500,300,4.838709677419355
Amarawati-Fruit And Vegetables,Cabbage,2016,1633,1933,300,18.37109614206981
Solapur,Methi (Bhaji),2015,100,400,300,300.0
Pune-Moshi,Ginger (Fresh),2016,2800,3100,300,10.714285714285714
Parli-Vaijnath,Soybean,2015,3377,3677,300,8.883624518803671
Vai,Onion,2016,400,700,300,75.0
Mahagaon,Wheat(Husked),2016,1600,1900,300,18.75
Chandur Bajar,Sorgum(Jawar),2015,1300,1600,300,23.076923076923077
Jafrabad,Soybean,2015,2800,3100,300,10.714285714285714
Jalna-Badnapur,Pigeon Pea (Tur),2016,7800,8100,300,3.8461538461538463
Ramtek,Carrot,2016,588,888,300,51.02040816326531
Jalna-Badnapur,Black Gram,2014,4500,4800,300,6.666666666666667
Vai,Onion,2016,475,775,300,63.1578947368421
Vai,Sorgum(Jawar),2016,1200,1500,300,25.0
Sillod,Green Gram,2016,4638,4938,300,6.468305304010349
Khed,Ladies Finger,2014,2550,2850,300,11.764705882352942
Lasalgaon,Bajri,2016,1441,1741,300,20.81887578070784
Rahata,Small Gourd,2015,1500,1800,300,20.0
Anajngaon Surji,Banana,2015,600,900,300,50.0
Tasgaon,Ghevda Seed,2014,2400,2700,300,12.5
Akola,Bajri,2015,1000,1300,300,30.0
Jalna-Badnapur,Bajri,2014,1050,1350,300,28.571428571428573
Bhiwapur,Soybean,2016,3200,3500,300,9.375
Shirpur,Sorgum(Jawar),2016,1490,1789,299,20.06711409395973
Nagpur,Rice(Paddy-Hus),2015,2683,2982,299,11.1442415206858
Amalner,Maize,2016,1009,1308,299,29.633300297324084
Kalmeshwar,Brinjal,2016,2578,2877,299,11.598138091543833
Naigaon,Ground Nut Pods (Dry),2015,4984,5283,299,5.999197431781702
Babhulgaon,Soybean,2016,3012,3311,299,9.9269588313413
Khamgaon,Soybean,2015,3197,3496,299,9.352517985611511
Indapur-Bhigwan,Ghevda Seed,2016,4451,4750,299,6.717591552460122
Kej,Pigeon Pea (Tur),2014,4401,4700,299,6.79391047489207
Sailu,Green Gram,2015,6901,7200,299,4.332705405013766
Ausa,Gram,2015,3429,3728,299,8.719743365412656
Shahada,Wheat(Husked),2015,1390,1689,299,21.510791366906474
Mahagaon,COTTON,2016,4665,4964,299,6.409431939978564
Parola,Bajri,2015,1177,1476,299,25.4035683942226
Murtizapur,Wheat(Husked),2016,1496,1795,299,19.986631016042782
Yeotmal,Cotton,2016,4300,4599,299,6.953488372093023
Kalmeshwar,Cluster Bean,2016,2844,3143,299,10.513361462728552
Shegaon,Black Gram,2015,6063,6362,299,4.931552036945407
Shrirampur,Wheat(Husked),2015,1433,1732,299,20.865317515701324
Dondaicha,Wheat(Husked),2015,1458,1757,299,20.507544581618657
Telhara,Soybean,2016,3229,3528,299,9.259832765562093
Kalmeshwar,Soybean,2016,3255,3554,299,9.185867895545314
Nagpur,Mosambi,2015,1553,1852,299,19.253058596265294
Latur,Sorgum(Jawar),2015,2189,2488,299,13.659205116491549
Gangapur,Gram,2015,3681,3980,299,8.122792719369736
Devala,BAJRI,2016,1366,1665,299,21.888726207906295
Chopda,Wheat(Husked),2016,1436,1735,299,20.821727019498606
Pulgaon,Cotton,2016,4450,4749,299,6.719101123595506
Jalna,Bajri,2016,1581,1880,299,18.912080961416823
Majalgaon,Wheat(Husked),2015,1465,1764,299,20.409556313993175
Nashik,Spinach,2016,442,741,299,67.6470588235294
Partur,Sorgum(Jawar),2015,1266,1565,299,23.617693522906794
Pusad,Green Gram,2015,6146,6445,299,4.86495281483892
Beed,Soybean,2015,3443,3742,299,8.684286959047343
Baramati,Soybean,2016,3001,3300,299,9.963345551482838
Sinner,Bajri,2016,1399,1698,299,21.37240886347391
Jintur-Bori,Soybean,2014,2861,3160,299,10.450891296749388
Dhule,Soybean,2015,3520,3818,298,8.465909090909092
Nandgaon,Wheat(Husked),2014,1431,1729,298,20.82459818308875
Parbhani,Pigeon Pea (Tur),2016,8075,8373,298,3.6904024767801857
Shevgaon,Sorgum(Jawar),2016,1791,2089,298,16.638749302065886
Raver,Sorgum(Jawar),2016,1170,1468,298,25.47008547008547
Kille Dharur,Bajri,2014,1389,1687,298,21.454283657307414
Barshi-Vairag,Maize,2016,1466,1764,298,20.32742155525239
Gevrai,Sorgum(Jawar),2015,1341,1639,298,22.22222222222222
Shevgaon-Bodhegaon,Sorgum(Jawar),2014,1541,1839,298,19.338092147955873
Shevgaon,Green Gram,2016,4502,4800,298,6.619280319857841
Manmad,Wheat(Husked),2015,1341,1639,298,22.22222222222222
Manwat,Gram,2015,4496,4794,298,6.628113879003559
Dound,Gram,2016,5275,5573,298,5.649289099526066
Vani,Soybean,2016,3320,3618,298,8.975903614457831
Aurangabad,Bottle Gourd,2016,676,974,298,44.082840236686394
Vaijapur,Sorgum(Jawar),2016,1587,1885,298,18.777567737870196
Wardha,PIGEON PEA (TUR),2016,5114,5412,298,5.8271411810715685
Baramati,Wheat(Husked),2016,1717,2015,298,17.35585323238206
Nira,Jaggery,2016,2866,3164,298,10.397766922540125
Raver,Sorgum(Jawar),2015,1013,1311,298,29.41757156959526
Barshi,Bor,2014,107,405,298,278.50467289719626
Murtizapur,Soybean,2014,3032,3330,298,9.82849604221636
Khamgaon,Sorgum(Jawar),2015,1131,1429,298,26.348364279398762
Raver,Wheat(Husked),2015,1345,1643,298,22.156133828996282
Gevrai,Bajri,2014,1197,1495,298,24.895572263993316
Nagpur,Potato,2015,677,975,298,44.01772525849335
Amarawati,Bitter Gourd,2016,3155,3453,298,9.445324881141046
Gevrai,Sesamum,2015,6900,7198,298,4.318840579710145
Nashik-Devlali,Kardai,2016,424,722,298,70.28301886792453
Mumbai,Snake Gourd,2015,1388,1685,297,21.397694524495677
Lasalgaon-Niphad,Soybean,2016,2621,2918,297,11.331552842426555
Nandurbar,Shepa,2015,5132,5429,297,5.7872174590802805
Khamgaon,Green Gram,2016,6350,6647,297,4.677165354330708
Amalner,SOYBEAN,2016,2321,2618,297,12.796208530805687
Washim,Green Gram,2016,5825,6122,297,5.098712446351931
Amarawati,BAJRI,2016,1821,2118,297,16.30971993410214
Risod,Soybean,2016,3051,3348,297,9.734513274336283
Jamkhed,Gram,2016,3978,4275,297,7.46606334841629
Kamthi,Spinach,2015,303,600,297,98.01980198019803
Latur,Soybean,2015,3382,3679,297,8.781785925487878
Ahmednagar,Wheat(Husked),2015,1531,1828,297,19.3990855649902
Telhara,Gram,2015,4180,4477,297,7.105263157894737
Gevrai,Sorgum(Jawar),2016,1633,1930,297,18.187385180649112
Mohol,Gram,2015,4033,4330,297,7.364244978923878
Amarawati,Linseed,2016,4453,4750,297,6.669660902762183
Chandrapur,Gram,2015,3540,3837,297,8.389830508474576
Pune-Pimpri,Mango(Raw),2016,1835,2132,297,16.185286103542236
Amarawati,Sorgum(Jawar),2015,1503,1800,297,19.760479041916167
Mumbai,Bitter Gourd,2016,988,1285,297,30.060728744939272
Amarawati,Wheat(Husked),2015,1546,1843,297,19.210866752910736
Indapur-Bhigwan,Gram,2015,3500,3797,297,8.485714285714286
Rahata,Wheat(Husked),2015,1292,1589,297,22.987616099071207
Jalgaon,Gram,2016,3716,4013,297,7.992465016146394
Pandharpur,Cabbage,2016,250,547,297,118.8
Akkolkot,Pigeon Pea (Tur),2015,6003,6300,297,4.94752623688156
Mumbai,Snake Gourd,2014,1281,1578,297,23.185011709601874
Vai,Flower,2014,1481,1778,297,20.054017555705606
Shrirampur,Bajri,2014,1267,1564,297,23.441199684293608
Jintur-Bori,Gram,2014,2028,2325,297,14.644970414201184
Parli-Vaijnath,Gram,2014,2075,2372,297,14.313253012048193
Karanja,Ground Nut Pods (Dry),2016,4563,4860,297,6.508875739644971
Vai,Flower,2016,815,1112,297,36.441717791411044
Ghatanji,Ground Nut Pods (Dry),2016,4600,4897,297,6.456521739130435
Kalvan,Wheat(Husked),2015,1401,1698,297,21.199143468950748
Nagpur,RICE(PADDY-HUS),2016,2667,2964,297,11.136107986501687
Akkolkot,Gram,2016,4375,4671,296,6.765714285714286
Jawala-Bajar,Green Gram,2016,5086,5382,296,5.81989775855289
Khed-Chakan,Tomato,2016,479,775,296,61.79540709812109
Satana,Wheat(Husked),2016,1699,1995,296,17.42201294879341
Amarawati,Pigeon Pea (Tur),2016,6676,6972,296,4.433792690233673
Nagpur,Flower,2016,924,1220,296,32.03463203463203
Dound,Gram,2016,3869,4165,296,7.650555699147066
Mumbai,Cabbage,2015,752,1048,296,39.361702127659576
Akkolkot,Gram,2015,3506,3802,296,8.442669709070165
Parli-Vaijnath,Soybean,2015,3023,3319,296,9.791597750578894
Shahapur,Ghosali(Bhaji),2015,908,1204,296,32.59911894273128
Satara,Brinjal,2015,560,856,296,52.857142857142854
Nagpur,Beet Root,2015,604,900,296,49.00662251655629
Khed-Chakan,Flower,2015,952,1248,296,31.092436974789916
Parbhani,Green Gram,2014,6808,7104,296,4.3478260869565215
Malegaon,Wheat(Husked),2015,1443,1739,296,20.512820512820515
Chandrapur,Cotton,2016,4173,4469,296,7.093218308171579
Satara,Tomato,2014,692,988,296,42.774566473988436
Shirpur,Wheat(Husked),2014,1477,1773,296,20.04062288422478
Parli-Vaijnath,Sorgum(Jawar),2014,1482,1778,296,19.973009446693656
Chopda,Maize,2016,962,1258,296,30.76923076923077
Akola,Wheat(Husked),2015,1438,1734,296,20.58414464534075
Khamgaon,Soybean,2015,3147,3443,296,9.40578328566889
Kalyan,Sorgum(Jawar),2016,1900,2196,296,15.578947368421053
Shevgaon-Bodhegaon,Sorgum(Jawar),2016,1588,1884,296,18.639798488664987
Loha,Green Gram,2016,6004,6300,296,4.930046635576282
Kalamb (Os),Gram,2015,3964,4260,296,7.467204843592331
Devala,Bajri,2016,1351,1647,296,21.909696521095483
Mandhal,Gram,2015,3097,3393,296,9.557636422344205
Himayatnagar,Pigeon Pea (Tur),2015,8093,8389,296,3.657481774372915
Udgir,Green Gram,2015,7175,7471,296,4.125435540069686
Ambejogai,Pigeon Pea (Tur),2016,5929,6225,296,4.992410187215382
Gevrai,Soybean,2014,2791,3087,296,10.605517735578646
Vaijapur,Wheat(Husked),2015,1497,1793,296,19.772879091516366
Kalamb (Os),Gram,2016,4939,5235,296,5.99311601538773
Akola,Sorgum(Jawar),2016,1437,1733,296,20.59846903270703
Solapur,Gram,2016,5394,5690,296,5.487578791249536
Panvel,Cucumber,2016,1229,1525,296,24.084621643612692
Vadgaon Peth,Cabbage,2016,469,765,296,63.11300639658849
Shahada,Green Gram,2016,6576,6872,296,4.5012165450121655
Pune-Moshi,Cabbage,2016,517,813,296,57.25338491295938
Aurangabad,Bottle Gourd,2014,392,688,296,75.51020408163265
Jalgaon,Potato,2015,610,906,296,48.52459016393443
Nashik,Spinach,2014,286,582,296,103.4965034965035
Karad,CAPSICUM,2016,736,1032,296,40.21739130434783
Nagpur,Beet Root,2016,1109,1405,296,26.690712353471596
Nagpur,Jack Fruit,2016,1040,1336,296,28.46153846153846
Satara,Cabbage,2016,584,880,296,50.68493150684932
Satara,Cabbage,2014,417,713,296,70.9832134292566
Kalyan,Cabbage,2016,1800,2096,296,16.444444444444443
Nagpur,Brinjal,2015,1096,1392,296,27.00729927007299
Nagpur,Ladies Finger,2015,2250,2546,296,13.155555555555555
Umared,Pigeon Pea (Tur),2016,5809,6105,296,5.095541401273885
Shevgaon-Bodhegaon,Gram,2015,3213,3509,296,9.212573918456272
Shevgaon-Bodhegaon,Sorgum(Jawar),2016,1670,1966,296,17.724550898203592
Murtizapur,Soybean,2015,3036,3332,296,9.749670619235836
Satara,Bottle Gourd,2016,568,864,296,52.11267605633803
Dhamangaon-Rly,Soybean,2015,2988,3284,296,9.906291834002678
Nagpur,GREEN CHILLI,2016,1000,1295,295,29.5
Pune-Manjri,Flower,2015,491,786,295,60.08146639511202
Washim,Pigeon Pea (Tur),2014,4718,5013,295,6.252649427723612
Risod,Soybean,2015,3471,3766,295,8.49899164505906
Latur,Maize,2016,1325,1620,295,22.264150943396228
Beed,Bajri,2015,1346,1641,295,21.916790490341754
Shrirampur,TOMATO,2016,886,1181,295,33.29571106094808
Mumbai,Sweet Potato,2016,1162,1457,295,25.387263339070568
Mumbai,Onion,2015,1273,1568,295,23.17360565593087
Kalmeshwar,Walvad,2016,1889,2184,295,15.616728427739545
Digras,Pigeon Pea (Tur),2015,6798,7093,295,4.339511621065019
Parli-Vaijnath,Pigeon Pea (Tur),2016,8142,8437,295,3.6231884057971016
Kalamb (Yawatmal),Cotton,2016,4363,4658,295,6.761402704561082
Bhokar,Pigeon Pea (Tur),2016,5360,5655,295,5.503731343283582
Savner,Wheat(Husked),2016,1369,1664,295,21.548575602629658
Dhule,Bajri,2015,1342,1637,295,21.982116244411326
Kolhapur,Cabbage,2016,202,497,295,146.03960396039605
Junnar-Otur,Cabbage,2016,145,440,295,203.44827586206895
Savner,Gram,2014,2370,2665,295,12.447257383966244
Kalamb (Os),Sorgum(Jawar),2016,1530,1825,295,19.281045751633986
Sangamner,Flower,2015,358,653,295,82.40223463687151
Khed (Shel Pimpalgaon),Farshi,2015,933,1228,295,31.618435155412648
Kalmeshwar,GREEN CHILLI,2016,1205,1500,295,24.481327800829874
Akola,Soybean,2014,2763,3058,295,10.676800579080709
Shegaon,Wheat(Husked),2016,1532,1827,295,19.255874673629243
Pombhurni,Cotton,2016,3800,4095,295,7.7631578947368425
Dudhani,Sorgum(Jawar),2016,1910,2205,295,15.44502617801047
Kalmeshwar,Raddish,2016,1921,2216,295,15.356585111920875
Umared,Coriander (Dry),2015,6350,6645,295,4.645669291338582
Katol,Soybean,2015,3128,3423,295,9.430946291560103
Ramtek,Flower,2016,1762,2057,295,16.74233825198638
Pune-Pimpri,GREEN CHILLI,2016,1338,1633,295,22.047832585949177
Baramati,Wheat(Husked),2015,1688,1983,295,17.476303317535546
Karad,Cucumber,2016,519,814,295,56.84007707129094
Karad,Cucumber,2016,523,818,295,56.40535372848949
Ausa,Gram,2015,3606,3901,295,8.180809761508597
Shrirampur,Capsicum,2015,1750,2045,295,16.857142857142858
Patan,Tomato,2015,1105,1400,295,26.69683257918552
Digras,Green Gram,2016,4392,4687,295,6.716757741347905
Varud,Cotton,2016,4300,4595,295,6.8604651162790695
Nashik,Raddish,2016,329,624,295,89.66565349544074
Sengaon,Soybean,2015,3438,3733,295,8.580570098894706
Sangrampur-Varvatbakal,Wheat(Husked),2015,1205,1500,295,24.481327800829874
Gangapur,Sorgum(Jawar),2016,1666,1961,295,17.707082833133253
Sakri,Onion,2016,100,395,295,295.0
Shegaon,Gram,2015,3523,3818,295,8.373545273914278
Lonar,Gram,2015,3070,3365,295,9.609120521172638
Vaijapur,Gram,2016,3985,4280,295,7.402760351317441
Solapur,Cabbage,2015,273,568,295,108.05860805860806
Kolhapur-Laxmipuri,Split Lentil,2016,6776,7071,295,4.353600944510036
Katol,Orange,2014,740,1035,295,39.86486486486486
Majalgaon,Gram,2014,1955,2249,294,15.038363171355499
Tumsar,Other Pulses,2016,4558,4852,294,6.450197455024133
Kada (Ashti),Tamarind,2015,3556,3850,294,8.26771653543307
Jamkhed,Black Gram,2014,4806,5100,294,6.117353308364544
Lonand,Wheat(Husked),2016,1619,1913,294,18.159357628165534
Pune-Pimpri,Ghosali(Bhaji),2016,2873,3167,294,10.233205708318831
Akola,Bajri,2015,1531,1825,294,19.203135205747877
Sangrampur-Varvatbakal,Soybean,2016,3000,3294,294,9.8
Sillod,Green Gram,2016,4728,5022,294,6.218274111675127
Pusad,Pigeon Pea (Tur),2014,4466,4760,294,6.58307210031348
Nandura,Maize,2016,1475,1769,294,19.93220338983051
Anajngaon Surji,Soybean,2015,2979,3273,294,9.86908358509567
Zarijamini,Gram,2016,3584,3878,294,8.203125
Parbhani,Pigeon Pea (Tur),2016,8092,8386,294,3.633217993079585
Jintur,Green Gram,2016,4353,4647,294,6.753962784286699
Panvel,Cucumber,2016,2324,2618,294,12.650602409638553
Panvel,Bottle Gourd,2016,1295,1589,294,22.7027027027027
Khed-Chakan,Onion,2016,444,738,294,66.21621621621621
Pulgaon,Cotton,2015,3779,4073,294,7.779835935432654
Patan,Tomato,2015,1347,1641,294,21.826280623608017
Aurangabad,Bottle Gourd,2015,450,744,294,65.33333333333333
Ratanagari,Cabbage,2016,431,725,294,68.21345707656613
Jamner-Neri,Cotton,2016,4502,4796,294,6.530430919591293
Partur,Gram,2016,4872,5166,294,6.0344827586206895
Sengaon,Soybean,2015,3413,3707,294,8.614122472897744
Katol,Orange,2015,321,615,294,91.58878504672897
Barshi,Cucumber,2016,282,576,294,104.25531914893617
Taloda,Sorgum(Jawar),2015,1658,1952,294,17.732207478890228
Amarawati,Cluster Bean,2016,2956,3250,294,9.945872801082544
Kalamb (Os),Sorgum(Jawar),2016,1607,1901,294,18.294959551960176
Nandura,Bajri,2015,1235,1529,294,23.805668016194332
Jalgaon,Cabbage,2016,553,847,294,53.164556962025316
Sinner,Sorgum(Jawar),2015,1004,1298,294,29.282868525896415
Yeotmal,Green Gram,2016,5605,5899,294,5.245316681534344
Kalmeshwar,Green Chilli,2016,1568,1862,294,18.75
Nandura,Bajri,2015,1236,1530,294,23.78640776699029
Rahata,CUCUMBER,2016,625,919,294,47.04
Dondaicha,Ground Nut Pods (Dry),2014,3660,3954,294,8.032786885245901
Sonpeth,Gram,2016,6041,6335,294,4.866743916570104
Sangamner,Sorgum(Jawar),2015,1744,2038,294,16.857798165137616
Kurdwadi,Gram,2016,3901,4195,294,7.53652909510382
Nandurbar,Cluster Bean,2015,3601,3895,294,8.16439877811719
Partur,Wheat(Husked),2015,1496,1790,294,19.6524064171123
Pune,Arvi,2016,2873,3167,294,10.233205708318831
Vadgaon Peth,Cabbage,2015,639,933,294,46.009389671361504
Shrirampur,Bajri,2014,1162,1456,294,25.301204819277107
Amarawati,Bajri,2015,1802,2096,294,16.315205327413985
Nandura,Gram,2014,2385,2679,294,12.327044025157234
Chalisgaon,Wheat(Husked),2015,1406,1700,294,20.910384068278805
Bhokar,Wheat(Husked),2016,1393,1686,293,21.033740129217517
Nagpur,Cucumber,2015,865,1158,293,33.872832369942195
Akola,Wheat(Husked),2016,1753,2046,293,16.714204221334853
Lonar,Gram,2015,3883,4176,293,7.545712078289982
Pune-Pimpri,Onion,2015,1086,1379,293,26.97974217311234
Chandur Rly.,Gram,2016,3959,4252,293,7.400858802727962
Kej,Sorgum(Jawar),2015,1760,2053,293,16.647727272727273
Lasalgaon,Maize,2014,940,1233,293,31.170212765957448
Shegaon,Sorgum(Jawar),2014,1058,1351,293,27.6937618147448
Vaijapur,Black Gram,2016,5761,6054,293,5.0859225828849155
Zarijamini,Pigeon Pea (Tur),2015,4630,4923,293,6.32829373650108
Ambejogai,Soybean,2016,3108,3401,293,9.427284427284427
Ambejogai,Sesamum,2014,8936,9229,293,3.2788719785138762
Solapur,Sorgum(Jawar),2015,1605,1898,293,18.25545171339564
Ratanagari,Cabbage,2014,635,928,293,46.14173228346457
Satana,Bajri,2015,1265,1558,293,23.16205533596838
Jamkhed,Black Gram,2015,9390,9683,293,3.1203407880724177
Mangalwedha,Wheat(Husked),2016,1955,2248,293,14.987212276214834
Nandura,SORGUM(JAWAR),2016,1147,1440,293,25.544899738448127
Chandur Rly.,Pigeon Pea (Tur),2016,6071,6364,293,4.826223027507824
Dound,Wheat(Husked),2014,1529,1822,293,19.162851536952257
Majalgaon,Bajri,2015,1338,1631,293,21.898355754857995
Ausa,Sorgum(Jawar),2015,1654,1947,293,17.714631197097944
Mumbai,Cabbage,2016,419,712,293,69.92840095465394
Barshi,Fodder,2016,723,1016,293,40.52558782849239
Kalmeshwar,Chavli (Shenga ),2016,2153,2446,293,13.608917789131445
Shahada,Wheat(Husked),2016,1558,1851,293,18.806161745827985
Patan,Brinjal,2014,1536,1829,293,19.075520833333332
Yeotmal,Soybean,2015,3018,3311,293,9.708416169648775
Dhamangaon-Rly,Soybean,2015,3058,3351,293,9.581425768476128
Kada,Wheat(Husked),2015,1536,1829,293,19.075520833333332
Amarawati,Sorgum(Jawar),2015,1593,1886,293,18.39296924042687
Baramati,Wheat(Husked),2016,1738,2031,293,16.858457997698505
Kille Dharur,Gram,2016,5287,5580,293,5.541895214677511
Paithan,Bajri,2016,1484,1777,293,19.743935309973047
Panvel,Bitter Gourd,2016,1257,1550,293,23.309466984884647
Chopda,Sunflower,2015,2499,2792,293,11.72468987595038
Nandurbar,Sorgum(Jawar),2015,1223,1516,293,23.957481602616518
Amarawati-Fruit And Vegetables,Potato,2016,1180,1473,293,24.83050847457627
Amalner,Bajri,2016,1106,1399,293,26.491862567811935
Mumbai,Snake Gourd,2015,1515,1808,293,19.339933993399338
Pune-Pimpri,Cluster Bean,2016,3427,3720,293,8.549751969652757
Akluj,Potato,2016,1038,1331,293,28.227360308285164
Chalisgaon,Onion,2016,213,506,293,137.55868544600938
Patan,GREEN CHILLI,2016,1237,1530,293,23.68633791430881
Kopargaon,Soybean,2014,2954,3247,293,9.918754231550441
Amarawati,Potato,2015,679,971,292,43.004418262150224
Beed,Wheat(Husked),2014,1546,1838,292,18.88745148771022
Mumbai-Fruit Market,MELON,2016,1983,2275,292,14.725163893091276
Dondaicha,Sorgum(Jawar),2014,1474,1766,292,19.810040705563093
Digras,Soybean,2015,3471,3763,292,8.412561221549986
Indapur,Jaggery,2015,2109,2401,292,13.845424371740162
Navapur,Tomato,2016,676,968,292,43.19526627218935
Baramati,Jaggery,2016,3640,3932,292,8.021978021978022
Kalmeshwar,Ladies Finger,2016,1608,1900,292,18.1592039800995
Nilanga,Sorgum(Jawar),2015,1204,1496,292,24.25249169435216
Dondaicha,Maize,2016,1192,1484,292,24.496644295302012
Shevgaon,Bajri,2014,1143,1435,292,25.546806649168854
Mumbai,Elephant Root,2015,2212,2504,292,13.200723327305607
Buldhana,Gram,2016,4329,4621,292,6.745206745206745
Karad,Bottle Gourd,2015,875,1167,292,33.371428571428574
Kannad,Wheat(Husked),2015,1373,1665,292,21.267297887836854
Lasalgaon,Ground Nut Pods (Dry),2014,3836,4128,292,7.6120959332638165
Amarawati-Fruit And Vegetables,Brinjal,2016,1958,2250,292,14.91317671092952
Indapur (Nimgaon Ketki),Sorgum(Jawar),2016,1843,2135,292,15.843733043950081
Ambad(Vadi Godri),Soybean,2014,2978,3270,292,9.805238415043654
Dudhani,Wheat(Husked),2016,1633,1925,292,17.881200244947948
Yeotmal,Soybean,2015,3029,3321,292,9.640145262462859
Pathardi,Gram,2016,3967,4259,292,7.360725989412654
Manmad,Gram,2015,3406,3698,292,8.573106283029947
Kalamb (Os),Bajri,2014,1429,1721,292,20.433869839048285
Mumbai,Bottle Gourd,2015,877,1169,292,33.29532497149373
Mumbai,Arvi,2015,1931,2223,292,15.121698601760746
Shirur,Pigeon Pea (Tur),2016,6624,6916,292,4.408212560386473
Ahmednagar,Bajri,2015,1472,1764,292,19.83695652173913
Ahmednagar,Green Gram,2015,7300,7592,292,4.0
Nashik-Devlali,Kanda Pat,2016,360,652,292,81.11111111111111
Malkapur,Soybean,2015,2938,3230,292,9.938733832539143
Satara,Cucumber,2016,383,675,292,76.2402088772846
Nandgaon Khandeshwar,Green Gram,2016,3939,4231,292,7.413048997207413
Shirpur,Sorgum(Jawar),2015,1243,1535,292,23.49155269509252
Jamkhed,Pigeon Pea (Tur),2015,5001,5293,292,5.83883223355329
Akola,Sunflower,2015,3306,3598,292,8.832425892317
Shirpur,Sorgum(Jawar),2015,1312,1604,292,22.25609756097561
Kolhapur-Laxmipuri,Spilt Gerrn Gram,2015,9954,10246,292,2.933494072734579
Satara,Bottle Gourd,2015,630,922,292,46.34920634920635
Aurangabad,Banana,2014,364,656,292,80.21978021978022
Gevrai,Sorgum(Jawar),2015,1462,1754,292,19.972640218878247
Mehkar,Gram,2015,4308,4600,292,6.7780872794800375
Kolhapur,Raddish,2016,275,567,292,106.18181818181819
Satana,Wheat(Husked),2016,1712,2004,292,17.05607476635514
Newasa,Wheat(Husked),2016,1608,1900,292,18.1592039800995
Shevgaon,Sorgum(Jawar),2016,1741,2033,292,16.771970132107985
Nagpur,Beet Root,2015,1008,1300,292,28.96825396825397
Anajngaon Surji,Gram,2015,2874,3166,292,10.160055671537926
Pune-Pimpri,Bitter Gourd,2014,3083,3375,292,9.471294193966916
Chandrapur,Banana,2015,800,1092,292,36.5
Latur,Bajri,2016,1437,1729,292,20.32011134307585
Chalisgaon,MAIZE,2016,941,1233,292,31.030818278427205
Chakur,Soybean,2016,3380,3672,292,8.63905325443787
Gondpimpri,Pigeon Pea (Tur),2016,6775,7067,292,4.3099630996309966
Shrirampur,Soybean,2016,3252,3544,292,8.979089790897909
Latur,Sorgum(Jawar),2015,2230,2522,292,13.094170403587444
Rahata,Ginger (Fresh),2015,3125,3417,292,9.344
Khamgaon,Lemon,2015,183,475,292,159.56284153005464
Raver,Wheat(Husked),2015,1405,1697,292,20.78291814946619
Paithan,Wheat(Husked),2016,1717,2008,291,16.94816540477577
Latur,Safflower,2014,2450,2741,291,11.877551020408163
Umared,Coriander (Dry),2015,6020,6311,291,4.833887043189368
Lasalgaon,Pigeon Pea (Tur),2015,4090,4381,291,7.114914425427873
Kalvan,BAJRI,2016,1359,1650,291,21.41280353200883
Pune-Pimpri,BITTER GOURD,2016,2164,2455,291,13.44731977818854
Karad,Flower,2015,736,1027,291,39.53804347826087
Umarga,Soybean,2014,3026,3317,291,9.616655651024455
Bhiwapur,Gram,2016,5143,5434,291,5.658176161773284
Murtizapur,Soybean,2015,3113,3404,291,9.347895920334082
Umarga,Gram,2015,3215,3506,291,9.051321928460343
Ghansawangi,Sorgum(Jawar),2016,1692,1983,291,17.19858156028369
Khed (Shel Pimpalgaon),Cucumber,2014,1262,1553,291,23.05863708399366
Pandharpur,Banana,2016,263,554,291,110.64638783269962
Ausa,Soybean,2014,3116,3407,291,9.338896020539153
Bhandara,Rice(Paddy-Hus),2015,2405,2696,291,12.099792099792099
Kannad,Wheat(Husked),2014,1490,1781,291,19.530201342281877
Sangamner,Bajri,2015,1273,1564,291,22.859387274155537
Loha,Turmeric,2015,7100,7391,291,4.098591549295775
Nagpur,Cabbage,2016,759,1050,291,38.3399209486166
Shirpur,Maize,2016,1129,1420,291,25.775022143489814
Vai,Cucumber,2016,1564,1855,291,18.60613810741688
Lonar,Gram,2014,2633,2924,291,11.052031902772503
Indapur-Bhigwan,Maize,2016,1160,1451,291,25.086206896551722
Murbad,Capsicum,2015,4427,4718,291,6.573300203297944
Pusad,Bajri,2016,1789,2080,291,16.26607043040805
Pune-Moshi,Carrot,2016,1342,1633,291,21.684053651266765
Rahata,Cabbage,2016,417,708,291,69.7841726618705
Umarga,Sesamum,2015,7661,7952,291,3.7984597311056
Kopargaon,Bajri,2016,1467,1758,291,19.83640081799591
Kopargaon,Sorgum(Jawar),2016,1554,1845,291,18.725868725868725
Mumbai,Elephant Root,2014,1717,2008,291,16.94816540477577
Khamgaon,Lemon,2015,108,399,291,269.44444444444446
Jalgaon,Cabbage,2015,491,782,291,59.26680244399186
Malkapur,WHEAT(HUSKED),2016,1834,2125,291,15.866957470010906
Mumbai,Sugar,2014,2725,3016,291,10.678899082568808
Malkapur,Soybean,2016,3145,3436,291,9.252782193958664
Amarawati,Gram,2016,7650,7941,291,3.803921568627451
Nandurbar,Sorgum(Jawar),2016,1386,1677,291,20.995670995670995
Shegaon,Pigeon Pea (Tur),2014,4074,4365,291,7.142857142857143
Barshi Takli,COTTON,2016,4605,4896,291,6.319218241042345
Dondaicha,Wheat(Husked),2015,1456,1747,291,19.986263736263737
Murbad,Bitter Gourd,2015,3995,4286,291,7.284105131414268
Latur,Safflower,2016,2540,2831,291,11.456692913385826
Ghoti,Tomato,2016,1300,1591,291,22.384615384615383
Ausa,Sorgum(Jawar),2015,1519,1810,291,19.157340355497038
Mumbai,Bottle Gourd,2015,942,1233,291,30.89171974522293
Chikhali,Wheat(Husked),2016,1417,1708,291,20.5363443895554
Savner,Ground Nut Pods (Dry),2016,5041,5331,290,5.752826820075382
Barshi,Cabbage,2016,510,800,290,56.86274509803921
Jalna,Jaggery,2014,2122,2412,290,13.666352497643732
Akkolkot,Gram,2016,5544,5834,290,5.2308802308802305
Mantha,Sorgum(Jawar),2016,1313,1603,290,22.086824067022086
Umarga,Wheat(Unhusked),2015,2637,2927,290,10.99734546833523
Mohol,Wheat(Unhusked),2015,2600,2890,290,11.153846153846153
Junnar-Otur,BOTTLE GOURD,2016,270,560,290,107.4074074074074
Lasur Station,Soybean,2015,3861,4151,290,7.511007511007511
Kolhapur,Harbara(Pendi),2016,510,800,290,56.86274509803921
Nagpur,Tomato,2015,1225,1515,290,23.6734693877551
Kalmeshwar,Green Chilli,2016,2506,2796,290,11.572226656025538
Baramati,Jaggery,2015,2238,2528,290,12.957998212689901
Dhamangaon-Rly,Soybean,2015,3000,3290,290,9.666666666666666
Chandrapur,Green Gram,2016,5200,5490,290,5.576923076923077
Sillod,Black Gram,2016,6655,6945,290,4.357625845229151
Savner,Gram,2016,5408,5698,290,5.362426035502959
Ramtek,Capsicum,2015,1070,1360,290,27.102803738317757
Bhivandi,Potato,2016,1105,1395,290,26.244343891402714
Dhamangaon-Rly,Soybean,2016,3422,3712,290,8.474576271186441
Ghoti,Flower,2015,1050,1340,290,27.61904761904762
Latur,Sunflower,2016,3429,3719,290,8.457276173811607
Hadgaon,Cotton,2016,4352,4642,290,6.663602941176471
Sonpeth,Wheat(Husked),2016,1946,2236,290,14.902363823227132
Lasalgaon,Maize,2014,875,1165,290,33.142857142857146
Pune-Pimpri,Flower,2014,1286,1576,290,22.55054432348367
Chikhali,Gram,2016,3978,4268,290,7.290095525389643
Vita,Onion,2016,461,751,290,62.906724511930584
Amarawati-Fruit And Vegetables,Potato,2016,1155,1445,290,25.10822510822511
Raver,Wheat(Husked),2016,1416,1706,290,20.480225988700564
Mumbai,Arvi,2014,2650,2940,290,10.943396226415095
Malkapur,Cotton,2014,3760,4050,290,7.712765957446808
Nagpur,Banana,2015,450,740,290,64.44444444444444
Sailu,Gram,2016,4010,4300,290,7.231920199501247
Shrirampur,Cucumber,2015,940,1230,290,30.851063829787233
Gangapur,Pigeon Pea (Tur),2015,5767,6057,290,5.028611062944338
Gangapur,Wheat(Husked),2016,1559,1849,290,18.601667735728032
Rahata,Carrot,2016,1255,1545,290,23.10756972111554
Sangrampur-Varvatbakal,Wheat(Husked),2016,1620,1910,290,17.901234567901234
Vaijapur,Gram,2015,3583,3873,290,8.093776165224671
Shevgaon-Bodhegaon,Pigeon Pea (Tur),2015,4790,5079,289,6.033402922755741
Parbhani,Pigeon Pea (Tur),2015,5300,5589,289,5.452830188679245
Parli-Vaijnath,SORGUM(JAWAR),2016,1427,1716,289,20.25227750525578
Jalgaon,Cabbage,2014,595,884,289,48.57142857142857
Pusad,Sesamum,2016,5855,6144,289,4.9359521776259605
Amarawati-Fruit And Vegetables,Bitter Gourd,2016,3182,3471,289,9.082338152105594
Lasalgaon-Vinchur,BAJRI,2016,1224,1513,289,23.61111111111111
Vaduj,Gram,2016,7589,7878,289,3.8081433653972856
Akluj,Water Melon,2015,222,511,289,130.18018018018017
Baramati,Bajri,2014,1469,1758,289,19.673247106875426
Udgir,Pigeon Pea (Tur),2015,10053,10342,289,2.8747637521137968
Nagpur,Rice(Paddy-Hus),2016,2863,3152,289,10.094306671323785
Pune,BAJRI,2016,2126,2415,289,13.59360301034807
Kalvan,Maize,2015,1046,1335,289,27.62906309751434
Amarawati,Kharbuj,2016,1676,1965,289,17.24343675417661
Jamkhed,Pigeon Pea (Tur),2015,4810,5099,289,6.008316008316008
Dhule,Bajri,2016,1355,1644,289,21.328413284132843
Pulgaon,Gram,2015,4040,4329,289,7.153465346534653
Ghatanji,Gram,2016,3966,4255,289,7.286938981341402
Ratanagari,Cabbage,2015,916,1205,289,31.550218340611355
Dhule,Sorgum(Jawar),2014,1535,1824,289,18.827361563517915
Manmad,Bajri,2016,1606,1895,289,17.99501867995019
Udgir,Gram,2015,4867,5156,289,5.937949455516746
Kalmeshwar,Coriander  ,2015,4226,4515,289,6.838618078561288
Mumbai,Cabbage,2016,892,1181,289,32.399103139013455
Chopda,Maize,2016,1098,1387,289,26.32058287795993
Vaijapur,Wheat(Husked),2014,1365,1654,289,21.17216117216117
Kannad,Wheat(Husked),2016,1558,1847,289,18.549422336328625
Khamgaon,Wheat(Husked),2014,1290,1579,289,22.4031007751938
Sangamner,Bajri,2016,1661,1950,289,17.399157134256473
Nampur,WHEAT(HUSKED),2016,1500,1789,289,19.266666666666666
Kolhapur,Carrot,2015,2300,2589,289,12.565217391304348
Vani,Soybean,2014,3035,3324,289,9.522240527182866
Morshi,Gram,2015,4044,4333,289,7.146389713155291
Patur,Soybean,2016,2944,3233,289,9.816576086956522
Aurangabad,Bottle Gourd,2015,511,800,289,56.55577299412916
Dudhani,Sorgum(Jawar),2016,2434,2723,289,11.873459326211997
Kalyan,Sorgum(Jawar),2016,1833,2122,289,15.766503000545553
Lasur Station,Soybean,2015,3454,3743,289,8.36711059640996
Tumsar,Wheat(Husked),2015,1332,1621,289,21.696696696696698
Vaduj,Green Gram,2015,7200,7489,289,4.013888888888889
Barshi,Cucumber,2016,266,555,289,108.64661654135338
Malegaon,Horse Gram,2014,3601,3890,289,8.025548458761454
Manwat,Wheat(Husked),2015,1489,1778,289,19.408999328408328
Satara,Potato,2015,678,967,289,42.62536873156342
Malegaon,Bajri,2015,1314,1603,289,21.993911719939117
Malegaon,Bajri,2015,1251,1540,289,23.101518784972022
Nagpur,Pumpkin,2015,562,850,288,51.245551601423486
Osmanabad,Cabbage,2015,625,913,288,46.08
Rahuri-Vambori,Sunflower,2014,2658,2946,288,10.835214446952596
Manmad,Bajri,2015,1311,1599,288,21.96796338672769
Barshi,Fodder,2014,361,649,288,79.77839335180056
Karanja,Soybean,2014,2970,3258,288,9.696969696969697
Chalisgaon,Pigeon Pea (Tur),2015,7008,7296,288,4.109589041095891
Sinner,Pigeon Pea (Tur),2015,3269,3557,288,8.810033649434077
Nagpur,Green Chilli,2016,1033,1321,288,27.87996127783156
Pathari,Soybean,2014,2973,3261,288,9.687184661957618
Shirpur,Pigeon Pea (Tur),2015,5454,5742,288,5.2805280528052805
Latur,Soybean,2016,3458,3746,288,8.328513591671486
Khamgaon,Sesamum,2015,7315,7603,288,3.9371155160628843
Gangapur,Sorgum(Jawar),2015,1476,1764,288,19.51219512195122
Jalgaon,JAGGERY,2016,3000,3288,288,9.6
Chikhali,Sorgum(Jawar),2016,1286,1574,288,22.3950233281493
Rahuri-Vambori,Sorgum(Jawar),2015,1563,1851,288,18.426103646833013
Rahata,Walvad,2015,1825,2113,288,15.780821917808218
Kalmeshwar,Ladies Finger,2016,1756,2044,288,16.40091116173121
Shrigonda,Bajri,2016,1334,1622,288,21.58920539730135
Shevgaon,Sorgum(Jawar),2015,1709,1997,288,16.8519602106495
Nashik-Devlali,Kanda Pat,2016,250,538,288,115.2
Jawala-Bajar,COTTON,2016,4656,4944,288,6.185567010309279
Khamgaon,Soybean,2014,2958,3246,288,9.736308316430021
Pune-Moshi,Sweet Potato,2016,1875,2163,288,15.36
Varora,Gram,2015,3019,3307,288,9.539582643259358
Kalyan,Flower,2015,1087,1375,288,26.494940202391906
Amarawati-Fruit And Vegetables,Cabbage,2016,2508,2796,288,11.483253588516746
Yeotmal,Cotton,2015,3885,4173,288,7.413127413127413
Amalner,Maize,2016,1122,1410,288,25.668449197860962
Sangrampur,Maize,2015,1050,1338,288,27.428571428571427
Umared,Lang,2015,1800,2088,288,16.0
Pusad,Gram,2015,3993,4281,288,7.212622088655147
Jalna,Bajri,2016,1443,1731,288,19.95841995841996
Ahmedpur,Pigeon Pea (Tur),2015,6306,6594,288,4.567078972407232
Solapur,Sorgum(Jawar),2016,1797,2085,288,16.026711185308848
Washim,Wheat(Husked),2015,1397,1685,288,20.61560486757337
Ausa,Soybean,2014,2899,3187,288,9.934460158675405
Lasalgaon,Wheat(Husked),2016,1703,1991,288,16.911332941867293
Patur,Soybean,2015,3461,3749,288,8.321294423577001
Ulhasnagar,Banana,2016,306,594,288,94.11764705882354
Sengaon,Pigeon Pea (Tur),2016,8127,8415,288,3.5437430786267994
Karad,Bottle Gourd,2015,900,1188,288,32.0
Indapur,Banana,2016,839,1127,288,34.32657926102503
Karad,Bottle Gourd,2015,556,844,288,51.798561151079134
Satara,Potato,2015,750,1038,288,38.4
Raver,Wheat(Husked),2014,1350,1638,288,21.333333333333332
Pune-Moshi,GHOSALI(BHAJI),2016,1632,1920,288,17.647058823529413
Udgir,Green Gram,2016,6269,6557,288,4.594034136225873
Solapur,Green Peas (Dry),2016,2925,3213,288,9.846153846153847
Chandur Bajar,Wheat(Husked),2015,1400,1688,288,20.571428571428573
Vaduj,Ghevda Seed,2016,5625,5913,288,5.12
Wardha,Cotton,2016,4575,4863,288,6.295081967213115
Ghansawangi,Sorgum(Jawar),2016,1713,2000,287,16.754232340922357
Varud-Rajura Bazar,Soybean,2016,3318,3605,287,8.649789029535865
Lonand,Gram,2015,3163,3450,287,9.073664242807462
Kille Dharur,Soybean,2015,3120,3407,287,9.198717948717949
Buldhana,Wheat(Husked),2015,1338,1625,287,21.449925261584454
Shrirampur,Carrot,2015,940,1227,287,30.53191489361702
Jalgaon Jamod-Aasalgaon,Wheat(Husked),2016,1513,1800,287,18.968935888962328
Jalgaon,Carrot,2016,683,970,287,42.020497803806734
Khed (Shel Pimpalgaon),Cluster Bean,2016,3492,3779,287,8.218785796105383
Amarawati,Green Gram,2016,6772,7059,287,4.238038984051979
Kille Dharur,Gram,2015,3663,3950,287,7.835107835107835
Barshi-Vairag,Wheat(Husked),2016,2062,2349,287,13.918525703200777
Jintur,Sorgum(Jawar),2015,1430,1717,287,20.06993006993007
Kalamnuri,Gram,2016,4055,4342,287,7.077681874229347
Savner,Gram,2015,4015,4302,287,7.148194271481943
Rahata,Sorgum(Jawar),2014,1088,1375,287,26.378676470588236
Aarni,Sorgum(Jawar),2015,863,1150,287,33.25608342989571
Pune-Pimpri,Ridge Gourd,2015,3780,4067,287,7.592592592592593
Khed-Chakan,Potato,2016,1263,1550,287,22.723673792557403
Gangapur,Green Gram,2014,6396,6683,287,4.487179487179487
Mangrulpeer,Wheat(Husked),2015,1300,1587,287,22.076923076923077
Kalamb (Os),Wheat(Husked),2014,1738,2025,287,16.513233601841197
Latur,Soybean,2015,3749,4036,287,7.655374766604428
Sangamner,Gram,2015,3731,4018,287,7.6923076923076925
Shevgaon,Sorgum(Jawar),2015,1253,1540,287,22.905027932960895
Patur,Soybean,2016,3431,3718,287,8.364908190032061
Shevgaon,Bajri,2014,1165,1452,287,24.63519313304721
Yeotmal,Soybean,2015,3335,3622,287,8.605697151424287
Dhule,Green Gram,2015,6660,6947,287,4.3093093093093096
Nashik-Devlali,Ambat Chuka,2016,360,647,287,79.72222222222223
Kalmeshwar,Ladies Finger,2016,2505,2792,287,11.457085828343313
Buldhana,Sorgum(Jawar),2016,1263,1550,287,22.723673792557403
Savner,Gram,2016,6295,6582,287,4.559173947577443
Kalyan,Cucumber,2015,1088,1375,287,26.378676470588236
Manora,Soybean,2015,3597,3884,287,7.978871281623575
Balapur,Sorgum(Jawar),2015,1138,1425,287,25.219683655536027
Mangrulpeer,Wheat(Husked),2014,1264,1551,287,22.705696202531644
Dhule,Wheat(Husked),2015,1499,1786,287,19.14609739826551
Satara,Potato,2015,713,1000,287,40.252454417952315
Bori,Black Gram,2016,3130,3417,287,9.169329073482428
Mumbai,Carrot,2015,991,1278,287,28.960645812310798
Osmanabad,Wheat(Husked),2016,1826,2113,287,15.717415115005476
Ramtek,Chavli (Shenga ),2015,880,1167,287,32.61363636363637
Dhamangaon-Rly,Gram,2014,2451,2738,287,11.709506323949409
Hingna,Soybean,2016,3263,3550,287,8.795586883236286
Chopda,Sorgum(Jawar),2016,1494,1780,286,19.143239625167336
Hinganghat,COTTON,2016,4729,5015,286,6.047790230492705
Beed,Bajri,2015,1302,1588,286,21.96620583717358
Bhandara,Indian Bean,2016,3509,3795,286,8.150470219435737
Sangrampur-Varvatbakal,WHEAT(HUSKED),2016,1567,1853,286,18.251435864709638
Hingoli,Cotton,2015,4150,4436,286,6.891566265060241
Chandrapur-Ganjwad,Brinjal,2015,414,700,286,69.08212560386474
Gangapur,Gram,2015,4117,4403,286,6.946805926645616
Gangapur,Wheat(Husked),2016,1707,1993,286,16.75454012888108
Bhivandi,Other Vegetables,2015,1105,1391,286,25.88235294117647
Shegaon,Wheat(Husked),2016,1561,1847,286,18.32158872517617
Sangali,Wheat(Unhusked),2016,3409,3695,286,8.389557054854796
Taloda,Gram,2014,3200,3486,286,8.9375
Gangapur,Sorgum(Jawar),2014,1730,2016,286,16.53179190751445
Telhara,Pigeon Pea (Tur),2015,5453,5739,286,5.2448193654868875
Kalmeshwar,Tomato,2016,1545,1831,286,18.511326860841425
Jalna,Soybean,2015,3038,3324,286,9.414088215931534
Pune-Pimpri,Tomato,2014,882,1168,286,32.426303854875286
Partur,Sorgum(Jawar),2015,1138,1424,286,25.131810193321616
Yeotmal,Soybean,2014,3014,3300,286,9.489051094890511
Latur-Murud,Sorgum(Jawar),2015,1242,1528,286,23.027375201288244
Risod,Gram,2015,3715,4001,286,7.698519515477793
Shirpur,Bajri,2016,1285,1571,286,22.2568093385214
Aheri,Sesamum,2014,7143,7429,286,4.003919921601568
Solapur,Jaggery,2016,3388,3674,286,8.441558441558442
Khamgaon,Sorgum(Jawar),2015,1210,1496,286,23.636363636363637
Jintur,Soybean,2015,3343,3629,286,8.555189949147472
Kalamb (Os),Black Gram,2015,6918,7204,286,4.134142815842729
Shrirampur,Green-Peas,2015,1764,2050,286,16.213151927437643
Amarawati-Fruit And Vegetables,Dhemse,2016,2450,2736,286,11.673469387755102
Washim,Soybean,2016,3517,3803,286,8.131930622689792
Ramtek,Ladies Finger,2015,943,1229,286,30.328738069989395
Amarawati-Fruit And Vegetables,Dhemse,2016,2881,3167,286,9.92710864283235
Karanja,Green Gram,2015,6264,6550,286,4.565772669220945
Tuljapur,Green Gram,2016,4343,4629,286,6.585309693760074
Manchar,Ghevda,2015,3167,3453,286,9.030628354910009
Panvel,Ghosali(Bhaji),2016,1500,1786,286,19.066666666666666
Pune-Pimpri,Cluster Bean,2015,5571,5857,286,5.133728235505295
Aurangabad,Bottle Gourd,2015,414,700,286,69.08212560386474
Rahata,Lemon,2015,1857,2143,286,15.401184706515886
Mangrulpeer,Soybean,2016,3587,3873,286,7.973236688040145
Pune-Pimpri,Flower,2016,1890,2176,286,15.132275132275133
Malegaon,Gram,2015,3100,3386,286,9.225806451612904
Karanja,Ground Nut Pods (Dry),2014,3446,3732,286,8.299477655252467
Nagbhid,Paddy-Unhusked,2015,1962,2247,285,14.525993883792049
Vai,Cucumber,2015,1365,1650,285,20.87912087912088
Amarawati,Bajri,2016,1427,1712,285,19.97196916608269
Aurangabad,Potato,2015,704,989,285,40.48295454545455
Ambad(Vadi Godri),Soybean,2014,2915,3200,285,9.777015437392796
Kille Dharur,Bajri,2016,1694,1979,285,16.82408500590319
Bhokar,Sorgum(Jawar),2015,1271,1556,285,22.42328874901652
Rajura,Pigeon Pea (Tur),2016,6987,7272,285,4.079003864319451
Bhokar,Sorgum(Jawar),2014,1263,1548,285,22.565320665083135
Bhokar,Sesamum,2014,8251,8536,285,3.454126772512423
Nandurbar,Soybean,2015,3410,3695,285,8.357771260997067
Risod,Soybean,2016,3554,3839,285,8.019133370849747
Sinner,Wheat(Husked),2016,1617,1902,285,17.625231910946198
Manwat,Bajri,2015,1450,1735,285,19.655172413793103
Nagpur,Math (Bhaji),2015,2100,2385,285,13.571428571428571
Lonar,Gram,2014,2455,2740,285,11.608961303462321
Shrirampur,Cucumber,2016,886,1171,285,32.16704288939052
Washim,Black Gram,2014,5083,5368,285,5.606925044265198
Jalgaon,Wal Papdi,2015,1323,1608,285,21.541950113378686
Nandura,Sesamum,2016,5778,6063,285,4.932502596053998
Buldhana,Soybean,2015,3000,3285,285,9.5
Nandura,Onion,2016,228,513,285,125.0
Lasalgaon,Maize,2014,979,1264,285,29.111338100102145
Jalgaon,Jaggery,2016,3193,3478,285,8.925775133103665
Mangrulpeer,Wheat(Husked),2014,1226,1511,285,23.246329526916803
Nagpur,Rice(Paddy-Hus),2015,2540,2825,285,11.220472440944881
Lasur Station,Bajri,2015,1113,1398,285,25.606469002695416
Kurdwadi-Modnimb,Wheat(Husked),2015,1472,1757,285,19.36141304347826
Ghoti,Capsicum,2016,1400,1685,285,20.357142857142858
Ahmedpur,Pigeon Pea (Tur),2016,8225,8510,285,3.465045592705167
Dhule,Soybean,2016,3278,3563,285,8.694325808419768
Pune-Pimpri,Flower,2014,1547,1832,285,18.422753716871362
Purna,Soybean,2015,3033,3318,285,9.396636993076163
Manmad,Green Gram,2016,6735,7020,285,4.23162583518931
Mumbai,Cabbage,2016,1815,2100,285,15.702479338842975
Amarawati,Bajri,2015,1469,1754,285,19.400953029271612
Hadgaon-Tamsa,Gram,2016,4110,4395,285,6.934306569343065
Digras,Gram,2015,4016,4301,285,7.096613545816733
Shevgaon,Bajri,2016,1474,1759,285,19.335142469470828
Nagpur,Cucumber,2016,615,900,285,46.34146341463415
Chalisgaon,Wheat(Husked),2014,1380,1665,285,20.652173913043477
Mumbai,Tomato,2015,1265,1550,285,22.529644268774703
Nandgaon Khandeshwar,Wheat(Husked),2015,1160,1445,285,24.56896551724138
Yeola,Bajri,2016,1484,1769,285,19.204851752021565
Jalgaon Jamod-Aasalgaon,Soybean,2016,3129,3414,285,9.108341323106425
Rahata,Potato,2015,923,1208,285,30.87757313109426
Mumbai,Cucumber,2015,923,1208,285,30.87757313109426
Gevrai,Mustard,2016,3081,3366,285,9.250243427458617
Achalpur,Gram,2015,3480,3765,285,8.189655172413794
Baramati,Sunflower,2014,3201,3486,285,8.903467666354265
Sindi,Gram,2016,4011,4296,285,7.105459985041137
Nagpur,Bottle Gourd,2015,519,804,285,54.91329479768786
Mumbai,Flower,2015,623,908,285,45.74638844301766
Nagpur,Rice(Paddy-Hus),2016,2632,2917,285,10.828267477203648
Kalamb (Yawatmal),Soybean,2014,3022,3307,285,9.43084050297816
Nagpur,Wal Bhaji,2014,2438,2723,285,11.689909762100083
Dondaicha,Sorgum(Jawar),2015,1673,1958,285,17.035265989240884
Manchar,Cabbage,2016,184,469,285,154.8913043478261
Sinner,Bajri,2016,1479,1764,285,19.26977687626775
Malkapur,Maize,2015,1154,1439,285,24.696707105719238
Vaijapur,Bajri,2016,1306,1591,285,21.822358346094948
Kalamb (Yawatmal),Soybean,2016,3346,3631,285,8.517632994620442
Ramtek,Brinjal,2015,867,1152,285,32.8719723183391
Sindi (Selu),Wheat(Husked),2016,1531,1816,285,18.6152841280209
Bhiwapur,Paddy-Unhusked,2014,2583,2868,285,11.033681765389083
Nagpur,Rice(Paddy-Hus),2016,2736,3020,284,10.380116959064328
Jalgaon Jamod-Aasalgaon,SOYBEAN,2016,2558,2842,284,11.102423768569194
Shrirampur,Sunflower,2015,2866,3150,284,9.909281228192603
Nagpur,Papai,2016,562,846,284,50.5338078291815
Sinner,Sorgum(Jawar),2015,1002,1286,284,28.343313373253494
Kalmeshwar,Tomato,2016,2360,2644,284,12.033898305084746
Chandrapur-Ganjwad,Flower,2015,683,967,284,41.58125915080527
Indapur,Bajri,2016,1498,1782,284,18.958611481975968
Aurangabad,CAPSICUM,2016,816,1100,284,34.80392156862745
Solapur,Banana,2015,189,473,284,150.26455026455025
Manora,SOYBEAN,2016,2615,2899,284,10.860420650095602
Chalisgaon,Wheat(Husked),2014,1402,1686,284,20.256776034236804
Majalgaon,Green Gram,2015,7198,7482,284,3.945540427896638
Wardha,Wheat(Husked),2016,1477,1761,284,19.22816519972918
Lasur Station,Gram,2016,5357,5641,284,5.30147470599216
Raver,Pigeon Pea (Tur),2016,7817,8101,284,3.6331073301778174
Chopda,Gram,2016,5750,6034,284,4.939130434782609
Karanja,Soybean,2015,3017,3301,284,9.413324494530992
Sailu,Pigeon Pea (Tur),2014,4134,4418,284,6.869859700048379
Chandrapur-Ganjwad,Potato,2016,1304,1588,284,21.779141104294478
Mumbai,Flower,2016,396,680,284,71.71717171717172
Shrirampur,Wheat(Husked),2016,1697,1981,284,16.73541543901002
Gevrai,Gram,2015,3801,4085,284,7.471717968955538
Washim,Soybean,2015,3539,3823,284,8.024865781294151
Osmanabad,Wheat(Husked),2015,1375,1659,284,20.654545454545456
Kolhapur-Laxmipuri,Bajri,2016,1958,2242,284,14.504596527068438
Mumbai,Carrot,2015,1008,1292,284,28.174603174603174
Pune-Moshi,BEET ROOT,2016,929,1213,284,30.570505920344456
Amarawati,Pigeon Pea (Tur),2015,7029,7313,284,4.040404040404041
Kalyan,Bottle Gourd,2016,1083,1367,284,26.223453370267773
Nagpur,Carrot,2016,740,1024,284,38.37837837837838
Lasur Station,Bajri,2016,1324,1608,284,21.45015105740181
Pune-Pimpri,Cabbage,2015,721,1005,284,39.389736477115115
Shirpur,Bajri,2016,1355,1639,284,20.95940959409594
Jalkot,Soybean,2015,3503,3787,284,8.107336568655438
Pune-Pimpri,Flower,2016,911,1195,284,31.174533479692645
Bhokar,Soybean,2014,2816,3100,284,10.085227272727273
Vadgaon Peth,Cabbage,2015,458,742,284,62.00873362445415
Kalamb (Os),Soybean,2016,3595,3879,284,7.899860917941585
Jintur,Soybean,2015,3593,3876,283,7.876426384636794
Amarawati,Wheat(Husked),2015,1626,1909,283,17.404674046740467
Sinner,Sorgum(Jawar),2015,1654,1937,283,17.110036275695283
Shrirampur,Wheat(Husked),2014,1408,1691,283,20.099431818181817
Mumbai,Sugar,2015,2659,2942,283,10.643098909364422
Mantha,Sorgum(Jawar),2015,1200,1483,283,23.583333333333332
Akola,Wheat(Husked),2016,1540,1823,283,18.376623376623378
Satara,Bottle Gourd,2015,550,833,283,51.45454545454545
Paithan,Bajri,2016,1341,1624,283,21.10365398956003
Jalgaon Jamod-Aasalgaon,Gram,2016,3867,4150,283,7.318334626325317
Sonpeth,Soybean,2014,2854,3137,283,9.915907498248073
Karanja,Ground Nut Pods (Dry),2014,3400,3683,283,8.323529411764707
Nagpur,Wheat(Husked),2016,1980,2263,283,14.292929292929292
Shirpur,Bajri,2015,1247,1530,283,22.694466720128307
Karanja,Soybean,2015,3050,3333,283,9.278688524590164
Shegaon,Sesamum,2015,6700,6983,283,4.223880597014926
Chopda,Soybean,2015,2914,3197,283,9.711736444749485
Manchar,Bottle Gourd,2015,567,850,283,49.91181657848325
Barshi-Vairag,Ground Nut Pods (Dry),2015,4564,4847,283,6.200701139351446
Panvel,Bottle Gourd,2014,1017,1300,283,27.826941986234022
Dondaicha,Sorgum(Jawar),2015,1414,1697,283,20.014144271570014
Ahmednagar,Bajri,2016,1809,2092,283,15.64400221116639
Koregaon,Wheat(Husked),2015,1617,1900,283,17.501546072974644
Nagpur,Rice(Paddy-Hus),2016,2771,3054,283,10.212919523637677
Mumbai,Tomato,2015,1388,1671,283,20.389048991354468
Rahata,Flower,2016,592,875,283,47.804054054054056
Kej,Bajri,2016,1305,1588,283,21.685823754789272
Bhokar,Soybean,2016,3536,3819,283,8.003393665158372
Rahata,Potato,2015,975,1258,283,29.025641025641026
Savner,Ground Nut Pods (Dry),2014,3095,3378,283,9.1437802907916
Kalyan,Cucumber,2016,1650,1933,283,17.151515151515152
Morshi,Pigeon Pea (Tur),2014,4500,4783,283,6.288888888888889
Pune,Sorgum(Jawar),2016,2561,2844,283,11.050370948848107
Chandrapur-Ganjwad,Capsicum,2015,650,933,283,43.53846153846154
Kalyan,Potato,2016,1371,1654,283,20.641867250182347
Yeotmal,Soybean,2016,3485,3768,283,8.12051649928264
Sillod,Gram,2015,3500,3783,283,8.085714285714285
Telhara,Pigeon Pea (Tur),2014,4000,4283,283,7.075
Shevgaon,Gram,2015,3567,3850,283,7.933837959069246
Gangakhed,Soybean,2016,3555,3838,283,7.960618846694796
Kada,Soybean,2016,3134,3417,283,9.029993618379068
Tumsar,Jaggery,2014,2827,3110,283,10.010611956137248
Digras,Pigeon Pea (Tur),2016,8572,8855,283,3.3014465702286513
Nagpur,Bor,2014,482,765,283,58.71369294605809
Yeotmal,PIGEON PEA (TUR),2016,5280,5563,283,5.359848484848484
Akluj,Cabbage,2016,278,561,283,101.79856115107914
Aurangabad,Orange,2015,655,938,283,43.20610687022901
Kille Dharur,Sorgum(Jawar),2015,2538,2821,283,11.150512214342001
Nagpur,Bitter Gourd,2015,2665,2948,283,10.619136960600375
Panvel,Ladies Finger,2016,1317,1600,283,21.488230827638574
Vaduj,Gram,2016,7117,7400,283,3.9763945482647185
Vaduj,Green Gram,2015,6578,6861,283,4.302219519610824
Malkapur,Onion,2016,459,742,283,61.6557734204793
Anajngaon Surji,Black Gram,2015,5400,5683,283,5.2407407407407405
Amalner,Wheat(Husked),2015,1527,1810,283,18.533071381794368
Mandhal,Pigeon Pea (Tur),2015,5568,5851,283,5.0826149425287355
Kalmeshwar,Coriander  ,2015,1993,2276,283,14.199698946312092
Washim-Ansing,Black Gram,2016,6550,6833,283,4.320610687022901
Kalmeshwar,Green Chilli,2016,3047,3329,282,9.255004922874958
Purna,Pigeon Pea (Tur),2016,8040,8322,282,3.5074626865671643
Ulhasnagar,Banana,2016,300,582,282,94.0
Ausa,Soybean,2016,3419,3701,282,8.248025738520035
Ausa,Sorgum(Jawar),2015,1537,1819,282,18.347430058555627
Khed-Chakan,Flower,2016,981,1263,282,28.74617737003058
Kalmeshwar,Chavli (Shenga ),2016,2078,2360,282,13.570741097208854
Amarawati,Black Gram,2015,5232,5514,282,5.389908256880734
Pune-Pimpri,Cucumber,2015,841,1123,282,33.53151010701546
Pusad,Bajri,2016,1716,1998,282,16.433566433566433
Akola,Wheat(Husked),2015,1452,1734,282,19.421487603305785
Kalmeshwar,Green Chilli,2016,1749,2031,282,16.123499142367066
Manmad,Wheat(Husked),2014,1466,1748,282,19.236016371077763
Nagpur,Wheat(Husked),2016,1825,2107,282,15.452054794520548
Khed-Chakan,Cucumber,2016,570,852,282,49.473684210526315
Solapur,Sorgum(Jawar),2016,1803,2085,282,15.640599001663894
Sengaon,Turmeric,2016,7989,8271,282,3.529853548629365
Sailu,Gram,2014,2391,2673,282,11.79422835633626
Ausa,Sunflower,2015,3230,3512,282,8.730650154798761
Sangali,Bajri,2016,1759,2041,282,16.0318362706083
Aarni,Ground Nut Pods (Dry),2014,3550,3832,282,7.943661971830986
Dhule,Sorgum(Jawar),2015,1451,1733,282,19.43487250172295
Amarawati-Fruit And Vegetables,Brinjal,2016,1073,1355,282,26.281453867660765
Washim-Ansing,Pigeon Pea (Tur),2016,6774,7056,282,4.1629760850310005
Kalmeshwar,Spinach,2016,1768,2050,282,15.950226244343892
Sonpeth,Wheat(Husked),2016,1550,1832,282,18.193548387096776
Karad,Bottle Gourd,2015,773,1055,282,36.48124191461837
Bhivandi,Other Vegetables,2016,934,1216,282,30.19271948608137
Sindi,Soybean,2015,2992,3274,282,9.425133689839573
Kalyan,Carrot,2016,853,1135,282,33.05978898007034
Shegaon,Green Gram,2016,4543,4825,282,6.207351970063835
Mahur,Soybean,2015,3300,3582,282,8.545454545454545
Pune,Wheat(Husked),2016,2008,2290,282,14.04382470119522
Mumbai,Sweet Potato,2015,894,1176,282,31.543624161073826
Partur,Wheat(Husked),2016,1738,2020,282,16.22554660529344
Kalyan,Cucumber,2016,1722,2004,282,16.37630662020906
Savner,Pigeon Pea (Tur),2015,5167,5449,282,5.4577124056512485
Panvel,Cabbage,2016,1309,1591,282,21.543162719633308
Lasalgaon,Maize,2016,1558,1840,282,18.10012836970475
Jalgaon,Coriander (Dry),2016,8095,8377,282,3.483631871525633
Kalamb (Os),Sorgum(Jawar),2015,1745,2027,282,16.160458452722064
Murtizapur,Gram,2016,4000,4282,282,7.05
Kalmeshwar,Bottle Gourd,2016,1472,1754,282,19.157608695652176
Aurangabad,Awala,2015,609,891,282,46.30541871921182
Kille Dharur,Bajri,2016,1522,1804,282,18.528252299605782
Nandura,Wheat(Husked),2016,1524,1806,282,18.503937007874015
Karad,Bottle Gourd,2015,732,1014,282,38.52459016393443
Partur,Sorgum(Jawar),2015,1540,1822,282,18.31168831168831
Manora,Soybean,2016,3530,3812,282,7.9886685552407934
Khed (Shel Pimpalgaon),Brinjal,2016,1248,1529,281,22.516025641025642
Manmad,Bajri,2015,1372,1653,281,20.481049562682216
Buldhana,Green Gram,2016,4764,5045,281,5.89840470193115
Nandura,Onion,2016,513,794,281,54.77582846003899
Gangapur,Wheat(Husked),2015,1435,1716,281,19.581881533101047
Mumbai,Elephant Root,2016,2450,2731,281,11.46938775510204
Shirpur,Pigeon Pea (Tur),2015,5372,5653,281,5.230826507818318
Chandur Rly.,Gram,2016,5875,6156,281,4.782978723404256
Nagpur,Cluster Bean,2014,1704,1985,281,16.490610328638496
Kalyan,Green-Peas,2016,1700,1981,281,16.529411764705884
Washim,Gram,2015,3158,3439,281,8.89803673210893
Akkolkot,Black Gram,2015,8557,8838,281,3.283861166296599
Nagbhid,Paddy-Unhusked,2015,1619,1900,281,17.356392835083383
Nagpur,Mango(Raw),2015,1827,2108,281,15.38040503557745
Akola,Sorgum(Jawar),2016,1575,1856,281,17.841269841269842
Kopargaon,SOYBEAN,2016,2466,2747,281,11.394971613949716
Kopargaon,Sorgum(Jawar),2016,1630,1911,281,17.23926380368098
Barshi,Tamarind,2016,5897,6178,281,4.765134814312362
Kalyan,Lemon,2016,1448,1729,281,19.406077348066297
Karanja,Wheat(Husked),2015,1392,1673,281,20.186781609195403
Pusad,Sorgum(Jawar),2016,1395,1676,281,20.14336917562724
Kurdwadi,Wheat(Husked),2014,1490,1771,281,18.859060402684563
Sonpeth,Sorgum(Jawar),2016,1626,1907,281,17.281672816728168
Mumbai,Sugar,2014,2947,3228,281,9.535120461486256
Nagpur,Spinach,2014,1719,2000,281,16.34671320535195
Shirpur,Bajri,2016,1508,1789,281,18.63395225464191
Barshi,Fodder,2015,332,613,281,84.63855421686748
Ramtek,Green Chilli,2015,1038,1319,281,27.071290944123316
Jamkhed,Soybean,2015,3231,3512,281,8.696997833488084
Pusad,Sorgum(Jawar),2015,1080,1361,281,26.01851851851852
Himayatnagar,Cotton,2015,3918,4199,281,7.172026544155181
Pune-Pimpri,Ghevda,2016,2255,2536,281,12.46119733924612
Lasur Station,Bajri,2016,1346,1627,281,20.87667161961367
Kalmeshwar,Cotton,2016,4672,4953,281,6.0145547945205475
Ausa,Bajri,2015,1484,1765,281,18.935309973045822
Murbad,Brinjal,2014,2623,2904,281,10.712924132672512
Majalgaon,Cotton,2015,3933,4214,281,7.1446732773963895
Lonar,Sorgum(Jawar),2016,1498,1779,281,18.758344459279037
Nagpur,Rice(Paddy-Hus),2016,2761,3042,281,10.177471930459978
Aurangabad,Potato,2014,2140,2421,281,13.130841121495328
Umarga,Sunflower,2015,3200,3481,281,8.78125
Aurangabad,Cabbage,2016,792,1073,281,35.47979797979798
Parli-Vaijnath,Soybean,2016,3624,3905,281,7.753863134657837
Dondaicha,Matki,2015,6883,7163,280,4.067993607438617
Kalyan,Carrot,2015,1720,2000,280,16.27906976744186
Mumbai,Bitter Gourd,2014,1376,1656,280,20.348837209302324
Jamkhed,Soybean,2014,2995,3275,280,9.348914858096828
Washim,Black Gram,2016,6733,7013,280,4.158621713946235
Mumbai,Elephant Root,2014,1216,1496,280,23.026315789473685
Pune-Pimpri,Green Chilli,2015,1740,2020,280,16.091954022988507
Chandur Bajar,Wheat(Husked),2015,1400,1680,280,20.0
Partur,Sorgum(Jawar),2015,1492,1772,280,18.766756032171582
Shirur,Indian Bean,2015,3629,3909,280,7.7156241388812346
Mehkar,Soybean,2016,3472,3752,280,8.064516129032258
Kalamb (Os),Black Gram,2015,4840,5120,280,5.785123966942149
Jintur,Gram,2016,4894,5174,280,5.721291377196567
Mumbai-Fruit Market,WATER MELON,2016,962,1242,280,29.106029106029105
Beed,Bajri,2016,1557,1837,280,17.98330122029544
Partur,Wheat(Husked),2016,1570,1850,280,17.8343949044586
Lonar,Wheat(Husked),2016,1525,1805,280,18.360655737704917
Kolhapur-Laxmipuri,Cowpea,2016,5332,5612,280,5.251312828207052
Nagpur,Green Chilli,2015,1140,1420,280,24.56140350877193
Bhokar,Sorgum(Jawar),2016,1238,1518,280,22.617124394184167
Gevrai,Gram,2016,4972,5252,280,5.631536604987932
Amalner,Wheat(Husked),2016,1533,1813,280,18.264840182648403
Rahuri-Vambori,Wheat(Husked),2015,1536,1816,280,18.229166666666668
Akola,Soybean,2015,2988,3268,280,9.370816599732262
Dudhani,Sorgum(Jawar),2016,1826,2106,280,15.334063526834612
Chandur Bajar,Sorgum(Jawar),2014,1250,1530,280,22.4
Panvel,Bottle Gourd,2016,1810,2090,280,15.469613259668508
Sangamner,Wheat(Husked),2015,1589,1869,280,17.621145374449338
Beed,Wheat(Husked),2015,1809,2089,280,15.478164731896076
Pandharpur,Banana,2015,474,754,280,59.07172995780591
Lonar,Wheat(Husked),2016,1746,2026,280,16.036655211912944
Kalyan,Carrot,2016,2130,2410,280,13.145539906103286
Khed (Shel Pimpalgaon),Cluster Bean,2015,2270,2550,280,12.334801762114537
Tumsar,Gram,2016,4937,5217,280,5.671460401053271
Mantha,Black Gram,2015,6933,7213,280,4.038655704601183
Chandur Rly.,Soybean,2015,3200,3480,280,8.75
Kopargaon,Maize,2016,1641,1921,280,17.062766605728214
Kada,Bajri,2016,1304,1584,280,21.47239263803681
Balapur,Gram,2016,3440,3720,280,8.13953488372093
Bhokar,Wheat(Husked),2015,1954,2234,280,14.329580348004095
Ghoti,Brinjal,2016,1483,1763,280,18.88064733648011
Yawal,Bajri,2016,1193,1473,280,23.47024308466052
Paithan,Bajri,2016,1310,1590,280,21.374045801526716
Manchar,Wal Bhaji,2016,1010,1290,280,27.722772277227723
Nira,Jaggery,2015,2825,3105,280,9.91150442477876
Pune,Wheat(Husked),2016,2157,2437,280,12.980992118683357
Khed (Shel Pimpalgaon),Farshi,2014,757,1037,280,36.98811096433289
Sangamner,Wheat(Husked),2016,1610,1890,280,17.391304347826086
Barshi-Vairag,Wheat(Husked),2016,1637,1917,280,17.10445937690898
Lasur Station,Bajri,2015,1330,1610,280,21.05263157894737
Amarawati,Papai,2015,693,973,280,40.4040404040404
Kalamb (Os),Soybean,2015,3380,3660,280,8.284023668639053
Kalmeshwar,Ladies Finger,2016,1508,1788,280,18.56763925729443
Hadgaon,Wheat(Husked),2015,1490,1770,280,18.79194630872483
Panvel,Flower,2016,1040,1320,280,26.923076923076923
Pune-Pimpri,Bitter Gourd,2016,2207,2487,280,12.686905301314
Kada,Soybean,2014,3035,3315,280,9.225700164744646
Karad,Brinjal,2016,568,848,280,49.29577464788732
Sangrampur,Sorgum(Jawar),2015,940,1220,280,29.78723404255319
Amarawati,Lemon,2015,1860,2140,280,15.053763440860216
Jalgaon,Maize(Corn.),2015,740,1020,280,37.83783783783784
Beed,Soybean,2014,2915,3195,280,9.60548885077187
Samudrapur,Cotton,2015,3902,4182,280,7.1758072783188105
Bhivandi,Rice(Paddy-Hus),2015,1450,1730,280,19.310344827586206
Panvel,Flower,2016,1080,1360,280,25.925925925925927
Umarkhed-Danki,Soybean,2015,2920,3200,280,9.58904109589041
Bhivandi,Rice(Paddy-Hus),2015,1630,1910,280,17.177914110429448
Kalvan,Gram,2015,3840,4120,280,7.291666666666667
Rahata,Potato,2016,1330,1610,280,21.05263157894737
Jalgaon,Jaggery,2015,2430,2710,280,11.522633744855968
Vaijapur,WHEAT(HUSKED),2016,1785,2065,280,15.686274509803921
Pune-Pimpri,Cabbage,2015,733,1013,280,38.19918144611187
Manchar,Shevga,2015,4025,4305,280,6.956521739130435
Pune,Jack Fruit(Raw),2015,900,1180,280,31.11111111111111
Kalamb (Os),Sesamum,2015,6563,6843,280,4.266341612067652
Jalgaon,Gram,2015,3624,3904,280,7.72626931567329
Kalyan,RIDGE GOURD,2016,1520,1800,280,18.42105263157895
Barshi,Fodder,2015,485,765,280,57.7319587628866
Dhule,Green Gram,2016,5840,6120,280,4.794520547945205
Sangrampur-Varvatbakal,Sorgum(Jawar),2016,1140,1420,280,24.56140350877193
Pune-Moshi,Potato,2016,1197,1477,280,23.391812865497077
Shrirampur,Brinjal,2016,862,1142,280,32.48259860788863
Bhivandi,Rice(Paddy-Hus),2015,1940,2220,280,14.43298969072165
Shrirampur,Green-Peas,2014,2380,2660,280,11.764705882352942
Amarawati,Sorgum(Jawar),2016,1548,1827,279,18.023255813953487
Parbhani,Pigeon Pea (Tur),2016,7871,8150,279,3.5446576038622792
Aurangabad,Potato,2016,769,1048,279,36.28088426527958
Pulgaon,Gram,2015,3040,3319,279,9.177631578947368
Aurangabad,Bottle Gourd,2015,482,761,279,57.88381742738589
Patan,Tomato,2016,918,1197,279,30.392156862745097
Vaijapur,Ground Nut Pods (Dry),2016,5672,5951,279,4.9188998589562765
Savner,Soybean,2014,2687,2966,279,10.383327130628954
Shegaon,Pigeon Pea (Tur),2014,4275,4554,279,6.526315789473684
Jamner,Cotton,2016,4526,4805,279,6.164383561643835
Kannad,Wheat(Husked),2014,1388,1667,279,20.10086455331412
Amarawati,Bitter Gourd,2016,2917,3196,279,9.564621186150154
Nandura,Onion,2016,270,549,279,103.33333333333333
Barshi,Flower,2016,242,521,279,115.2892561983471
Khed-Chakan,Carrot,2016,904,1183,279,30.86283185840708
Malegaon,Bajri,2014,1251,1530,279,22.302158273381295
Washim,Wheat(Husked),2015,1389,1668,279,20.086393088552917
Khamgaon,Soybean,2015,2937,3216,279,9.499489274770173
Kopargaon,Bajri,2014,1224,1503,279,22.794117647058822
Kalmeshwar,Ladies Finger,2016,2440,2719,279,11.434426229508198
Vaijapur,Wheat(Husked),2016,1570,1849,279,17.770700636942674
Baramati,Sunflower,2014,2921,3200,279,9.551523450872988
Telhara,SOYBEAN,2016,2559,2838,279,10.902696365767879
Sangamner,Gram,2015,4017,4296,279,6.9454817027632565
Barshi-Vairag,Ground Nut Pods (Dry),2015,4303,4582,279,6.483848477806181
Purna,Wheat(Husked),2015,1319,1598,279,21.152388172858227
Risod,Soybean,2016,3384,3663,279,8.24468085106383
Mumbai,Sugar,2014,2872,3151,279,9.714484679665738
Lasur Station,Bajri,2016,1497,1776,279,18.637274549098198
Kej,Bajri,2014,1592,1871,279,17.525125628140703
Umarga,Sorgum(Jawar),2015,1438,1717,279,19.401947148817804
Bhivandi,Onion,2016,763,1042,279,36.566186107470514
Amarawati,Pigeon Pea (Tur),2016,6215,6494,279,4.489139179404666
Ratanagari,CABBAGE,2016,479,758,279,58.24634655532359
Mumbai,Elephant Root,2015,1779,2058,279,15.682967959527824
Mangalwedha,Wheat(Husked),2016,1813,2092,279,15.388858246001103
Sonpeth,Wheat(Husked),2016,1957,2236,279,14.256515074092999
Varora,Soybean,2016,2863,3142,279,9.745022703457911
Nagpur,Rice(Paddy-Hus),2015,2396,2675,279,11.64440734557596
Latur,Sunflower,2016,3296,3575,279,8.464805825242719
Nagpur,CUCUMBER,2016,853,1132,279,32.708089097303635
Risod,Soybean,2016,3175,3454,279,8.78740157480315
Kopargaon,Soybean,2016,3078,3357,279,9.064327485380117
Shegaon,Sunflower,2015,2880,3159,279,9.6875
Karanja,Soybean,2015,3102,3381,279,8.994197292069632
Patan,Cabbage,2016,1021,1300,279,27.32615083251714
Solapur,Sorgum(Jawar),2016,1870,2149,279,14.919786096256685
Kalamb (Os),Soybean,2014,3041,3320,279,9.174613613942782
Kalyan,Elephant Root,2016,2483,2761,278,11.196133709222714
Ambad(Vadi Godri),Wheat(Husked),2014,1433,1711,278,19.39986043265876
Ambad(Vadi Godri),Bajri,2016,1511,1789,278,18.39841164791529
Kamthi,Tomato,2016,193,471,278,144.04145077720207
Kalmeshwar,Brinjal,2015,1130,1408,278,24.601769911504423
Ambad(Vadi Godri),Maize,2014,896,1174,278,31.026785714285715
Nashik,TOMATO,2016,407,685,278,68.30466830466831
Islampur,Brinjal,2016,263,541,278,105.70342205323193
Beed,Sorgum(Jawar),2016,1605,1883,278,17.3208722741433
Nandurbar,Sorgum(Jawar),2015,1024,1302,278,27.1484375
Khed (Shel Pimpalgaon),Ladies Finger,2015,1006,1284,278,27.634194831013918
Pune-Pimpri,Cluster Bean,2015,2736,3014,278,10.160818713450292
Patur,Sorgum(Jawar),2016,1378,1656,278,20.174165457184326
Morshi,Pigeon Pea (Tur),2014,4500,4778,278,6.177777777777778
Kalyan,Bitter Gourd,2016,933,1211,278,29.79635584137192
Buldhana,Wheat(Husked),2016,1489,1767,278,18.670248488918737
Dhamangaon-Rly,Gram,2015,3092,3370,278,8.990944372574386
Kalamb (Yawatmal),Gram,2016,3866,4144,278,7.19089498189343
Kalmeshwar,Cabbage,2016,882,1160,278,31.519274376417233
Kej,Wheat(Husked),2015,1940,2218,278,14.329896907216495
Mumbai,Snake Gourd,2014,1474,1752,278,18.860244233378562
Dhule,Matki,2014,5912,6190,278,4.7023004059539915
Ghoti,Cabbage,2016,983,1261,278,28.280773143438452
Ambejogai,Soybean,2014,3076,3354,278,9.037711313394018
Satana,Bajri,2015,1200,1478,278,23.166666666666668
Nandura,Maize,2016,1421,1699,278,19.56368754398311
Aurangabad,Bottle Gourd,2016,586,864,278,47.44027303754266
Dhule,Maize,2015,1032,1310,278,26.93798449612403
Solapur,Papai,2016,556,834,278,50.0
Buldhana,Gram,2015,3835,4113,278,7.2490221642764014
Telhara,Cotton,2016,4229,4507,278,6.573658075195081
Mumbai,Carrot,2015,1070,1348,278,25.981308411214954
Osmanabad,Wheat(Husked),2015,1467,1745,278,18.950238582140422
Paithan,Wheat(Husked),2016,1751,2029,278,15.876641918903484
Washim,Black Gram,2014,4271,4549,278,6.509014282369469
Kalmeshwar,Walvad,2016,2655,2933,278,10.47080979284369
Nandgaon Khandeshwar,Ground Nut Pods (Dry),2016,4200,4478,278,6.619047619047619
Bhandara,Wheat(Husked),2016,1433,1711,278,19.39986043265876
Manora,Soybean,2016,3011,3289,278,9.232813018930587
Vani,Soybean,2016,3446,3724,278,8.067324434126524
Solapur,Jaggery,2015,2182,2460,278,12.740604949587535
Raver,Gram,2016,3932,4210,278,7.070193285859613
Shevgaon,Sorgum(Jawar),2016,1620,1898,278,17.160493827160494
Wardha,Soybean,2016,3088,3366,278,9.00259067357513
Patan,Flower,2016,1483,1761,278,18.745785569790964
Jintur,Sorgum(Jawar),2015,1115,1393,278,24.932735426008968
Akola,Soybean,2015,3233,3511,278,8.598824621094959
Ghansawangi,Green Gram,2016,4600,4878,278,6.043478260869565
Rahata,Beet Root,2016,1000,1278,278,27.8
Bhandara,Gram,2016,6091,6369,278,4.564110983418158
Vaijapur,Sorgum(Jawar),2014,1093,1371,278,25.434583714547117
Tumsar,Jaggery,2015,2146,2424,278,12.954333643988816
Pune-Pimpri,Shepu,2016,328,606,278,84.7560975609756
Tumsar,Pigeon Pea (Tur),2015,5110,5388,278,5.440313111545988
Paithan,Bajri,2016,1517,1795,278,18.32564271588662
Yeola,Wheat(Husked),2015,1435,1713,278,19.372822299651567
Ambejogai,Soybean,2016,3626,3903,277,7.639271924986211
Mumbai,Onion,2015,1906,2183,277,14.53305351521511
Amarawati,Cluster Bean,2016,3382,3659,277,8.190419869899468
Karad,Cucumber,2016,450,727,277,61.55555555555556
Shahada,Sorgum(Jawar),2014,1348,1625,277,20.548961424332344
Nagpur,Rice(Paddy-Hus),2016,2642,2919,277,10.48448145344436
Kalyan,Rice(Paddy-Hus),2016,2537,2814,277,10.918407567993693
Karad,Bottle Gourd,2015,856,1133,277,32.35981308411215
Nagpur,Dhemse,2014,1769,2046,277,15.65856416054268
Mumbai,Sugar,2014,3038,3315,277,9.117840684660962
Sengaon,Soybean,2015,3381,3658,277,8.192842354333038
Khed (Shel Pimpalgaon),Green Chilli,2016,706,983,277,39.23512747875354
Bhiwapur,Gram,2016,3950,4227,277,7.012658227848101
Pachora,BAJRI,2016,1074,1351,277,25.79143389199255
Kannad,Bajri,2016,1591,1868,277,17.410433689503456
Karad,Tomato,2015,654,931,277,42.35474006116208
Mahur,Cotton,2014,3623,3900,277,7.645597571073695
Navapur,Green Chilli,2016,633,910,277,43.75987361769352
Ghatanji,Cotton,2016,4399,4676,277,6.296885655830871
Shrirampur,Bor,2014,1023,1300,277,27.0772238514174
Navapur,Tomato,2016,633,910,277,43.75987361769352
Mehkar,Green Gram,2016,5219,5496,277,5.307530178195057
Shrirampur,Potato,2014,1956,2233,277,14.161554192229039
Murum,Black Gram,2015,8611,8888,277,3.2168157008477527
Nandgaon,Wheat(Husked),2014,1447,1724,277,19.143054595715274
Murtizapur,Soybean,2015,2996,3273,277,9.2456608811749
Majalgaon,Bajri,2015,1669,1946,277,16.59676452965848
Nandurbar,Gram,2014,2319,2596,277,11.944803794739112
Shahada,Wheat(Husked),2015,1487,1764,277,18.62811028917283
Jalgaon,Black Gram,2015,7476,7753,277,3.7051899411449973
Mumbai,Capsicum,2016,765,1042,277,36.209150326797385
Kolhapur-Malkapur,Tomato,2016,111,388,277,249.54954954954954
Mumbai,Bottle Gourd,2016,1069,1346,277,25.912067352666043
Vaijapur,Pigeon Pea (Tur),2016,7722,7999,277,3.5871535871535873
Aurad Shahajani,Gram,2016,5460,5737,277,5.073260073260073
Amalner,Green Gram,2015,6217,6494,277,4.455525172912981
Nagpur,Papai,2016,517,794,277,53.57833655705996
Lasalgaon,Bajri,2016,1346,1623,277,20.579494799405648
Mumbai,SWEET POTATO,2016,738,1015,277,37.53387533875339
Sonpeth,Sorgum(Jawar),2016,1492,1769,277,18.5656836461126
Patan,Brinjal,2015,877,1154,277,31.584948688711517
Hingoli,Gram,2015,4407,4684,277,6.2854549580213295
Barshi,Cabbage,2016,355,632,277,78.02816901408451
Partur,SOYBEAN,2016,2536,2813,277,10.922712933753942
Kalyan,Cucumber,2015,1256,1533,277,22.054140127388536
Mangrulpeer,Wheat(Husked),2016,1475,1752,277,18.779661016949152
Satara,Potato,2015,567,844,277,48.85361552028219
Manmad,Sorgum(Jawar),2016,1435,1712,277,19.303135888501743
Lasalgaon,Bajri,2015,1300,1577,277,21.307692307692307
Pandharkawada,Soybean,2014,2889,3166,277,9.588092765662859
Dound,Gram,2015,4005,4281,276,6.891385767790262
Kej,Sesamum,2015,8950,9226,276,3.083798882681564
Pusad,Sorgum(Jawar),2016,1488,1764,276,18.548387096774192
Mandhal,Pigeon Pea (Tur),2015,5236,5512,276,5.271199388846448
Pusad,SORGUM(JAWAR),2016,1350,1626,276,20.444444444444443
Kalamb (Os),Soybean,2014,2873,3149,276,9.606682909850331
Shevgaon,Sorgum(Jawar),2015,1723,1999,276,16.018572257690074
Nagpur,Spinach,2016,576,852,276,47.916666666666664
Baramati,Bajri,2015,1450,1726,276,19.03448275862069
Amarawati,Papai,2016,606,882,276,45.54455445544554
Mangrulpeer,Soybean,2016,3437,3713,276,8.030258946755891
Sonpeth,Soybean,2014,3030,3306,276,9.108910891089108
Nagpur,Wheat(Husked),2015,1812,2088,276,15.2317880794702
Karanja,Ground Nut Pods (Dry),2015,4698,4974,276,5.874840357598979
Kalmeshwar,Raddish,2016,909,1185,276,30.363036303630363
Kurdwadi-Modnimb,Wheat(Husked),2016,1619,1895,276,17.047560222359483
Hadgaon-Tamsa,Cotton,2015,4289,4565,276,6.435066449055724
Gangapur,Sorgum(Jawar),2016,1520,1796,276,18.157894736842106
Ambejogai,Wheat(Husked),2015,1560,1836,276,17.692307692307693
Mumbai,Carrot,2016,562,838,276,49.11032028469751
Mumbai,Carrot,2016,484,760,276,57.02479338842975
Ahmedpur,Pigeon Pea (Tur),2016,9043,9319,276,3.0520844852372
Palghar(Bevur),Wheat(Husked),2015,2093,2369,276,13.186813186813186
Mumbai,Carrot,2016,668,944,276,41.31736526946108
Gevrai,Bajri,2015,1096,1372,276,25.182481751824817
Hanegaon,Green Gram,2016,4712,4988,276,5.857385398981324
Beed,BAJRI,2016,1359,1635,276,20.309050772626932
Kamthi,Brinjal,2016,190,466,276,145.26315789473685
Kalyan,Carrot,2016,1052,1328,276,26.23574144486692
Shahada,Maize,2016,920,1196,276,30.0
Mahagaon,Wheat(Husked),2016,1567,1843,276,17.61327377153797
Pune-Pimpri,Coriander  ,2016,327,603,276,84.40366972477064
Manwat,Sorgum(Jawar),2016,1678,1954,276,16.448152562574492
Manwat,Pigeon Pea (Tur),2016,8400,8676,276,3.2857142857142856
Devala,Bajri,2016,1581,1857,276,17.4573055028463
Washim,Soybean,2015,3296,3572,276,8.37378640776699
Kille Dharur,Soybean,2016,2596,2872,276,10.631741140215716
Sangrampur,Green Gram,2015,6900,7176,276,4.0
Majalgaon,Soybean,2014,2978,3254,276,9.267965077233042
Kalmeshwar,Bitter Gourd,2015,2744,3020,276,10.058309037900875
Beed,Sorgum(Jawar),2016,1670,1946,276,16.526946107784433
Ramtek,Tomato,2015,1086,1362,276,25.414364640883978
Kille Dharur,Soybean,2015,3265,3541,276,8.453292496171516
Shevgaon,Bajri,2016,1556,1832,276,17.737789203084834
Chandrapur-Ganjwad,CABBAGE,2016,316,592,276,87.34177215189874
Malegaon,Ground Nut Pods (Dry),2014,4100,4376,276,6.7317073170731705
Amalner,Sorgum(Jawar),2014,1300,1576,276,21.23076923076923
Amalner,Sorgum(Jawar),2015,1200,1476,276,23.0
Phaltan,Jaggery,2014,2913,3189,276,9.474768280123584
Sindi,SOYBEAN,2016,2583,2858,275,10.646535036778939
Dondaicha,Wheat(Husked),2014,1401,1676,275,19.628836545324766
Amarawati,Lemon,2015,1825,2100,275,15.068493150684931
Shrirampur,Carrot,2015,950,1225,275,28.94736842105263
Barshi,Green Gram,2015,6600,6875,275,4.166666666666667
Balapur,Soybean,2016,3400,3675,275,8.088235294117647
Kalyan,Wheat(Husked),2016,2075,2350,275,13.25301204819277
Tumsar,Black Gram,2014,3500,3775,275,7.857142857142857
Rahuri-Vambori,Gram,2015,4259,4534,275,6.456914768725053
Kalamb (Os),Sorgum(Jawar),2015,2075,2350,275,13.25301204819277
Sindi,Wheat(Husked),2015,1336,1611,275,20.58383233532934
Kalyan,Wheat(Husked),2016,2013,2288,275,13.66120218579235
Kalvan,Bajri,2016,1377,1652,275,19.970951343500364
Shrigonda,Sunflower,2016,3983,4258,275,6.904343459703741
Jawala-Bajar,Ground Nut Pods (Dry),2015,5175,5450,275,5.314009661835748
Sangamner,Gram,2015,4142,4417,275,6.6393046837276675
Gangapur,Sorgum(Jawar),2015,1417,1692,275,19.407198306280875
Kalmeshwar,Green Chilli,2015,2084,2359,275,13.195777351247601
Jintur,Cotton,2016,4217,4492,275,6.52122361868627
Solapur,Banana,2015,277,552,275,99.27797833935018
Vai,Brinjal,2015,1085,1360,275,25.34562211981567
Balapur,Wheat(Husked),2016,1550,1825,275,17.741935483870968
Amarawati,Dhemse,2016,2633,2908,275,10.444360045575388
Ramtek,Cabbage,2015,975,1250,275,28.205128205128204
Amarawati-Fruit And Vegetables,CORIANDER ,2016,1490,1765,275,18.456375838926174
Nandura,Wheat(Husked),2015,1434,1709,275,19.17712691771269
Dudhani,Black Gram,2015,9782,10057,275,2.811286035575547
Mumbai,Sweet Potato,2015,881,1156,275,31.214528944381385
Vai,Bottle Gourd,2016,1292,1567,275,21.28482972136223
Amarawati,Gram,2015,3500,3775,275,7.857142857142857
Shrirampur,Sorgum(Jawar),2014,1456,1731,275,18.88736263736264
Devala,Bajri,2016,1432,1707,275,19.20391061452514
Balapur,Wheat(Husked),2016,1475,1750,275,18.64406779661017
Ramtek,Orange,2016,725,1000,275,37.93103448275862
Amarawati,Bajri,2015,1788,2063,275,15.380313199105146
Pathardi,Gram,2015,3119,3394,275,8.816928502725233
Amalner,Black Gram,2016,9525,9800,275,2.8871391076115485
Amalner,BAJRI,2016,1160,1435,275,23.70689655172414
Nandura,Sesamum,2015,7000,7275,275,3.9285714285714284
Shrirampur,Brinjal,2015,904,1179,275,30.420353982300885
Dound,Green Gram,2016,4767,5042,275,5.768827354730439
Vaduj,Ghevda Seed,2014,5875,6150,275,4.680851063829787
Koregaon,Onion,2015,750,1025,275,36.666666666666664
Anajngaon Surji,Wheat(Husked),2015,1407,1682,275,19.545131485429994
Pune-Moshi,Chavli (Shenga ),2016,2246,2521,275,12.243989314336599
Shahada,Sorgum(Jawar),2015,1327,1602,275,20.723436322532027
Nandgaon,Wheat(Husked),2016,1921,2196,275,14.315460697553357
Khed-Chakan,Onion,2016,486,761,275,56.584362139917694
Achalpur,Green Gram,2015,5275,5550,275,5.213270142180095
Panvel,Ghevda,2016,1825,2100,275,15.068493150684931
Bhiwapur,Coriander (Dry),2016,6250,6525,275,4.4
Jalgaon Jamod-Aasalgaon,Soybean,2015,3488,3763,275,7.884174311926605
Jalna-Badnapur,Green Gram,2016,4500,4775,275,6.111111111111111
Tasgaon,Gram,2015,4000,4275,275,6.875
Panvel,Ladies Finger,2016,3800,4075,275,7.2368421052631575
Panvel,Ladies Finger,2016,2125,2400,275,12.941176470588236
Barshi,Shepu,2016,300,575,275,91.66666666666667
Malkapur,Bajri,2016,1200,1475,275,22.916666666666668
Nagpur,Sorgum(Jawar),2015,1575,1850,275,17.46031746031746
Koregaon,Sorgum(Jawar),2015,1725,2000,275,15.942028985507246
Ahmednagar,Soybean,2015,3200,3475,275,8.59375
Panvel,Flower,2016,1275,1550,275,21.568627450980394
Pandharpur,Cabbage,2015,258,533,275,106.5891472868217
Akola,Sorgum(Jawar),2015,1321,1596,275,20.81756245268736
Kopargaon,Wheat(Husked),2015,1525,1800,275,18.0327868852459
Lonar,Black Gram,2016,4808,5083,275,5.71963394342762
Shrirampur,Green Chilli,2016,905,1180,275,30.386740331491712
Solapur,Guava,2015,1275,1550,275,21.568627450980394
Jalna,Neem-Seed,2015,509,784,275,54.02750491159136
Nashik-Devlali,SPINACH,2016,165,440,275,166.66666666666666
Ausa,Black Gram,2014,5226,5501,275,5.262150784538845
Nagpur,Papai,2016,525,800,275,52.38095238095238
Lonand,Gram,2015,3488,3763,275,7.884174311926605
Yawal,Bajri,2015,1000,1275,275,27.5
Bhokar,Sesamum,2014,9654,9929,275,2.8485601823078515
Patur,Pigeon Pea (Tur),2016,6450,6725,275,4.263565891472868
Rahata,Cucumber,2015,1125,1400,275,24.444444444444443
Panvel,Ridge Gourd,2015,2900,3175,275,9.482758620689655
Kille Dharur,Sorgum(Jawar),2016,1785,2060,275,15.406162464985995
Rahata,Ladies Finger,2014,1738,2013,275,15.822784810126583
Chandrapur-Ganjwad,Chavli (Pala),2015,475,750,275,57.89473684210526
Chalisgaon,Tomato,2016,675,950,275,40.74074074074074
Sailu,Sorgum(Jawar),2015,1303,1578,275,21.10514198004605
Washim-Ansing,Gram,2016,8675,8950,275,3.170028818443804
Hadgaon-Tamsa,Gram,2016,3969,4244,275,6.928697404887881
Bhivandi,Potato,2016,1097,1372,275,25.068368277119415
Nagpur,Small Gourd,2016,1406,1681,275,19.559032716927454
Mangrulpeer,Soybean,2016,3440,3715,275,7.994186046511628
Ulhasnagar,Sugarcane,2016,296,571,275,92.9054054054054
Akole,Soybean,2016,3250,3525,275,8.461538461538462
Shahapur,Brinjal,2015,950,1225,275,28.94736842105263
Ulhasnagar,Banana,2016,300,575,275,91.66666666666667
Buldhana,Maize,2016,1125,1400,275,24.444444444444443
Aurangabad,Awala,2014,713,988,275,38.569424964936886
Atpadi,Cotton,2015,4075,4350,275,6.748466257668712
Jalgaon,Potato,2015,455,730,275,60.43956043956044
Lasalgaon,Maize,2015,1213,1488,275,22.67106347897774
Shirpur,Black Gram,2014,6009,6284,275,4.576468630387752
Kurdwadi-Modnimb,Wheat(Husked),2016,1699,1974,275,16.18599175985874
Nagpur,Wheat(Husked),2016,1838,2113,275,14.961915125136018
Nagpur,Wheat(Husked),2016,1809,2084,275,15.201768933112216
Ghoti,Cabbage,2015,1300,1575,275,21.153846153846153
Satara,Cabbage,2015,725,1000,275,37.93103448275862
Jamkhed,Bajri,2016,1532,1807,275,17.950391644908617
Buldhana,Sorgum(Jawar),2016,1294,1569,275,21.25193199381762
Nagpur,Rice(Paddy-Hus),2016,2500,2775,275,11.0
Nanded,Green Gram,2015,7254,7529,275,3.7910118555279846
Koregaon,Wheat(Husked),2015,1600,1875,275,17.1875
Koregaon,Ghevda Seed,2016,4000,4275,275,6.875
Ghoti,Flower,2014,1153,1428,275,23.850823937554207
Shrirampur,Water Melon,2016,800,1075,275,34.375
Pathari,Sorgum(Jawar),2015,1600,1875,275,17.1875
Nagpur,SMALL GOURD,2016,894,1169,275,30.76062639821029
Nagpur,Beet Root,2015,538,813,275,51.11524163568773
Ahmednagar,Maize,2016,1776,2051,275,15.484234234234235
Yawal,Maize,2016,1000,1275,275,27.5
Sangamner,Wheat(Husked),2016,1635,1909,274,16.75840978593272
Vai,Cucumber,2015,1138,1412,274,24.077328646748683
Jalna,Bajri,2015,1057,1331,274,25.922421948912014
Shevgaon-Bodhegaon,Sorgum(Jawar),2014,1462,1736,274,18.741450068399452
Chandrapur,Pigeon Pea (Tur),2015,6350,6624,274,4.31496062992126
Kalmeshwar,Flower,2016,961,1235,274,28.51196670135276
Rahuri,POTATO,2016,1205,1479,274,22.738589211618258
Nagpur,Beet Root,2016,939,1213,274,29.179978700745473
Nilanga,Gram,2014,2426,2700,274,11.294311624072547
Kurdwadi,Wheat(Husked),2016,1526,1800,274,17.955439056356486
Vaijapur,Soybean,2016,2496,2770,274,10.977564102564102
Kalmeshwar,Flower,2016,1026,1300,274,26.705653021442494
Kopargaon,BAJRI,2016,1138,1412,274,24.077328646748683
Chalisgaon,Wheat(Husked),2015,1570,1844,274,17.452229299363058
Wardha,Cotton,2016,4240,4514,274,6.462264150943396
Latur,Safflower,2016,2525,2799,274,10.851485148514852
Nagpur,Papai,2015,483,757,274,56.7287784679089
Beed,Bajri,2015,1415,1689,274,19.363957597173144
Chopda,Gram,2015,3119,3393,274,8.784866944533505
Sangamner,Gram,2014,2176,2450,274,12.591911764705882
Mumbai,Bottle Gourd,2015,1163,1437,274,23.5597592433362
Nagpur,Tomato,2016,574,848,274,47.73519163763066
Amarawati,Papai,2016,705,979,274,38.86524822695036
Nandurbar,Maize,2015,1286,1560,274,21.30637636080871
Barshi,Wheat(Husked),2015,1615,1889,274,16.96594427244582
Aarni,Soybean,2015,2963,3237,274,9.247384407694904
Malegaon,Horse Gram,2016,3743,4017,274,7.320331285065455
Akole,Tomato,2014,137,411,274,200.0
Gevrai,Wheat(Husked),2014,1439,1713,274,19.041000694927032
Solapur,Cabbage,2016,300,574,274,91.33333333333333
Nagpur,Brinjal,2014,1088,1362,274,25.183823529411764
Manchar,Small Gourd,2015,843,1117,274,32.50296559905101
Khed (Shel Pimpalgaon),Ladies Finger,2016,2506,2780,274,10.933758978451715
Nandurbar,Bajri,2015,1034,1308,274,26.499032882011605
Karanja,Soybean,2015,2990,3264,274,9.163879598662207
Kannad,Bajri,2016,1597,1871,274,17.1571696931747
Dondaicha,Wheat(Husked),2014,1476,1750,274,18.56368563685637
Tumsar,Green Gram,2014,5448,5722,274,5.0293685756240825
Shirpur,Wheat(Husked),2016,1671,1945,274,16.39736684619988
Patur,Pigeon Pea (Tur),2016,8526,8800,274,3.2136992728125735
Ramtek,Green Chilli,2015,896,1170,274,30.580357142857142
Nampur,Green Gram,2016,4439,4713,274,6.172561387699933
Jalna,Green Gram,2015,6550,6824,274,4.183206106870229
Mandhal,Pigeon Pea (Tur),2016,7052,7326,274,3.8854225751559843
Nagpur,Jack Fruit,2016,1304,1578,274,21.012269938650306
Jamner-Neri,Cotton,2014,3776,4050,274,7.25635593220339
Pune-Pimpri,Cabbage,2016,800,1074,274,34.25
Navapur,TOMATO,2016,611,884,273,44.680851063829785
Rahuri-Vambori,Sorgum(Jawar),2016,1400,1673,273,19.5
Naigaon,Soybean,2015,3020,3293,273,9.039735099337749
Rahata,Bitter Gourd,2016,5500,5773,273,4.963636363636364
Kalmeshwar,Methi (Bhaji),2016,1251,1524,273,21.822541966426858
Nagpur,Bitter Gourd,2015,2269,2542,273,12.031732040546496
Vai,Tomato,2015,1195,1468,273,22.84518828451883
Kalmeshwar,Chavli (Shenga ),2016,877,1150,273,31.12884834663626
Pune-Manjri,GREEN-PEAS,2016,6227,6500,273,4.384133611691023
Dhule,Jaggery,2016,1900,2173,273,14.368421052631579
Indapur,Jaggery,2015,1989,2262,273,13.72549019607843
Pusad,Green Gram,2016,5321,5594,273,5.130614546137944
Mangrulpeer,Gram,2014,2232,2505,273,12.231182795698924
Pune,Bajri,2016,2120,2393,273,12.877358490566039
Mukhed,Green Gram,2015,8177,8450,273,3.338632750397456
Kalyan,CARROT,2016,1327,1600,273,20.572720422004522
Shevgaon,Bajri,2015,1190,1463,273,22.941176470588236
Washim,Sorgum(Jawar),2016,1192,1465,273,22.90268456375839
Chalisgaon,Bajri,2015,1308,1581,273,20.871559633027523
Jintur,Green Gram,2014,6877,7150,273,3.9697542533081287
Kolhapur-Laxmipuri,Split Gram,2016,5958,6231,273,4.582074521651561
Manchar,Shepu,2015,1414,1687,273,19.306930693069308
Kolhapur-Laxmipuri,Split Lentil,2016,6692,6965,273,4.079497907949791
Amalner,Green Gram,2016,5134,5407,273,5.3174912349045576
Bhokar,Gram,2015,3092,3365,273,8.829236739974126
Kopargaon,Soybean,2014,3016,3289,273,9.051724137931034
Mumbai,Potato,2015,907,1180,273,30.09922822491731
Vai,Cucumber,2015,1054,1327,273,25.901328273244783
Nagpur,Ladies Finger,2014,1100,1373,273,24.818181818181817
Satara,Tomato,2016,885,1158,273,30.847457627118644
Chopda,Sorgum(Jawar),2014,1328,1601,273,20.55722891566265
Nandura,Maize,2016,1126,1399,273,24.24511545293073
Aurangabad,Bitter Gourd,2015,877,1150,273,31.12884834663626
Yeola,Wheat(Husked),2015,1413,1686,273,19.32059447983015
Pombhurni,Paddy-Unhusked,2016,2034,2307,273,13.421828908554572
Ahmedpur,Gram,2015,3492,3765,273,7.81786941580756
Malegaon (Washim),Gram,2016,4096,4369,273,6.6650390625
Ashti-Karanja,Soybean,2015,3344,3617,273,8.163875598086124
Shrirampur,Sorgum(Jawar),2016,1496,1769,273,18.24866310160428
Nagpur,Sweet Potato,2016,709,982,273,38.5049365303244
Sakri,MAIZE,2016,871,1143,272,31.228473019517796
Kalmeshwar,Tomato,2016,701,973,272,38.80171184022824
Junnar-Otur,CABBAGE,2016,197,469,272,138.0710659898477
Nagpur,Tomato,2016,1128,1400,272,24.113475177304963
Hingoli,Soybean,2016,3066,3338,272,8.871493803000652
Pusad,Sorgum(Jawar),2014,1235,1507,272,22.024291497975707
Lasalgaon-Vinchur,Sorgum(Jawar),2016,1212,1484,272,22.442244224422442
Sangamner,Wheat(Husked),2015,1598,1870,272,17.02127659574468
Pune-Pimpri,Cucumber,2014,1281,1553,272,21.233411397345822
Nagpur,Parwar,2016,1121,1393,272,24.264049955396967
Achalpur,Gram,2016,3994,4266,272,6.810215322984477
Pune-Pimpri,Wal Papdi,2015,2371,2643,272,11.471952762547449
Kalamb (Os),Coriander (Dry),2014,8420,8692,272,3.2304038004750595
Kalmeshwar,Pumpkin,2015,1007,1279,272,27.010923535253227
Kalmeshwar,Tomato,2015,980,1252,272,27.755102040816325
Kalamb (Yawatmal),Soybean,2016,3463,3735,272,7.854461449610165
Nagpur,Flower,2016,1312,1584,272,20.73170731707317
Malegaon (Washim),Green Gram,2016,4669,4941,272,5.825658599271793
Pimpalgaon Basawant,Tomato,2016,263,535,272,103.42205323193916
Aarni,Soybean,2015,3015,3287,272,9.02155887230514
Kalamb (Os),Sorgum(Jawar),2016,1558,1830,272,17.458279845956355
Kalamb (Os),Sorgum(Jawar),2016,1486,1758,272,18.304172274562585
Dondaicha,Bajri,2016,1407,1679,272,19.3319118692253
Bhivandi,Rice(Paddy-Hus),2015,2024,2296,272,13.438735177865613
Kada,Wheat(Husked),2015,1510,1782,272,18.013245033112582
Phaltan,Maize,2016,1597,1869,272,17.031934877896056
Akluj,Water Melon,2016,271,543,272,100.3690036900369
Kolhapur,Sweet Potato,2015,657,929,272,41.400304414003045
Katol,Orange,2014,722,994,272,37.67313019390582
Anajngaon Surji,Sorgum(Jawar),2016,1228,1500,272,22.149837133550488
Mumbai,Ridge Gourd,2014,1692,1964,272,16.07565011820331
Kille Dharur,Sorgum(Jawar),2015,1929,2201,272,14.100570243649559
Vaijapur,Green Gram,2016,4913,5185,272,5.536332179930795
Rahata,Cabbage,2016,507,779,272,53.64891518737672
Morshi,SOYBEAN,2016,2571,2843,272,10.57954103461688
Rahata,Bitter Gourd,2015,2571,2843,272,10.57954103461688
Manmad,Gram,2016,4454,4726,272,6.106870229007634
Jintur-Bori,Gram,2016,3955,4227,272,6.8773704171934265
Nandura,Maize,2014,1032,1304,272,26.356589147286822
Mumbai,Flower,2014,1160,1432,272,23.448275862068964
Sangli-Phale Bhajipalam,Water Melon,2015,85,357,272,320.0
Akola,Wheat(Husked),2015,1435,1707,272,18.954703832752614
Jalna,Soybean,2015,3321,3593,272,8.190304125263475
Chandur Bajar,Wheat(Husked),2016,1403,1675,272,19.38702779757662
Mul,Paddy-Unhusked,2015,2096,2368,272,12.977099236641221
Panvel,Brinjal,2016,3371,3643,272,8.068822307920499
Buldhana-Dhad,Maize,2016,1127,1399,272,24.134871339840284
Sonpeth,Soybean,2015,3530,3801,271,7.6770538243626065
Murtizapur,Gram,2016,4062,4333,271,6.671590349581487
Nandura,Bajri,2016,1540,1811,271,17.5974025974026
Chandrapur-Ganjwad,Spinach,2014,659,930,271,41.122913505311075
Khed (Shel Pimpalgaon),Green Chilli,2016,754,1025,271,35.94164456233422
Shirpur,Black Gram,2015,5279,5550,271,5.13354802045842
Kopargaon,Soybean,2015,3186,3457,271,8.505963590709353
Anajngaon Surji,Wheat(Husked),2015,1529,1800,271,17.724002616088946
Shrirampur,Ground Nut Pods (Dry),2015,2300,2571,271,11.782608695652174
Kalmeshwar,Brinjal,2015,1082,1353,271,25.046210720887245
Umarkhed,Soybean,2015,2929,3200,271,9.252304540798907
Nira,Jaggery,2015,2795,3066,271,9.695885509838998
Mehkar,Soybean,2016,3266,3537,271,8.297611757501532
Lasalgaon,Bajri,2015,1317,1588,271,20.577069096431284
Nagpur,Jack Fruit,2016,967,1238,271,28.024819027921406
Kalyan,Bottle Gourd,2016,1481,1752,271,18.298446995273466
Sonpeth,Sorgum(Jawar),2016,1579,1850,271,17.162761241291957
Kille Dharur,Soybean,2015,2993,3264,271,9.054460407617775
Chandrapur,Gram,2016,5550,5821,271,4.882882882882883
Tiwasa,COTTON,2016,4700,4971,271,5.76595744680851
Malegaon,Wheat(Husked),2015,1451,1722,271,18.676774638180564
Taloda,Maize,2015,916,1187,271,29.58515283842795
Vai,Cucumber,2015,1358,1629,271,19.95581737849779
Jintur,Pigeon Pea (Tur),2016,8176,8447,271,3.314579256360078
Amarawati,Onion,2016,254,525,271,106.69291338582677
Vai,Cucumber,2014,1100,1371,271,24.636363636363637
Chopda,Soybean,2014,2991,3262,271,9.060514877967234
Mumbai,Bottle Gourd,2015,694,965,271,39.04899135446686
Manchar,Shepu,2014,491,762,271,55.193482688391036
Nagpur,Beet Root,2016,717,988,271,37.79637377963738
Nagpur,Rice(Paddy-Hus),2014,3557,3828,271,7.618779870677537
Nagpur,Rice(Paddy-Hus),2015,2491,2762,271,10.879164993978321
Chimur,Pigeon Pea (Tur),2016,7641,7912,271,3.5466561968328754
Shirpur,Soybean,2015,2937,3208,271,9.227102485529452
Ahmedpur,Maize,2015,1500,1771,271,18.066666666666666
Jalgaon Jamod,Soybean,2015,3100,3371,271,8.741935483870968
Buldhana,SORGUM(JAWAR),2016,1200,1471,271,22.583333333333332
Barshi,Fodder,2015,571,842,271,47.46059544658494
Karanja,Ground Nut Pods (Dry),2014,3578,3849,271,7.5740637227501395
Kalmeshwar,Ladies Finger,2016,2412,2683,271,11.235489220563847
Mumbai,Cucumber,2016,483,754,271,56.107660455486545
Nashik,Mint,2014,186,457,271,145.69892473118279
Pachora,Maize,2015,1144,1415,271,23.68881118881119
Mumbai,Cucumber,2015,884,1155,271,30.65610859728507
Mumbai,Cucumber,2015,1075,1346,271,25.209302325581394
Sillod,Bajri,2015,1021,1292,271,26.542605288932418
Nagpur,Cabbage,2015,483,754,271,56.107660455486545
Karad,Flower,2015,580,850,270,46.55172413793103
Anajngaon Surji,Sorgum(Jawar),2015,1260,1530,270,21.428571428571427
Sangrampur-Varvatbakal,Wheat(Husked),2016,1255,1525,270,21.51394422310757
Mandhal,Soybean,2015,3557,3827,270,7.590666291818948
Karanja,Soybean,2015,3374,3644,270,8.002371072910492
Amarawati,Cluster Bean,2016,2610,2880,270,10.344827586206897
Savner,Soybean,2016,3179,3449,270,8.49323686693929
Umari,Gram,2016,3979,4249,270,6.785624528776075
Kalyan,Green-Peas,2016,2242,2512,270,12.042818911685995
Aarni,Ground Nut Pods (Dry),2014,3694,3964,270,7.309149972929074
Gangakhed,Soybean,2016,3661,3931,270,7.375034143676591
Amarawati,Potato,2016,667,937,270,40.47976011994003
Sengaon,Gram,2016,5249,5519,270,5.143836921318346
Sengaon,Gram,2016,4028,4298,270,6.7030784508440915
Baramati,Maize,2015,1521,1791,270,17.75147928994083
Gangakhed,Cotton,2015,4100,4370,270,6.585365853658536
Umarkhed-Danki,Pigeon Pea (Tur),2016,7100,7370,270,3.8028169014084505
Sonpeth,Pigeon Pea (Tur),2014,4050,4320,270,6.666666666666667
Bhandara,RICE(PADDY-HUS),2016,2790,3060,270,9.67741935483871
Osmanabad,Soybean,2014,2730,3000,270,9.89010989010989
Kalamb (Yawatmal),Soybean,2016,3440,3710,270,7.848837209302325
Washim,Soybean,2016,3738,4008,270,7.223113964686998
Gadhinglaj,Jaggery,2015,2008,2278,270,13.44621513944223
Sangamner,Bajri,2015,1359,1629,270,19.867549668874172
Umarga,BAJRI,2016,1087,1357,270,24.83900643974241
Indapur,Bajri,2015,1165,1435,270,23.175965665236053
Pathardi,Cotton,2014,3752,4022,270,7.196162046908316
Patur,Sorgum(Jawar),2016,1505,1775,270,17.940199335548172
Jalgaon,Jaggery,2016,2733,3003,270,9.879253567508233
Mangalwedha,Wheat(Husked),2016,2020,2290,270,13.366336633663366
Vadgaon Peth,Cabbage,2015,570,840,270,47.36842105263158
Solapur,Banana,2015,519,789,270,52.02312138728324
Pombhurni,Cotton,2015,3481,3751,270,7.756391841424878
Ghatanji,Pigeon Pea (Tur),2015,5451,5721,270,4.953219592735278
Kopargaon,Wheat(Husked),2016,1657,1927,270,16.294508147254074
Murtizapur,Soybean,2016,3562,3832,270,7.580011229646266
Koregaon,Sorgum(Jawar),2015,1600,1870,270,16.875
Patan,Tomato,2015,1089,1359,270,24.793388429752067
Lasur Station,Bajri,2015,1138,1408,270,23.725834797891036
Shirpur,Wheat(Husked),2015,1410,1680,270,19.148936170212767
Nanded,Pigeon Pea (Tur),2016,5860,6130,270,4.607508532423208
Latur,Soybean,2016,3251,3521,270,8.305136880959704
Dound,Gram,2016,4070,4340,270,6.6339066339066335
Kalmeshwar,Spinach,2016,1426,1696,270,18.93408134642356
Ramtek,Cluster Bean,2016,1610,1880,270,16.770186335403725
Ulhasnagar,Banana,2016,300,570,270,90.0
Sakri,WHEAT(HUSKED),2016,1467,1737,270,18.404907975460123
Varud-Rajura Bazar,Soybean,2016,3171,3441,270,8.514664143803216
Patan,Brinjal,2015,970,1240,270,27.835051546391753
Yawal,Sorgum(Jawar),2016,1113,1383,270,24.258760107816713
Lasalgaon,Bajri,2015,1286,1556,270,20.995334370139968
Latur,Soybean,2016,3868,4138,270,6.980351602895554
Kolhapur,Snake Gourd,2015,240,510,270,112.5
Kopargaon,Soybean,2016,2576,2846,270,10.48136645962733
Washim,Wheat(Husked),2015,1339,1609,270,20.164301717699775
Amarawati,Wheat(Husked),2015,1586,1856,270,17.023959646910466
Pombhurni,Paddy-Unhusked,2016,2030,2300,270,13.300492610837438
Kolhapur,Maize(Corn.),2015,780,1050,270,34.61538461538461
Raver,WHEAT(HUSKED),2016,1832,2102,270,14.737991266375547
Murtizapur,Pigeon Pea (Tur),2015,8840,9110,270,3.0542986425339365
Devala,Green Gram,2016,5987,6257,270,4.509771170870219
Kada,Sunflower,2015,3201,3471,270,8.434864104967199
Pune-Pimpri,Beet Root,2015,1930,2200,270,13.989637305699482
Mandhal,Pigeon Pea (Tur),2016,7055,7325,270,3.8270729978738482
Mantha,Soybean,2014,3014,3284,270,8.95819508958195
Chandrapur-Ganjwad,Cabbage,2014,238,508,270,113.4453781512605
Amalner,Soybean,2016,3200,3470,270,8.4375
Mumbai,Sweet Potato,2015,850,1120,270,31.764705882352942
Bhokar,Soybean,2015,3426,3695,269,7.851722124927028
Umared,Sunflower,2016,3138,3407,269,8.572339069471
Amarawati,Melon,2016,675,944,269,39.851851851851855
Kurdwadi-Modnimb,Bajri,2016,1207,1476,269,22.286661143330573
Rahuri-Vambori,Wheat(Husked),2014,1487,1756,269,18.09011432414257
Mumbai,Elephant Root,2015,2108,2377,269,12.76091081593928
Majalgaon,Bajri,2015,1314,1583,269,20.47184170471842
Bhokar,Wheat(Husked),2015,1350,1619,269,19.925925925925927
Malegaon,Maize,2014,1250,1519,269,21.52
Kalmeshwar,SOYBEAN,2016,2610,2879,269,10.306513409961687
Karad,Carrot,2016,795,1064,269,33.83647798742138
Dondaicha,Maize,2016,1152,1421,269,23.350694444444443
Dondaicha,Maize,2014,1175,1444,269,22.893617021276597
Karad,Bottle Gourd,2016,495,764,269,54.343434343434346
Varud-Rajura Bazar,Soybean,2015,2978,3247,269,9.0329079919409
Manchar,Kanda Pat,2014,408,677,269,65.93137254901961
Tumsar,Linseed,2015,3599,3868,269,7.47429841622673
Pune-Pimpri,Ridge Gourd,2015,3794,4063,269,7.090142329994729
Baramati,Maize,2016,1665,1934,269,16.156156156156158
Kopargaon,SORGUM(JAWAR),2016,1798,2067,269,14.961067853170189
Solapur,Grapes,2015,149,418,269,180.53691275167785
Mumbai,Tomato,2015,1196,1465,269,22.49163879598662
Kalyan,Elephant Root,2015,2108,2377,269,12.76091081593928
Sengaon,Pigeon Pea (Tur),2016,8681,8950,269,3.098721345467112
Mangalwedha,WHEAT(UNHUSKED),2016,2890,3159,269,9.30795847750865
Patur,Soybean,2016,3406,3675,269,7.897827363476218
Vai,Cucumber,2015,1044,1313,269,25.766283524904214
Paithan,Green Gram,2016,3927,4196,269,6.850012732365673
Kannad,BAJRI,2016,1333,1602,269,20.180045011252812
Mumbai,Cabbage,2016,719,988,269,37.41307371349096
Lasur Station,Wheat(Husked),2014,1490,1759,269,18.053691275167786
Kalmeshwar,LADIES FINGER,2016,1008,1277,269,26.686507936507937
Mumbai,Capsicum,2016,908,1177,269,29.625550660792953
Kalvan,Wheat(Husked),2016,1528,1797,269,17.604712041884817
Patur,Wheat(Husked),2016,1617,1886,269,16.63574520717378
Amarawati-Fruit And Vegetables,Onion,2016,206,475,269,130.58252427184465
Jalkot,Green Gram,2016,4700,4969,269,5.723404255319149
Vai,Bottle Gourd,2014,1070,1339,269,25.14018691588785
Nandura,Onion,2016,233,502,269,115.45064377682404
Palghar(Bevur),Wheat(Husked),2016,2024,2293,269,13.290513833992096
Dound,Gram,2015,2589,2858,269,10.390112012359985
Nandura,Maize,2016,1393,1662,269,19.310839913854988
Aurangabad,Bajri,2014,1268,1537,269,21.214511041009462
Nagbhid,Paddy-Unhusked,2015,1767,2036,269,15.22354272778721
Nandura,Sorgum(Jawar),2014,1151,1420,269,23.370981754995658
Nandura,Wheat(Husked),2015,1327,1596,269,20.27128862094951
Nagpur,Bitter Gourd,2014,2669,2938,269,10.078681153990258
Aurangabad,Cabbage,2015,570,839,269,47.19298245614035
Nagpur,WHEAT(HUSKED),2016,2016,2285,269,13.343253968253968
Nandura,Maize,2015,1029,1298,269,26.141885325558796
Jintur,Soybean,2015,3370,3639,269,7.982195845697329
Sailu,Sorgum(Jawar),2016,1675,1944,269,16.059701492537314
Amarawati-Fruit And Vegetables,Carrot,2016,2919,3188,269,9.215484755053101
Mumbai,Bottle Gourd,2014,1164,1432,268,23.02405498281787
Umared,Soybean,2015,2900,3168,268,9.241379310344827
Parbhani,Wheat(Husked),2015,1470,1738,268,18.231292517006803
Hingoli,Sorgum(Jawar),2015,1274,1542,268,21.036106750392463
Mumbai-Onion And Potato Mkt,Potato,2016,1159,1427,268,23.123382226056947
Nagpur,Carrot,2014,1564,1832,268,17.135549872122763
Telhara,Green Gram,2014,7492,7760,268,3.5771489588894823
Kalmeshwar,Tomato,2016,947,1215,268,28.299894403379092
Nagpur,Bottle Gourd,2016,668,936,268,40.119760479041915
Nagpur,Raddish,2016,1077,1345,268,24.88393686165274
Pune-Pimpri,Cucumber,2016,1184,1452,268,22.635135135135137
Dhule,Bajri,2015,1073,1341,268,24.976700838769805
Pune,SORGUM(JAWAR),2016,2804,3072,268,9.557774607703282
Sangali,Wheat(Unhusked),2016,3013,3281,268,8.894789246598075
Varora,Cotton,2015,4021,4289,268,6.665008704302412
Nagpur,Tomato,2015,602,870,268,44.51827242524917
Nanded,Ground Nut Pods (Dry),2015,5148,5416,268,5.205905205905206
Akola,Wheat(Husked),2015,1533,1801,268,17.482061317677758
Sangrampur-Varvatbakal,Wheat(Husked),2015,1242,1510,268,21.578099838969404
Barshi,Kharbuj,2016,415,683,268,64.57831325301204
Jintur,Turmeric,2016,8098,8366,268,3.309459125710052
Aurangabad,Bottle Gourd,2016,453,721,268,59.16114790286976
Shrirampur,Bajri,2016,1227,1495,268,21.841890790546046
Rahuri-Vambori,Green Gram,2015,8285,8553,268,3.2347616173808085
Pusad,Wheat(Husked),2015,1449,1717,268,18.49551414768806
Pandharpur,Banana,2016,791,1059,268,33.881163084702905
Manora,Pigeon Pea (Tur),2016,8316,8584,268,3.2227032227032226
Kalmeshwar,Walvad,2015,2836,3104,268,9.449929478138223
Raver,Maize,2015,1031,1299,268,25.994180407371484
Vai,Flower,2015,1032,1300,268,25.968992248062015
Bhivandi,Onion,2016,903,1171,268,29.678848283499445
Chikhali,Sorgum(Jawar),2016,1277,1545,268,20.986687548942836
Nagpur,Rice(Paddy-Hus),2016,2529,2797,268,10.597073942269672
Kalmeshwar,Green Chilli,2015,2974,3242,268,9.011432414256893
Shirpur,Maize,2016,1448,1716,268,18.50828729281768
Patan,Flower,2016,1200,1468,268,22.333333333333332
Kurdwadi,Maize,2014,1062,1330,268,25.235404896421844
Loha,Pigeon Pea (Tur),2016,6061,6329,268,4.421712588681736
Ahmednagar,Gram,2015,4164,4432,268,6.43611911623439
Umared,Linseed,2016,5935,6203,268,4.5155855096882895
Kalyan,Cucumber,2016,1688,1956,268,15.876777251184834
Kalmeshwar,Ladies Finger,2016,2384,2652,268,11.241610738255034
Khed-Chakan,Bottle Gourd,2015,795,1063,268,33.710691823899374
Amarawati,Wheat(Husked),2016,1795,2062,267,14.874651810584957
Atpadi,Bajri,2016,1733,2000,267,15.406809001731101
Ghansawangi,Gram,2016,4100,4367,267,6.512195121951219
Achalpur,Gram,2014,2400,2667,267,11.125
Karad,Flower,2015,300,567,267,89.0
Shirur,GREEN GRAM,2016,4285,4552,267,6.231038506417736
Kalmeshwar,Methi (Bhaji),2016,2200,2467,267,12.136363636363637
Mangalwedha,Wheat(Unhusked),2014,2560,2827,267,10.4296875
Mehkar,Soybean,2015,3133,3400,267,8.522183210979891
Hadgaon,Sorgum(Jawar),2015,1333,1600,267,20.03000750187547
Amarawati,Lemon,2015,2033,2300,267,13.133300541072307
Aurangabad,Papai,2015,933,1200,267,28.617363344051448
Karad,Cucumber,2015,933,1200,267,28.617363344051448
Shevgaon,Gram,2015,3423,3690,267,7.800175284837861
Pathardi,Sorgum(Jawar),2016,1594,1861,267,16.750313676286073
Yawal,SORGUM(JAWAR),2016,1080,1347,267,24.72222222222222
Amarawati,Coriander  ,2015,1622,1889,267,16.461159062885326
Nagpur,Rice(Paddy-Hus),2016,2498,2765,267,10.688550840672539
Pune-Pimpri,Cucumber,2015,1533,1800,267,17.416829745596868
Taloda,Sorgum(Jawar),2015,1109,1376,267,24.075743913435527
Patan,Cabbage,2015,994,1261,267,26.861167002012074
Kalmeshwar,Flower,2016,1266,1533,267,21.09004739336493
Jalgaon,Guava,2015,1783,2050,267,14.974761637689287
Umarkhed-Danki,Soybean,2015,2900,3167,267,9.206896551724139
Kej,Bajri,2016,1362,1629,267,19.60352422907489
Jalgaon,Green Gram,2016,6133,6400,267,4.353497472688733
Aurangabad,Cucumber,2016,474,741,267,56.32911392405063
Chopda,Soybean,2014,2733,3000,267,9.769484083424809
Varud,Cotton,2015,3696,3963,267,7.224025974025974
Nandurbar,Cluster Bean,2014,4300,4567,267,6.209302325581396
Jalgaon,Papai,2015,933,1200,267,28.617363344051448
Amarawati-Fruit And Vegetables,Bitter Gourd,2016,1938,2205,267,13.777089783281733
Sailu,Gram,2014,2562,2829,267,10.421545667447306
Chandrapur-Ganjwad,Cabbage,2015,411,678,267,64.96350364963503
Anajngaon Surji,Soybean,2015,2972,3239,267,8.983849259757738
Ahmednagar,WHEAT(HUSKED),2016,1849,2116,267,14.440237966468361
Achalpur,Soybean,2016,2682,2949,267,9.955257270693512
Ghansawangi,Bajri,2016,1600,1867,267,16.6875
Jalna,Soybean,2014,2999,3266,267,8.902967655885295
Mumbai,Cucumber,2015,827,1094,267,32.285368802902056
Baramati,Sunflower,2016,3220,3487,267,8.29192546583851
Kalmeshwar,Coriander  ,2016,1659,1926,267,16.09403254972875
Kalmeshwar,Chavli (Shenga ),2016,1221,1488,267,21.867321867321866
Jamkhed,Soybean,2016,3000,3267,267,8.9
Mohol,Gram,2014,2213,2480,267,12.065070040668775
Achalpur,Lentil,2015,5233,5500,267,5.102235811198166
Karad,Cabbage,2015,389,656,267,68.63753213367609
Ausa,Sunflower,2016,2695,2962,267,9.907235621521336
Manora,Soybean,2016,3617,3884,267,7.381808128283107
Balapur,GREEN GRAM,2016,4400,4667,267,6.068181818181818
Jalgaon Jamod,Ground Nut Pods (Dry),2014,2750,3017,267,9.709090909090909
Sindi,Cotton,2016,4268,4535,267,6.2558575445173386
Shrirampur,Potato,2016,1390,1657,267,19.20863309352518
Jalgaon Jamod,Soybean,2015,3000,3267,267,8.9
Latur,Safflower,2015,2499,2766,267,10.684273709483794
Vai,Cucumber,2016,1275,1542,267,20.941176470588236
Sengaon,Black Gram,2016,9300,9567,267,2.870967741935484
Nagpur,Coriander (Dry),2016,7000,7267,267,3.8142857142857145
Pandharkawada,Soybean,2015,2941,3208,267,9.078544712682762
Shrirampur,Bor,2015,911,1178,267,29.308452250274424
Sillod-Bharadi,Soybean,2016,2533,2800,267,10.540860639557836
Sinner,Pigeon Pea (Tur),2016,7035,7302,267,3.795309168443497
Kalyan,Bitter Gourd,2016,933,1200,267,28.617363344051448
Patan,Cabbage,2016,973,1240,267,27.440904419321686
Bhiwapur,Green Gram,2016,5300,5567,267,5.037735849056604
Kalyan,GREEN CHILLI,2016,1233,1500,267,21.65450121654501
Panvel,Snake Gourd,2016,2022,2289,267,13.204747774480712
Chandrapur-Ganjwad,Jack Fruit(Raw),2016,733,1000,267,36.4256480218281
Nandura,Sesamum,2015,6983,7250,267,3.8235715308606615
Mangalwedha,Green Gram,2016,4260,4527,267,6.267605633802817
Akhadabalapur,Pigeon Pea (Tur),2015,5650,5917,267,4.725663716814159
Khed (Shel Pimpalgaon),Bottle Gourd,2016,500,767,267,53.4
Amarawati,Papai,2016,933,1200,267,28.617363344051448
Ramtek,Guava,2015,700,967,267,38.142857142857146
Manora,Soybean,2015,3583,3850,267,7.451855986603405
Rahata,Ground Nut Pods (Dry),2015,2675,2942,267,9.981308411214954
Dondaicha,Maize,2016,1065,1332,267,25.070422535211268
Vai,Bottle Gourd,2015,1040,1307,267,25.673076923076923
Purna,Green Gram,2015,7310,7577,267,3.652530779753762
Amarawati,Green Chilli,2016,2760,3027,267,9.673913043478262
Jintur,Soybean,2016,3398,3665,267,7.857563272513243
Karad,Banana,2015,600,867,267,44.5
Pune-Moshi,Cucumber,2016,553,820,267,48.282097649186255
Ahmedpur,Gram,2016,6228,6495,267,4.2870905587668595
Panvel,Ladies Finger,2015,2133,2400,267,12.517580872011251
Pune-Pimpri,Onion,2015,1125,1392,267,23.733333333333334
Beed,Wheat(Husked),2015,1775,2042,267,15.04225352112676
Shrigonda,SUNFLOWER,2016,2933,3200,267,9.103307193999319
Kalyan,Elephant Root,2015,2100,2367,267,12.714285714285714
Karad,Banana,2015,600,867,267,44.5
Malkapur,Soybean,2016,2979,3246,267,8.962739174219537
Kurdwadi-Modnimb,Wheat(Husked),2016,1522,1789,267,17.542706964520367
Akhadabalapur,Gram,2016,3711,3978,267,7.19482619240097
Shrirampur,Sorgum(Jawar),2016,1667,1934,267,16.016796640671867
Vasai,Onion,2016,800,1067,267,33.375
Mangalwedha,Horse Gram,2015,2000,2267,267,13.35
Kalyan,Green Chilli,2016,1167,1433,266,22.793487574978577
Telhara,Pigeon Pea (Tur),2015,6061,6327,266,4.38871473354232
Karanja,Sorgum(Jawar),2015,1328,1594,266,20.03012048192771
Ausa,Sorgum(Jawar),2015,1538,1804,266,17.29518855656697
Nilanga,SORGUM(JAWAR),2016,1048,1314,266,25.38167938931298
Pune-Pimpri,Cucumber,2014,1103,1369,266,24.11604714415231
Kalyan,Elephant Root,2016,2867,3133,266,9.277990931287059
Varud,Cotton,2016,4353,4619,266,6.110728233402251
Akhadabalapur,Sorgum(Jawar),2015,1267,1533,266,20.994475138121548
Shevgaon-Bodhegaon,Sorgum(Jawar),2015,1501,1767,266,17.72151898734177
Panvel,Ghosali(Bhaji),2015,1867,2133,266,14.247455811462238
Murum,Gram,2015,4501,4767,266,5.909797822706065
Aurangabad,Capsicum,2015,943,1209,266,28.207847295864262
Kolhapur,Snake Gourd,2016,634,900,266,41.95583596214511
Kalmeshwar,Coriander  ,2016,1607,1873,266,16.552582451773493
Beed,Green Gram,2016,4850,5116,266,5.484536082474227
Solapur,Banana,2015,147,413,266,180.95238095238096
Kalyan,Carrot,2016,1567,1833,266,16.975111678366304
Pune-Pimpri,Ground Nut Pods (Dry),2016,3067,3333,266,8.672970329312031
Chopda,Sorgum(Jawar),2016,1535,1801,266,17.32899022801303
Koregaon,Sorgum(Jawar),2014,1867,2133,266,14.247455811462238
Daryapur,Soybean,2015,3185,3451,266,8.351648351648352
Malkapur,Wheat(Husked),2015,1405,1671,266,18.93238434163701
Hingoli,Sorgum(Jawar),2015,1482,1748,266,17.94871794871795
Samudrapur,Gram,2016,3885,4151,266,6.846846846846847
Nashik,Cabbage,2016,362,628,266,73.48066298342542
Dhule,Horse Gram,2016,4250,4516,266,6.258823529411765
Jalgaon Jamod,Soybean,2015,3217,3483,266,8.268573204849238
Kada,Maize,2014,1032,1298,266,25.775193798449614
Lasalgaon,Bajri,2014,1176,1442,266,22.61904761904762
Panvel,Brinjal,2015,1367,1633,266,19.45866861741039
Tumsar,Jaggery,2015,1974,2240,266,13.47517730496454
Washim,Wheat(Husked),2015,1463,1729,266,18.181818181818183
Lasalgaon,Maize,2016,1437,1703,266,18.510786360473208
Jintur,Gram,2015,3122,3388,266,8.52017937219731
Kopargaon,Wheat(Husked),2014,1433,1699,266,18.562456385205863
Ambejogai,Sorgum(Jawar),2015,2140,2406,266,12.429906542056075
Dudhani,Wheat(Husked),2015,1356,1622,266,19.616519174041297
Dhule,Green Gram,2015,6562,6828,266,4.053642182261505
Indapur,Banana,2016,835,1101,266,31.856287425149702
Solapur,Papai,2015,367,633,266,72.47956403269755
Amalner,Coriander (Dry),2016,8586,8852,266,3.098066620079199
Panvel,Cucumber,2015,1367,1633,266,19.45866861741039
Armori-Desaiganj,Paddy-Unhusked,2014,1674,1940,266,15.890083632019117
Kolhapur-Malkapur,CLUSTER BEAN,2016,167,433,266,159.2814371257485
Patan,Cucumber,2014,967,1233,266,27.50775594622544
Ausa,Maize,2016,1525,1791,266,17.442622950819672
Jintur,Gram,2015,4111,4377,266,6.4704451471661395
Lasur Station,Gram,2016,4941,5207,266,5.383525602104837
Kinwat,Sorgum(Jawar),2015,967,1233,266,27.50775594622544
Nandgaon Khandeshwar,Wheat(Husked),2015,1100,1366,266,24.181818181818183
Latur,Safflower,2016,2661,2927,266,9.996242014280346
Partur,Green Gram,2016,4696,4962,266,5.664395229982964
Umared,Green Gram,2016,5686,5952,266,4.678156876538868
Chandur Bajar,Wheat(Husked),2015,1367,1633,266,19.45866861741039
Bhokar,Turmeric,2015,6481,6747,266,4.10430489122049
Chandur Rly.,Soybean,2015,3329,3595,266,7.9903875037548815
Kille Dharur,Soybean,2014,2835,3101,266,9.382716049382717
Vaijapur,Tamarind,2016,2010,2276,266,13.233830845771145
Sangamner,Wheat(Husked),2015,1520,1786,266,17.5
Gangapur,Wheat(Husked),2016,1621,1887,266,16.409623689080814
Manchar,Pavtta,2015,3267,3533,266,8.142026323844506
Nagpur,Capsicum,2015,1742,2008,266,15.269804822043628
Bhivandi,Wheat(Husked),2015,2017,2283,266,13.187902825979178
Kalmeshwar,Cluster Bean,2015,2034,2300,266,13.077679449360865
Naigaon,Sorgum(Jawar),2014,1167,1433,266,22.793487574978577
Dondaicha,Maize,2015,1016,1282,266,26.181102362204726
Sakri,Wheat(Husked),2015,1200,1466,266,22.166666666666668
Akole,Bajri,2014,1467,1733,266,18.132242672119972
Manchar,Cabbage,2015,762,1028,266,34.90813648293963
Savner,Soybean,2015,2947,3213,266,9.026128266033254
Dound,Cowpea,2015,6167,6433,266,4.313280363223609
Nagpur,Tomato,2016,1217,1483,266,21.857025472473296
Ambejogai,Gram,2016,3984,4250,266,6.676706827309237
Beed,Pigeon Pea (Tur),2015,5467,5733,266,4.865556978233035
Satara,Green Chilli,2016,913,1179,266,29.13472070098576
Kada,Maize,2016,1234,1500,266,21.555915721231766
Kalmeshwar,Tomato,2015,2054,2320,266,12.950340798442065
Panvel,Ladies Finger,2016,2717,2983,266,9.79020979020979
Pathardi,Sorgum(Jawar),2016,1588,1854,266,16.750629722921914
Satara,Cabbage,2016,413,679,266,64.40677966101696
Panvel,Cluster Bean,2016,1267,1533,266,20.994475138121548
Amarawati,Bajri,2016,1597,1863,266,16.656230432060113
Kada,Wheat(Husked),2015,1547,1812,265,17.129928894634777
Chandrapur-Ganjwad,Flower,2015,345,610,265,76.81159420289855
Nandurbar,Sorgum(Jawar),2015,1332,1597,265,19.894894894894893
Parli-Vaijnath,Soybean,2014,3013,3278,265,8.79522071025556
Risod,Soybean,2016,2793,3058,265,9.488005728607233
Lasalgaon,Bajri,2015,1252,1517,265,21.166134185303516
Kej,Soybean,2016,3046,3311,265,8.699934340118189
Hingoli,Pigeon Pea (Tur),2016,8073,8338,265,3.28254676080763
Kalmeshwar,Chavli (Shenga ),2015,1163,1428,265,22.785898538263112
Kopargaon,Sorgum(Jawar),2016,1558,1823,265,17.008985879332478
Rahuri-Vambori,WHEAT(HUSKED),2016,1803,2068,265,14.697726012201885
Lonand,Bajri,2015,1375,1640,265,19.272727272727273
Pandharkawada,Cotton,2015,3763,4028,265,7.042253521126761
Khamgaon,Neem-Seed,2015,739,1004,265,35.859269282814616
Kille Dharur,Wheat(Husked),2016,1952,2217,265,13.575819672131148
Kej,Green Gram,2016,4840,5105,265,5.475206611570248
Dondaicha,Maize,2014,1185,1450,265,22.362869198312236
Pachora,Wheat(Husked),2016,1442,1707,265,18.377253814147018
Shevgaon-Bodhegaon,Gram,2015,3075,3340,265,8.617886178861788
Shrirampur,Flower,2016,982,1247,265,26.985743380855396
Manmad,Maize,2015,1139,1404,265,23.266022827041265
Navapur,Green Chilli,2015,1353,1618,265,19.58610495195861
Sangrampur-Varvatbakal,Sorgum(Jawar),2015,1000,1265,265,26.5
Nilanga,Soybean,2015,3400,3665,265,7.794117647058823
Telhara,Pigeon Pea (Tur),2015,5977,6242,265,4.433662372427639
Pathari,Sorgum(Jawar),2016,1600,1865,265,16.5625
Solapur,Pigeon Pea (Tur),2015,8171,8436,265,3.243177089707502
Mumbai,Ladies Finger,2016,1581,1846,265,16.761543327008223
Bhandara,Wheat(Husked),2015,1477,1742,265,17.941773865944484
Ausa,Sunflower,2016,2676,2941,265,9.902840059790732
Malkapur,Maize,2016,1127,1392,265,23.513753327417923
Akola,Sorgum(Jawar),2014,1304,1569,265,20.322085889570552
Parola,Gram,2016,3219,3484,265,8.232370301335818
Udgir,Jaggery,2015,2087,2352,265,12.697652132247244
Akhadabalapur,Soybean,2014,2671,2936,265,9.921377761138151
Shrirampur,Sorgum(Jawar),2015,1448,1713,265,18.30110497237569
Mumbai,Snake Gourd,2015,855,1120,265,30.994152046783626
Akole,Soybean,2016,2880,3145,265,9.20138888888889
Kalmeshwar,Bottle Gourd,2016,1159,1424,265,22.86453839516825
Ahmedpur,Ground Nut Pods (Dry),2014,3385,3650,265,7.828655834564254
Raver,Gram,2016,6419,6684,265,4.128368904813834
Nagpur,Flower,2016,700,965,265,37.857142857142854
Jalna,Maize,2015,1023,1288,265,25.90420332355816
Shrirampur,Tomato,2016,800,1065,265,33.125
Nandgaon Khandeshwar,Soybean,2015,3002,3267,265,8.82744836775483
Sindi (Selu),Cotton,2016,4195,4460,265,6.3170441001191895
Dudhani,Sorgum(Jawar),2015,1618,1883,265,16.378244746600743
Sangamner,Wheat(Husked),2016,1640,1905,265,16.158536585365855
Nagpur,Potato,2015,639,904,265,41.47104851330204
Jintur,Wheat(Husked),2015,1562,1827,265,16.965428937259922
Savner,Gram,2015,3292,3557,265,8.0498177399757
Latur,Bajri,2015,1247,1512,265,21.251002405773857
Patur,Wheat(Husked),2015,1298,1563,265,20.41602465331279
Gangapur,Gram,2016,5935,6200,265,4.465037910699242
Ambad(Vadi Godri),Bajri,2016,1645,1910,265,16.109422492401215
Amarawati-Fruit And Vegetables,Papai,2016,1721,1986,265,15.398024404416038
Kalmeshwar,Flower,2016,1085,1350,265,24.42396313364055
Amalner,Wheat(Husked),2016,1639,1904,265,16.168395363026235
Kalmeshwar,Cucumber,2016,1219,1484,265,21.73913043478261
Savner,Gram,2015,3921,4185,264,6.732976281560826
Rahuri,Potato,2016,1345,1609,264,19.62825278810409
Washim,Soybean,2015,3357,3621,264,7.864164432529043
Dondaicha,Wheat(Husked),2014,1416,1680,264,18.64406779661017
Solapur,Gram,2015,4225,4489,264,6.2485207100591715
Lasalgaon,Bajri,2015,1222,1486,264,21.60392798690671
Pathari,Bajri,2016,1342,1606,264,19.672131147540984
Savner,Gram,2015,4028,4292,264,6.554121151936445
Nagpur,Mosambi,2016,1714,1978,264,15.402567094515753
Mangrulpeer,Soybean,2016,3615,3879,264,7.3029045643153525
Chopda,Soybean,2016,3036,3300,264,8.695652173913043
Yeola,Wheat(Husked),2015,1430,1694,264,18.46153846153846
Chandur Rly.,Gram,2015,3305,3569,264,7.987897125567322
Shirpur,Bajri,2015,1132,1396,264,23.32155477031802
Karad,Cucumber,2014,600,864,264,44.0
Vai,Bottle Gourd,2016,1145,1409,264,23.056768558951966
Shrigonda,Wheat(Husked),2016,1700,1964,264,15.529411764705882
Chalisgaon,Sorgum(Jawar),2015,1200,1464,264,22.0
Shevgaon,Gram,2015,3045,3309,264,8.669950738916256
Washim,SOYBEAN,2016,2675,2939,264,9.869158878504672
Dhule,Green Gram,2015,6864,7128,264,3.8461538461538463
Jalna,MAIZE,2016,1034,1298,264,25.53191489361702
Barshi-Vairag,Gram,2016,6133,6397,264,4.304581770748411
Ghoti,Cabbage,2016,2221,2485,264,11.886537595677623
Amarawati,Cucumber,2016,2600,2864,264,10.153846153846153
Amarawati-Fruit And Vegetables,Brinjal,2016,1440,1704,264,18.333333333333332
Sangamner,Wheat(Husked),2014,1500,1764,264,17.6
Nandurbar,Maize,2014,965,1229,264,27.357512953367877
Mumbai,Cucumber,2015,771,1035,264,34.24124513618677
Hingoli,Gram,2015,2912,3176,264,9.065934065934066
Aurangabad,Potato,2016,1477,1741,264,17.87406905890318
Lasur Station,Bajri,2015,1153,1417,264,22.89679098005204
Bhokar,Pigeon Pea (Tur),2016,6008,6272,264,4.394141145139813
Umarkhed,Soybean,2015,2900,3164,264,9.10344827586207
Kalmeshwar,Cluster Bean,2015,1782,2046,264,14.814814814814815
Ambad(Vadi Godri),Wheat(Husked),2014,1477,1741,264,17.87406905890318
Sangali,Bajri,2016,1793,2057,264,14.723926380368098
Satara,Cabbage,2014,377,641,264,70.026525198939
Ambejogai,Wheat(Husked),2015,2193,2457,264,12.038303693570452
Mumbai,Capsicum,2015,1656,1920,264,15.942028985507246
Amarawati,Wheat(Husked),2016,1719,1983,264,15.357766143106458
Jamkhed,Soybean,2015,3200,3463,263,8.21875
Rahata,Flower,2016,300,563,263,87.66666666666667
Gangapur,Wheat(Husked),2016,1642,1905,263,16.017052375152254
Lasalgaon-Vinchur,Bajri,2015,1375,1638,263,19.12727272727273
Pune-Pimpri,Ghosali(Bhaji),2014,2721,2984,263,9.665564130834252
Nandura,Sorgum(Jawar),2015,1210,1473,263,21.735537190082646
Latur-Murud,Sorgum(Jawar),2016,1386,1649,263,18.975468975468974
Tumsar,Rice(Paddy-Hus),2016,2182,2445,263,12.053162236480294
Pandharpur,Banana,2014,1081,1344,263,24.32932469935245
Barshi,Turmeric,2016,6075,6338,263,4.329218106995885
Achalpur,Gram,2015,4050,4313,263,6.493827160493828
Ambejogai,Soybean,2016,3717,3980,263,7.07559860102233
Ramtek,Spinach,2015,556,819,263,47.302158273381295
Nagpur,Small Gourd,2016,764,1027,263,34.424083769633505
Parli-Vaijnath,Soybean,2015,3069,3332,263,8.569566634082763
Rahata,Bitter Gourd,2014,2775,3038,263,9.477477477477477
Karad,Flower,2014,475,738,263,55.36842105263158
Vai,Brinjal,2016,1064,1327,263,24.718045112781954
Lakhani,Paddy-Unhusked,2014,1837,2100,263,14.316820903647251
Chikhali,Gram,2015,3056,3319,263,8.606020942408376
Shrirampur,Flower,2016,884,1147,263,29.751131221719458
Bhokar,Cotton,2015,4011,4274,263,6.556968337073049
Umared,Gram,2014,2526,2789,263,10.411718131433096
Buldhana-Dhad,Maize,2016,1292,1555,263,20.356037151702786
Kalvan,Wheat(Husked),2016,1627,1890,263,16.164720344191764
Chandrapur-Ganjwad,Cabbage,2016,305,568,263,86.22950819672131
Kalyan,Potato,2016,775,1038,263,33.935483870967744
Mantha,Soybean,2015,3550,3813,263,7.408450704225352
Khed (Shel Pimpalgaon),Cluster Bean,2016,2263,2526,263,11.621741051701282
Sangamner,Bajri,2014,1350,1613,263,19.48148148148148
Kolhapur-Malkapur,Flower,2016,150,413,263,175.33333333333334
Barshi,Other Cereals,2016,3400,3663,263,7.735294117647059
Khed-Chakan,Tomato,2016,470,733,263,55.95744680851064
Amarawati,Flower,2015,2125,2388,263,12.376470588235295
Washim,Wheat(Husked),2015,1447,1710,263,18.17553559087768
Nagpur,Paddy-Unhusked,2015,1550,1813,263,16.967741935483872
Solapur,Green Peas (Dry),2016,3700,3963,263,7.108108108108108
Sinner,Bajri,2015,1187,1450,263,22.15669755686605
Sinner,Wheat(Husked),2016,1610,1872,262,16.273291925465838
Kalmeshwar,Cluster Bean,2016,1934,2196,262,13.547052740434333
Sangrampur,Wheat(Husked),2015,1117,1379,262,23.455684870188005
Ausa,Soybean,2014,3070,3332,262,8.534201954397394
Shevgaon,Wheat(Husked),2016,1501,1763,262,17.455029980013325
Ahmedpur,Green Gram,2015,7463,7725,262,3.510652552592791
Achalpur,Soybean,2016,3213,3475,262,8.154372860255213
Kalmeshwar,Brinjal,2016,1685,1947,262,15.548961424332344
Kalyan,Onion,2016,1057,1319,262,24.78713339640492
Basmat,Soybean,2016,2577,2839,262,10.16686069072565
Latur,Safflower,2016,2640,2902,262,9.924242424242424
Amalner,Gram,2015,3638,3900,262,7.20175920835624
Pathardi,Bajri,2014,1286,1548,262,20.37325038880249
Sangrampur-Varvatbakal,Wheat(Husked),2016,1450,1712,262,18.06896551724138
Panvel,Bitter Gourd,2014,3413,3675,262,7.676530911221799
Beed,Bajri,2016,1444,1706,262,18.14404432132964
Manwat,Sorgum(Jawar),2016,1555,1817,262,16.84887459807074
Chandrapur-Ganjwad,Potato,2015,817,1079,262,32.06854345165239
Dhamangaon-Rly,Soybean,2014,3064,3326,262,8.550913838120104
Aurangabad,Cabbage,2015,763,1025,262,34.33813892529489
Pune-Pimpri,Flower,2015,900,1162,262,29.11111111111111
Jalna,Bajri,2015,1265,1527,262,20.711462450592887
Satana,Wheat(Husked),2016,1760,2022,262,14.886363636363637
Kalmeshwar,Chavli (Shenga ),2016,1207,1469,262,21.70671085335543
Malegaon (Washim),Soybean,2015,3422,3684,262,7.656341320864991
Yeola,SORGUM(JAWAR),2016,1655,1917,262,15.830815709969789
Nandura,Bajri,2016,1278,1540,262,20.50078247261346
Yeotmal,Soybean,2015,3064,3326,262,8.550913838120104
Kalamb (Os),Soybean,2016,3763,4025,262,6.962529896359288
Khed-Chakan,Tomato,2016,496,758,262,52.82258064516129
Kalmeshwar,Coriander  ,2016,2610,2872,262,10.03831417624521
Pulgaon,Soybean,2016,3158,3420,262,8.296390120329322
Sangamner,Soybean,2016,3588,3850,262,7.302118171683389
Aurangabad,Potato,2015,638,900,262,41.06583072100314
Solapur,Bajri,2014,1202,1464,262,21.79700499168053
Kalmeshwar,Tomato,2015,1545,1807,262,16.957928802588995
Kopargaon,Bajri,2016,1687,1949,262,15.530527563722584
Jintur-Bori,Gram,2015,2964,3226,262,8.83940620782726
Rahuri-Vambori,Wheat(Husked),2016,1567,1829,262,16.719846841097638
Gangapur,Sorgum(Jawar),2015,1380,1642,262,18.985507246376812
Rahata,Bottle Gourd,2016,488,750,262,53.68852459016394
Ramtek,Chavli (Shenga ),2016,1038,1300,262,25.240847784200387
Vaijapur,Bajri,2015,1505,1767,262,17.408637873754152
Akluj,Sorgum(Jawar),2014,1588,1850,262,16.49874055415617
Karad,Cabbage,2016,588,850,262,44.5578231292517
Kada (Ashti),Bajri,2016,1288,1550,262,20.341614906832298
Nagpur,Green-Peas,2015,2063,2325,262,12.699951526902568
Nagpur,Cluster Bean,2014,1865,2127,262,14.048257372654156
Solapur,PIGEON PEA (TUR),2016,5437,5699,262,4.818833915762369
Manwat,Sorgum(Jawar),2015,1401,1663,262,18.70092790863669
Jalgaon,Cucumber,2016,1500,1762,262,17.466666666666665
Bhokar,Soybean,2016,2587,2849,262,10.127560881329726
Pandharpur,Banana,2015,293,555,262,89.419795221843
Rahuri-Vambori,Ground Nut Pods (Dry),2015,3176,3438,262,8.249370277078086
Rahuri,Potato,2016,1538,1800,262,17.035110533159948
Pathardi,Bajri,2016,1270,1532,262,20.62992125984252
Indapur-Bhigwan,Horse Gram,2015,3863,4125,262,6.782293554232462
Partur,SORGUM(JAWAR),2016,1875,2137,262,13.973333333333333
Lonar,Green Gram,2016,4834,5096,262,5.419942076954903
Manmad,Bajri,2014,1311,1573,262,19.98474446987033
Nandurbar,Wheat(Husked),2015,1412,1674,262,18.555240793201133
Buldhana,Soybean,2016,3462,3724,262,7.5678798382437895
Koregaon,Sorgum(Jawar),2015,1663,1925,262,15.754660252555622
Digras,Black Gram,2015,10170,10431,261,2.566371681415929
Raver,Wheat(Husked),2016,1597,1858,261,16.343143393863492
Buldhana-Dhad,Soybean,2016,3708,3969,261,7.038834951456311
Latur,Sorgum(Jawar),2015,2388,2649,261,10.92964824120603
Partur,Pigeon Pea (Tur),2015,5840,6101,261,4.469178082191781
Amarawati-Fruit And Vegetables,Potato,2016,1089,1350,261,23.96694214876033
Dhamangaon-Rly,Cotton,2016,4747,5008,261,5.498209395407626
Umarga,Gram,2015,3311,3572,261,7.882814859559046
Aurangabad,Awala,2014,589,850,261,44.31239388794567
Kalyan,Cucumber,2016,1767,2028,261,14.770797962648556
Jalna,Cotton,2016,4143,4404,261,6.299782766111513
Nashik,CABBAGE,2016,265,526,261,98.49056603773585
Jalna,Soybean,2016,3282,3543,261,7.952468007312614
Amarawati,Ladies Finger,2016,2254,2515,261,11.579414374445431
Loha,Wheat(Husked),2014,1474,1735,261,17.706919945725915
Lasalgaon-Vinchur,Maize,2016,1088,1349,261,23.988970588235293
Mumbai,Cabbage,2015,362,623,261,72.09944751381215
Paithan,Pigeon Pea (Tur),2016,7899,8160,261,3.304215723509305
Amarawati,Cabbage,2016,2533,2794,261,10.303987366758784
Varora,Soybean,2015,2900,3161,261,9.0
Wardha,Soybean,2014,2727,2988,261,9.570957095709572
Ambejogai,BAJRI,2016,1390,1651,261,18.776978417266186
Ausa,Sorgum(Jawar),2015,1455,1716,261,17.938144329896907
Nagpur,Parwar,2014,1404,1665,261,18.58974358974359
Paithan,Gram,2016,3912,4173,261,6.671779141104294
Amarawati,Brinjal,2016,1950,2211,261,13.384615384615385
Parli-Vaijnath,Soybean,2016,3496,3757,261,7.465675057208238
Jamner,Maize,2016,1365,1626,261,19.12087912087912
Kille Dharur,Gram,2015,4435,4696,261,5.88500563697858
Chopda,Ground Nut Pods (Dry),2016,5041,5302,261,5.1775441380678435
Khamgaon,Ground Nut Pods (Dry),2016,5008,5269,261,5.211661341853035
Jamner,Cotton,2014,3783,4044,261,6.89928628072958
Gevrai,Cotton,2015,3693,3954,261,7.067424857839155
Patur,Sorgum(Jawar),2016,1500,1761,261,17.4
Sengaon,Ground Nut Pods (Dry),2016,5276,5537,261,4.946929492039424
Hadgaon,Soybean,2016,3333,3594,261,7.830783078307831
Taloda,Maize,2015,1202,1463,261,21.713810316139767
Shahada,Wheat(Husked),2015,1563,1824,261,16.698656429942417
Kolhapur-Laxmipuri,Cowpea,2016,5205,5466,261,5.014409221902017
Shevgaon,Wheat(Husked),2016,1667,1927,260,15.596880623875226
Chandrapur-Ganjwad,Ladies Finger,2016,560,820,260,46.42857142857143
Mumbai,Sweet Potato,2014,870,1130,260,29.885057471264368
Panvel,Snake Gourd,2016,980,1240,260,26.53061224489796
Chalisgaon,Bajri,2015,1100,1360,260,23.636363636363637
Khed (Shel Pimpalgaon),Walvad,2015,1250,1510,260,20.8
Vaduj,Ghevda Seed,2015,2960,3220,260,8.783783783783784
Washim,GREEN GRAM,2016,4320,4580,260,6.018518518518518
Fulambri,Cotton,2016,4641,4901,260,5.602240896358543
Pathardi,Sorgum(Jawar),2015,1515,1775,260,17.16171617161716
Jalgaon Jamod-Aasalgaon,Soybean,2014,2840,3100,260,9.154929577464788
Chandrapur-Ganjwad,Chavli (Shenga ),2014,790,1050,260,32.91139240506329
Chopda,Sorgum(Jawar),2016,1505,1765,260,17.27574750830565
Nagpur,Melon,2015,500,760,260,52.0
Pune-Moshi,CABBAGE,2016,367,627,260,70.84468664850137
Kolhapur-Laxmipuri,Split Lentil,2016,6540,6800,260,3.9755351681957185
Balapur,Green Gram,2015,6500,6760,260,4.0
Kille Dharur,Green Gram,2016,4690,4950,260,5.543710021321962
Pathardi,Gram,2015,3520,3780,260,7.386363636363637
Ramtek,Mango,2016,1820,2080,260,14.285714285714286
Mumbai,Flower,2014,880,1140,260,29.545454545454547
Pune-Pimpri,Bitter Gourd,2015,3640,3900,260,7.142857142857143
Mantha,Pigeon Pea (Tur),2016,7330,7590,260,3.5470668485675305
Malegaon,Wheat(Husked),2014,1454,1714,260,17.881705639614857
Panvel,Cabbage,2016,700,960,260,37.142857142857146
Panvel,Ridge Gourd,2015,3740,4000,260,6.951871657754011
Umarga,Wheat(Husked),2014,1365,1625,260,19.047619047619047
Gevrai,Sorgum(Jawar),2016,1628,1888,260,15.97051597051597
Nagpur,Tomato,2014,1640,1900,260,15.853658536585366
Barshi,Mosambi,2015,220,480,260,118.18181818181819
Barshi,Fodder,2016,725,985,260,35.86206896551724
Darwha,Soybean,2015,3383,3643,260,7.685486254803429
Mehkar,Maize,2016,1287,1547,260,20.2020202020202
Chandrapur-Ganjwad,Potato,2015,680,940,260,38.23529411764706
Paranda,Gram,2015,4040,4300,260,6.435643564356436
Sailu,Pigeon Pea (Tur),2016,6248,6508,260,4.161331626120359
Nashik,Spinach,2015,200,460,260,130.0
Shevgaon,Onion,2016,508,768,260,51.181102362204726
Parbhani,Wheat(Husked),2015,1453,1713,260,17.894012388162423
Rahata,Gram,2015,3668,3928,260,7.088331515812432
Nashik-Devlali,Banana,2016,840,1100,260,30.952380952380953
Ausa,Maize,2014,1131,1391,260,22.988505747126435
Kolhapur-Laxmipuri,Cowpea,2015,4908,5168,260,5.297473512632437
Tumsar,Jaggery,2015,2145,2405,260,12.121212121212121
Ausa,Soybean,2016,3608,3868,260,7.206208425720621
Chalisgaon,Bajri,2014,1102,1362,260,23.593466424682397
Vai,Brinjal,2016,1580,1840,260,16.455696202531644
Dhule,Maize,2015,959,1219,260,27.111574556830032
Amarawati,Orange,2015,860,1120,260,30.232558139534884
Shevgaon,Bajri,2016,1335,1595,260,19.475655430711612
Shirpur,Maize,2015,881,1141,260,29.511918274687854
Manmad,Wheat(Husked),2014,1486,1746,260,17.49663526244953
Buldhana,Wheat(Husked),2015,1370,1630,260,18.978102189781023
Partur,Sorgum(Jawar),2015,1216,1476,260,21.38157894736842
Pusad,Soybean,2016,3276,3536,260,7.936507936507937
Amarawati,Carrot,2016,2460,2720,260,10.56910569105691
Kalyan,Ridge Gourd,2015,1080,1340,260,24.074074074074073
Shrirampur,Bottle Gourd,2016,880,1140,260,29.545454545454547
Dhule,Maize,2014,917,1177,260,28.353326063249728
Armori-Desaiganj,Paddy-Unhusked,2014,1485,1745,260,17.50841750841751
Kalyan,Tomato,2015,1900,2160,260,13.68421052631579
Sindkhed Raja,Wheat(Husked),2015,1540,1800,260,16.883116883116884
Amalner,Wheat(Husked),2016,1515,1775,260,17.16171617161716
Kalmeshwar,Soybean,2015,2961,3221,260,8.78081729145559
Pusad,Soybean,2015,3950,4210,260,6.582278481012659
Sindkhed Raja,Sorgum(Jawar),2015,1540,1800,260,16.883116883116884
Rahuri-Vambori,Pigeon Pea (Tur),2015,4466,4726,260,5.821764442454097
Shevgaon,Cotton,2015,3617,3877,260,7.188277578103401
Gondpimpri,Pigeon Pea (Tur),2016,8100,8360,260,3.2098765432098766
Aarni,Soybean,2015,3000,3260,260,8.666666666666666
Ramtek,Cabbage,2016,600,860,260,43.333333333333336
Kalyan,Brinjal,2015,1080,1340,260,24.074074074074073
Nandura,Sesamum,2016,5360,5620,260,4.850746268656716
Sinner,Sorgum(Jawar),2015,1240,1500,260,20.967741935483872
Kalmeshwar,METHI (BHAJI),2016,1568,1828,260,16.581632653061224
Buldhana,Soybean,2015,3465,3725,260,7.503607503607504
Murtizapur,Wheat(Husked),2016,1501,1761,260,17.3217854763491
Shevgaon,Wheat(Husked),2015,1359,1619,260,19.131714495952906
Patan,Flower,2015,780,1040,260,33.333333333333336
Kurdwadi,Sunflower,2016,2583,2843,260,10.065814943863725
Lonand,Gram,2015,3840,4100,260,6.770833333333333
Dondaicha,Pigeon Pea (Tur),2015,4900,5160,260,5.3061224489795915
Umarga,SUNFLOWER,2016,2620,2880,260,9.923664122137405
Latur,Safflower,2015,2550,2810,260,10.196078431372548
Kalyan,Bottle Gourd,2016,1240,1500,260,20.967741935483872
Amarawati,Ladies Finger,2016,3067,3327,260,8.4773394196283
Murbad,Tomato,2014,2900,3160,260,8.96551724137931
Varud,Cotton,2016,4193,4453,260,6.200810875268305
Balapur,Sorgum(Jawar),2016,1260,1520,260,20.634920634920636
Satara,Cucumber,2016,370,630,260,70.27027027027027
Kalamb (Yawatmal),Soybean,2014,2960,3220,260,8.783783783783784
Akhadabalapur,Castor Seed,2015,3060,3320,260,8.49673202614379
Satara,Bottle Gourd,2016,572,832,260,45.45454545454545
Sangli-Phale Bhajipalam,Water Melon,2016,83,343,260,313.2530120481928
Satara,Bottle Gourd,2015,595,855,260,43.69747899159664
Sailu,Sorgum(Jawar),2014,1156,1416,260,22.491349480968857
Mumbai,Snake Gourd,2015,1457,1717,260,17.844886753603294
Himayatnagar,Sorgum(Jawar),2016,1250,1510,260,20.8
Umarga,Sesamum,2016,4000,4260,260,6.5
Amarawati,Linseed,2016,4920,5179,259,5.264227642276423
Rahuri-Vambori,Gram,2014,2122,2381,259,12.205466540999058
Pune,Bajri,2015,1628,1887,259,15.909090909090908
Nandurbar,Bajri,2014,1125,1384,259,23.022222222222222
Jintur,Soybean,2016,3545,3804,259,7.306064880112835
Pachora,Pigeon Pea (Tur),2016,7765,8024,259,3.3354797166773986
Anajngaon Surji,Sorgum(Jawar),2016,1250,1509,259,20.72
Anajngaon Surji,Pigeon Pea (Tur),2014,4908,5167,259,5.277098614506928
Chandrapur-Ganjwad,Flower,2016,209,468,259,123.92344497607655
Kalmeshwar,Raddish,2016,1054,1313,259,24.573055028463
Wardha,Gram,2016,3987,4246,259,6.496112365186857
Kada,Gram,2015,4096,4355,259,6.3232421875
Aurangabad,Papai,2015,547,806,259,47.34917733089579
Karanja,Wheat(Husked),2015,1431,1690,259,18.099231306778478
Shirpur,Maize,2016,1144,1403,259,22.63986013986014
Shrirampur,Sorgum(Jawar),2016,1585,1844,259,16.34069400630915
Nagpur,Brinjal,2016,909,1168,259,28.492849284928493
Patur,Soybean,2016,3523,3782,259,7.351688901504399
Varud-Rajura Bazar,Maize,2016,1216,1475,259,21.299342105263158
Vai,Cucumber,2015,1158,1417,259,22.36614853195164
Barshi,Fodder,2014,398,657,259,65.07537688442211
Mantha,Soybean,2016,3383,3642,259,7.655926692284954
Latur,Maize,2015,1081,1340,259,23.959296947271046
Vaijapur,Bajri,2016,1427,1686,259,18.149964961457602
Gevrai,Bajri,2015,1329,1588,259,19.48833709556057
Vaijapur,Gram,2015,4152,4411,259,6.237957610789981
Kalyan,Potato,2016,1217,1476,259,21.281840591618735
Lasur Station,Wheat(Husked),2015,1554,1813,259,16.666666666666668
Daryapur,Sorgum(Jawar),2015,1148,1407,259,22.5609756097561
Mumbai,Elephant Root,2016,2933,3192,259,8.83054892601432
Kalmeshwar,Green Chilli,2014,3019,3278,259,8.578999668764492
Malkapur,Wheat(Husked),2016,1559,1818,259,16.61321359846055
Pathari,Pigeon Pea (Tur),2015,5018,5277,259,5.16141889198884
Navapur,Coriander  ,2016,783,1042,259,33.077905491698594
Nandgaon,Pigeon Pea (Tur),2014,3659,3918,259,7.078436731347363
Solapur,Cabbage,2016,305,564,259,84.91803278688525
Shahada,Maize,2015,1206,1465,259,21.475953565505804
Dondaicha-Sindkheda,Bajri,2016,1461,1720,259,17.727583846680357
Amalner,Bajri,2016,1557,1816,259,16.634553628773283
Vadgaon Peth,Cabbage,2015,355,614,259,72.95774647887323
Sindi (Selu),Cotton,2015,3669,3928,259,7.059144180975743
Amarawati,Linseed,2016,4295,4554,259,6.030267753201397
Mumbai,Elephant Root,2016,2819,3077,258,9.152181624689605
Amarawati,Pigeon Pea (Tur),2015,7192,7450,258,3.5873192436040044
Buldhana,Gram,2016,4060,4318,258,6.354679802955665
Ahmedpur,Sunflower,2015,3224,3482,258,8.002481389578163
Mantha,Pigeon Pea (Tur),2016,8000,8258,258,3.225
Nandura,Onion,2016,347,605,258,74.35158501440922
Kalmeshwar,Walvad,2016,1679,1937,258,15.366289458010721
Amarawati,Wheat(Husked),2015,1667,1925,258,15.476904619076185
Shevgaon,Wheat(Husked),2015,1344,1602,258,19.196428571428573
Sangali,Soybean,2015,3355,3613,258,7.690014903129657
Baramati,Bajri,2015,1475,1733,258,17.491525423728813
Khed (Shel Pimpalgaon),Walvad,2015,1542,1800,258,16.731517509727627
Pune,Wheat(Husked),2014,1906,2164,258,13.536201469045121
Sangamner,Gram,2015,3871,4129,258,6.664944458796176
Beed,Gram,2015,3893,4151,258,6.62727973285384
Mukhed,Black Gram,2015,7655,7913,258,3.3703461789679947
Pombhurni,Paddy-Unhusked,2016,1916,2174,258,13.465553235908143
Kalamb (Os),Bajri,2015,1290,1548,258,20.0
Bhokar,Sorgum(Jawar),2015,1281,1539,258,20.140515222482435
Lasur Station,MAIZE,2016,936,1194,258,27.564102564102566
Kalamb (Os),Pigeon Pea (Tur),2014,4156,4414,258,6.2078922040423485
Kalamb (Yawatmal),Soybean,2016,3325,3583,258,7.7593984962406015
Jamkhed,Pigeon Pea (Tur),2015,4950,5208,258,5.212121212121212
Yeotmal,Cotton,2016,4261,4519,258,6.0549166862238915
Kalmeshwar,Walvad,2014,3834,4092,258,6.729264475743349
Nagpur,Rice(Paddy-Hus),2014,3553,3811,258,7.261469180973825
Rahata,Carrot,2016,992,1250,258,26.008064516129032
Mumbai,Sweet Potato,2016,967,1225,258,26.680455015511892
Nanded,Pigeon Pea (Tur),2015,6130,6388,258,4.208809135399674
Nagpur,PUMPKIN,2016,571,829,258,45.18388791593695
Kalmeshwar,Cluster Bean,2015,1873,2131,258,13.774693005872932
Aurad Shahajani,Gram,2016,5282,5540,258,4.8845134418780765
Ahmednagar,Gram,2015,4268,4526,258,6.044985941893159
Patur,Wheat(Husked),2016,1887,2145,258,13.672496025437201
Mehkar,Sorgum(Jawar),2015,1008,1266,258,25.595238095238095
Chikhali,Soybean,2016,3419,3677,258,7.546066101199181
Pune-Pimpri,CABBAGE,2016,583,841,258,44.25385934819897
Lasalgaon-Vinchur,Maize,2015,1228,1486,258,21.009771986970684
Kalmeshwar,Brinjal,2016,661,919,258,39.03177004538578
Chandrapur,Pigeon Pea (Tur),2016,8250,8508,258,3.1272727272727274
Barshi,Lemon,2016,317,575,258,81.38801261829653
Taloda,Black Gram,2015,3044,3302,258,8.47568988173456
Kalyan,Brinjal,2015,1817,2075,258,14.199229499174463
Lasalgaon,Bajri,2015,1412,1670,258,18.271954674220964
Amarawati-Fruit And Vegetables,Maize(Corn.),2016,971,1229,258,26.570545829042224
Telhara,Soybean,2016,2856,3114,258,9.033613445378151
Risod,Soybean,2016,3453,3711,258,7.471763683753258
Kalyan,Tomato,2016,1421,1679,258,18.156228008444756
Savner,Soybean,2016,3202,3460,258,8.057464084946908
Kalyan,Tomato,2016,1050,1308,258,24.571428571428573
Mumbai,CAPSICUM,2016,750,1008,258,34.4
Chalisgaon,Bajri,2015,1147,1405,258,22.493461203138622
Shirpur,CHILLIES(RED),2016,1523,1781,258,16.940249507550888
Ausa,Maize,2016,1454,1712,258,17.744154057771663
Manmad,Wheat(Husked),2014,1472,1730,258,17.527173913043477
Risod,SOYBEAN,2016,2630,2888,258,9.809885931558936
Kalyan,BRINJAL,2016,1125,1383,258,22.933333333333334
Ghatanji,Soybean,2016,3470,3728,258,7.435158501440922
Kopargaon,Soybean,2016,3360,3618,258,7.678571428571429
Kalyan,Cabbage,2016,1121,1379,258,23.01516503122212
Beed,Bajri,2014,1375,1632,257,18.69090909090909
Washim-Ansing,Pigeon Pea (Tur),2016,8204,8461,257,3.1326182350073135
Jalgaon Jamod-Aasalgaon,Soybean,2014,3057,3314,257,8.406934903500163
Solapur,Jaggery,2016,3078,3335,257,8.349577647823262
Barshi,Wheat(Husked),2014,1437,1694,257,17.884481558803063
Shevgaon,Gram,2015,4075,4332,257,6.306748466257669
Beed,Bajri,2016,1352,1609,257,19.00887573964497
Gevrai,COTTON,2016,4638,4895,257,5.541181543768866
Panvel,Cucumber,2016,1514,1771,257,16.974900924702773
Panvel,Cucumber,2016,957,1214,257,26.854754440961337
Kada,Sunflower,2014,2881,3138,257,8.92051371051718
Nilanga,Soybean,2016,3523,3780,257,7.294919103037184
Pusad,Wheat(Husked),2014,1410,1667,257,18.22695035460993
Jalgaon,Maize(Corn.),2015,786,1043,257,32.69720101781171
Malkapur,Maize,2016,1120,1377,257,22.946428571428573
Taloda,Sorgum(Jawar),2016,1625,1882,257,15.815384615384616
Buldhana-Dhad,Maize,2015,1100,1357,257,23.363636363636363
Mumbai,Arvi,2015,1012,1269,257,25.395256916996047
Kalmeshwar,Flower,2015,1153,1410,257,22.289679098005205
Kalmeshwar,Cucumber,2015,756,1013,257,33.99470899470899
Kolhapur,Guava,2015,143,400,257,179.72027972027973
Vadgaon Peth,Cabbage,2015,314,571,257,81.84713375796179
Dudhani,Green Gram,2015,7300,7557,257,3.5205479452054793
Chikhali,Soybean,2016,3419,3676,257,7.516817782977479
Kalyan,Cabbage,2015,718,975,257,35.79387186629526
Kolhapur,Sweet Potato,2015,431,688,257,59.62877030162413
Shevgaon,Bajri,2015,1332,1589,257,19.294294294294293
Panvel,Brinjal,2016,2929,3186,257,8.774325708432912
Kej,Gram,2016,3999,4256,257,6.426606651662916
Vai,Cabbage,2016,988,1245,257,26.012145748987855
Jafrabad,Soybean,2015,3314,3571,257,7.754978877489439
Kej,Tamarind,2016,6829,7086,257,3.7633621320837602
Buldhana-Dhad,Maize,2016,1109,1366,257,23.174030658250675
Dondaicha,Maize,2015,957,1214,257,26.854754440961337
Risod,Gram,2015,4150,4407,257,6.192771084337349
Vaijapur,Bajri,2014,1275,1532,257,20.15686274509804
Sindkhed Raja,Wheat(Husked),2016,1714,1971,257,14.99416569428238
Akola,Soybean,2015,2995,3252,257,8.580968280467445
Washim,Soybean,2015,3059,3316,257,8.401438378555083
Shrirampur,Brinjal,2015,762,1019,257,33.727034120734906
Savner,Soybean,2015,2975,3232,257,8.638655462184873
Gondpimpri,Gram,2015,3143,3400,257,8.176901049952274
Dhule,Bajri,2015,1093,1350,257,23.513266239707228
Devala,Cowpea,2014,2348,2605,257,10.945485519591141
Savner,Gram,2015,4220,4477,257,6.090047393364929
Rahata,Potato,2015,757,1014,257,33.949801849405546
Shirur,Ground Nut Pods (Dry),2015,2779,3036,257,9.247930910399424
Latur,Safflower,2016,2554,2811,257,10.062646828504308
Beed,Soybean,2015,3382,3639,257,7.599053814311058
Gondpimpri,Soybean,2015,3522,3779,257,7.296990346394094
Barshi,Ladies Finger,2016,300,557,257,85.66666666666667
Ausa,Soybean,2016,3803,4060,257,6.757822771496187
Rahuri-Vambori,Gram,2015,3433,3690,257,7.486163705214098
Yawal,Sorgum(Jawar),2016,1110,1367,257,23.153153153153152
Nagpur,Wheat(Husked),2016,1894,2151,257,13.569165786694827
Chalisgaon,Onion,2016,451,708,257,56.98447893569845
Lasalgaon,Sorgum(Jawar),2015,1428,1685,257,17.99719887955182
Nandurbar,Wheat(Husked),2016,1585,1842,257,16.214511041009462
Washim,Soybean,2015,3118,3375,257,8.242463117382938
Pune,Arvi,2016,2933,3190,257,8.76235935901807
Kalmeshwar,Spinach,2016,947,1204,257,27.138331573389653
Lonar,Gram,2016,4048,4305,257,6.348814229249012
Mumbai,Arvi,2014,2743,3000,257,9.36930368209989
Aurangabad,Wal Bhaji,2015,900,1157,257,28.555555555555557
Hinganghat,Pigeon Pea (Tur),2014,4184,4441,257,6.142447418738049
Jalkot,Pigeon Pea (Tur),2014,4207,4464,257,6.108866175421916
Kille Dharur,Gram,2015,3715,3971,256,6.890982503364738
Patur,Pigeon Pea (Tur),2016,8565,8821,256,2.9889083479276124
Latur,Safflower,2016,2629,2885,256,9.737542791936097
Mumbai,Sweet Potato,2015,880,1136,256,29.09090909090909
Manora,Gram,2014,2294,2550,256,11.159546643417611
Nilanga,Sorgum(Jawar),2015,1518,1774,256,16.86429512516469
Mumbai-Fruit Market,Melon,2016,1684,1940,256,15.20190023752969
Satara,Bottle Gourd,2015,512,768,256,50.0
Murbad,Ghevda,2015,4133,4389,256,6.194047907089281
Vai,Bottle Gourd,2015,1052,1308,256,24.334600760456272
Barshi,Pomegranate,2016,313,569,256,81.78913738019169
Vaduj,Green Gram,2014,7122,7378,256,3.5944959281100815
Dondaicha,Sorgum(Jawar),2016,1654,1910,256,15.477629987908102
Aurad Shahajani,Green Gram,2015,6501,6757,256,3.937855714505461
Mehkar,Wheat(Husked),2015,1363,1619,256,18.782098312545855
Ramtek,Soybean,2015,3384,3640,256,7.5650118203309695
Telhara,Green Gram,2015,5819,6075,256,4.399381336999484
Risod,Soybean,2016,3504,3760,256,7.30593607305936
Vaduj,Gram,2016,7033,7289,256,3.63998293757998
Mohol,Gram,2015,3342,3598,256,7.660083782166367
Dondaicha-Sindkheda,Pigeon Pea (Tur),2016,6950,7206,256,3.683453237410072
Shirpur,Maize,2014,1048,1304,256,24.427480916030536
Umari,Gram,2016,4800,5056,256,5.333333333333333
Jalna,Green Gram,2016,5849,6105,256,4.376816549837579
Murbad,Ladies Finger,2014,2633,2889,256,9.722749715153817
Shevgaon,Sorgum(Jawar),2015,1262,1518,256,20.28526148969889
Mumbai,Flower,2014,1033,1289,256,24.78218780251694
Amarawati,Bitter Gourd,2016,3119,3375,256,8.207758897082398
Shrirampur,Sorgum(Jawar),2015,1401,1657,256,18.272662384011422
Mumbai,Onion,2015,1459,1715,256,17.54626456477039
Barshi,Brinjal,2016,238,494,256,107.56302521008404
Khed-Chakan,Potato,2016,1488,1744,256,17.204301075268816
Navapur,Green Chilli,2016,796,1052,256,32.1608040201005
Kalmeshwar,Bitter Gourd,2015,2580,2836,256,9.922480620155039
Kalamb (Os),Maize,2016,1713,1969,256,14.944541739638062
Vaduj,Ghevda Seed,2015,4611,4867,256,5.551941010626762
Malegaon (Washim),Soybean,2016,3531,3787,256,7.2500708014726705
Mumbai,LADIES FINGER,2016,1592,1848,256,16.08040201005025
Chandrapur,Pigeon Pea (Tur),2016,7970,8226,256,3.2120451693851946
Amarawati,Bajri,2015,1294,1550,256,19.783616692426584
Yeola,Bajri,2015,1257,1513,256,20.365950676213206
Chikhali,Sorgum(Jawar),2016,1242,1498,256,20.611916264090176
Anajngaon Surji,Soybean,2015,3014,3270,256,8.49369608493696
Achalpur,Soybean,2016,3534,3790,256,7.243916242218449
Gangapur,Gram,2015,3166,3422,256,8.085912823752368
Bhivandi,Other Vegetables,2016,917,1173,256,27.91712104689204
Kopargaon,Wheat(Husked),2015,1480,1736,256,17.2972972972973
Jintur-Bori,Soybean,2014,2967,3223,256,8.628244017526121
Vai,BOTTLE GOURD,2016,1022,1278,256,25.048923679060664
Risod,Soybean,2015,3561,3817,256,7.188991856220163
Mantha,Sorgum(Jawar),2016,1413,1669,256,18.117480537862704
Nagpur,Beet Root,2016,576,832,256,44.44444444444444
Ambejogai,Sorgum(Jawar),2015,2054,2310,256,12.4634858812074
Dhule,Maize,2015,1325,1581,256,19.32075471698113
Dhule,MATKI,2016,5025,5281,256,5.0945273631840795
Nandura,Maize,2016,1095,1351,256,23.378995433789953
Yeotmal,Gram,2014,2389,2645,256,10.715780661364589
Shirpur,Wheat(Husked),2016,1573,1829,256,16.274634456452638
Chalisgaon,Wheat(Husked),2015,1400,1656,256,18.285714285714285
Bhokar,Gram,2016,3900,4156,256,6.564102564102564
Karanja,Gram,2016,4067,4323,256,6.294566019178756
Rahuri-Vambori,Sorgum(Jawar),2015,1195,1450,255,21.338912133891213
Shrirampur,Flower,2016,855,1110,255,29.82456140350877
Barshi,Fodder,2016,480,735,255,53.125
Umarga,Soybean,2015,3341,3596,255,7.6324453756360375
Chandrapur-Ganjwad,Potato,2015,856,1111,255,29.789719626168225
Partur,Soybean,2016,3226,3481,255,7.904525728456292
Shegaon,Mustard,2015,3125,3380,255,8.16
Amarawati,Spinach,2015,1889,2144,255,13.499205929062997
Aurangabad,Brinjal,2016,610,865,255,41.80327868852459
Kalmeshwar,Chavli (Shenga ),2016,1418,1673,255,17.983074753173483
Jintur,Wheat(Husked),2016,1618,1873,255,15.760197775030901
Chalisgaon,Maize,2015,1183,1438,255,21.55536770921386
Shrirampur,Bajri,2016,1625,1880,255,15.692307692307692
Yeotmal,Gram,2015,2797,3052,255,9.116910976045764
Ausa,Paddy-Unhusked,2014,851,1106,255,29.964747356051703
Pachora,Maize,2016,1267,1522,255,20.126282557221785
Chakur,Pigeon Pea (Tur),2016,8751,9006,255,2.9139526911210147
Bhivandi,Other Vegetables,2015,1086,1341,255,23.480662983425415
Pune,Bajri,2015,1720,1975,255,14.825581395348838
Nagpur,Wheat(Husked),2015,1827,2082,255,13.957307060755337
Pathardi,Sorgum(Jawar),2015,1528,1783,255,16.68848167539267
Hanegaon,Pigeon Pea (Tur),2016,9287,9542,255,2.7457736621083235
Umarga,Sunflower,2016,2513,2768,255,10.147234381217668
Nagbhid,Paddy-Unhusked,2015,1593,1848,255,16.0075329566855
Khed-Chakan,Cabbage,2016,493,748,255,51.724137931034484
Chakur,Soybean,2016,3687,3942,255,6.916192026037429
Ghoti,Bitter Gourd,2014,2236,2491,255,11.404293381037567
Shahada,SORGUM(JAWAR),2016,1341,1596,255,19.01565995525727
Raver,Wheat(Husked),2016,1609,1864,255,15.848353014294593
Jalgaon,Gram,2016,5833,6088,255,4.371678381621807
Vaijapur,Bajri,2015,1133,1388,255,22.506619593998234
Kalamb (Os),Pigeon Pea (Tur),2016,7505,7760,255,3.3977348434377084
Kalmeshwar,TOMATO,2016,709,964,255,35.966149506346966
Gevrai,Bajri,2016,1398,1653,255,18.240343347639485
Dudhani,Pigeon Pea (Tur),2014,4908,5163,255,5.19559902200489
Shirpur,Maize,2016,1164,1419,255,21.90721649484536
Vaduj,Sorgum(Jawar),2016,2178,2433,255,11.707988980716253
Lohara,Green Gram,2016,4713,4968,255,5.410566518141311
Dondaicha-Sindkheda,Sorgum(Jawar),2016,1458,1713,255,17.48971193415638
Nilanga,Sunflower,2015,3295,3550,255,7.738998482549317
Khamgaon,Sorgum(Jawar),2016,1232,1487,255,20.698051948051948
Mumbai,Sugar,2015,2650,2905,255,9.622641509433961
Akkolkot,Gram,2015,3800,4055,255,6.7105263157894735
Rajura,COTTON,2016,4594,4849,255,5.550718328254245
Chandur Rly.,Pigeon Pea (Tur),2016,8087,8342,255,3.15320885371584
Digras,Gram,2016,4911,5166,255,5.192425167990226
Darwha,Soybean,2014,2788,3043,255,9.146341463414634
Nira,Jaggery,2016,2979,3234,255,8.559919436052366
Jamkhed,Gram,2016,3979,4234,255,6.408645388288515
Ahmedpur,Sorgum(Jawar),2014,895,1150,255,28.491620111731844
Chikhali,Soybean,2015,3226,3481,255,7.904525728456292
Chikhali,Soybean,2015,2970,3225,255,8.585858585858587
Osmanabad,Soybean,2015,3351,3606,255,7.609668755595345
Mumbai,Sweet Potato,2016,1128,1383,255,22.606382978723403
Kamthi,Brinjal,2016,200,455,255,127.5
Mumbai,Sweet Potato,2016,1068,1323,255,23.876404494382022
Kalyan,Brinjal,2015,1456,1711,255,17.513736263736263
Mumbai,Arvi,2016,1600,1855,255,15.9375
Vadgaon Peth,Cabbage,2015,318,573,255,80.18867924528301
Lasalgaon-Vinchur,Wheat(Husked),2016,1728,1983,255,14.756944444444445
Amarawati,Soybean,2015,3114,3369,255,8.188824662813103
Buldhana,Wheat(Husked),2016,1372,1627,255,18.58600583090379
Shrirampur,Green Gram,2016,4671,4926,255,5.459216441875402
Amarawati,Wheat(Husked),2014,1496,1751,255,17.045454545454547
Aurangabad,Maize(Corn.),2016,589,844,255,43.2937181663837
Karanja,Soybean,2015,3047,3302,255,8.36888743025927
Rahuri,Potato,2016,1600,1855,255,15.9375
Murtizapur,Wheat(Husked),2015,1315,1570,255,19.39163498098859
Digras,Bajri,2015,1295,1550,255,19.69111969111969
Jalna,Soybean,2015,3051,3306,255,8.357915437561456
Manchar,Chavli (Shenga ),2015,800,1055,255,31.875
Nagpur,Rice(Paddy-Hus),2015,2433,2688,255,10.480887792848335
Parola,Sorgum(Jawar),2016,1365,1619,254,18.60805860805861
Mumbai,Snake Gourd,2015,855,1109,254,29.707602339181285
Karanja,Soybean,2016,3627,3881,254,7.003032809484423
Sangrampur-Varvatbakal,Sorgum(Jawar),2016,1200,1454,254,21.166666666666668
Phaltan,Potato,2016,1773,2027,254,14.326001128031585
Ahmednagar,Gram,2015,4109,4363,254,6.181552689218788
Udgir,Black Gram,2015,8923,9177,254,2.8465762635884793
Wardha,COTTON,2016,4687,4941,254,5.41924471943674
Bhokar,Sunflower,2015,2990,3244,254,8.494983277591974
Chandur Bajar,SORGUM(JAWAR),2016,1254,1508,254,20.25518341307815
Purna,Wheat(Husked),2016,1590,1844,254,15.974842767295597
Patan,Brinjal,2015,1207,1461,254,21.04391052195526
Manchar,Shepu,2016,327,581,254,77.67584097859327
Gangapur,Sorgum(Jawar),2015,1444,1698,254,17.590027700831026
Ausa,Safflower,2015,2227,2481,254,11.405478221823081
Barshi,Fodder,2015,406,660,254,62.5615763546798
Mumbai,Shevga,2016,821,1075,254,30.937880633373933
Amarawati,Cabbage,2014,2377,2631,254,10.68573832562053
Nandgaon Khandeshwar,Wheat(Husked),2016,1222,1476,254,20.78559738134206
Nagpur,Cucumber,2014,1723,1977,254,14.741729541497389
Yeola,Bajri,2016,1605,1859,254,15.825545171339565
Karanja,Wheat(Husked),2015,1410,1664,254,18.01418439716312
Jalgaon,Bitter Gourd,2015,3131,3385,254,8.11242414564037
Pandharpur,Cabbage,2015,271,525,254,93.7269372693727
Bhiwapur,Green Gram,2016,5333,5587,254,4.762797674854679
Junnar-Otur,Cabbage,2016,208,462,254,122.11538461538461
Lasur Station,Bajri,2015,1137,1391,254,22.33948988566403
Rahuri-Vambori,Wheat(Husked),2016,1596,1850,254,15.914786967418546
Nagpur,Cluster Bean,2014,1727,1981,254,14.70758540822235
Nagpur,Wheat(Husked),2016,1960,2214,254,12.959183673469388
Hadgaon-Tamsa,Cotton,2016,4364,4618,254,5.8203483043079745
Amarawati,Carrot,2016,2593,2847,254,9.795603548013883
Nagpur,Bottle Gourd,2015,481,735,254,52.80665280665281
Shevgaon-Bodhegaon,Gram,2014,2664,2918,254,9.534534534534535
Nilanga,Gram,2016,4245,4499,254,5.983510011778563
Wardha,Soybean,2016,3249,3503,254,7.817790089258233
Amarawati-Fruit And Vegetables,Carrot,2016,2569,2823,254,9.887115609186454
Rahata,Potato,2016,925,1179,254,27.45945945945946
Bhokar,Wheat(Husked),2015,1354,1608,254,18.75923190546529
Kille Dharur,Soybean,2014,3024,3278,254,8.399470899470899
Majalgaon,Wheat(Husked),2016,1820,2074,254,13.956043956043956
Amarawati,Orange,2014,1046,1300,254,24.282982791587
Hingoli,Soybean,2016,3725,3979,254,6.818791946308725
Akola,Sorgum(Jawar),2015,1197,1451,254,21.219715956558062
Deglur,Gram,2016,4222,4476,254,6.0161061108479394
Chandur Rly.,Soybean,2016,3562,3816,254,7.130825379000561
Lasalgaon,Maize,2016,1181,1435,254,21.507197290431836
Sailu,Sorgum(Jawar),2016,1411,1664,253,17.93054571226081
Lasalgaon-Vinchur,Bajri,2016,1500,1753,253,16.866666666666667
Bhokar,Wheat(Husked),2016,1479,1732,253,17.106152805949968
Armori-Desaiganj,Paddy-Unhusked,2014,1700,1953,253,14.882352941176471
Ratanagari,Cabbage,2015,564,817,253,44.858156028368796
Raver,Bajri,2016,1248,1501,253,20.272435897435898
Nagpur,Chavli (Shenga ),2016,1065,1318,253,23.75586854460094
Tumsar,Pigeon Pea (Tur),2015,6173,6426,253,4.098493439170581
Mohol,Gram,2016,3936,4189,253,6.4278455284552845
Varud-Rajura Bazar,Soybean,2016,3486,3739,253,7.257601835915089
Khed-Chakan,Flower,2016,435,688,253,58.160919540229884
Hadgaon,Soybean,2015,3421,3674,253,7.395498392282958
Tumsar,Green Gram,2015,6175,6428,253,4.097165991902834
Bori,Green Gram,2016,3984,4237,253,6.350401606425703
Basmat,Pigeon Pea (Tur),2015,7725,7978,253,3.2750809061488675
Nandgaon,Bajri,2016,1481,1734,253,17.083051991897367
Vadgaon Peth,Cabbage,2014,491,744,253,51.527494908350306
Nagpur,Coriander  ,2016,771,1024,253,32.81452658884565
Nagpur,Papai,2016,507,760,253,49.90138067061144
Paithan,Wheat(Husked),2015,1464,1717,253,17.281420765027324
Malkapur,Maize,2015,1186,1439,253,21.33220910623946
Pune-Pimpri,Flower,2015,1026,1279,253,24.658869395711502
Mumbai,Sugar,2015,2699,2952,253,9.373842163764357
Patan,Brinjal,2015,738,991,253,34.28184281842818
Bhivandi,Other Vegetables,2015,1133,1386,253,22.33009708737864
Nandurbar,Wheat(Husked),2014,1370,1623,253,18.467153284671532
Parli-Vaijnath,Green Gram,2014,5953,6206,253,4.249958004367546
Nashik,Cabbage,2016,380,633,253,66.57894736842105
Bhokar,Sorgum(Jawar),2015,1225,1478,253,20.653061224489797
Chopda,Gram,2014,2347,2600,253,10.77971878994461
Shirur,Sorgum(Jawar),2016,1484,1737,253,17.048517520215633
Vai,CUCUMBER,2016,1171,1424,253,21.605465414175917
Sailu,Wheat(Husked),2015,1604,1857,253,15.773067331670823
Mul,PADDY-UNHUSKED,2016,1851,2104,253,13.668287412209617
Mul,Paddy-Unhusked,2016,1975,2228,253,12.810126582278482
Chopda,Bajri,2016,1183,1436,253,21.386306001690617
Rajura,Soybean,2015,2971,3224,253,8.51565129585998
Bhandara,Rice(Paddy-Hus),2016,3235,3488,253,7.820710973724884
Telhara,Gram,2016,4061,4314,253,6.229992612656981
Kalamb (Os),Pigeon Pea (Tur),2015,9815,10068,253,2.5776872134488027
Vai,FLOWER,2016,890,1143,253,28.426966292134832
Achalpur,Pigeon Pea (Tur),2014,4550,4803,253,5.56043956043956
Amarawati-Fruit And Vegetables,Carrot,2016,2460,2713,253,10.284552845528456
Nandgaon Khandeshwar,Soybean,2016,2803,3056,253,9.026043524794863
Indapur (Nimgaon Ketki),Wheat(Husked),2015,1441,1694,253,17.557251908396946
Nandura,Wheat(Husked),2016,1520,1773,253,16.644736842105264
Mandhal,Pigeon Pea (Tur),2015,5474,5727,253,4.621848739495798
Mumbai,Cucumber,2015,791,1044,253,31.984829329962075
Bhiwapur,Soybean,2014,3080,3332,252,8.181818181818182
Sailu,Soybean,2015,3307,3559,252,7.620199576655579
Ambejogai,Wheat(Husked),2015,2011,2263,252,12.53107906514172
Chikhali,Wheat(Husked),2015,1394,1646,252,18.077474892395983
Devala,Matki,2016,5511,5763,252,4.57267283614589
Bhokar,Sesamum,2015,6734,6986,252,3.7422037422037424
Mumbai,Elephant Root,2015,1888,2140,252,13.347457627118644
Shegaon,Sorgum(Jawar),2014,1141,1393,252,22.085889570552148
Kopargaon,Bajri,2014,1220,1472,252,20.65573770491803
Kalmeshwar,Chavli (Shenga ),2015,2028,2280,252,12.42603550295858
Nanded,Pigeon Pea (Tur),2015,4824,5076,252,5.223880597014926
Amalner,Sorgum(Jawar),2016,1654,1906,252,15.235792019347038
Aurangabad,Cabbage,2015,752,1004,252,33.51063829787234
Mumbai,Sugar,2015,2489,2741,252,10.124548011249498
Malegaon,Wheat(Husked),2016,1624,1876,252,15.517241379310345
Shegaon,Sorgum(Jawar),2015,1161,1413,252,21.705426356589147
Majalgaon,Gram,2015,3937,4189,252,6.400812801625603
Ramtek,Chavli (Shenga ),2016,962,1214,252,26.195426195426194
Bori,GRAM,2016,6364,6616,252,3.9597737272155875
Nagpur,Cabbage,2016,940,1192,252,26.80851063829787
Ramtek,Tomato,2015,1087,1339,252,23.183072677092916
Aurangabad,Carrot,2015,881,1133,252,28.603859250851304
Nagbhid,Paddy-Unhusked,2015,1716,1968,252,14.685314685314685
Pune,Sorgum(Jawar),2016,2876,3128,252,8.762169680111265
Hingoli,Soybean,2015,3308,3560,252,7.617896009673519
Kalyan,Elephant Root,2015,2213,2465,252,11.387257117035698
Jintur,SOYBEAN,2016,2545,2797,252,9.901768172888016
Malegaon,Green Gram,2016,6200,6452,252,4.064516129032258
Manora,Soybean,2016,2789,3041,252,9.035496593761204
Kalyan,Tomato,2016,1137,1389,252,22.16358839050132
Murbad,Ladies Finger,2015,3432,3684,252,7.3426573426573425
Aurangabad,Potato,2016,989,1241,252,25.480283114256824
Deulgaon Raja,COTTON,2016,4681,4933,252,5.3834650715659045
Chimur,Pigeon Pea (Tur),2016,7520,7772,252,3.351063829787234
Tumsar,Green Gram,2016,4214,4466,252,5.980066445182724
Shrirampur,Tomato,2016,787,1039,252,32.020330368487926
Telhara,Wheat(Husked),2016,1538,1790,252,16.384915474642394
Kalyan,Potato,2016,1088,1340,252,23.16176470588235
Mumbai,Carrot,2016,738,990,252,34.146341463414636
Pombhurni,PADDY-UNHUSKED,2016,1908,2160,252,13.20754716981132
Chikhali,Wheat(Husked),2015,1416,1667,251,17.725988700564972
Ausa,Sorgum(Jawar),2015,1482,1733,251,16.936572199730094
Arvi,Soybean,2015,2985,3236,251,8.408710217755443
Akot,Soybean,2015,3100,3351,251,8.096774193548388
Junnar-Otur,Cabbage,2016,188,439,251,133.51063829787233
Nandura,Sorgum(Jawar),2016,1313,1564,251,19.116527037319116
Shrirampur,Cucumber,2015,1362,1613,251,18.4287812041116
Bhandara,Rice(Paddy-Hus),2015,2601,2852,251,9.650134563629374
Mumbai,Tomato,2015,1143,1394,251,21.95975503062117
Kopargaon,Wheat(Husked),2014,1427,1678,251,17.589348283111423
Sailu,Soybean,2016,3150,3401,251,7.968253968253968
Solapur,Banana,2016,795,1046,251,31.572327044025158
Jawala-Bajar,Ground Nut Pods (Dry),2015,5125,5376,251,4.897560975609756
Parbhani,Gram,2014,2200,2451,251,11.409090909090908
Pandharkawada,Cotton,2015,3750,4001,251,6.693333333333333
Buldhana,Green Gram,2016,4333,4584,251,5.792753288714517
Lasalgaon,Black Gram,2015,7500,7751,251,3.3466666666666667
Mumbai,Sugar,2015,2673,2924,251,9.390198279087167
Murum,Green Gram,2016,5050,5301,251,4.97029702970297
Tuljapur,GREEN GRAM,2016,4550,4801,251,5.516483516483516
Shahapur,Paddy-Unhusked,2015,1600,1851,251,15.6875
Karanja,Sorgum(Jawar),2016,1663,1914,251,15.093205051112447
Pune,Lemon,2015,74,325,251,339.18918918918916
Chikhali,Wheat(Husked),2016,1424,1675,251,17.626404494382022
Pune,Lemon,2015,71,322,251,353.5211267605634
Washim-Ansing,Soybean,2016,3523,3774,251,7.124609707635538
Malegaon,Ground Nut Pods (Dry),2016,4000,4251,251,6.275
Indapur-Bhigwan,Sunflower,2015,2933,3184,251,8.557790658029322
Dondaicha-Sindkheda,Bajri,2016,1086,1337,251,23.112338858195212
Nira,Jaggery,2014,3126,3377,251,8.029430582213692
Kalamb (Os),Coriander (Dry),2015,8200,8451,251,3.0609756097560976
Devala,Bajri,2014,1304,1555,251,19.24846625766871
Telhara,Gram,2015,3568,3819,251,7.0347533632287
Kalmeshwar,Gram,2015,3910,4161,251,6.419437340153452
Vaijapur,Black Gram,2016,6488,6739,251,3.868680641183724
Akluj,Wheat(Husked),2015,1618,1869,251,15.512978986402967
Nandurbar,Maize,2016,1004,1255,251,25.0
Digras,Gram,2015,4107,4358,251,6.111516922327733
Kalmeshwar,Bottle Gourd,2016,937,1188,251,26.78762006403415
Latur,Safflower,2016,2555,2806,251,9.823874755381604
Paithan,Bajri,2015,1296,1547,251,19.367283950617285
Sailu,Wheat(Husked),2015,1520,1771,251,16.513157894736842
Shirur,Sorgum(Jawar),2016,1440,1691,251,17.430555555555557
Parbhani,Pigeon Pea (Tur),2015,4879,5130,251,5.144496823119492
Lonar,Gram,2016,4923,5174,251,5.098517164330692
Vani,Pigeon Pea (Tur),2016,5668,5919,251,4.428369795342272
Nashik,BOTTLE GOURD,2016,224,475,251,112.05357142857143
Dondaicha,Bajri,2016,1318,1569,251,19.04400606980273
Kalmeshwar,Brinjal,2016,1168,1419,251,21.48972602739726
Umared,Mustard,2015,2995,3246,251,8.380634390651085
Pune,Sorgum(Jawar),2016,2270,2520,250,11.013215859030836
Lonand,Gram,2016,6150,6400,250,4.065040650406504
Kalyan,Curry Leaves,2016,1250,1500,250,20.0
Jafrabad,Sorgum(Jawar),2014,850,1100,250,29.41176470588235
Kalyan,Flower,2016,761,1011,250,32.8515111695138
Ramtek,Maize(Corn.),2016,917,1167,250,27.262813522355508
Aurangabad,Awala,2016,888,1138,250,28.153153153153152
Malegaon (Washim),Gram,2015,3800,4050,250,6.578947368421052
Vadgaon Peth,Cabbage,2015,350,600,250,71.42857142857143
Barshi,Spinach,2014,200,450,250,125.0
Koregaon,Coriander (Dry),2014,10200,10450,250,2.450980392156863
Sillod,Safflower,2016,2650,2900,250,9.433962264150944
Tasgaon,Ghevda Seed,2015,2800,3050,250,8.928571428571429
Shirpur,Soybean,2014,2650,2900,250,9.433962264150944
Kalyan,Indian Bean,2016,6800,7050,250,3.676470588235294
Bhokar,Wheat(Husked),2016,1471,1721,250,16.99524133242692
Buldhana,Wheat(Husked),2016,1377,1627,250,18.15541031227306
Koregaon,Ghevda Seed,2015,3950,4200,250,6.329113924050633
Kalyan,Carrot,2015,2025,2275,250,12.345679012345679
Jalgaon Jamod-Aasalgaon,Gram,2014,2175,2425,250,11.494252873563218
Nira-Saswad,Green Gram,2016,4850,5100,250,5.154639175257732
Panvel,Snake Gourd,2014,2550,2800,250,9.803921568627452
Tuljapur,Gram,2015,4600,4850,250,5.434782608695652
Pune,Bajri,2015,1819,2069,250,13.743815283122595
Achalpur,Lentil,2015,5213,5463,250,4.79570305006714
Vai,Onion,2016,450,700,250,55.55555555555556
Nagbhid,Wheat(Husked),2015,1450,1700,250,17.24137931034483
Nandura,Sunflower,2015,2510,2760,250,9.9601593625498
Tasgaon,Black Gram,2014,4300,4550,250,5.813953488372093
Satara,Cabbage,2015,515,765,250,48.54368932038835
Malegaon (Washim),Sorgum(Jawar),2015,1450,1700,250,17.24137931034483
Parbhani,Wheat(Husked),2016,1550,1800,250,16.129032258064516
Ghoti,Ladies Finger,2014,1693,1943,250,14.766686355581808
Nagpur,Parwar,2015,2450,2700,250,10.204081632653061
Panvel,Brinjal,2014,2850,3100,250,8.771929824561404
Shirpur,Bajri,2016,1293,1543,250,19.334880123743233
Kurdwadi,Lemon,2016,100,350,250,250.0
Amarawati,Gram,2014,2500,2750,250,10.0
Kurdwadi,Lemon,2016,100,350,250,250.0
Nagpur,Parwar,2015,1100,1350,250,22.727272727272727
Patan,Capsicum,2016,3000,3250,250,8.333333333333334
Malegaon,Wheat(Husked),2016,1531,1781,250,16.329196603527105
Taloda,Wheat(Husked),2016,1560,1810,250,16.025641025641026
Koregaon,Wheat(Husked),2016,1600,1850,250,15.625
Shrirampur,Sorgum(Jawar),2015,1558,1808,250,16.046213093709884
Sakri,Gram,2015,3349,3599,250,7.4649148999701405
Navapur,Other Cereals,2016,2400,2650,250,10.416666666666666
Sonpeth,Pigeon Pea (Tur),2016,5044,5294,250,4.956383822363204
Barshi,Wheat(Husked),2016,1715,1965,250,14.577259475218659
Panvel,Ridge Gourd,2014,3383,3633,250,7.389890629618682
Navapur,Methi (Bhaji),2016,2750,3000,250,9.090909090909092
Buldhana-Dhad,Maize,2016,1050,1300,250,23.80952380952381
Nandura,Sesamum,2015,6500,6750,250,3.8461538461538463
Tasgaon,Soybean,2014,2950,3200,250,8.474576271186441
Akhadabalapur,Black Gram,2015,5000,5250,250,5.0
Bhiwapur,Pigeon Pea (Tur),2015,5000,5250,250,5.0
Koregaon,Sorgum(Jawar),2015,1600,1850,250,15.625
Ramtek,Ladies Finger,2016,1250,1500,250,20.0
Rahata,Lemon,2015,3875,4125,250,6.451612903225806
Manchar,Ghevda,2016,3500,3750,250,7.142857142857143
Vai,Flower,2014,2150,2400,250,11.627906976744185
Amarawati,Cabbage,2016,2083,2333,250,12.00192030724916
Jafrabad,Soybean,2015,2950,3200,250,8.474576271186441
Kada,PIGEON PEA (TUR),2016,4700,4950,250,5.319148936170213
Mumbai,Sweet Potato,2016,988,1238,250,25.303643724696357
Kada,Gram,2016,4000,4250,250,6.25
Nagpur,Spinach,2016,763,1013,250,32.765399737876805
Pune-Moshi,Small Gourd,2016,1875,2125,250,13.333333333333334
Manchar,Capsicum,2015,2200,2450,250,11.363636363636363
Pune-Pimpri,Sorgum(Jawar),2016,2500,2750,250,10.0
Manchar,Bitter Gourd,2016,633,883,250,39.494470774091624
Manchar,Brinjal,2015,1400,1650,250,17.857142857142858
Manchar,Beet Root,2015,800,1050,250,31.25
Aurangabad,FLOWER,2016,742,992,250,33.692722371967655
Satara,Ghevda,2015,1167,1417,250,21.422450728363327
Pune-Moshi,Small Gourd,2016,2278,2528,250,10.974539069359087
Ahmednagar,Pigeon Pea (Tur),2016,5951,6201,250,4.200974626113259
Ramtek,BITTER GOURD,2016,1700,1950,250,14.705882352941176
Manchar,Cabbage,2014,100,350,250,250.0
Bhivandi,Onion,2016,1006,1256,250,24.85089463220676
Nagpur,SPINACH,2016,572,822,250,43.70629370629371
Aarni,Wheat(Husked),2015,1050,1300,250,23.80952380952381
Kada,Bajri,2015,1315,1565,250,19.011406844106464
Taloda,MAIZE,2016,1120,1370,250,22.321428571428573
Nandurbar,Shepa,2014,5900,6150,250,4.237288135593221
Indapur,Black Gram,2015,8000,8250,250,3.125
Kada (Ashti),Gram,2016,4125,4375,250,6.0606060606060606
Solapur,Carrot,2016,1700,1950,250,14.705882352941176
Kalamb (Os),Sesamum,2015,7580,7830,250,3.2981530343007917
Pune-Pimpri,Bitter Gourd,2014,2357,2607,250,10.606703436571914
Pune-Pimpri,Tomato,2016,750,1000,250,33.333333333333336
Aurangabad,Awala,2015,550,800,250,45.45454545454545
Jafrabad,Gram,2016,4750,5000,250,5.2631578947368425
Ramtek,Ladies Finger,2015,889,1139,250,28.1214848143982
Umarga,Sesamum,2016,5950,6200,250,4.201680672268908
Murbad,Brinjal,2015,3467,3717,250,7.210845111047015
Parola,Gram,2016,2106,2356,250,11.870845204178538
Tuljapur,Soybean,2016,3600,3850,250,6.944444444444445
Murbad,Capsicum,2014,2250,2500,250,11.11111111111111
Kada (Ashti),Pigeon Pea (Tur),2016,6250,6500,250,4.0
Murbad,Capsicum,2014,4160,4410,250,6.009615384615385
Nanded,Gram,2015,4151,4401,250,6.022645145748013
Pune,Wheat(Husked),2016,2151,2401,250,11.622501162250117
Varud-Rajura Bazar,Pigeon Pea (Tur),2015,7300,7550,250,3.4246575342465753
Hanegaon,Pigeon Pea (Tur),2016,8100,8350,250,3.0864197530864197
Ratanagari,Sweet Potato,2016,2000,2250,250,12.5
Lasur Station,Wheat(Husked),2016,1599,1849,250,15.634771732332707
Sailu,Sorgum(Jawar),2014,1350,1600,250,18.51851851851852
Jalgaon,Papai,2014,1200,1450,250,20.833333333333332
Manchar,Walvad,2015,2800,3050,250,8.928571428571429
Sangamner,Sorgum(Jawar),2014,1538,1788,250,16.25487646293888
Ahmedpur,Gram,2015,3467,3717,250,7.210845111047015
Ahmedpur,Gram,2015,3513,3763,250,7.116424708226587
Amarawati,Black Gram,2015,5281,5531,250,4.733951903048665
Daryapur,Soybean,2015,3120,3370,250,8.012820512820513
Kalyan,Bitter Gourd,2014,1450,1700,250,17.24137931034483
Patan,Flower,2015,650,900,250,38.46153846153846
Lasalgaon,Wheat(Husked),2014,1526,1776,250,16.382699868938403
Dhule,Sesamum,2014,10733,10983,250,2.3292648840026087
Kalyan,Capsicum,2014,3000,3250,250,8.333333333333334
Amarawati,Cluster Bean,2015,2250,2500,250,11.11111111111111
Shahapur,Ghosali(Bhaji),2014,967,1217,250,25.853154084798344
Sillod,Mustard,2016,4150,4400,250,6.024096385542169
Jintur-Bori,Gram,2015,3800,4050,250,6.578947368421052
Amarawati,Bitter Gourd,2015,2800,3050,250,8.928571428571429
Ramtek,Cluster Bean,2016,1935,2185,250,12.919896640826874
Gondiya,Rice(Paddy-Hus),2016,1150,1400,250,21.73913043478261
Manmad,Bajri,2015,1195,1445,250,20.92050209205021
Kalyan,Potato,2014,2050,2300,250,12.195121951219512
Sillod,Mustard,2016,4250,4500,250,5.882352941176471
Jalgaon,Pigeon Pea (Tur),2016,7150,7400,250,3.4965034965034967
Buldhana,Sorgum(Jawar),2016,1355,1605,250,18.45018450184502
Kalyan,Bajri,2015,1600,1850,250,15.625
Rahuri-Songaon,Bajri,2016,1300,1550,250,19.23076923076923
Kalyan,Bitter Gourd,2015,1988,2238,250,12.575452716297788
Barshi-Vairag,Wheat(Husked),2015,1832,2082,250,13.646288209606986
Tuljapur,Wheat(Husked),2015,1358,1608,250,18.40942562592047
Amarawati,Green Chilli,2015,2100,2350,250,11.904761904761905
Nandurbar,Safflower,2016,3250,3500,250,7.6923076923076925
Nagpur,Bottle Gourd,2016,636,886,250,39.308176100628934
Pune-Pimpri,Potato,2016,1300,1550,250,19.23076923076923
Loha,Wheat(Husked),2015,1500,1750,250,16.666666666666668
Patan,Brinjal,2014,1462,1712,250,17.09986320109439
Mumbai,Horse Gram,2016,2950,3200,250,8.474576271186441
Lasalgaon-Niphad,Wheat(Husked),2016,1577,1827,250,15.85288522511097
Ausa,Green Gram,2015,7551,7801,250,3.3108197589723214
Patan,Flower,2014,1425,1675,250,17.54385964912281
Varud-Rajura Bazar,Soybean,2015,3008,3258,250,8.311170212765957
Pune,Jack Fruit(Raw),2015,850,1100,250,29.41176470588235
Malkapur,Wheat(Husked),2015,1429,1679,250,17.49475157452764
Solapur,Spinach,2015,250,500,250,100.0
Rahuri-Vambori,Ground Nut Pods (Dry),2015,3000,3250,250,8.333333333333334
Junnar-Otur,Capsicum,2016,250,500,250,100.0
Pusad,Gram,2015,3905,4155,250,6.402048655569782
Jalgaon,Pigeon Pea (Tur),2015,6500,6750,250,3.8461538461538463
Yawal,Sorgum(Jawar),2016,1230,1480,250,20.32520325203252
Dound,Green Gram,2016,5950,6200,250,4.201680672268908
Ramtek,Chavli (Shenga ),2016,828,1078,250,30.193236714975846
Palus,Sweet Potato,2015,500,750,250,50.0
Umarkhed,Gram,2016,8350,8600,250,2.9940119760479043
Patan,Cabbage,2015,569,819,250,43.936731107205624
Washim,Soybean,2014,3057,3307,250,8.177952240758914
Navapur,Flower,2016,1000,1250,250,25.0
Akhadabalapur,Gram,2015,4000,4250,250,6.25
Chandrapur-Ganjwad,Brinjal,2016,313,563,250,79.87220447284345
Rahata,Cucumber,2015,667,917,250,37.481259370314845
Washim,Gram,2016,8267,8517,250,3.024071610015725
Chandvad,Ladies Finger,2016,3295,3545,250,7.587253414264036
Rahata,Cluster Bean,2016,4000,4250,250,6.25
Sangrampur-Varvatbakal,Maize,2016,1050,1300,250,23.80952380952381
Rahata,Shevga,2014,3050,3300,250,8.19672131147541
Shahada,Cotton,2015,3700,3950,250,6.756756756756757
Kolhapur-Malkapur,Cluster Bean,2016,358,608,250,69.83240223463687
Panvel,Brinjal,2016,1250,1500,250,20.0
Shirpur,Soybean,2016,2750,3000,250,9.090909090909092
Kolhapur-Malkapur,Cluster Bean,2016,283,533,250,88.33922261484099
Panvel,Brinjal,2016,2400,2650,250,10.416666666666666
Rahata,Cucumber,2016,500,750,250,50.0
Rahata,Cucumber,2016,460,710,250,54.34782608695652
Umared,Lang,2016,3306,3556,250,7.562008469449486
Parbhani,Gram,2015,4250,4500,250,5.882352941176471
Chandrapur-Ganjwad,Bitter Gourd,2015,400,650,250,62.5
Chandur Rly.,Green Gram,2016,4780,5030,250,5.2301255230125525
Karad,Sweet Potato,2015,720,970,250,34.72222222222222
Bhandara,Rice(Paddy-Hus),2015,2571,2821,250,9.723842862699339
Ghansawangi,Cotton,2016,4325,4575,250,5.780346820809249
Nagpur,Melon,2016,467,717,250,53.53319057815846
Barshi,Neem-Seed,2016,875,1125,250,28.571428571428573
Kolhapur,Beet Root,2016,750,1000,250,33.333333333333336
Nagpur,Bitter Gourd,2015,1704,1954,250,14.671361502347418
Karad,Flower,2015,950,1200,250,26.31578947368421
Akola,Bajri,2016,1650,1900,250,15.151515151515152
Panvel,Cluster Bean,2016,2300,2550,250,10.869565217391305
Karad,Potato,2015,963,1213,250,25.96053997923157
Nashik-Devlali,Tandulja,2016,750,1000,250,33.333333333333336
Malegaon,Wheat(Husked),2014,1436,1686,250,17.409470752089135
Shirur,Green Gram,2015,6960,7210,250,3.5919540229885056
Jawala-Bajar,Sorgum(Jawar),2015,1550,1800,250,16.129032258064516
Jamkhed,Soybean,2015,3000,3250,250,8.333333333333334
Panvel,Snake Gourd,2015,1967,2217,250,12.709710218607016
Nilanga,Soybean,2016,3150,3400,250,7.936507936507937
Jamkhed,Soybean,2015,3000,3250,250,8.333333333333334
Ghansawangi,Bajri,2016,1550,1800,250,16.129032258064516
Kinwat,Pigeon Pea (Tur),2015,5350,5600,250,4.672897196261682
Malegaon,Wheat(Husked),2014,1421,1671,250,17.593244194229417
Jamner,Cotton,2015,3750,4000,250,6.666666666666667
Chimur,Soybean,2016,3260,3510,250,7.668711656441718
Rahata,Bitter Gourd,2015,2375,2625,250,10.526315789473685
Pune-Pimpri,Chavli (Shenga ),2016,3000,3250,250,8.333333333333334
Shirur,Green Gram,2014,6450,6700,250,3.875968992248062
Pune-Pimpri,Bajri,2016,2100,2350,250,11.904761904761905
Risod,Wheat(Husked),2015,1425,1675,250,17.54385964912281
Kolhapur-Laxmipuri,Bajri,2015,2050,2300,250,12.195121951219512
Ghansawangi,Gram,2015,3050,3300,250,8.19672131147541
Beed,Gram,2016,6300,6550,250,3.9682539682539684
Solapur,Guava,2015,2250,2500,250,11.11111111111111
Chikhali,Soybean,2016,3557,3807,250,7.028394714647175
Balapur,Black Gram,2015,5550,5800,250,4.504504504504505
Washim-Ansing,GRAM,2016,7000,7250,250,3.5714285714285716
Nagpur,Rice(Paddy-Hus),2014,3550,3800,250,7.042253521126761
Washim-Ansing,Black Gram,2016,9400,9650,250,2.6595744680851063
Kolhapur,Melon,2016,2000,2250,250,12.5
Indapur (Nimgaon Ketki),Bajri,2016,1801,2051,250,13.8811771238201
Mumbai,Arvi,2015,2675,2925,250,9.345794392523365
Jamkhed,Wheat(Husked),2016,1650,1900,250,15.151515151515152
Rahata,Walvad,2014,1500,1750,250,16.666666666666668
Umared,Linseed,2016,5059,5309,250,4.941688080648349
Shevgaon,Green Gram,2016,3967,4217,250,6.301991429291657
Nashik-Devlali,Ambat Chuka,2016,163,413,250,153.37423312883436
Nashik-Devlali,Ambat Chuka,2016,150,400,250,166.66666666666666
Solapur,Green Peas (Dry),2015,5900,6150,250,4.237288135593221
Mahagaon,WHEAT(HUSKED),2016,1550,1800,250,16.129032258064516
Jalna,Rajgira,2015,4750,5000,250,5.2631578947368425
Sangali,Bajri,2016,1600,1850,250,15.625
Ghansawangi,Soybean,2014,2838,3088,250,8.809020436927414
Nagpur,Parwar,2014,1314,1564,250,19.025875190258752
Nagpur,Spinach,2014,1323,1573,250,18.89644746787604
Rahata,Shevga,2016,2000,2250,250,12.5
Bhokar,PIGEON PEA (TUR),2016,5808,6058,250,4.304407713498622
Rahata,Lemon,2016,5458,5708,250,4.580432392817882
Manwat,Pigeon Pea (Tur),2016,6200,6450,250,4.032258064516129
Rahata,Mango(Raw),2016,2583,2833,250,9.67866821525358
Palus,Cucumber,2016,800,1050,250,31.25
Barshi,Chillies(Red),2016,600,850,250,41.666666666666664
Beed,Pigeon Pea (Tur),2016,7499,7749,250,3.333777837044939
Nira-Saswad,Ghevda Seed,2016,1250,1500,250,20.0
Shrirampur,Potato,2015,942,1192,250,26.53927813163482
Chalisgaon,Soybean,2015,3000,3250,250,8.333333333333334
Chandrapur-Ganjwad,Spinach,2016,625,875,250,40.0
Indapur-Bhigwan,Maize,2016,1872,2122,250,13.354700854700855
Achalpur,Rajgira,2015,4038,4288,250,6.191183754333829
Ambad(Vadi Godri),MAIZE,2016,969,1219,250,25.799793601651185
Jalna-Badnapur,Sorgum(Jawar),2015,1050,1300,250,23.80952380952381
Pune-Moshi,Elephant Root,2016,2125,2375,250,11.764705882352942
Chandur Bajar,Sorgum(Jawar),2014,1300,1550,250,19.23076923076923
Kopargaon,Soybean,2016,3437,3687,250,7.273785277858598
Navapur,Brinjal,2016,1600,1850,250,15.625
Ratanagari,Sweet Potato,2014,950,1200,250,26.31578947368421
Navapur,Brinjal,2016,2042,2292,250,12.242899118511264
Chandur Bajar,Wheat(Husked),2014,1450,1700,250,17.24137931034483
Chandrapur-Ganjwad,Cabbage,2016,245,495,250,102.04081632653062
Paranda,Cotton,2014,3800,4050,250,6.578947368421052
Vaijapur,Bajri,2016,1738,1988,250,14.384349827387801
Palus,Carrot,2016,1167,1417,250,21.422450728363327
Panvel,Ridge Gourd,2016,1400,1650,250,17.857142857142858
Palus,Carrot,2016,650,900,250,38.46153846153846
Jalgaon Jamod-Aasalgaon,Soybean,2015,3225,3475,250,7.751937984496124
Balapur,Sorgum(Jawar),2015,1190,1440,250,21.008403361344538
Nira,Jaggery,2015,2925,3175,250,8.547008547008547
Panvel,Ridge Gourd,2016,4213,4463,250,5.9340137669119395
Jalna-Badnapur,Pigeon Pea (Tur),2016,8150,8400,250,3.067484662576687
Rahata,Ground Nut Pods (Dry),2015,2667,2917,250,9.373828271466067
Chandrapur-Ganjwad,Potato,2016,1408,1658,250,17.755681818181817
Navapur,Cucumber,2016,250,500,250,100.0
Indapur-Bhigwan,Pavtta,2016,2650,2900,250,9.433962264150944
Shegaon,Soybean,2015,2964,3214,250,8.434547908232119
Nandura,Maize,2015,1165,1415,250,21.459227467811157
Nagpur,Castor Seed,2015,3000,3250,250,8.333333333333334
Raver,Wheat(Husked),2016,1601,1851,250,15.61524047470331
Anajngaon Surji,Banana,2015,650,900,250,38.46153846153846
Mahur,Ground Nut Pods (Dry),2016,4600,4850,250,5.434782608695652
Kalyan,Tomato,2016,869,1119,250,28.768699654775602
Khed (Shel Pimpalgaon),Shevga,2016,3250,3500,250,7.6923076923076925
Panvel,Flower,2016,1250,1500,250,20.0
Nagpur,Maize(Corn.),2016,567,817,250,44.091710758377424
Pune-Pimpri,Walvad,2015,1850,2100,250,13.513513513513514
Akkalkuwa,Wheat(Husked),2015,1200,1450,250,20.833333333333332
Nandgaon,Soybean,2016,3284,3534,250,7.612667478684531
Nagpur,Coriander (Dry),2014,9750,10000,250,2.5641025641025643
Rahata,Cluster Bean,2014,5000,5250,250,5.0
Chandur Bajar,Wheat(Husked),2016,1575,1825,250,15.873015873015873
Ghansawangi,Sorgum(Jawar),2016,1600,1850,250,15.625
Chandur Rly.,Gram,2015,3600,3850,250,6.944444444444445
Osmanabad,Shepu,2016,850,1100,250,29.41176470588235
Bhiwapur,Pigeon Pea (Tur),2016,6900,7150,250,3.6231884057971016
Osmanabad,Ground Nut Pods (Dry),2016,5000,5250,250,5.0
Soygaon,Cotton,2015,3800,4050,250,6.578947368421052
Solapur,GOOSEFOOT,2016,350,600,250,71.42857142857143
Umarkhed-Danki,Soybean,2016,3450,3700,250,7.246376811594203
Nagpur,Linseed,2015,4300,4550,250,5.813953488372093
Nagpur,Linseed,2015,4100,4350,250,6.097560975609756
Savner,Soybean,2015,2750,3000,250,9.090909090909092
Chandur Rly.,Pigeon Pea (Tur),2015,6500,6750,250,3.8461538461538463
Panvel,Cucumber,2015,1250,1500,250,20.0
Sinner,Soybean,2015,3700,3950,250,6.756756756756757
Karad,Banana,2015,613,863,250,40.783034257748774
Chandur Bajar,Sorgum(Jawar),2016,1300,1550,250,19.23076923076923
Khed-Chakan,Spinach,2016,400,650,250,62.5
Panvel,Cucumber,2015,2000,2250,250,12.5
Khed-Chakan,Shepu,2016,400,650,250,62.5
Ramtek,Potato,2016,750,1000,250,33.333333333333336
Umarkhed-Danki,Pigeon Pea (Tur),2016,8450,8700,250,2.9585798816568047
Gangapur,Soybean,2014,2796,3046,250,8.94134477825465
Khed-Chakan,Potato,2016,1400,1650,250,17.857142857142858
Tasgaon,Soybean,2015,3354,3604,250,7.4537865235539655
Aurangabad,Cucumber,2015,407,657,250,61.42506142506142
Vaijapur,Sorgum(Jawar),2015,1489,1738,249,16.722632639355272
Mohol,Wheat(Husked),2015,1635,1884,249,15.229357798165138
Lasur Station,Maize,2014,914,1163,249,27.24288840262582
Shevgaon,Sorgum(Jawar),2016,1783,2032,249,13.965227145260796
Rahata,Soybean,2015,3300,3549,249,7.545454545454546
Junnar-Otur,Brinjal,2016,195,444,249,127.6923076923077
Partur,WHEAT(HUSKED),2016,1871,2120,249,13.308391234633886
Nandurbar,Maize,2015,1388,1637,249,17.939481268011527
Kej,Gram,2016,3965,4214,249,6.279949558638084
Digras,Pigeon Pea (Tur),2015,8780,9029,249,2.835990888382688
Katol,Mosambi,2016,2800,3049,249,8.892857142857142
Indapur,Jaggery,2015,2205,2454,249,11.29251700680272
Udgir,Jaggery,2015,1906,2155,249,13.064008394543547
Mangrulpeer,Wheat(Husked),2015,1274,1523,249,19.5447409733124
Kalvan,Bajri,2016,1537,1786,249,16.20039037085231
Murum,Gram,2015,3791,4040,249,6.568187813241889
Yawal,Onion,2016,955,1204,249,26.073298429319372
Vaijapur,Bajri,2015,1544,1793,249,16.126943005181346
Chopda,Black Gram,2015,6884,7133,249,3.617083091226031
Paithan,Bajri,2016,1349,1598,249,18.458117123795404
Malegaon,Bajri,2015,1251,1500,249,19.904076738609113
Dhamangaon-Rly,Soybean,2016,3450,3699,249,7.217391304347826
Achalpur,Soybean,2015,3751,4000,249,6.63822980538523
Nashik,Spinach,2014,205,454,249,121.46341463414635
Manmad,Bajri,2016,1571,1820,249,15.8497772119669
Devala,Maize,2015,1240,1489,249,20.080645161290324
Jintur,Wheat(Husked),2016,1719,1968,249,14.485165794066317
Bhokar,Sesamum,2016,6133,6382,249,4.060003261046796
Phaltan,Maize,2015,1425,1674,249,17.473684210526315
Devala,Maize,2014,952,1201,249,26.15546218487395
Jalgaon,Gram,2016,4734,4983,249,5.259822560202788
Akot,Sunflower,2016,2587,2836,249,9.625048318515654
Nira-Saswad,CORIANDER (DRY),2016,5751,6000,249,4.329681794470527
Nagbhid,Paddy-Unhusked,2015,1720,1969,249,14.476744186046512
Majalgaon,Wheat(Husked),2016,1620,1869,249,15.37037037037037
Risod,Green Gram,2016,4924,5173,249,5.056864337936637
Mangalwedha,Gram,2015,3718,3967,249,6.697149004841313
Telhara,Gram,2015,2986,3234,248,8.305425318151373
Nagpur,Potato,2015,581,829,248,42.68502581755594
Manmad,Wheat(Husked),2015,1314,1562,248,18.873668188736684
Akola,Soybean,2014,2979,3227,248,8.324941255454851
Kada,Pigeon Pea (Tur),2015,4800,5048,248,5.166666666666667
Manora,Soybean,2016,3313,3561,248,7.485662541503169
Lasalgaon-Niphad,Wheat(Husked),2016,1658,1906,248,14.957780458383594
Akola,Soybean,2015,3021,3269,248,8.209202250910295
Mahur,Cotton,2016,4104,4352,248,6.042884990253412
Malkapur,Wheat(Husked),2015,1365,1613,248,18.168498168498168
Nagpur,Capsicum,2014,2124,2372,248,11.67608286252354
Kurdwadi,Wheat(Husked),2015,1538,1786,248,16.124837451235372
Malegaon (Washim),Soybean,2014,3051,3299,248,8.12848246476565
Amarawati,Wheat(Husked),2015,1590,1838,248,15.59748427672956
Kalamb (Yawatmal),Cotton,2015,4058,4306,248,6.1113849186791525
Mumbai,Potato,2015,802,1050,248,30.92269326683292
Fulambri,Cotton,2015,4421,4669,248,5.609590590364171
Aurangabad,Cabbage,2014,676,924,248,36.68639053254438
Mohol,Wheat(Husked),2015,1542,1790,248,16.08300907911803
Nagpur,Ladies Finger,2014,1684,1932,248,14.726840855106888
Shevgaon-Bodhegaon,Gram,2016,5581,5829,248,4.443648091739831
Kalmeshwar,Ladies Finger,2015,1992,2240,248,12.449799196787149
Raver,Wheat(Husked),2015,1399,1647,248,17.726947819871338
Dondaicha-Sindkheda,Bajri,2016,1338,1586,248,18.53512705530643
Vaijapur,Green Gram,2015,8848,9096,248,2.8028933092224233
Tuljapur,Black Gram,2015,8297,8545,248,2.989032180306135
Shevgaon,Wheat(Husked),2015,1537,1785,248,16.135328562134028
Malegaon,Maize,2014,982,1230,248,25.254582484725052
Karad,Tomato,2016,476,724,248,52.10084033613445
Patan,Tomato,2014,1040,1288,248,23.846153846153847
Chandrapur-Ganjwad,Potato,2016,1559,1807,248,15.907633098139833
Sinner,Maize,2015,998,1246,248,24.849699398797597
Shegaon,Sorgum(Jawar),2015,1192,1440,248,20.80536912751678
Nagpur,Green Chilli,2015,1800,2048,248,13.777777777777779
Tumsar,Wheat(Husked),2015,1326,1574,248,18.702865761689292
Parli-Vaijnath,Soybean,2016,3551,3799,248,6.98394818361025
Vaijapur,Horse Gram,2016,3444,3692,248,7.200929152148665
Sangamner,Wheat(Husked),2016,1710,1958,248,14.502923976608187
Ambad(Vadi Godri),Wheat(Husked),2015,1470,1718,248,16.87074829931973
Bhandara,Rice(Paddy-Hus),2014,3386,3634,248,7.324276432368577
Kannad,Wheat(Husked),2016,1730,1978,248,14.335260115606937
Pathardi,Bajri,2015,1281,1529,248,19.359875097580016
Kalyan,Brinjal,2016,1796,2044,248,13.808463251670378
Tumsar,Sarsav,2015,3020,3268,248,8.211920529801324
Buldhana,Wheat(Husked),2015,1420,1668,248,17.464788732394368
Aurangabad,Potato,2015,677,925,248,36.63220088626292
Gevrai,Sorgum(Jawar),2015,1353,1601,248,18.329637841832962
Karad,Tomato,2016,524,772,248,47.32824427480916
Paithan,Gram,2016,3884,4132,248,6.385169927909372
Dhamangaon-Rly,Wheat(Husked),2015,1177,1425,248,21.07051826677995
Washim,Black Gram,2014,4332,4580,248,5.724838411819022
Lohara,Soybean,2015,3422,3670,248,7.247223845704267
Nagpur,Capsicum,2015,1464,1712,248,16.939890710382514
Kolhapur-Laxmipuri,Split Lentil,2016,6000,6248,248,4.133333333333334
Kinwat,Ground Nut Pods (Dry),2016,4876,5124,248,5.086136177194422
Akola,Sorgum(Jawar),2015,1275,1522,247,19.372549019607842
Purna,Wheat(Husked),2015,1508,1755,247,16.379310344827587
Nampur,Bajri,2016,1167,1414,247,21.165381319622966
Patur,Soybean,2015,3008,3255,247,8.211436170212766
Nandura,Sorgum(Jawar),2015,1190,1437,247,20.756302521008404
Gevrai,Gram,2015,2304,2551,247,10.72048611111111
Kannad,Wheat(Husked),2014,1409,1656,247,17.530163236337827
Nandurbar,Bajri,2015,1118,1365,247,22.093023255813954
Purna,Gram,2016,3851,4098,247,6.413918462736952
Latur,Maize,2015,1371,1618,247,18.016046681254558
Khamgaon,Wheat(Husked),2015,1334,1581,247,18.515742128935532
Chopda,Wheat(Husked),2016,1574,1821,247,15.692503176620077
Paranda,Maize,2015,1283,1530,247,19.251753702260327
Ramtek,Pumpkin,2016,973,1220,247,25.38540596094553
Ulhasnagar,Sugarcane,2016,306,553,247,80.71895424836602
Aurangabad,Cabbage,2015,516,763,247,47.86821705426357
Chalisgaon,Bajri,2015,1124,1371,247,21.97508896797153
Dhule,Sorgum(Jawar),2016,1423,1670,247,17.35769501054111
Latur-Murud,Sorgum(Jawar),2015,1750,1997,247,14.114285714285714
Satana,Wheat(Husked),2014,1530,1777,247,16.143790849673202
Sangamner,Gram,2015,4611,4858,247,5.356755584471915
Chopda,Sorgum(Jawar),2014,1382,1629,247,17.872648335745296
Kalvan,Wheat(Husked),2014,1437,1684,247,17.18858733472512
Amarawati,Math (Bhaji),2016,2565,2812,247,9.62962962962963
Amarawati,Pigeon Pea (Tur),2014,4824,5071,247,5.1202321724709785
Manmad,Gram,2015,3203,3450,247,7.71152044957852
Majalgaon,Gram,2016,3930,4177,247,6.2849872773536894
Kalmeshwar,Ladies Finger,2016,1172,1419,247,21.07508532423208
Kada,Soybean,2014,2843,3090,247,8.688005627857896
Savner,Pigeon Pea (Tur),2014,4256,4503,247,5.803571428571429
Pune,Bajri,2015,1657,1904,247,14.906457453228727
Gevrai,Bajri,2016,1515,1762,247,16.303630363036305
Kopargaon,Bajri,2014,1204,1451,247,20.514950166112957
Taloda,Maize,2016,1249,1496,247,19.77582065652522
Amarawati-Fruit And Vegetables,Cabbage,2016,2782,3029,247,8.878504672897197
Pune,Bajri,2015,1688,1935,247,14.632701421800947
Ramtek,Ladies Finger,2015,871,1118,247,28.35820895522388
Gangapur,Sorgum(Jawar),2015,1562,1809,247,15.813060179257363
Kalmeshwar,Bottle Gourd,2016,603,850,247,40.96185737976783
Barshi,Fodder,2015,209,456,247,118.18181818181819
Sangamner,Bajri,2016,1763,2010,247,14.010209869540557
Rahuri-Vambori,Ground Nut Pods (Dry),2016,4282,4529,247,5.768332554880897
Bhokar,Sesamum,2015,8009,8256,247,3.084030465726058
Kalamb (Os),Soybean,2016,3492,3738,246,7.0446735395189
Barshi,Tamarind Seed,2015,1457,1703,246,16.88400823610158
Kopargaon,Wheat(Husked),2016,1570,1816,246,15.668789808917197
Majalgaon,Wheat(Husked),2014,1277,1523,246,19.26389976507439
Panvel,Ghosali(Bhaji),2016,1085,1331,246,22.672811059907833
Umarkhed,Soybean,2014,2942,3188,246,8.361658735554045
Pune,Bajri,2015,1768,2014,246,13.914027149321267
Sonpeth,Sorgum(Jawar),2016,1643,1889,246,14.972611077297627
Amalner,Black Gram,2015,7114,7360,246,3.45797019960641
Pune,Bajri,2015,1942,2188,246,12.667353244078269
Satara,Cabbage,2016,408,654,246,60.294117647058826
Nagbhid,Paddy-Unhusked,2016,2026,2272,246,12.142152023692004
Shirur,Bajri,2016,1466,1712,246,16.780354706684857
Lasur Station,Maize,2016,1381,1627,246,17.81317885590152
Dound,Gram,2015,3364,3610,246,7.312722948870392
Wardha,Gram,2014,2429,2675,246,10.127624536846438
Mumbai,Tomato,2015,966,1212,246,25.46583850931677
Kurdwadi-Modnimb,Maize,2016,1662,1908,246,14.8014440433213
Buldhana-Dhad,Soybean,2015,3373,3619,246,7.293210791580195
Sailu,Soybean,2015,3391,3637,246,7.254497198466529
Rahata,Gram,2016,3793,4039,246,6.485631426311627
Basmat,Soybean,2015,3485,3731,246,7.0588235294117645
Buldhana,Soybean,2016,3617,3863,246,6.801216477743987
Paithan,Wheat(Husked),2016,1732,1978,246,14.203233256351039
Pathardi,Bajri,2016,1340,1586,246,18.35820895522388
Mehkar,Sorgum(Jawar),2015,1087,1333,246,22.63109475620975
Achalpur,Wheat(Husked),2016,1585,1831,246,15.520504731861198
Barshi-Vairag,Gram,2016,4157,4403,246,5.917729131585278
Ner Parasopant,Pigeon Pea (Tur),2015,4738,4984,246,5.19206416209371
Chikhali,Soybean,2016,3608,3854,246,6.818181818181818
Kopargaon,Wheat(Husked),2016,1533,1779,246,16.046966731898237
Achalpur,Soybean,2016,3418,3664,246,7.197191339964892
Chandur Rly.,Soybean,2016,3189,3435,246,7.714016933207902
Mehkar,Wheat(Husked),2016,1585,1831,246,15.520504731861198
Bhokar,SOYBEAN,2016,2533,2779,246,9.711804184761153
Loha,Black Gram,2014,4684,4930,246,5.251921434671221
Nandurbar,Sorgum(Jawar),2015,1176,1422,246,20.918367346938776
Patur,Soybean,2015,2993,3239,246,8.219178082191782
Devala,Wheat(Husked),2015,1305,1551,246,18.850574712643677
Sindi (Selu),Wheat(Husked),2016,1523,1769,246,16.152330925804332
Zarijamini,Cotton,2015,3802,4048,246,6.470278800631247
Pandharpur,Banana,2015,420,666,246,58.57142857142857
Rahuri-Vambori,Wheat(Husked),2016,1754,2000,246,14.025085518814139
Kalmeshwar,Coriander  ,2015,1606,1852,246,15.317559153175592
Umarkhed-Danki,Soybean,2016,3246,3492,246,7.578558225508318
Ulhasnagar,Sugarcane,2016,295,541,246,83.38983050847457
Mohol,Maize,2015,1351,1597,246,18.208734270910437
Bhiwapur,Soybean,2016,3383,3629,246,7.271652379544783
Kalmeshwar,Ladies Finger,2015,4932,5178,246,4.987834549878346
Purna,Wheat(Husked),2016,1513,1759,246,16.259087904824852
Akluj,Water Melon,2015,308,554,246,79.87012987012987
Nagpur,Pumpkin,2016,904,1150,246,27.212389380530972
Sinner,Sorgum(Jawar),2015,1221,1467,246,20.147420147420146
Bhokar,Soybean,2015,3070,3315,245,7.980456026058632
Aurangabad,Bottle Gourd,2015,472,717,245,51.90677966101695
Udgir,Green Gram,2015,7566,7811,245,3.23817076394396
Satara,Tomato,2016,407,652,245,60.1965601965602
Nira,Jaggery,2015,2553,2798,245,9.596553074813944
Amalner,Bajri,2016,1571,1816,245,15.595162316995545
Kolhapur-Malkapur,Ladies Finger,2016,255,500,245,96.07843137254902
Lasalgaon-Niphad,Soybean,2016,3544,3789,245,6.913092550790068
Ausa,Maize,2015,1187,1432,245,20.64026958719461
Chandrapur-Ganjwad,Onion,2016,595,840,245,41.1764705882353
Chalisgaon,Sorgum(Jawar),2016,1355,1600,245,18.081180811808117
Gevrai,Bajri,2016,1653,1898,245,14.821536600120993
Deglur,Gram,2016,4099,4344,245,5.977067577457917
Parbhani,Gram,2016,5210,5455,245,4.702495201535509
Sindi,Wheat(Husked),2015,1238,1483,245,19.78998384491115
Nashik,Spinach,2016,188,433,245,130.31914893617022
Jalna,Maize,2016,1185,1430,245,20.675105485232066
Ramtek,Cabbage,2016,1132,1377,245,21.643109540636043
Kalyan,Brinjal,2016,1122,1367,245,21.836007130124777
Digras,Soybean,2014,3042,3287,245,8.053911900065746
Pusad,Sorgum(Jawar),2015,1101,1346,245,22.252497729336966
Sinner,Wheat(Husked),2014,1580,1825,245,15.50632911392405
Vasai,Paddy-Unhusked,2015,1441,1686,245,17.002081887578072
Kalmeshwar,Cluster Bean,2016,1024,1269,245,23.92578125
Kille Dharur,Wheat(Husked),2016,1875,2120,245,13.066666666666666
Jintur,Wheat(Husked),2014,1387,1632,245,17.664023071377073
Rahuri-Vambori,Sorgum(Jawar),2015,1255,1500,245,19.52191235059761
Dhule,Matki,2016,4930,5175,245,4.9695740365111565
Solapur,Grapes,2016,133,378,245,184.21052631578948
Tasgaon,Gram,2014,2855,3100,245,8.581436077057793
Murum,Gram,2016,4252,4497,245,5.761994355597366
Ghatanji,Gram,2016,3880,4125,245,6.314432989690721
Chalisgaon,Maize,2015,1129,1374,245,21.70062001771479
Kolhapur-Laxmipuri,Paddy-Unhusked,2016,1800,2045,245,13.61111111111111
Kalvan,Soybean,2016,3580,3825,245,6.843575418994414
Akkolkot,Sorgum(Jawar),2016,1856,2101,245,13.200431034482758
Mantha,Soybean,2014,2991,3236,245,8.191240387830158
Digras,GRAM,2016,6393,6638,245,3.8323165962771784
Patur,Gram,2015,3905,4150,245,6.274007682458387
Rahuri-Vambori,Sorgum(Jawar),2016,1563,1808,245,15.674984005118363
Chandur Bajar,Wheat(Husked),2016,1567,1812,245,15.634971282705807
Solapur,Soybean,2014,3147,3392,245,7.785192246584049
Mumbai,Elephant Root,2014,1311,1556,245,18.688024408848207
Mangalwedha,Wheat(Husked),2016,1835,2080,245,13.35149863760218
Amarawati,Math (Bhaji),2016,2270,2515,245,10.79295154185022
Katol,Sorgum(Jawar),2015,1218,1463,245,20.114942528735632
Wardha,Gram,2015,2863,3108,245,8.557457212713937
Mangrulpeer,Sorgum(Jawar),2015,1081,1326,245,22.664199814986123
Mangalwedha,Onion,2016,369,614,245,66.39566395663957
Ramtek,Spinach,2016,1705,1950,245,14.36950146627566
Beed,Sesamum,2014,11503,11748,245,2.12987916195775
Lasalgaon-Niphad,Wheat(Husked),2016,1650,1895,245,14.848484848484848
Tumsar,Jaggery,2014,2650,2895,245,9.245283018867925
Khamgaon,SORGUM(JAWAR),2016,1186,1431,245,20.657672849915684
Amarawati,Tomato,2016,1465,1710,245,16.72354948805461
Pachora,Maize,2015,1133,1378,245,21.624007060900265
Kolhapur-Laxmipuri,Gr.Nut Kernels,2015,8267,8511,244,2.951493891375348
Katol,PIGEON PEA (TUR),2016,4643,4887,244,5.255222916217963
Kalyan,Squash Gourd,2015,650,894,244,37.53846153846154
Kej,Wheat(Husked),2014,1459,1703,244,16.72378341329678
Chikhali,Maize,2015,961,1205,244,25.39021852237253
Khed (Shel Pimpalgaon),Cluster Bean,2014,3469,3713,244,7.03372729893341
Vaduj,Green Gram,2015,8000,8244,244,3.05
Jintur,Soybean,2015,3054,3298,244,7.9895219384413885
Mehkar,Maize,2015,1070,1314,244,22.80373831775701
Naigaon,Gram,2016,4133,4377,244,5.903701911444472
Beed,Bajri,2016,1385,1629,244,17.617328519855597
Mumbai,Sweet Potato,2014,752,996,244,32.4468085106383
Chikhali,Sorgum(Jawar),2016,1320,1564,244,18.484848484848484
Jalgaon-Masawat,Maize,2016,1040,1284,244,23.46153846153846
Karanja,Wheat(Husked),2015,1441,1685,244,16.932685634975712
Washim,Wheat(Husked),2015,1432,1676,244,17.039106145251395
Jamner-Neri,Cotton,2015,3750,3994,244,6.506666666666667
Chandur Rly.,Soybean,2016,3490,3734,244,6.991404011461318
Karad,Flower,2016,396,640,244,61.61616161616162
Kannad,Wheat(Husked),2015,1439,1683,244,16.956219596942322
Ambejogai,Black Gram,2014,4171,4415,244,5.84991608726924
Ramtek,Potato,2016,1600,1844,244,15.25
Mukhed,Black Gram,2015,8336,8580,244,2.927063339731286
Rahata,Potato,2015,889,1133,244,27.446569178852645
Pandharpur,Banana,2015,677,921,244,36.04135893648449
Morshi,Gram,2014,2256,2500,244,10.815602836879433
Patur,Wheat(Husked),2015,1281,1525,244,19.047619047619047
Chopda,Maize,2015,997,1241,244,24.473420260782348
Shirur,Sorgum(Jawar),2015,1275,1519,244,19.137254901960784
Nagpur,Bor,2015,400,644,244,61.0
Kalyan,Carrot,2016,1556,1800,244,15.681233933161954
Taloda,Sorgum(Jawar),2014,1645,1889,244,14.832826747720365
Mumbai,Elephant Root,2014,1400,1644,244,17.428571428571427
Jalna,Bajri,2016,1625,1869,244,15.015384615384615
Majalgaon,Soybean,2015,3278,3522,244,7.443563148261135
Indapur-Bhigwan,SOYBEAN,2016,2406,2650,244,10.141313383208646
Akkolkot,Pigeon Pea (Tur),2015,5198,5442,244,4.694113120430935
Akole,Tomato,2016,319,563,244,76.48902821316615
Ghoti,Brinjal,2014,2211,2455,244,11.035730438715513
Washim,Wheat(Husked),2014,1438,1682,244,16.968011126564672
Purna,Soybean,2016,3362,3606,244,7.257584770969661
Satara,Cabbage,2015,416,660,244,58.65384615384615
Buldhana,Soybean,2015,2997,3241,244,8.141474808141474
Shahada,Wheat(Husked),2015,1452,1696,244,16.804407713498623
Dound,Bajri,2015,1436,1680,244,16.991643454038996
Shahapur,Bhagar/Vari,2015,2689,2933,244,9.07400520639643
Tumsar,Lentil,2015,4274,4518,244,5.708937763219467
Bhokardan,Gram,2016,4478,4722,244,5.4488610987047785
Sonpeth,Bajri,2016,1166,1410,244,20.926243567753
Nagpur,Beet Root,2016,856,1100,244,28.50467289719626
Partur,Pigeon Pea (Tur),2014,4360,4604,244,5.5963302752293576
Vaduj,Sorgum(Jawar),2015,2189,2433,244,11.146642302421197
Lasalgaon,Bajri,2015,1182,1426,244,20.642978003384094
Kalmeshwar,Pigeon Pea (Tur),2015,4682,4926,244,5.211448099102947
Savner,Gram,2014,2262,2506,244,10.786914235190098
Nagpur,Tomato,2016,708,952,244,34.463276836158194
Bhivandi,Onion,2015,1498,1742,244,16.288384512683578
Mantha,Gram,2014,2258,2502,244,10.806023029229406
Bhiwapur,Cotton,2015,3619,3863,244,6.742193976236529
Bhivandi,Onion,2015,1598,1842,244,15.269086357947435
Lonand,Bajri,2015,1344,1588,244,18.154761904761905
Mangrulpeer,Sorgum(Jawar),2015,1208,1452,244,20.198675496688743
Sangrampur,Wheat(Husked),2015,1215,1458,243,20.0
Parbhani,Gram,2015,4034,4277,243,6.023797719385225
Amalner,Maize,2014,933,1176,243,26.04501607717042
Sonpeth,Sorgum(Jawar),2016,1584,1827,243,15.340909090909092
Nagpur,Brinjal,2016,522,765,243,46.55172413793103
Nagpur,Ginger (Fresh),2016,2476,2719,243,9.81421647819063
Patan,Cucumber,2015,607,850,243,40.0329489291598
Chandur Rly.,Soybean,2014,3056,3299,243,7.951570680628272
Kalamb (Os),Wheat(Husked),2014,1346,1589,243,18.053491827637444
Pachora,Bajri,2016,1592,1835,243,15.263819095477388
Indapur (Nimgaon Ketki),Wheat(Husked),2016,1964,2207,243,12.372708757637474
Sinner,Wheat(Husked),2016,1777,2020,243,13.674732695554304
Ambejogai,Soybean,2015,3105,3348,243,7.826086956521739
Latur-Murud,Pigeon Pea (Tur),2016,7964,8207,243,3.0512305374183826
Ramtek,Ladies Finger,2015,819,1062,243,29.67032967032967
Telhara,Green Gram,2014,6095,6338,243,3.9868744872846595
Chopda,Gram,2015,2977,3220,243,8.162579778300302
Nagpur,Chavli (Shenga ),2016,1014,1257,243,23.964497041420117
Telhara,Gram,2015,4187,4430,243,5.80367805111058
Partur,Pigeon Pea (Tur),2015,5064,5307,243,4.798578199052133
Pune-Pimpri,Bitter Gourd,2016,1400,1643,243,17.357142857142858
Kada,Wheat(Husked),2015,1584,1827,243,15.340909090909092
Jalgaon,Gram,2016,6149,6392,243,3.951862091396975
Ramtek,Brinjal,2016,861,1104,243,28.222996515679444
Chandrapur-Ganjwad,Cabbage,2016,389,632,243,62.46786632390746
Jalna,Black Gram,2015,6713,6956,243,3.619842097422911
Paithan,Bajri,2016,1313,1556,243,18.50723533891851
Kolhapur,Water Melon,2015,548,791,243,44.34306569343066
Ahmednagar,Bajri,2014,1507,1750,243,16.124751161247513
Lonar,Soybean,2015,3895,4138,243,6.238767650834403
Beed,Gram,2016,6193,6436,243,3.9237849184563216
Beed,Gram,2016,3900,4143,243,6.230769230769231
Jalna,Maize,2014,966,1209,243,25.15527950310559
Pandharkawada,Cotton,2014,3759,4002,243,6.464485235434956
Kalmeshwar,Raddish,2016,1007,1250,243,24.13108242303873
Bhiwapur,Soybean,2014,3000,3243,243,8.1
Murtizapur,Wheat(Husked),2016,1528,1771,243,15.903141361256544
Malegaon (Washim),Pigeon Pea (Tur),2016,6757,7000,243,3.596270534260767
Barshi,Pomegranate,2016,345,588,243,70.43478260869566
Kopargaon,Soybean,2016,2834,3077,243,8.574453069865914
Karanja,Sesamum,2016,5493,5736,243,4.423812124522119
Raver,Maize,2016,1091,1334,243,22.273143904674612
Jintur,Gram,2016,3959,4202,243,6.137913614549128
Kalyan,Elephant Root,2015,2114,2357,243,11.494796594134343
Pandharkawada,Ground Nut Pods (Dry),2015,4726,4969,243,5.1417689377909435
Paithan,Wheat(Husked),2015,1473,1716,243,16.4969450101833
Aurangabad,Awala,2015,614,857,243,39.57654723127036
Devala,Maize,2015,1136,1379,243,21.390845070422536
Yeotmal,Ground Nut Pods (Dry),2015,5205,5448,243,4.6685878962536025
Raver,Sorgum(Jawar),2015,1145,1388,243,21.222707423580786
Nagbhid,Paddy-Unhusked,2014,2257,2500,243,10.76650420912716
Kalmeshwar,Walvad,2015,1726,1969,243,14.078794901506374
Barshi-Vairag,Ground Nut Pods (Dry),2015,4550,4793,243,5.34065934065934
Manmad,Bajri,2015,1222,1465,243,19.885433715220948
Aurangabad,Bottle Gourd,2016,516,759,243,47.093023255813954
Buldhana,Sorgum(Jawar),2016,1262,1505,243,19.25515055467512
Naigaon,Soybean,2015,3011,3254,243,8.07040850215875
Telhara,Black Gram,2015,4665,4907,242,5.187566988210075
Dound,Bajri,2015,1430,1672,242,16.923076923076923
Nagpur,Chavli (Shenga ),2014,1683,1925,242,14.379084967320262
Gangapur,Sorgum(Jawar),2015,1420,1662,242,17.04225352112676
Risod,BLACK GRAM,2016,6283,6525,242,3.8516632182078623
Pune-Pimpri,Flower,2015,1095,1337,242,22.100456621004565
Shirur,Gram,2014,2157,2399,242,11.219286045433472
Vai,Bottle Gourd,2016,1232,1474,242,19.642857142857142
Parbhani,Gram,2016,4791,5033,242,5.051137549572115
Jintur-Bori,Soybean,2015,3521,3763,242,6.873047429707469
Chopda,Wheat(Husked),2016,1521,1763,242,15.910585141354373
Rahata,Shevga,2016,608,850,242,39.80263157894737
Amarawati,Wheat(Husked),2016,1758,2000,242,13.765642775881684
Rahuri-Vambori,Gram,2015,3034,3276,242,7.9762689518787075
Kalmeshwar,Raddish,2016,1219,1461,242,19.85233798195242
Paithan,Soybean,2014,2907,3149,242,8.324733402132782
Kannad,Bajri,2015,1548,1790,242,15.633074935400517
Kalyan,Potato,2015,630,872,242,38.41269841269841
Sailu,Gram,2015,3540,3782,242,6.836158192090395
Kalmeshwar,Cluster Bean,2015,899,1141,242,26.918798665183537
Nandura,Sorgum(Jawar),2015,1180,1422,242,20.508474576271187
Tumsar,Other Pulses,2016,2557,2799,242,9.46421587798201
Akot,Gram,2016,4249,4491,242,5.695457754765827
Deulgaon Raja,Cotton,2015,4172,4414,242,5.800575263662512
Karanja,Soybean,2016,3782,4024,242,6.398730830248546
Pathari,Sorgum(Jawar),2016,1598,1840,242,15.143929912390488
Tumsar,Jaggery,2016,2255,2497,242,10.731707317073171
Ausa,Maize,2016,1551,1793,242,15.602836879432624
Chikhali,Soybean,2016,3367,3609,242,7.187407187407187
Solapur,Green Peas (Dry),2016,3933,4175,242,6.153063818967709
Washim,Black Gram,2015,5362,5604,242,4.513241327862738
Jamkhed,Pigeon Pea (Tur),2014,4808,5050,242,5.033277870216306
Chandur Rly.,Gram,2015,3654,3896,242,6.62287903667214
Satara,Cabbage,2014,554,796,242,43.68231046931408
Morshi,Gram,2015,4029,4271,242,6.006453214197071
Sinner,Sorgum(Jawar),2015,1644,1886,242,14.720194647201946
Rahata,Cabbage,2016,429,671,242,56.41025641025641
Jamkhed,Soybean,2015,3000,3242,242,8.066666666666666
Hadgaon,Cotton,2016,4342,4584,242,5.573468447719945
Kille Dharur,Sorgum(Jawar),2016,1679,1921,242,14.413341274568195
Chandrapur-Ganjwad,Carrot,2015,625,867,242,38.72
Newasa,Wheat(Husked),2016,1583,1825,242,15.287428932406822
Latur-Murud,Sorgum(Jawar),2016,1563,1805,242,15.483045425463851
Ausa,Bajri,2015,1526,1768,242,15.858453473132371
Himayatnagar,Cotton,2015,3823,4065,242,6.330107245618624
Mehkar,Wheat(Husked),2016,1523,1765,242,15.889691398555483
Patur,Soybean,2016,3513,3755,242,6.888699117563336
Shevgaon,Sorgum(Jawar),2016,1523,1765,242,15.889691398555483
Hinganghat,Wheat(Husked),2016,1428,1669,241,16.876750700280112
Bhandara,Gram,2016,5420,5661,241,4.446494464944649
Devala,Maize,2015,1271,1512,241,18.96144767899292
Ramtek,Ladies Finger,2016,936,1177,241,25.747863247863247
Manwat,Green Gram,2016,4651,4892,241,5.18168135884756
Mumbai,Snake Gourd,2015,742,983,241,32.47978436657682
Dudhani,Pigeon Pea (Tur),2015,11765,12006,241,2.0484487887802807
Chandrapur,Pigeon Pea (Tur),2015,4633,4874,241,5.201813080077703
Mumbai,Tomato,2015,996,1237,241,24.196787148594378
Indapur,Gram,2016,3262,3503,241,7.388105456774984
Ramtek,GREEN CHILLI,2016,882,1123,241,27.324263038548754
Karanja,Sorgum(Jawar),2016,1375,1616,241,17.527272727272727
Nandura,Maize,2016,1163,1404,241,20.722269991401546
Ner Parasopant,Pigeon Pea (Tur),2016,8697,8938,241,2.7710704840749685
Aurangabad,Bottle Gourd,2014,568,809,241,42.429577464788736
Dondaicha-Sindkheda,Maize,2016,1050,1291,241,22.952380952380953
Kalamb (Yawatmal),Soybean,2016,3618,3859,241,6.66113875069099
Kalmeshwar,Green Chilli,2014,3417,3658,241,7.052970441908107
Nandurbar,Bajri,2016,1472,1713,241,16.372282608695652
Taloda,Sorgum(Jawar),2015,1172,1413,241,20.563139931740615
Bhivandi,Wheat(Husked),2015,1892,2133,241,12.73784355179704
Kalmeshwar,Green Chilli,2015,1391,1632,241,17.325664989216392
Partur,Gram,2016,5748,5989,241,4.192762700069589
Lasalgaon,Bajri,2015,1328,1569,241,18.147590361445783
Kurdwadi,Wheat(Husked),2015,1460,1701,241,16.506849315068493
Barshi-Vairag,Soybean,2016,2998,3239,241,8.038692461641094
Rahuri-Vambori,Bajri,2016,1590,1831,241,15.157232704402515
Indapur,Bajri,2014,1500,1741,241,16.066666666666666
Ramtek,Brinjal,2016,450,691,241,53.55555555555556
Ramtek,Brinjal,2016,532,773,241,45.30075187969925
Sengaon,Pigeon Pea (Tur),2016,8730,8971,241,2.7605956471935853
Devala,Sorgum(Jawar),2014,2009,2250,241,11.996017919362867
Ramtek,Brinjal,2016,1677,1918,241,14.370900417412045
Yawal,MAIZE,2016,960,1201,241,25.104166666666668
Anajngaon Surji,Gram,2015,3895,4136,241,6.187419768934531
Umarga,Soybean,2016,3396,3637,241,7.096584216725559
Mandhal,Soybean,2015,2955,3196,241,8.155668358714044
Chimur,Cotton,2016,4282,4523,241,5.628211116300794
Sangrampur,Sorgum(Jawar),2015,973,1214,241,24.76875642343268
Anajngaon Surji,Black Gram,2014,4892,5133,241,4.926410466067048
Karad,Banana,2015,567,808,241,42.504409171075835
Ramtek,SPINACH,2016,886,1127,241,27.200902934537247
Kalyan,Papai,2016,865,1106,241,27.86127167630058
Mumbai,Squash Gourd,2014,863,1104,241,27.925840092699882
Jamkhed,Gram,2015,3181,3422,241,7.576233888714241
Mul,Paddy-Unhusked,2015,1884,2125,241,12.791932059447984
Jamner,Cotton,2016,4248,4489,241,5.673258003766478
Satana,Bajri,2014,1274,1515,241,18.91679748822606
Mukhed,Green Gram,2015,7485,7726,241,3.2197728790915163
Mahur,Cotton,2016,4314,4555,241,5.586462679647659
Chopda,Sunflower,2016,2851,3092,241,8.453174324798317
Patur,Soybean,2015,3021,3262,241,7.977490897053956
Lasalgaon,MAIZE,2016,1027,1267,240,23.369036027263874
Malkapur,Wheat(Husked),2016,1687,1927,240,14.226437462951985
Kalmeshwar,Green Chilli,2015,1612,1852,240,14.88833746898263
Khamgaon,Sesamum,2015,7198,7438,240,3.33425951653237
Varud-Rajura Bazar,Soybean,2015,3441,3681,240,6.974716652136007
Indapur (Nimgaon Ketki),Wheat(Husked),2015,1459,1699,240,16.449623029472242
Mohol,Gram,2016,3980,4220,240,6.030150753768845
Khamgaon,Green Gram,2016,5560,5800,240,4.316546762589928
Murtizapur,Soybean,2015,3328,3568,240,7.211538461538462
Bhokar,Sorgum(Jawar),2015,1260,1500,240,19.047619047619047
Sakri,Wheat(Husked),2016,1388,1628,240,17.29106628242075
Aurangabad,Bottle Gourd,2015,489,729,240,49.079754601226995
Buldhana,Sorgum(Jawar),2016,1183,1423,240,20.28740490278952
Shirpur,Soybean,2015,2971,3211,240,8.078088185796028
Yawal,Maize,2016,951,1191,240,25.236593059936908
Mumbai,Onion,2016,710,950,240,33.80281690140845
Bhivandi,Potato,2016,1230,1470,240,19.51219512195122
Sangamner,Bajri,2016,1350,1590,240,17.77777777777778
Karad,Water Melon,2016,1000,1240,240,24.0
Nandurbar,Cluster Bean,2014,4491,4731,240,5.344021376085505
Himayatnagar,Wheat(Husked),2015,1163,1403,240,20.63628546861565
Murbad,Ghevda,2015,2600,2840,240,9.23076923076923
Pune-Manjri,Chavli (Pala),2016,775,1015,240,30.967741935483872
Udgir,Green Gram,2016,6631,6871,240,3.6193635952345047
Pune,Wheat(Husked),2014,1803,2043,240,13.311148086522463
Latur,Safflower,2016,2550,2790,240,9.411764705882353
Latur,Maize,2015,1214,1454,240,19.769357495881383
Ramtek,Pumpkin,2015,860,1100,240,27.906976744186046
Sinner,Wheat(Husked),2016,1762,2002,240,13.620885357548241
Shrirampur,Cucumber,2015,893,1133,240,26.875699888017916
Majalgaon,Soybean,2016,3018,3258,240,7.952286282306163
Amarawati,Spinach,2016,2005,2245,240,11.970074812967582
Purna,Black Gram,2016,6506,6746,240,3.6889025514909313
Jalgaon,Carrot,2015,740,980,240,32.432432432432435
Solapur,Pigeon Pea (Tur),2015,9394,9634,240,2.5548222269533745
Sinner,Wheat(Husked),2015,1396,1636,240,17.191977077363898
Manchar,Flower,2015,863,1103,240,27.80996523754345
Umarkhed,Soybean,2015,3360,3600,240,7.142857142857143
Sangrampur-Varvatbakal,Wheat(Husked),2016,1550,1790,240,15.483870967741936
Akot,Gram,2016,5137,5377,240,4.671987541366557
Bhivandi,Wheat(Husked),2015,1400,1640,240,17.142857142857142
Jalgaon,Maize(Corn.),2015,600,840,240,40.0
Sengaon,Pigeon Pea (Tur),2015,9040,9280,240,2.6548672566371683
Ghoti,Flower,2016,1008,1248,240,23.80952380952381
Kopargaon,Pigeon Pea (Tur),2015,4500,4740,240,5.333333333333333
Pune-Manjri,Harbara(Pendi),2016,1170,1410,240,20.512820512820515
Vai,Bottle Gourd,2016,1420,1660,240,16.901408450704224
Kalyan,Bottle Gourd,2016,1040,1280,240,23.076923076923077
Kalyan,Capsicum,2015,1120,1360,240,21.428571428571427
Bhokar,Sesamum,2016,5020,5260,240,4.780876494023905
Pune-Pimpri,Potato,2015,2840,3080,240,8.450704225352112
Kalyan,Indian Bean,2016,8280,8520,240,2.898550724637681
Kinwat,Black Gram,2016,6280,6520,240,3.821656050955414
Akot,WHEAT(HUSKED),2016,1680,1920,240,14.285714285714286
Akluj,Banana,2015,167,407,240,143.7125748502994
Jalna,Banana,2015,277,517,240,86.64259927797833
Nagpur,Bitter Gourd,2014,2604,2844,240,9.216589861751151
Udgir,Gram,2015,4583,4823,240,5.236744490508401
Kalyan,Onion,2016,510,750,240,47.05882352941177
Sindi (Selu),Wheat(Husked),2016,1526,1766,240,15.727391874180865
Panvel,Bottle Gourd,2016,950,1190,240,25.263157894736842
Gevrai,Sorgum(Jawar),2015,1337,1577,240,17.95063575168287
Chandrapur-Ganjwad,Cucumber,2016,300,540,240,80.0
Rahuri,Papai,2016,235,475,240,102.12765957446808
Nandgaon,Bajri,2015,1377,1617,240,17.429193899782135
Dudhani,Pigeon Pea (Tur),2014,4887,5127,240,4.910988336402701
Jalgaon Jamod-Aasalgaon,Wheat(Husked),2016,1560,1800,240,15.384615384615385
Gangapur,Bajri,2015,1219,1459,240,19.688269073010666
Chandrapur-Ganjwad,Potato,2015,660,900,240,36.36363636363637
Mahur,Cotton,2015,3800,4040,240,6.315789473684211
Pandharkawada,Soybean,2015,2960,3200,240,8.108108108108109
Akhadabalapur,Pigeon Pea (Tur),2015,5507,5747,240,4.358089704013074
Vaduj,Ghevda Seed,2016,2560,2800,240,9.375
Sangamner,Sorgum(Jawar),2016,1780,2020,240,13.48314606741573
Fulambri,Cotton,2016,4609,4849,240,5.207203297895422
Shrirampur,Potato,2016,1330,1570,240,18.045112781954888
Nandura,Onion,2016,475,715,240,50.526315789473685
Ghansawangi,Gram,2015,3420,3660,240,7.017543859649122
Nagpur,Cucumber,2014,1468,1708,240,16.348773841961854
Parbhani,Cotton,2016,4270,4510,240,5.620608899297424
Phaltan,Jaggery,2015,2385,2625,240,10.062893081761006
Bhiwapur,Soybean,2014,2850,3090,240,8.421052631578947
Malkapur,Maize,2015,943,1183,240,25.45068928950159
Amarawati-Fruit And Vegetables,Dhemse,2016,1795,2035,240,13.370473537604457
Akhadabalapur,Wheat(Husked),2015,1520,1760,240,15.789473684210526
Bhandara,WHEAT(HUSKED),2016,1766,2005,239,13.533408833522083
Amarawati,Potato,2016,1215,1454,239,19.670781893004115
Shrirampur,Flower,2016,904,1143,239,26.438053097345133
Shevgaon,Pigeon Pea (Tur),2016,7323,7562,239,3.2636897446401747
Shirpur,Wheat(Husked),2015,1407,1646,239,16.986496090973702
Amalner,Maize,2016,1534,1773,239,15.580182529335072
Ambejogai,Green Gram,2015,7100,7339,239,3.3661971830985915
Yawal,Gram,2016,3995,4234,239,5.982478097622027
Shevgaon-Bodhegaon,Gram,2016,5944,6183,239,4.020861372812921
Amarawati-Fruit And Vegetables,Carrot,2016,2515,2754,239,9.502982107355864
Sillod,Wheat(Husked),2016,1504,1743,239,15.89095744680851
Pathardi,Sorgum(Jawar),2015,1509,1748,239,15.838303512259774
Washim,Sorgum(Jawar),2015,1227,1466,239,19.47840260798696
Anajngaon Surji,Sorgum(Jawar),2016,1228,1467,239,19.462540716612377
Barshi,Paddy-Unhusked,2014,1342,1581,239,17.80923994038748
Beed,Sorgum(Jawar),2015,1619,1858,239,14.762198888202594
Sillod-Bharadi,Soybean,2016,3601,3840,239,6.63704526520411
Ausa,Gram,2015,4297,4536,239,5.56202001396323
Pandharpur,Banana,2015,597,836,239,40.03350083752094
Shahada,Wheat(Husked),2014,1445,1684,239,16.53979238754325
Shevgaon,Sorgum(Jawar),2015,1307,1546,239,18.286151491966336
Amarawati,Bajri,2016,1853,2092,239,12.898003237992445
Ausa,SORGUM(JAWAR),2016,1581,1820,239,15.117014547754586
Beed,Bajri,2016,1397,1636,239,17.108088761632068
Shrirampur,Water Melon,2016,896,1135,239,26.674107142857142
Gondpimpri,Soybean,2015,3017,3256,239,7.921776599270799
Jalna,Jaggery,2014,2312,2551,239,10.337370242214533
Savner,Gram,2016,3770,4009,239,6.339522546419098
Pusad,Wheat(Husked),2015,1575,1814,239,15.174603174603174
Jalna,Maize,2015,1020,1259,239,23.431372549019606
Ghoti,Cabbage,2016,908,1147,239,26.3215859030837
Kurdwadi-Modnimb,Maize,2015,1461,1700,239,16.358658453114305
Jalna,Jaggery,2015,2195,2434,239,10.888382687927107
Kurdwadi,Pigeon Pea (Tur),2014,3229,3468,239,7.401672344379064
Kolhapur,Snake Gourd,2015,360,599,239,66.38888888888889
Sindkhed Raja,Soybean,2016,3741,3980,239,6.388666132050254
Chandrapur,Soybean,2015,3142,3381,239,7.606619987269255
Mehkar,Wheat(Husked),2014,1308,1547,239,18.27217125382263
Kada,Bajri,2015,1161,1400,239,20.585701981050818
Chalisgaon,Sorgum(Jawar),2014,1202,1441,239,19.883527454242927
Rahata,Bottle Gourd,2014,269,508,239,88.84758364312268
Murum,Black Gram,2016,8743,8982,239,2.733615463799611
Kopargaon,WHEAT(HUSKED),2016,1756,1995,239,13.610478359908884
Dondaicha-Sindkheda,Wheat(Husked),2016,1493,1732,239,16.008037508372404
Majalgaon,Cotton,2015,3643,3882,239,6.560527038155366
Loha,Pigeon Pea (Tur),2016,8442,8681,239,2.8310826818289505
Nandura,Wheat(Husked),2015,1272,1511,239,18.78930817610063
Hingoli,Soybean,2014,3087,3326,239,7.742144476838354
Mumbai,GREEN CHILLI,2016,1144,1383,239,20.89160839160839
Chandrapur-Ganjwad,Brinjal,2015,166,405,239,143.97590361445782
Taloda,Maize,2015,1148,1387,239,20.818815331010452
Lasalgaon-Niphad,Wheat(Husked),2016,1517,1756,239,15.754779169413316
Lasalgaon-Vinchur,Wheat(Husked),2016,1541,1780,239,15.509409474367294
Lasur Station,Maize,2015,1014,1253,239,23.570019723865876
Udgir,GREEN GRAM,2016,4679,4918,239,5.107929044667664
Nagpur,Paddy-Unhusked,2016,1724,1963,239,13.863109048723897
Kalmeshwar,Spinach,2016,1769,2008,239,13.510457885811192
Kalmeshwar,CHAVLI (SHENGA ),2016,537,776,239,44.506517690875235
Latur,Safflower,2015,2561,2800,239,9.332292073408825
Katol,Orange,2015,301,540,239,79.40199335548172
Manwat,Gram,2015,3701,3939,238,6.430694406917049
Gangapur,Gram,2015,3602,3840,238,6.607440310938368
Pune-Pimpri,Tomato,2015,967,1205,238,24.612202688728026
Pathardi,Sorgum(Jawar),2015,1500,1738,238,15.866666666666667
Jalgaon,Jaggery,2016,3425,3663,238,6.9489051094890515
Katol,Soybean,2015,3027,3265,238,7.862570201519657
Gevrai,Mustard,2016,3550,3788,238,6.704225352112676
Akluj,Potato,2015,762,1000,238,31.233595800524935
Umared,Lang,2016,3275,3513,238,7.267175572519084
Shevgaon-Bodhegaon,Green Gram,2016,4591,4829,238,5.184055761272054
Ralegaon,Cotton,2016,4346,4584,238,5.476300046019328
Risod,Soybean,2016,3457,3695,238,6.884582007520972
Nagpur,Pumpkin,2016,756,994,238,31.48148148148148
Mantha,Soybean,2015,3229,3467,238,7.370703004026014
Kada,Gram,2015,3250,3488,238,7.323076923076923
Khed-Chakan,Carrot,2016,735,973,238,32.38095238095238
Ausa,Sorgum(Jawar),2015,1740,1978,238,13.67816091954023
Shrirampur,Soybean,2015,2856,3094,238,8.333333333333334
Shevgaon,Wheat(Husked),2015,1293,1531,238,18.406805877803556
Pune,Bajri,2014,1815,2053,238,13.112947658402204
Osmanabad,Sorgum(Jawar),2016,1739,1977,238,13.6860264519839
Osmanabad,Sorgum(Jawar),2016,1817,2055,238,13.098514034122179
Chandur Bajar,Wheat(Husked),2015,1375,1613,238,17.30909090909091
Mangrulpeer,Gram,2015,2267,2505,238,10.498456109395677
Wardha,Soybean,2014,3121,3359,238,7.62576097404678
Pusad,Bajri,2015,1150,1388,238,20.695652173913043
Chimur,Soybean,2016,3165,3403,238,7.519747235387046
Yawal,Wheat(Husked),2016,1650,1888,238,14.424242424242424
Loha,Pigeon Pea (Tur),2014,4500,4738,238,5.288888888888889
Mangrulpeer,Green Gram,2016,5200,5438,238,4.576923076923077
Shrirampur,Bitter Gourd,2016,762,1000,238,31.233595800524935
Paithan,Bajri,2015,1343,1581,238,17.72151898734177
Murum,Gram,2015,4317,4555,238,5.513087792448459
Pune-Moshi,Onion,2016,550,788,238,43.27272727272727
Deulgaon Raja,Cotton,2015,3661,3899,238,6.500956022944551
Washim,Soybean,2015,3127,3365,238,7.6111288775183885
Devala,Green Gram,2015,7392,7630,238,3.2196969696969697
Devala,Sorgum(Jawar),2015,1579,1817,238,15.07283090563648
Sangli-Phale Bhajipalam,Water Melon,2015,72,310,238,330.55555555555554
Murbad,Ladies Finger,2014,3831,4069,238,6.212477160010441
Paithan,Sorgum(Jawar),2016,1610,1848,238,14.782608695652174
Dhule,Cowpea,2015,3656,3894,238,6.5098468271334795
Mumbai,Flower,2015,704,942,238,33.80681818181818
Shevgaon,Cotton,2014,3859,4097,238,6.167400881057269
Koregaon,Sorgum(Jawar),2014,1600,1838,238,14.875
Manora,Wheat(Husked),2016,1500,1738,238,15.866666666666667
Dound,Bajri,2015,1393,1631,238,17.08542713567839
Kalmeshwar,Coriander  ,2015,3838,4076,238,6.201146430432517
Latur,Sorgum(Jawar),2015,2525,2763,238,9.425742574257425
Jalna,Jaggery,2015,2190,2428,238,10.867579908675799
Jamkhed,Gram,2015,3213,3451,238,7.407407407407407
Partur,GREEN GRAM,2016,4267,4505,238,5.577689243027889
Jalkot,Soybean,2014,3200,3438,238,7.4375
Anajngaon Surji,Sunflower,2015,2825,3063,238,8.424778761061948
Nagpur,Brinjal,2015,1081,1319,238,22.01665124884366
Jalna,Bajri,2015,1084,1322,238,21.95571955719557
Malkapur,Wheat(Husked),2016,1708,1946,238,13.934426229508198
Amarawati-Fruit And Vegetables,Beet Root,2016,2062,2300,238,11.54219204655674
Rahuri-Vambori,Ground Nut Pods (Dry),2015,3164,3402,238,7.522123893805309
Kalmeshwar,Pumpkin,2016,614,852,238,38.762214983713356
Kalmeshwar,Pumpkin,2016,924,1162,238,25.757575757575758
Jalna,Soybean,2016,3578,3816,238,6.651760760201229
Amalner,Pigeon Pea (Tur),2016,6950,7188,238,3.4244604316546763
Nira,Jaggery,2015,2913,3151,238,8.170271198077582
Mumbai,Flower,2015,678,915,237,34.95575221238938
Aurangabad,Potato,2016,1191,1428,237,19.8992443324937
Ausa,Sorgum(Jawar),2014,1277,1514,237,18.55912294440094
Washim-Ansing,Green Gram,2016,5033,5270,237,4.708921120604013
Pusad,Soybean,2015,3113,3350,237,7.613234821715387
Washim,Black Gram,2015,6445,6682,237,3.6772692009309544
Umared,Other Pulses,2015,7328,7565,237,3.234170305676856
Umarga,Wheat(Unhusked),2015,2817,3054,237,8.413205537806176
Mumbai,Tomato,2016,719,956,237,32.962447844228095
Shevgaon,Cotton,2014,3865,4102,237,6.131953428201811
Dhule,Matki,2015,7349,7586,237,3.224928561709076
Koregaon,Wheat(Husked),2015,1613,1850,237,14.693118412895226
Khamgaon,Wheat(Husked),2016,1512,1749,237,15.674603174603174
Manora,Soybean,2015,3157,3394,237,7.507127019322141
Sangli-Phale Bhajipalam,Water Melon,2015,75,312,237,316.0
Murbad,Ghosali(Bhaji),2014,2713,2950,237,8.735716918540362
Shegaon,Gram,2016,4017,4254,237,5.8999253174010455
Dhule,Black Gram,2015,10653,10890,237,2.224725429456491
Lonar,Gram,2016,6364,6601,237,3.7240729101194217
Umari,Gram,2016,3912,4149,237,6.058282208588957
Rahuri-Vambori,Sorgum(Jawar),2014,1631,1868,237,14.530962599632128
Shrirampur,Wheat(Husked),2016,1667,1904,237,14.217156568686264
Washim,Soybean,2016,3134,3371,237,7.562220804084237
Jalgaon,Cucumber,2016,328,565,237,72.2560975609756
Chalisgaon,Maize,2016,1417,1654,237,16.725476358503883
Ner Parasopant,Pigeon Pea (Tur),2016,7674,7911,237,3.0883502736512902
Patur,Wheat(Husked),2016,1493,1730,237,15.874079035498996
Parola,Pigeon Pea (Tur),2016,6663,6900,237,3.5569563259792885
Tumsar,Other Cereals,2016,3538,3775,237,6.698699830412663
Manchar,Cabbage,2016,238,475,237,99.5798319327731
Pandharkawada,Pigeon Pea (Tur),2016,8213,8450,237,2.8856690612443687
Washim,Wheat(Husked),2016,1790,2027,237,13.240223463687151
Indapur,Ground Nut Pods (Dry),2016,4763,5000,237,4.975855553222758
Manmad,Bajri,2015,1205,1442,237,19.66804979253112
Ramtek,Cucumber,2016,838,1075,237,28.281622911694512
Rahata,Flower,2016,418,655,237,56.698564593301434
Nandura,Maize,2015,1182,1419,237,20.050761421319798
Nandura,Maize,2015,1356,1593,237,17.47787610619469
Amalner,Wheat(Husked),2016,1498,1735,237,15.82109479305741
Murum,Sorgum(Jawar),2016,1887,2124,237,12.559618441971383
Dound,Gram,2014,2404,2641,237,9.858569051580698
Dudhani,Sorgum(Jawar),2016,1839,2076,237,12.887438825448614
Rahuri-Vambori,Wheat(Husked),2016,2050,2287,237,11.560975609756097
Yawal,Soybean,2015,3213,3450,237,7.376283846872083
Yeotmal,Soybean,2015,3217,3454,237,7.3671122163506375
Akot,Wheat(Husked),2015,1272,1509,237,18.632075471698112
Latur-Murud,Sorgum(Jawar),2016,1450,1687,237,16.344827586206897
Yawal,Soybean,2015,3088,3325,237,7.674870466321243
Latur,Soybean,2014,3072,3309,237,7.71484375
Chandrapur-Ganjwad,Potato,2016,1518,1755,237,15.612648221343873
Latur,Safflower,2016,2595,2832,237,9.132947976878613
Umared,Sunflower,2015,2980,3217,237,7.953020134228188
Nandgaon,Bajri,2014,1327,1564,237,17.85983421250942
Murtizapur,Soybean,2016,3420,3657,237,6.9298245614035086
Kalyan,Bottle Gourd,2015,838,1075,237,28.281622911694512
Ramtek,Flower,2015,1688,1925,237,14.040284360189574
Aurangabad,Bottle Gourd,2015,416,653,237,56.97115384615385
Akkolkot,Wheat(Unhusked),2016,3163,3400,237,7.492886500158078
Murbad,Tomato,2015,2736,2973,237,8.662280701754385
Jalgaon,Sorgum(Jawar),2016,1720,1956,236,13.720930232558139
Nandurbar,Maize,2016,1327,1563,236,17.78447626224567
Parli-Vaijnath,Soybean,2014,2970,3206,236,7.946127946127946
Mehkar,Wheat(Husked),2015,1443,1679,236,16.354816354816354
Mandhal,Green Gram,2016,4865,5101,236,4.850976361767729
Gevrai,Soybean,2014,3082,3318,236,7.657365347177158
Baramati,Soybean,2015,2922,3158,236,8.0766598220397
Dhule,Jaggery,2016,1350,1586,236,17.48148148148148
Sonpeth,Sorgum(Jawar),2015,1721,1957,236,13.712957582800698
Kalmeshwar,Flower,2015,1872,2108,236,12.606837606837606
Dudhani,Sorgum(Jawar),2016,1882,2118,236,12.539851222104145
Mumbai-Onion And Potato Mkt,Onion,2016,591,827,236,39.93231810490694
Amarawati-Fruit And Vegetables,Spinach,2016,2012,2248,236,11.72962226640159
Murbad,Bitter Gourd,2014,2950,3186,236,8.0
Karad,Tomato,2016,600,836,236,39.333333333333336
Shevgaon-Bodhegaon,Bajri,2016,1360,1596,236,17.352941176470587
Mangrulpeer,Sorgum(Jawar),2016,1148,1384,236,20.557491289198605
Jawala-Bajar,Pigeon Pea (Tur),2016,8117,8353,236,2.907478132314895
Nagpur,Flower,2014,1304,1540,236,18.098159509202453
Amarawati-Fruit And Vegetables,Methi (Bhaji),2016,2582,2818,236,9.14020139426801
Kalmeshwar,Brinjal,2015,1057,1293,236,22.327341532639547
Shegaon,Sorgum(Jawar),2015,1166,1402,236,20.240137221269297
Anajngaon Surji,Sorgum(Jawar),2015,1350,1586,236,17.48148148148148
Chopda,Maize,2016,1204,1440,236,19.601328903654483
Ambejogai,Soybean,2014,3059,3295,236,7.714939522719843
Ramtek,CHAVLI (SHENGA ),2016,882,1118,236,26.75736961451247
Aurangabad,Maize(Corn.),2016,500,736,236,47.2
Rahuri-Vambori,Sorgum(Jawar),2016,1568,1804,236,15.051020408163266
Chimur,Cotton,2016,4316,4552,236,5.4680259499536605
Amarawati,Beet Root,2016,2355,2591,236,10.021231422505307
Sinner,Wheat(Husked),2016,1740,1976,236,13.563218390804598
Nashik-Devlali,Chavli (Pala),2016,412,648,236,57.28155339805825
Shrirampur,Carrot,2015,809,1045,236,29.171817058096416
Kalmeshwar,Ladies Finger,2016,772,1008,236,30.569948186528496
Jalgaon,Cluster Bean,2014,3588,3824,236,6.5774804905239685
Yawal,Maize,2016,965,1201,236,24.4559585492228
Aurangabad,BRINJAL,2016,620,856,236,38.064516129032256
Shirpur,Wheat(Husked),2014,1417,1653,236,16.654904728299222
Mumbai,Potato,2015,964,1200,236,24.481327800829874
Ramtek,Flower,2016,1732,1968,236,13.625866050808314
Amarawati-Fruit And Vegetables,METHI (BHAJI),2016,1780,2016,236,13.258426966292134
Murbad,Tomato,2014,3393,3629,236,6.955496610669025
Sailu,Wheat(Husked),2015,1400,1636,236,16.857142857142858
Nagpur,Wal Bhaji,2015,1464,1700,236,16.120218579234972
Kille Dharur,Bajri,2015,1416,1652,236,16.666666666666668
Udgir,Wheat(Husked),2015,1200,1436,236,19.666666666666668
Amarawati,Linseed,2015,5343,5579,236,4.416994198016096
Sinner,Bajri,2015,1308,1543,235,17.966360856269112
Amarawati,Papai,2016,559,794,235,42.039355992844364
Amarawati-Fruit And Vegetables,Cabbage,2016,1610,1845,235,14.596273291925465
Kalvan,Bajri,2016,1581,1816,235,14.864010120177102
Manmad,Flower,2016,318,553,235,73.8993710691824
Chikhali,Sorgum(Jawar),2015,1235,1470,235,19.02834008097166
Devala,Maize,2015,1056,1291,235,22.25378787878788
Parola,Bajri,2016,1447,1682,235,16.240497581202487
Ahmedpur,Gram,2015,4133,4368,235,5.685942414710864
Shrirampur,Water Melon,2015,918,1153,235,25.59912854030501
Nashik,SPINACH,2016,267,502,235,88.01498127340824
Kalvan,Bajri,2015,1123,1358,235,20.926090828138914
Latur,Safflower,2015,2615,2850,235,8.98661567877629
Umarga,Gram,2016,3983,4218,235,5.90007532011047
Nagpur,Coriander  ,2015,1590,1825,235,14.779874213836479
Sangrampur,Wheat(Husked),2015,1115,1350,235,21.076233183856502
Rahuri-Vambori,Sorgum(Jawar),2016,1608,1843,235,14.614427860696518
Lonar,Sorgum(Jawar),2016,1352,1587,235,17.381656804733726
Jintur,Cotton,2016,4570,4805,235,5.142231947483588
Nandurbar,Sorgum(Jawar),2015,1154,1389,235,20.363951473136915
Sangrampur-Varvatbakal,Sorgum(Jawar),2015,1042,1277,235,22.55278310940499
Anajngaon Surji,Soybean,2014,3002,3237,235,7.8281145902731515
Ramtek,Flower,2015,645,880,235,36.434108527131784
Amarawati,Gram,2016,4113,4348,235,5.713591052759543
Nandura,Wheat(Husked),2015,1431,1666,235,16.42208245981831
Bhokar,Sorgum(Jawar),2015,1240,1475,235,18.951612903225808
Ausa,Soybean,2016,3749,3984,235,6.268338223526274
Karmala,Gram,2015,3125,3360,235,7.52
Hinganghat,Wheat(Husked),2016,1550,1785,235,15.161290322580646
Mumbai,Sugar,2016,3612,3847,235,6.50609080841639
Nagpur,Chavli (Pala),2014,1192,1427,235,19.71476510067114
Latur,Soybean,2015,3565,3800,235,6.5918653576437585
Savner,Soybean,2015,3327,3562,235,7.063420498948001
Ramtek,Spinach,2016,580,815,235,40.51724137931034
Buldhana,Maize,2016,1296,1531,235,18.132716049382715
Amarawati,Sorgum(Jawar),2016,1708,1943,235,13.758782201405152
Kalyan,Bottle Gourd,2016,725,960,235,32.41379310344828
Rahata,Bajri,2016,1121,1356,235,20.96342551293488
Nandura,Maize,2015,1167,1402,235,20.137103684661525
Shrirampur,Cucumber,2015,1023,1258,235,22.97165200391007
Udgir,Sorgum(Jawar),2015,1000,1235,235,23.5
Jalgaon,Gram,2015,2795,3030,235,8.407871198568873
Mumbai,Cucumber,2015,1089,1324,235,21.57943067033976
Nandura,Sorgum(Jawar),2015,1209,1444,235,19.43755169561621
Khamgaon,Sorgum(Jawar),2015,1220,1455,235,19.262295081967213
Kalyan,Cucumber,2016,765,1000,235,30.718954248366014
Kopargaon,Wheat(Husked),2014,1349,1584,235,17.420311341734617
Shahada,Maize,2015,1237,1472,235,18.997574777687955
Akola,Wheat(Husked),2014,1447,1682,235,16.240497581202487
Kalyan,Onion,2016,605,839,234,38.67768595041322
Manchar,Flower,2015,803,1037,234,29.140722291407222
Mumbai,Potato,2015,910,1144,234,25.714285714285715
Sangrampur,Sorgum(Jawar),2015,973,1207,234,24.049331963001027
Morshi,Gram,2015,4044,4278,234,5.786350148367952
Mangrulpeer,Soybean,2016,3286,3520,234,7.121119902617163
Mangalwedha,Pigeon Pea (Tur),2015,5000,5234,234,4.68
Samudrapur,Cotton,2015,3768,4002,234,6.210191082802548
Ramtek,Cucumber,2016,833,1067,234,28.09123649459784
Panvel,Bitter Gourd,2015,2983,3217,234,7.844451894066376
Chopda,Ground Nut Pods (Dry),2016,4340,4574,234,5.391705069124424
Jamkhed,Gram,2015,3647,3881,234,6.416232519879353
Ratanagari,Cabbage,2015,451,685,234,51.88470066518847
Khamgaon,Sesamum,2015,6133,6367,234,3.8154247513451818
Kalmeshwar,Walvad,2015,2498,2732,234,9.367493995196156
Panvel,Ridge Gourd,2016,2833,3067,234,8.259795270031768
Nagpur,Wheat(Husked),2015,1893,2127,234,12.361331220285262
Jalgaon,Carrot,2015,1933,2167,234,12.105535437144335
Lasur Station,Bajri,2015,1242,1476,234,18.840579710144926
Chandrapur-Ganjwad,Pumpkin,2016,333,567,234,70.27027027027027
Amarawati,Potato,2015,783,1017,234,29.885057471264368
Kalmeshwar,Flower,2016,762,996,234,30.708661417322833
Chandur Bajar,Wheat(Husked),2015,1413,1647,234,16.56050955414013
Jafrabad,Soybean,2016,3083,3317,234,7.5900097307817065
Jalgaon Jamod,Pigeon Pea (Tur),2015,3933,4167,234,5.949656750572083
Latur-Murud,Soybean,2016,3402,3636,234,6.878306878306878
Bhokardan,Cotton,2014,3803,4037,234,6.153037075992637
Mumbai,Sweet Potato,2014,833,1067,234,28.09123649459784
Panvel,Brinjal,2014,3133,3367,234,7.468879668049793
Vani,Soybean,2016,3362,3596,234,6.960142772159429
Parli-Vaijnath,Green Gram,2016,4250,4484,234,5.5058823529411764
Amarawati,Kharbuj,2016,1333,1567,234,17.554388597149288
Kada,Bajri,2014,1278,1512,234,18.309859154929576
Kej,Coriander (Dry),2016,9370,9604,234,2.497331910352188
Satara,Cucumber,2016,558,792,234,41.935483870967744
Devala,Matki,2016,6591,6825,234,3.5502958579881656
Solapur,Jaggery,2016,3341,3575,234,7.003891050583658
Tumsar,Wheat(Husked),2014,1285,1519,234,18.21011673151751
Kalyan,Bottle Gourd,2015,932,1166,234,25.107296137339056
Yawal,Banana,2016,650,884,234,36.0
Rahuri-Songaon,Wheat(Husked),2016,1433,1667,234,16.329378925331472
Murum,Gram,2016,4111,4345,234,5.6920457309657015
Mauda,Gram,2016,5711,5945,234,4.097355979688321
Jintur,Wheat(Husked),2015,1423,1657,234,16.444132115249474
Shrirampur,Mango(Raw),2015,844,1078,234,27.725118483412324
Pune-Moshi,Beet Root,2016,833,1067,234,28.09123649459784
Chakur,Gram,2016,4966,5200,234,4.712041884816754
Amarawati,Cabbage,2015,2033,2267,234,11.510083620265616
Chakur,Soybean,2016,3739,3973,234,6.258357849692431
Buldhana,Maize,2016,1533,1767,234,15.264187866927593
Pune,Bajri,2016,2024,2258,234,11.561264822134387
Maregaon,Cotton,2015,3640,3874,234,6.428571428571429
Manora,Soybean,2015,3350,3584,234,6.985074626865671
Nandurbar,Sorgum(Jawar),2016,1391,1625,234,16.822429906542055
Gangapur,Wheat(Husked),2016,1729,1963,234,13.533834586466165
Kalamb (Yawatmal),Soybean,2014,2995,3229,234,7.813021702838063
Tumsar,Linseed,2016,6436,6670,234,3.6357986326911127
Umarkhed-Danki,Wheat(Husked),2014,1433,1667,234,16.329378925331472
Nandura,Black Gram,2015,5033,5267,234,4.649314524140672
Nagbhid,Paddy-Unhusked,2016,1659,1893,234,14.104882459312838
Jalgaon Jamod-Aasalgaon,Gram,2015,3833,4067,234,6.104878685103053
Shrirampur,Potato,2014,2054,2288,234,11.39240506329114
Basmat,Gram,2015,3434,3668,234,6.814210832847991
Panvel,Bottle Gourd,2015,1633,1867,234,14.329454990814451
Savner,Soybean,2016,3114,3348,234,7.514450867052023
Nandgaon,Maize,2016,1522,1756,234,15.374507227332458
Jintur,Pigeon Pea (Tur),2015,7852,8086,234,2.980132450331126
Vaduj,GRAM,2016,7722,7956,234,3.0303030303030303
Kalyan,Bajri,2016,1833,2067,234,12.76595744680851
Wardha,Sorgum(Jawar),2016,1450,1683,233,16.06896551724138
Mumbai,Squash Gourd,2015,725,958,233,32.13793103448276
Raver,Wheat(Husked),2014,1307,1540,233,17.82708492731446
Karad,Tomato,2014,600,833,233,38.833333333333336
Murbad,Bottle Gourd,2014,1400,1633,233,16.642857142857142
Kalmeshwar,RADDISH,2016,659,892,233,35.35660091047041
Amarawati,Bajri,2015,1300,1533,233,17.923076923076923
Sillod,Mustard,2016,4000,4233,233,5.825
Pune-Moshi,Chavli (Shenga ),2016,1913,2146,233,12.179822268687925
Sinner,Wheat(Husked),2016,1768,2001,233,13.178733031674208
Mumbai,Sweet Potato,2015,850,1083,233,27.41176470588235
Akole,TOMATO,2016,170,403,233,137.05882352941177
Murbad,Ladies Finger,2015,2350,2583,233,9.914893617021276
Ramtek,Jack Fruit,2016,978,1211,233,23.824130879345603
Kalyan,Onion,2015,1317,1550,233,17.691723614274867
Kalmeshwar,Cucumber,2016,527,760,233,44.212523719165084
Baramati,Maize,2015,1373,1606,233,16.970138383102693
Gangapur,Sorgum(Jawar),2014,1375,1608,233,16.945454545454545
Jalgaon,Guava,2014,1892,2125,233,12.315010570824525
Akluj,Water Melon,2015,267,500,233,87.26591760299625
Pachora,Maize,2016,1192,1425,233,19.546979865771814
Nandura,Bajri,2014,1094,1327,233,21.29798903107861
Umared,Cotton,2015,3841,4074,233,6.0661286123405365
Kurdwadi,Green Gram,2015,6034,6267,233,3.86145177328472
Amarawati-Fruit And Vegetables,Melon,2016,700,933,233,33.285714285714285
Kinwat,Ground Nut Pods (Dry),2016,5500,5733,233,4.236363636363636
Kalyan,Cucumber,2016,967,1200,233,24.095139607032056
Jawala-Bajar,Turmeric,2016,8400,8633,233,2.7738095238095237
Shevgaon,Wheat(Husked),2016,1676,1909,233,13.902147971360382
Hadgaon,Pigeon Pea (Tur),2015,6700,6933,233,3.4776119402985075
Telhara,Cotton,2016,4247,4480,233,5.486225570991288
Panvel,Bitter Gourd,2016,4225,4458,233,5.514792899408284
Patur,Sorgum(Jawar),2015,1175,1408,233,19.829787234042552
Pusad,Bajri,2016,1790,2023,233,13.016759776536313
Parbhani,Wheat(Husked),2015,1464,1697,233,15.915300546448087
Washim-Ansing,PIGEON PEA (TUR),2016,5767,6000,233,4.040228888503555
Barshi,Cluster Bean,2015,200,433,233,116.5
Kalyan,Green Gram,2016,6900,7133,233,3.3768115942028984
Kalvan,Bajri,2015,1221,1454,233,19.082719082719084
Akola,Sorgum(Jawar),2015,1279,1512,233,18.21735731039875
Anajngaon Surji,Sorgum(Jawar),2015,1260,1493,233,18.49206349206349
Nagpur,Parwar,2015,1256,1489,233,18.55095541401274
Akhadabalapur,Turmeric,2014,5000,5233,233,4.66
Mumbai,Onion,2015,1217,1450,233,19.14543960558751
Vaijapur,Bajri,2015,1502,1735,233,15.512649800266312
Barshi,Soybean,2014,3105,3338,233,7.50402576489533
Kalyan,Papai,2015,1250,1483,233,18.64
Ahmedpur,Sorgum(Jawar),2015,1624,1857,233,14.347290640394089
Mumbai,Snake Gourd,2016,857,1090,233,27.18786464410735
Jalna,Jaggery,2016,3036,3269,233,7.674571805006588
Kolhapur-Laxmipuri,Split Lentil,2016,6742,6975,233,3.4559477899733015
Samudrapur,Soybean,2015,3075,3308,233,7.5772357723577235
Jamkhed,Bajri,2015,1600,1833,233,14.5625
Achalpur,Soybean,2016,3455,3688,233,6.743849493487699
Pune-Pimpri,Bitter Gourd,2014,3450,3683,233,6.753623188405797
Chalisgaon,Bajri,2016,1343,1576,233,17.34921816827997
Udgir,Gram,2016,7850,8083,233,2.968152866242038
Amarawati-Fruit And Vegetables,Beet Root,2016,967,1200,233,24.095139607032056
Varud-Rajura Bazar,Soybean,2015,3073,3306,233,7.582167263260657
Taloda,Wheat(Husked),2014,1467,1700,233,15.882753919563736
Majalgaon,Wheat(Husked),2015,1573,1806,233,14.812460267005722
Sindkhed Raja,Sorgum(Jawar),2016,1267,1500,233,18.389897395422256
Mandhal,Pigeon Pea (Tur),2016,7675,7908,233,3.035830618892508
Barshi-Vairag,Pigeon Pea (Tur),2016,8396,8629,233,2.7751310147689376
Sindkhed Raja,Maize,2016,1000,1233,233,23.3
Chalisgaon,Sorgum(Jawar),2015,1127,1360,233,20.674356699201418
Pune-Pimpri,Ridge Gourd,2014,2017,2250,233,11.551809618244919
Bhandara,Rice(Paddy-Hus),2014,3018,3251,233,7.7203445990722335
Chalisgaon,Bajri,2016,1361,1594,233,17.119764878765615
Amarawati-Fruit And Vegetables,Bitter Gourd,2016,3150,3383,233,7.396825396825397
Satara,Brinjal,2015,667,900,233,34.93253373313343
Umarkhed,Wheat(Husked),2014,1467,1700,233,15.882753919563736
Akola,Soybean,2015,3060,3292,232,7.5816993464052285
Pandharpur,Banana,2014,981,1213,232,23.649337410805302
Washim,Soybean,2015,3100,3332,232,7.483870967741935
Nagpur,Ghosali(Bhaji),2016,573,805,232,40.488656195462475
Satara,Tomato,2016,536,768,232,43.28358208955224
Devala,Sorgum(Jawar),2014,2344,2576,232,9.897610921501707
Washim,Wheat(Husked),2014,1463,1695,232,15.857826384142173
Buldhana,Soybean,2015,3222,3454,232,7.200496585971447
Devala,Sorgum(Jawar),2014,2297,2529,232,10.100130605137135
Jalgaon,Maize(Corn.),2015,781,1013,232,29.70550576184379
Chopda,Sorgum(Jawar),2014,1389,1621,232,16.70266378689705
Ramtek,Brinjal,2016,1114,1346,232,20.825852782764812
Junnar-Otur,Farshi,2016,300,532,232,77.33333333333333
Mumbai,Cabbage,2015,524,756,232,44.274809160305345
Beed,Bajri,2014,1285,1517,232,18.054474708171206
Bhokardan,Green Gram,2016,4604,4836,232,5.039096437880104
Washim,Wheat(Husked),2015,1494,1726,232,15.528781793842034
Pathardi,Bajri,2015,1260,1492,232,18.41269841269841
Khamgaon,Bajri,2015,1299,1531,232,17.8598922247883
Khamgaon,Sunflower,2015,2986,3218,232,7.769591426657736
Bhandara,Rice(Paddy-Hus),2015,2123,2355,232,10.927932171455488
Shahada,Wheat(Husked),2015,1439,1671,232,16.122307157748438
Nagpur,Small Gourd,2014,1704,1936,232,13.615023474178404
Achalpur,Soybean,2016,2950,3182,232,7.864406779661017
Aurangabad,TOMATO,2016,456,688,232,50.87719298245614
Nagpur,Coriander  ,2014,1580,1812,232,14.683544303797468
Mandhal,Gram,2015,4215,4447,232,5.504151838671412
Pathardi,Bajri,2014,1260,1492,232,18.41269841269841
Aurangabad,Bitter Gourd,2016,708,940,232,32.76836158192091
Risod,Soybean,2016,3644,3876,232,6.366630076838639
Hingoli,Gram,2015,4072,4304,232,5.697445972495088
Jintur,Wheat(Husked),2016,1685,1917,232,13.768545994065281
Dound,Bajri,2015,1499,1731,232,15.476984656437626
Mantha,Soybean,2015,3130,3362,232,7.412140575079873
Lonar,Soybean,2015,3525,3757,232,6.581560283687943
Wardha,Soybean,2016,2864,3096,232,8.100558659217876
Achalpur,Wheat(Husked),2016,1607,1839,232,14.436838830118234
Dondaicha,Bajri,2015,1001,1233,232,23.176823176823177
Mumbai,ELEPHANT ROOT,2016,1836,2068,232,12.636165577342048
Pune,Bajri,2016,1879,2111,232,12.346993081426291
Murbad,Paddy-Unhusked,2016,1477,1709,232,15.707515233581585
Kurdwadi,Gram,2015,4158,4390,232,5.5796055796055795
Mumbai,Elephant Root,2016,1988,2220,232,11.670020120724345
Rahuri-Vambori,Gram,2015,2391,2623,232,9.703053115851109
Gangapur,Green Gram,2016,4018,4250,232,5.774016923842708
Nagpur,Chavli (Pala),2015,545,777,232,42.56880733944954
Nagpur,Carrot,2015,1572,1804,232,14.758269720101781
Murtizapur,Soybean,2016,3708,3940,232,6.256742179072276
Gevrai,Cotton,2014,3804,4036,232,6.0988433228180865
Nagpur,Brinjal,2015,620,852,232,37.41935483870968
Gevrai,Green Gram,2015,6819,7051,232,3.4022583956591874
Mumbai,Green Chilli,2016,1035,1267,232,22.415458937198068
Dondaicha,Sorgum(Jawar),2015,1429,1661,232,16.23512946116165
Paithan,BAJRI,2016,1339,1571,232,17.32636295743092
Kopargaon,Sorgum(Jawar),2015,1157,1389,232,20.051858254105444
Khamgaon,Green Gram,2015,6958,7189,231,3.319919517102616
Newasa,WHEAT(HUSKED),2016,1814,2045,231,12.734288864388093
Rahata,Bottle Gourd,2015,377,608,231,61.273209549071616
Shrirampur,Potato,2015,1127,1358,231,20.496894409937887
Baramati,Maize,2015,1415,1646,231,16.325088339222614
Shrirampur,Flower,2015,881,1112,231,26.220204313280362
Dhule,Pigeon Pea (Tur),2015,6230,6461,231,3.707865168539326
Parbhani,Gram,2015,3918,4149,231,5.895865237366003
Pune,Sorgum(Jawar),2016,2276,2507,231,10.1493848857645
Navapur,Ground Nut Pods (Dry),2016,5244,5475,231,4.4050343249427915
Mumbai,Cabbage,2015,669,900,231,34.52914798206278
Jalgaon,Cluster Bean,2014,3892,4123,231,5.9352517985611515
Jintur,Soybean,2016,3437,3668,231,6.720977596741344
Khamgaon,Wheat(Husked),2016,1556,1787,231,14.845758354755784
Lonar,Wheat(Husked),2016,1887,2118,231,12.241653418124006
Nandura,Maize,2015,1223,1454,231,18.887980376124286
Barshi,Maize,2016,1287,1518,231,17.94871794871795
Gevrai,Soybean,2015,3457,3688,231,6.682094301417414
Akluj,Water Melon,2015,195,426,231,118.46153846153847
Gangapur,Pigeon Pea (Tur),2016,7172,7403,231,3.2208588957055215
Ausa,Sorgum(Jawar),2015,1687,1918,231,13.692946058091286
Nagpur,Cabbage,2014,938,1169,231,24.62686567164179
Ausa,Sorgum(Jawar),2014,1237,1468,231,18.674211802748584
Nagpur,Chavli (Pala),2014,992,1223,231,23.286290322580644
Khamgaon,Neem-Seed,2016,951,1182,231,24.290220820189276
Sailu,Sorgum(Jawar),2016,1510,1741,231,15.298013245033113
Hingoli,Wheat(Husked),2014,1498,1729,231,15.42056074766355
Dharangaon,Bajri,2016,1490,1721,231,15.503355704697986
Mudkhed,Sorgum(Jawar),2015,1192,1423,231,19.379194630872483
Tumsar,Gram,2016,5454,5685,231,4.235423542354235
Shahada,Soybean,2015,2988,3219,231,7.730923694779117
Kopargaon,Soybean,2015,3011,3242,231,7.671869810694122
Beed,Bajri,2016,1464,1695,231,15.778688524590164
Barshi,CABBAGE,2016,444,675,231,52.027027027027025
Nagpur,Spinach,2015,504,735,231,45.833333333333336
Amarawati,Cabbage,2015,1354,1585,231,17.06056129985229
Osmanabad,Cabbage,2015,563,794,231,41.03019538188277
Mumbai,Snake Gourd,2015,869,1100,231,26.582278481012658
Lasur Station,Maize,2015,1255,1486,231,18.406374501992033
Bhiwapur,PADDY-UNHUSKED,2016,1870,2101,231,12.352941176470589
Jalna,Soybean,2015,3035,3266,231,7.611202635914333
Nagpur,Ladies Finger,2015,1646,1877,231,14.034021871202917
Mumbai,Cucumber,2016,446,677,231,51.79372197309417
Chandrapur-Ganjwad,Onion,2016,488,719,231,47.33606557377049
Majalgaon,BAJRI,2016,1330,1560,230,17.293233082706767
Patan,Cucumber,2015,772,1002,230,29.792746113989637
Mehkar,Wheat(Husked),2014,1371,1601,230,16.77607585703866
Mehkar,Maize,2015,1100,1330,230,20.90909090909091
Chalisgaon,Wheat(Husked),2015,1439,1669,230,15.983321751216122
Pune-Pimpri,Mango(Raw),2015,1080,1310,230,21.296296296296298
Kille Dharur,Soybean,2016,3008,3238,230,7.6462765957446805
Tumsar,Linseed,2016,4830,5060,230,4.761904761904762
Sengaon,Gram,2016,4083,4313,230,5.633112907176096
Ghatanji,Soybean,2016,3650,3880,230,6.301369863013699
Ghoti,Cucumber,2014,910,1140,230,25.274725274725274
Kille Dharur,Sorgum(Jawar),2016,1860,2090,230,12.365591397849462
Anajngaon Surji,Banana,2016,790,1020,230,29.11392405063291
Kalmeshwar,Flower,2015,605,835,230,38.01652892561984
Samudrapur,Gram,2015,3111,3341,230,7.39312118289939
Mohol,Gram,2016,6483,6713,230,3.5477402437143297
Ambejogai,Green Gram,2016,4985,5215,230,4.613841524573721
Nampur,MAIZE,2016,1049,1279,230,21.9256434699714
Panvel,Bitter Gourd,2016,4030,4260,230,5.707196029776675
Ner Parasopant,Soybean,2016,3440,3670,230,6.686046511627907
Rahuri-Vambori,Wheat(Husked),2014,1515,1745,230,15.181518151815181
Jintur,Soybean,2015,3024,3254,230,7.605820105820106
Dhule,SORGUM(JAWAR),2016,1233,1463,230,18.653690186536902
Baramati,JAGGERY,2016,2970,3200,230,7.744107744107744
Phaltan,Maize,2015,1353,1583,230,16.999260901699927
Ahmednagar,Wheat(Husked),2015,1620,1850,230,14.197530864197532
Shrirampur,Papai,2015,550,780,230,41.81818181818182
Nandurbar,Bajri,2015,1071,1301,230,21.475256769374415
Sangamner,Bajri,2015,1404,1634,230,16.381766381766383
Telhara,Gram,2015,3103,3333,230,7.412181759587496
Kalmeshwar,Spinach,2015,670,900,230,34.32835820895522
Nandura,WHEAT(HUSKED),2016,1605,1835,230,14.330218068535826
Pune-Moshi,Cabbage,2016,496,726,230,46.37096774193548
Pune-Pimpri,FLOWER,2016,667,897,230,34.48275862068966
Shrirampur,GREEN GRAM,2016,4263,4493,230,5.395261552897021
Shrirampur,Water Melon,2015,820,1050,230,28.048780487804876
Manchar,Cucumber,2015,1350,1580,230,17.037037037037038
Jintur-Bori,Soybean,2014,2987,3217,230,7.700033478406428
Murtizapur,Soybean,2016,3037,3267,230,7.573263088574251
Mantha,SORGUM(JAWAR),2016,1870,2100,230,12.29946524064171
Ner Parasopant,Soybean,2015,3353,3583,230,6.859528780196839
Umared,Sorgum(Jawar),2015,1495,1725,230,15.384615384615385
Kalyan,Cucumber,2016,940,1170,230,24.46808510638298
Aurangabad,Wheat(Husked),2015,1570,1800,230,14.64968152866242
Chopda,Maize,2015,1053,1283,230,21.84235517568851
Jalgaon,Gram,2015,3945,4175,230,5.830164765525982
Karjat (Raigad),Paddy-Unhusked,2015,1384,1614,230,16.61849710982659
Achalpur,Ground Nut Pods (Dry),2015,3800,4030,230,6.052631578947368
Ramtek,Brinjal,2016,457,687,230,50.328227571115974
Nilanga,Sorgum(Jawar),2016,1376,1606,230,16.71511627906977
Chimur,Cotton,2015,4067,4297,230,5.655274157855914
Sangrampur-Varvatbakal,Sorgum(Jawar),2016,1050,1280,230,21.904761904761905
Sangrampur-Varvatbakal,SORGUM(JAWAR),2016,1077,1307,230,21.355617455896006
Yawal,Sorgum(Jawar),2016,1220,1450,230,18.852459016393443
Raver,Maize,2016,910,1140,230,25.274725274725274
Jalgaon,Jaggery,2016,3141,3371,230,7.322508755173511
Raver,Wheat(Husked),2016,1625,1855,230,14.153846153846153
Akola,Bajri,2016,1563,1793,230,14.71529110684581
Nagpur,Rice(Paddy-Hus),2015,2497,2727,230,9.2110532639167
Loha,Sorgum(Jawar),2015,1157,1387,230,19.878997407087294
Karanja,Gram,2016,4124,4354,230,5.5771096023278375
Beed,Wheat(Husked),2016,1735,1965,230,13.256484149855908
Sangrampur,Sorgum(Jawar),2015,927,1156,229,24.70334412081985
Panvel,Bitter Gourd,2016,3071,3300,229,7.456854444806252
Tumsar,Jaggery,2016,3278,3507,229,6.985967053081147
Vaduj,Ghevda Seed,2015,3357,3586,229,6.821566875186178
Shrirampur,Flower,2015,838,1067,229,27.326968973747018
Nagpur,Paddy-Unhusked,2015,1550,1779,229,14.774193548387096
Chopda,Soybean,2016,2715,2944,229,8.43462246777164
Nandurbar,Maize,2015,1135,1364,229,20.176211453744493
Vai,Bottle Gourd,2016,1114,1343,229,20.556552962298024
Sengaon,Soybean,2016,3457,3686,229,6.624240671102112
Mul,Paddy-Unhusked,2016,1849,2078,229,12.385073012439156
Akluj,Banana,2015,105,334,229,218.0952380952381
Malkapur,Wheat(Husked),2015,1436,1665,229,15.947075208913649
Pune-Pimpri,Cluster Bean,2016,4500,4729,229,5.088888888888889
Pune-Pimpri,Flower,2015,737,966,229,31.0719131614654
Koregaon,Gram,2015,4500,4729,229,5.088888888888889
Majalgaon,Pigeon Pea (Tur),2016,5725,5954,229,4.0
Nandurbar,Pigeon Pea (Tur),2016,7147,7376,229,3.2041415978732335
Nagpur,Green-Peas,2014,2192,2421,229,10.447080291970803
Sengaon,Soybean,2016,3723,3952,229,6.150953532097771
Amarawati-Fruit And Vegetables,Brinjal,2016,1171,1400,229,19.55593509820666
Nandura,Maize,2016,1148,1377,229,19.94773519163763
Nagpur,Flower,2016,679,908,229,33.726067746686304
Shirpur,Wheat(Husked),2014,1403,1632,229,16.32216678545973
Kopargaon,Soybean,2015,2979,3208,229,7.6871433366901645
Nagpur,Wheat(Husked),2015,1844,2073,229,12.418655097613883
Aarni,Wheat(Husked),2014,1273,1502,229,17.98900235663786
Savner,Gram,2014,2347,2576,229,9.757136770345122
Kopargaon,Sorgum(Jawar),2016,1444,1673,229,15.858725761772853
Dhule,Sorgum(Jawar),2016,1417,1646,229,16.16090331686662
Nilanga,Soybean,2016,3327,3556,229,6.883077847911031
Shahada,Maize,2014,911,1140,229,25.13721185510428
Dudhani,Bajri,2015,1162,1391,229,19.707401032702236
Dudhani,Sorgum(Jawar),2015,1696,1925,229,13.502358490566039
Patan,Cabbage,2015,900,1129,229,25.444444444444443
Ner Parasopant,Pigeon Pea (Tur),2015,5656,5885,229,4.048797736916549
Kalmeshwar,Raddish,2016,747,976,229,30.65595716198126
Amarawati,PIGEON PEA (TUR),2016,5774,6003,229,3.966054728091444
Malkapur,Wheat(Husked),2015,1506,1735,229,15.205843293492697
Pune-Pimpri,Squash Gourd,2016,2057,2286,229,11.132717549829849
Shevgaon-Bodhegaon,Bajri,2016,1414,1643,229,16.195190947666195
Patan,Ladies Finger,2015,1500,1729,229,15.266666666666667
Mehkar,WHEAT(HUSKED),2016,1736,1965,229,13.191244239631336
Partur,Sorgum(Jawar),2015,1127,1356,229,20.319432120674357
Jamkhed,Bajri,2016,1513,1742,229,15.135492399206873
Ahmednagar,Gram,2015,3533,3762,229,6.481743560713275
Mumbai,Tomato,2015,1265,1494,229,18.102766798418973
Phaltan,Maize,2015,1325,1554,229,17.28301886792453
Pune-Pimpri,Cabbage,2015,671,900,229,34.12816691505216
Tumsar,Lentil,2015,5313,5542,229,4.310182571052136
Kannad,Wheat(Husked),2015,1423,1652,229,16.092761770906534
Panvel,Cucumber,2015,1500,1729,229,15.266666666666667
Sonpeth,GREEN GRAM,2016,4230,4459,229,5.41371158392435
Jamkhed,Soybean,2015,3000,3229,229,7.633333333333334
Khed-Chakan,Flower,2016,367,596,229,62.39782016348774
Kalmeshwar,Brinjal,2016,979,1208,229,23.391215526046988
Sakri,Bajri,2016,1304,1533,229,17.561349693251532
Panvel,Ghosali(Bhaji),2015,2214,2443,229,10.343270099367661
Karad,Flower,2015,1057,1286,229,21.665089877010406
Devala,Bajri,2015,1344,1573,229,17.038690476190474
Mehkar,GREEN GRAM,2016,5229,5458,229,4.3794224517116085
Latur-Murud,Sorgum(Jawar),2016,1393,1622,229,16.439339554917446
Akluj,Potato,2015,818,1047,229,27.99511002444988
Vai,Tomato,2015,1182,1411,229,19.37394247038917
Panvel,Ridge Gourd,2015,3457,3686,229,6.624240671102112
Murbad,Bitter Gourd,2015,5464,5693,229,4.191068814055637
Udgir,Pigeon Pea (Tur),2016,8272,8501,229,2.768375241779497
Tumsar,Linseed,2015,4064,4293,229,5.63484251968504
Kalmeshwar,Methi (Bhaji),2015,1859,2088,229,12.318450779989242
Panvel,Ladies Finger,2015,3414,3643,229,6.7076742823667255
Bhokar,Soybean,2014,3085,3314,229,7.423014586709886
Panvel,Ghosali(Bhaji),2016,1200,1429,229,19.083333333333332
Kalmeshwar,Bottle Gourd,2016,914,1142,228,24.945295404814004
Sillod,Wheat(Husked),2015,1272,1500,228,17.92452830188679
Dondaicha-Sindkheda,WHEAT(HUSKED),2016,1734,1962,228,13.14878892733564
Dondaicha-Sindkheda,Sorgum(Jawar),2016,1560,1788,228,14.615384615384615
Jintur,Ground Nut Pods (Dry),2016,4617,4845,228,4.938271604938271
Murbad,Bitter Gourd,2014,1886,2114,228,12.089077412513255
Mumbai,Cucumber,2015,776,1004,228,29.38144329896907
Shirpur,Maize,2015,1240,1468,228,18.387096774193548
Kalmeshwar,Cucumber,2016,514,742,228,44.3579766536965
Dondaicha,Maize,2015,1085,1313,228,21.013824884792626
Jintur,Soybean,2016,3697,3925,228,6.167162564241277
Sillod-Bharadi,Soybean,2014,3000,3228,228,7.6
Barshi-Vairag,Pigeon Pea (Tur),2014,4702,4930,228,4.849000425350915
Pulgaon,Soybean,2016,3415,3643,228,6.6764275256222545
Manora,Soybean,2016,3542,3770,228,6.437041219649915
Jamner-Neri,Cotton,2016,4248,4476,228,5.367231638418079
Karad,Cabbage,2016,404,632,228,56.43564356435643
Kalmeshwar,Cucumber,2015,1330,1558,228,17.142857142857142
Buldhana-Dhad,Maize,2016,1433,1661,228,15.910676901605024
Pune-Pimpri,Cabbage,2015,947,1175,228,24.076029567053855
Kalmeshwar,Cotton,2015,3751,3979,228,6.078379098906958
Kannad,Wheat(Husked),2015,1421,1649,228,16.045038705137227
Tumsar,OTHER PULSES,2016,5078,5306,228,4.489956675856637
Nanded,Pigeon Pea (Tur),2016,7522,7750,228,3.0311087476734913
Ramtek,Potato,2016,1295,1523,228,17.606177606177607
Ramtek,Potato,2016,1283,1511,228,17.770849571317225
Mohol,Wheat(Husked),2016,1815,2043,228,12.561983471074381
Shrirampur,Soybean,2014,2818,3046,228,8.09084457061746
Jalgaon,Cluster Bean,2016,4345,4573,228,5.24741081703107
Khed-Chakan,CABBAGE,2016,272,500,228,83.82352941176471
Armori-Desaiganj,Paddy-Unhusked,2015,1444,1672,228,15.789473684210526
Amalner,Wheat(Husked),2015,1498,1726,228,15.220293724966622
Beed,Wheat(Husked),2016,1646,1874,228,13.85176184690158
Kalyan,Elephant Root,2016,1933,2161,228,11.795137092602173
Mul,Paddy-Unhusked,2015,2000,2228,228,11.4
Aurangabad,Flower,2016,536,764,228,42.53731343283582
Ner Parasopant,Soybean,2016,3403,3631,228,6.6999706141639725
Murtizapur,Soybean,2015,3015,3243,228,7.562189054726368
Solapur,Soybean,2014,2948,3176,228,7.734056987788331
Akot,Maize,2016,1140,1368,228,20.0
Nagpur,Cucumber,2015,1467,1695,228,15.541922290388548
Rahata,POTATO,2016,1127,1355,228,20.23070097604259
Rahata,Gram,2014,2186,2414,228,10.430009149130832
Amarawati,Math (Bhaji),2015,1886,2114,228,12.089077412513255
Washim,Soybean,2014,3096,3324,228,7.364341085271318
Patan,Cabbage,2015,936,1164,228,24.358974358974358
Amarawati,Ladies Finger,2015,1829,2057,228,12.465828321487152
Murum,Sorgum(Jawar),2016,1922,2150,228,11.86264308012487
Gangapur,Bajri,2014,1198,1426,228,19.031719532554256
Vani,Cotton,2015,3905,4133,228,5.838668373879641
Raver,Sorgum(Jawar),2015,1245,1473,228,18.313253012048193
Aurangabad,Bottle Gourd,2015,400,628,228,57.0
Kalvan,Pigeon Pea (Tur),2016,6411,6639,228,3.5563874590547497
Ramtek,Carrot,2016,878,1106,228,25.968109339407746
Gevrai,Sorgum(Jawar),2016,1548,1776,228,14.728682170542635
Karanja,Wheat(Husked),2014,1369,1597,228,16.654492330168004
Telhara,Sunflower,2015,2938,3166,228,7.760381211708645
Chopda,Maize,2015,955,1183,228,23.87434554973822
Lasur Station,Bajri,2015,1313,1541,228,17.364813404417365
Nashik-Devlali,Papai,2016,805,1033,228,28.322981366459626
Umari,Pigeon Pea (Tur),2016,8101,8329,228,2.814467349709912
Pusad,Sorgum(Jawar),2015,1266,1494,228,18.009478672985782
Lasalgaon,Wheat(Husked),2016,1798,2026,228,12.68075639599555
Dhamangaon-Rly,Pigeon Pea (Tur),2014,4592,4820,228,4.965156794425087
Aheri,Pigeon Pea (Tur),2016,6954,7182,228,3.278688524590164
Barshi,Squash Gourd,2016,395,623,228,57.721518987341774
Chandrapur-Ganjwad,Onion,2016,640,868,228,35.625
Shegaon,Sorgum(Jawar),2015,1096,1324,228,20.802919708029197
Latur,Soybean,2015,3185,3413,228,7.158555729984301
Beed,Gram,2016,3968,4195,227,5.720766129032258
Nagbhid,Paddy-Unhusked,2014,2044,2271,227,11.105675146771038
Balapur,Sorgum(Jawar),2015,1448,1675,227,15.676795580110497
Murbad,Ladies Finger,2015,3633,3860,227,6.248279658684283
Nandurbar,Green Gram,2015,6905,7132,227,3.287472845763939
Tumsar,Sarsav,2016,3296,3523,227,6.887135922330097
Amalner,Onion,2016,151,378,227,150.33112582781456
Murbad,Ladies Finger,2015,4403,4630,227,5.155575743811038
Sengaon,Gram,2016,5024,5251,227,4.518312101910828
Chandrapur-Ganjwad,POTATO,2016,1132,1359,227,20.053003533568905
Amarawati,Gram,2015,3521,3748,227,6.447032093155354
Purna,Soybean,2015,3503,3730,227,6.480159862974594
Vaduj,Gram,2015,3867,4094,227,5.87018360486165
Dhule,Maize,2016,1269,1496,227,17.88810086682427
Shrirampur,SOYBEAN,2016,2552,2779,227,8.89498432601881
Amarawati,Math (Bhaji),2016,2420,2647,227,9.380165289256198
Lasur Station,Soybean,2016,3430,3657,227,6.618075801749272
Achalpur,Soybean,2015,3220,3447,227,7.049689440993789
Aurangabad,Banana,2015,251,478,227,90.43824701195219
Anajngaon Surji,Soybean,2015,2960,3187,227,7.668918918918919
Sakri,Gram,2015,3186,3413,227,7.124921531701193
Kalmeshwar,Coriander  ,2014,2696,2923,227,8.419881305637983
Majalgaon,Cotton,2015,3663,3890,227,6.197106197106197
Ahmedpur,Soybean,2016,3660,3887,227,6.202185792349726
Gangapur,Bajri,2014,1316,1543,227,17.24924012158055
Yawal,Cotton,2015,3994,4221,227,5.683525287931898
Nandura,Sorgum(Jawar),2015,1187,1414,227,19.12384161752317
Shrirampur,Sorgum(Jawar),2016,1625,1852,227,13.96923076923077
Buldhana,Sorgum(Jawar),2016,1218,1445,227,18.637110016420362
Ausa,Jaggery,2015,1851,2078,227,12.263641274986494
Nandura,Wheat(Husked),2015,1360,1587,227,16.691176470588236
Pathardi,Bajri,2015,1253,1480,227,18.116520351157224
Pulgaon,Soybean,2015,2938,3165,227,7.726344452008169
Ambejogai,Wheat(Husked),2015,1757,1984,227,12.919749573136027
Shahada,Wheat(Husked),2016,1642,1869,227,13.824604141291108
Vai,Bottle Gourd,2016,1091,1318,227,20.80659945004583
Murbad,Ladies Finger,2014,3720,3947,227,6.102150537634409
Nagpur,Small Gourd,2015,900,1127,227,25.22222222222222
Buldhana,Maize,2016,1183,1410,227,19.18850380388842
Bhokar,Wheat(Husked),2015,1346,1573,227,16.86478454680535
Aurangabad,Banana,2015,298,525,227,76.1744966442953
Devala,Horse Gram,2016,3141,3368,227,7.226997771410379
Anajngaon Surji,Soybean,2015,2958,3185,227,7.674104124408384
Shrirampur,Potato,2015,742,969,227,30.59299191374663
Pune-Pimpri,Beet Root,2015,1682,1909,227,13.495838287752676
Akola,Bajri,2015,1567,1794,227,14.48627951499681
Nandurbar,Maize,2016,1323,1550,227,17.157974300831444
Nandgaon,Horse Gram,2014,2636,2863,227,8.611532625189682
Nagpur,Parwar,2014,1219,1446,227,18.621821164889255
Nagpur,Cluster Bean,2015,1304,1531,227,17.4079754601227
Solapur,Banana,2016,971,1198,227,23.377960865087537
Shrirampur,Cabbage,2016,809,1036,227,28.059332509270703
Beed,Bajri,2015,1338,1565,227,16.965620328849027
Pune-Pimpri,Wal Papdi,2015,2264,2491,227,10.026501766784452
Korpana,Soybean,2015,3383,3610,227,6.710020691693763
Jintur,Black Gram,2014,4252,4479,227,5.338664158043274
Latur,Safflower,2015,2637,2864,227,8.608266970041715
Digras,Gram,2015,3761,3988,227,6.035628822121776
Umari,Gram,2016,3975,4202,227,5.710691823899371
Nagpur,Capsicum,2016,1309,1536,227,17.3414820473644
Akluj,Wheat(Husked),2015,1554,1781,227,14.607464607464607
Barshi,Fodder,2016,808,1035,227,28.094059405940595
Karad,Tomato,2016,477,704,227,47.58909853249476
Latur,SAFFLOWER,2016,2592,2819,227,8.757716049382717
Kille Dharur,Bajri,2016,1816,2043,227,12.5
Ausa,Maize,2016,1139,1366,227,19.929762949956103
Lasalgaon-Vinchur,Sorgum(Jawar),2016,1366,1592,226,16.544655929721817
Lasur Station,Maize,2014,1084,1310,226,20.84870848708487
Gevrai,Bajri,2016,1370,1596,226,16.496350364963504
Mehkar,Sorgum(Jawar),2016,1254,1480,226,18.02232854864434
Nagpur,Mosambi,2015,1274,1500,226,17.739403453689167
Lasalgaon-Niphad,Soybean,2016,3376,3602,226,6.694312796208531
Hadgaon,Cotton,2015,4132,4358,226,5.469506292352372
Vai,Flower,2016,770,996,226,29.350649350649352
Washim-Ansing,Pigeon Pea (Tur),2016,8817,9043,226,2.5632301236248156
Umarkhed,Soybean,2016,3347,3573,226,6.752315506423663
Jawala-Bajar,Soybean,2016,2768,2994,226,8.164739884393063
Nagpur,Spinach,2016,535,761,226,42.242990654205606
Gevrai,Bajri,2015,1371,1597,226,16.484318016046682
Sillod,Wheat(Husked),2016,1419,1645,226,15.926708949964764
Pusad,Soybean,2014,3039,3265,226,7.436656794998354
Mumbai,Sugar,2015,2489,2715,226,9.079951787866612
Vai,Cucumber,2014,927,1153,226,24.379719525350595
Chandrapur,Pigeon Pea (Tur),2014,4313,4539,226,5.239972177138882
Shirpur,Bajri,2015,1023,1249,226,22.091886608015642
Parbhani,SOYBEAN,2016,2545,2771,226,8.880157170923379
Shegaon,Soybean,2016,2896,3122,226,7.803867403314917
Nandura,Maize,2014,965,1191,226,23.419689119170986
Latur,Soybean,2016,3395,3621,226,6.656848306332843
Kolhapur-Laxmipuri,Gram,2014,3127,3353,226,7.227374480332587
Sailu,SORGUM(JAWAR),2016,2044,2270,226,11.056751467710372
Mumbai,Sugar,2016,3155,3381,226,7.163232963549921
Risod,Soybean,2016,3746,3972,226,6.03310197544047
Dondaicha,Maize,2015,1233,1459,226,18.329278183292782
Nagpur,Jack Fruit,2016,1732,1958,226,13.04849884526559
Shrirampur,Soybean,2015,3354,3580,226,6.738223017292785
Kej,Wheat(Husked),2016,1946,2172,226,11.613566289825282
Kalamb (Os),Bajri,2016,1171,1397,226,19.299743808710502
Vai,Brinjal,2015,796,1022,226,28.391959798994975
Bhivandi,Other Vegetables,2015,1157,1383,226,19.533275713050994
Nagbhid,Paddy-Unhusked,2015,1625,1851,226,13.907692307692308
Telhara,Soybean,2016,3426,3652,226,6.5966141272621135
Murbad,Tomato,2015,3227,3453,226,7.003408738766656
Tuljapur,Gram,2016,4165,4391,226,5.426170468187275
Jintur-Bori,Sorgum(Jawar),2015,1352,1578,226,16.715976331360945
Karanja,Gram,2016,4067,4293,226,5.556921563806245
Aurangabad,Cabbage,2015,639,865,226,35.36776212832551
Aurangabad,Bottle Gourd,2016,372,598,226,60.75268817204301
Raver,Sorgum(Jawar),2015,1156,1382,226,19.55017301038062
Amarawati,Wheat(Husked),2015,1604,1830,226,14.089775561097257
Katol,Ground Nut Pods (Dry),2015,3525,3751,226,6.411347517730497
Amarawati,Potato,2016,1226,1452,226,18.43393148450245
Mangalwedha,Bajri,2016,1195,1421,226,18.91213389121339
Barshi,Wheat(Husked),2014,1510,1736,226,14.966887417218542
Nilanga,Sorgum(Jawar),2015,1154,1380,226,19.584055459272097
Washim,Soybean,2015,3111,3337,226,7.264545162327226
Rahuri,Gram,2014,2144,2370,226,10.541044776119403
Rahuri-Vambori,Sorgum(Jawar),2016,1433,1659,226,15.771109560362875
Mumbai,Flower,2015,752,978,226,30.0531914893617
Mantha,Soybean,2016,3675,3900,225,6.122448979591836
Patur,Soybean,2016,3458,3683,225,6.506651243493349
Panvel,Cucumber,2014,1413,1638,225,15.92356687898089
Yawal,Sorgum(Jawar),2016,1200,1425,225,18.75
Jamkhed,Soybean,2016,3155,3380,225,7.131537242472266
Kalyan,POTATO,2016,871,1096,225,25.832376578645235
Nagpur,Ladies Finger,2014,2125,2350,225,10.588235294117647
Yeola,Bajri,2014,1245,1470,225,18.072289156626507
Gangapur,Bajri,2015,1191,1416,225,18.89168765743073
Parli-Vaijnath,Soybean,2016,3169,3394,225,7.100031555695803
Dhamangaon-Rly,Wheat(Husked),2015,1200,1425,225,18.75
Patur,Sorgum(Jawar),2015,1175,1400,225,19.148936170212767
Parli-Vaijnath,Wheat(Husked),2015,1435,1660,225,15.679442508710801
Barshi,Soybean,2014,3125,3350,225,7.2
Jafrabad,Soybean,2016,3600,3825,225,6.25
Yeola,Soybean,2014,3138,3363,225,7.170172084130019
Achalpur,Soybean,2015,3005,3230,225,7.487520798668885
Kille Dharur,Green Gram,2014,7133,7358,225,3.154353007149867
Pandharkawada,Cotton,2015,3750,3975,225,6.0
Lonand,Bajri,2016,1700,1925,225,13.235294117647058
Patur,Wheat(Husked),2015,1275,1500,225,17.647058823529413
Patur,Wheat(Husked),2016,1594,1819,225,14.11543287327478
Jalgaon,Amla,2016,1200,1425,225,18.75
Kej,Black Gram,2014,4926,5151,225,4.5676004872107185
Sangrampur-Varvatbakal,Sorgum(Jawar),2016,1213,1438,225,18.549051937345425
Jalgaon,Maize(Corn.),2015,625,850,225,36.0
Yeola,Green Gram,2014,7352,7577,225,3.060391730141458
Chopda,Black Gram,2015,9150,9375,225,2.459016393442623
Sillod-Bharadi,Bajri,2016,1525,1750,225,14.754098360655737
Amarawati-Fruit And Vegetables,DHEMSE,2016,1563,1788,225,14.395393474088293
Umared,Soybean,2016,3322,3547,225,6.773028296207104
Achalpur,Gram,2015,4275,4500,225,5.2631578947368425
Ahmednagar,Maize,2015,1000,1225,225,22.5
Nanded,GRAM,2016,7717,7942,225,2.915640793054296
Tuljapur,Gram,2016,5700,5925,225,3.9473684210526314
Ghansawangi,Bajri,2016,1150,1375,225,19.565217391304348
Amarawati,Cucumber,2016,1688,1913,225,13.329383886255924
Chopda,Soybean,2014,2936,3161,225,7.663487738419619
Sakri,Wheat(Husked),2016,1418,1643,225,15.867418899858956
Kille Dharur,Wheat(Husked),2015,1450,1675,225,15.517241379310345
Chimur,Soybean,2016,3438,3663,225,6.544502617801047
Mumbai,Sugar,2016,3620,3845,225,6.2154696132596685
Kej,Wheat(Husked),2015,2350,2575,225,9.574468085106384
Jalgaon Jamod,Ground Nut Pods (Dry),2014,3163,3388,225,7.113499841922226
Pune-Pimpri,Ridge Gourd,2015,2567,2792,225,8.76509544215037
Buldhana,Sorgum(Jawar),2015,1100,1325,225,20.454545454545453
Achalpur,Wheat(Husked),2016,1563,1788,225,14.395393474088293
Kada,Green Gram,2015,7025,7250,225,3.202846975088968
Kej,Sorgum(Jawar),2016,1759,1984,225,12.791358726549175
Jintur,Wheat(Husked),2015,1540,1765,225,14.61038961038961
Kalmeshwar,Tomato,2016,1063,1288,225,21.16650987770461
Kalmeshwar,Tomato,2016,953,1178,225,23.609653725078697
Sangrampur-Varvatbakal,Maize,2015,1050,1275,225,21.428571428571427
Tasgaon,Sorgum(Jawar),2014,1375,1600,225,16.363636363636363
Jalna,Banana,2016,175,400,225,128.57142857142858
Bhokardan-Pimpalgaon Renu,Pigeon Pea (Tur),2016,7950,8175,225,2.830188679245283
Kalvan,Wheat(Husked),2015,1546,1771,225,14.553686934023286
Akhadabalapur,Gram,2016,3475,3700,225,6.474820143884892
Patur,Pigeon Pea (Tur),2014,4350,4575,225,5.172413793103448
Anajngaon Surji,Banana,2014,950,1175,225,23.68421052631579
Nashik-Devlali,Papai,2016,775,1000,225,29.032258064516128
Taloda,Bajri,2016,1500,1725,225,15.0
Patur,Sorgum(Jawar),2015,1475,1700,225,15.254237288135593
Khed (Shel Pimpalgaon),Cabbage,2016,1900,2125,225,11.842105263157896
Sangamner,Bajri,2015,1350,1575,225,16.666666666666668
Jalkot,Sunflower,2015,3300,3525,225,6.818181818181818
Shirur,Indian Bean,2016,3456,3681,225,6.510416666666667
Jamkhed,Gram,2015,3175,3400,225,7.086614173228346
Osmanabad,Water Melon,2016,625,850,225,36.0
Chandur Bajar,Wheat(Husked),2015,1350,1575,225,16.666666666666668
Anajngaon Surji,Green Gram,2015,7200,7425,225,3.125
Sinner,Castor Seed,2015,2800,3025,225,8.035714285714286
Jamkhed,Gram,2015,3530,3755,225,6.373937677053824
Manchar,Wal Papdi,2015,3050,3275,225,7.377049180327869
Manchar,Maize(Corn.),2015,500,725,225,45.0
Sinner,Soybean,2014,3045,3270,225,7.389162561576355
Naigaon,Green Gram,2014,7000,7225,225,3.2142857142857144
Amarawati,Potato,2016,1470,1695,225,15.306122448979592
Sinner,Wheat(Husked),2015,1541,1766,225,14.600908500973395
Umarga,Safflower,2015,2428,2653,225,9.266886326194399
Sailu,Cotton,2015,4238,4463,225,5.3091080698442665
Akhadabalapur,Pigeon Pea (Tur),2015,4450,4675,225,5.056179775280899
Barshi,Black Gram,2016,7542,7767,225,2.983293556085919
Nagpur,Sweet Potato,2016,1050,1275,225,21.428571428571427
Nagpur,Capsicum,2015,2154,2379,225,10.445682451253482
Kalmeshwar,Chavli (Shenga ),2016,1139,1364,225,19.754170324846356
Panvel,Ghosali(Bhaji),2016,1275,1500,225,17.647058823529413
Bhusaval,Bajri,2016,1550,1775,225,14.516129032258064
Nagpur,Cluster Bean,2015,1425,1650,225,15.789473684210526
Lonar,Sorgum(Jawar),2016,1817,2042,225,12.383048981838195
Manchar,Flower,2015,858,1083,225,26.223776223776223
Latur,Soybean,2014,3062,3287,225,7.348138471587198
Parola,Sorgum(Jawar),2016,1365,1590,225,16.483516483516482
Amarawati,Dhemse,2015,2400,2625,225,9.375
Kalmeshwar,Coriander  ,2014,3101,3326,225,7.255723960012899
Chandrapur-Ganjwad,Brinjal,2015,275,500,225,81.81818181818181
Tasgaon,Gram,2015,3250,3475,225,6.923076923076923
Solapur,Hemp,2014,225,450,225,100.0
Amarawati,Wheat(Husked),2014,1700,1925,225,13.235294117647058
Dhule,Cowpea,2014,3985,4210,225,5.646173149309912
Dudhani,Wheat(Husked),2014,1380,1605,225,16.304347826086957
Amarawati,Pigeon Pea (Tur),2014,5000,5225,225,4.5
Mumbai,Tomato,2015,958,1183,225,23.48643006263048
Mumbai,Sugar,2015,2484,2709,225,9.057971014492754
Shrigonda,MAIZE,2016,1108,1333,225,20.306859205776174
Khamgaon,Wheat(Husked),2014,1357,1582,225,16.58069270449521
Mumbai,Squash Gourd,2015,817,1042,225,27.539779681762546
Shrirampur,Sorgum(Jawar),2016,1470,1695,225,15.306122448979592
Shahapur,Paddy-Unhusked,2015,1433,1658,225,15.7013258897418
Jintur-Bori,Sorgum(Jawar),2014,1100,1325,225,20.454545454545453
Shevgaon,Bajri,2016,1365,1590,225,16.483516483516482
Pune-Pimpri,Onion,2015,3650,3875,225,6.164383561643835
Kalyan,Wheat(Husked),2015,1963,2188,225,11.462047885888946
Chikhali,Wheat(Husked),2014,1350,1575,225,16.666666666666668
Raver,Gram,2016,4934,5159,225,4.560194568301581
Kalamnuri,Wheat(Husked),2016,1600,1825,225,14.0625
Kalmeshwar,Brinjal,2014,871,1096,225,25.832376578645235
Pune-Pimpri,Wal Papdi,2015,2563,2788,225,8.778774873195474
Jalgaon Jamod-Aasalgaon,Wheat(Husked),2016,1350,1575,225,16.666666666666668
Jalgaon Jamod-Aasalgaon,SORGUM(JAWAR),2016,1075,1300,225,20.930232558139537
Sangrampur,Sorgum(Jawar),2015,969,1194,225,23.21981424148607
Lohara,Wheat(Husked),2015,1250,1475,225,18.0
Buldhana-Dhad,Soybean,2015,3075,3300,225,7.317073170731708
Chandur Bajar,Wheat(Husked),2016,1600,1825,225,14.0625
Umarga,Sorgum(Jawar),2015,1464,1688,224,15.300546448087431
Nagpur,Wal Bhaji,2014,2328,2552,224,9.621993127147766
Barshi,Water Melon,2016,270,494,224,82.96296296296296
Rahuri-Vambori,Wheat(Husked),2015,1461,1685,224,15.331964407939767
Ghoti,Cabbage,2015,1201,1425,224,18.651124063280598
Mumbai-Fruit Market,Melon,2016,1524,1748,224,14.698162729658792
Kalmeshwar,Brinjal,2015,1488,1712,224,15.053763440860216
Solapur,Gram,2015,3957,4181,224,5.660854182461461
Khamgaon,Maize,2015,1138,1362,224,19.68365553602812
Jalkot,Soybean,2015,3442,3666,224,6.5078442765833815
Chandur Bajar,Pigeon Pea (Tur),2014,4699,4923,224,4.766971696105554
Barshi-Vairag,Gram,2016,5204,5428,224,4.304381245196003
Barshi,Fodder,2016,719,943,224,31.154381084840054
Chopda,Ground Nut Pods (Dry),2015,5101,5325,224,4.391295824348167
Parbhani,SORGUM(JAWAR),2016,1696,1920,224,13.20754716981132
Aurangabad,Cabbage,2015,571,795,224,39.229422066549915
Patur,Gram,2015,2951,3175,224,7.590647238224331
Nashik,Spinach,2016,204,428,224,109.80392156862744
Navapur,FLOWER,2016,597,821,224,37.52093802345058
Shahada,Sorgum(Jawar),2015,1239,1463,224,18.07909604519774
Manchar,Shepu,2015,566,790,224,39.57597173144876
Shevgaon,Bajri,2014,1124,1348,224,19.9288256227758
Jawala-Bajar,Wheat(Husked),2015,1519,1743,224,14.746543778801843
Buldhana,Soybean,2015,3141,3365,224,7.131486787647246
Sangrampur-Varvatbakal,Wheat(Husked),2015,1273,1497,224,17.596229379418695
Majalgaon,Sunflower,2016,2976,3200,224,7.526881720430108
Nagpur,Chavli (Shenga ),2014,1348,1572,224,16.617210682492583
Kada,Maize,2015,979,1203,224,22.880490296220632
Sailu,Soybean,2014,2906,3130,224,7.708189951823813
Indapur (Nimgaon Ketki),Sorgum(Jawar),2016,1653,1877,224,13.55111917725348
Ambejogai,Soybean,2015,3684,3908,224,6.080347448425624
Shrirampur,Water Melon,2015,808,1032,224,27.722772277227723
Malkapur,Wheat(Husked),2016,1722,1946,224,13.008130081300813
Ashti-Karanja,Soybean,2016,2553,2777,224,8.773991382687035
Mumbai,Bottle Gourd,2014,860,1084,224,26.046511627906977
Indapur (Nimgaon Ketki),Sorgum(Jawar),2015,1551,1775,224,14.442295293359123
Solapur,Jaggery,2015,2074,2298,224,10.800385728061716
Pune-Moshi,Carrot,2016,1524,1748,224,14.698162729658792
Devani,Pigeon Pea (Tur),2016,9057,9281,224,2.4732251297339074
Varud-Rajura Bazar,Soybean,2014,3113,3337,224,7.195631223899775
Dondaicha,Bajri,2015,1299,1523,224,17.244033872209393
Sillod-Bharadi,Wheat(Husked),2016,1452,1676,224,15.426997245179063
Phaltan,Maize,2016,1325,1548,223,16.830188679245282
Raver,Wheat(Husked),2014,1324,1547,223,16.842900302114803
Ghoti,Cabbage,2016,1733,1956,223,12.867859203693017
Aurangabad,Maize(Corn.),2015,524,747,223,42.55725190839695
Vani,Gram,2016,7094,7317,223,3.143501550606146
Mumbai,Sugar,2016,3081,3304,223,7.23790976955534
Kalamb (Os),Bajri,2015,1568,1791,223,14.221938775510203
Ramtek,Raddish,2016,462,685,223,48.268398268398265
Pachora,Wheat(Husked),2016,1449,1672,223,15.38992408557626
Nagpur,Green Chilli,2014,1377,1600,223,16.19462599854757
Ausa,Sunflower,2014,2722,2945,223,8.19250551065393
Taloda,Green Gram,2015,6594,6817,223,3.381862299059751
Hingoli,Wheat(Husked),2015,1724,1947,223,12.935034802784223
Jafrabad,Wheat(Husked),2015,1344,1567,223,16.592261904761905
Kalmeshwar,Bitter Gourd,2015,1788,2011,223,12.472035794183444
Patur,Soybean,2015,3067,3290,223,7.270948809911966
Nagpur,Small Gourd,2015,1429,1652,223,15.605318404478657
Vasai,Paddy-Unhusked,2015,1447,1670,223,15.411195577055977
Vai,Bottle Gourd,2015,944,1167,223,23.622881355932204
Vaduj,GHEVDA SEED,2016,7144,7367,223,3.121500559910414
Ner Parasopant,Gram,2016,3980,4203,223,5.603015075376884
Shrirampur,Bor,2015,904,1127,223,24.668141592920353
Nashik,Spinach,2016,261,484,223,85.44061302681992
Bhokar,Wheat(Husked),2015,1397,1620,223,15.962777380100215
Akhadabalapur,Gram,2016,3730,3953,223,5.978552278820375
Gevrai,Bajri,2015,1397,1620,223,15.962777380100215
Chandrapur-Ganjwad,Ladies Finger,2014,744,967,223,29.973118279569892
Kalmeshwar,SPINACH,2016,473,696,223,47.145877378435515
Shrirampur,Papai,2015,800,1023,223,27.875
Manora,Soybean,2016,3538,3761,223,6.302996042962126
Gangapur,Pigeon Pea (Tur),2016,8105,8328,223,2.7513880320789634
Chalisgaon,Sorgum(Jawar),2015,1188,1411,223,18.77104377104377
Sinner,Maize,2015,1248,1471,223,17.868589743589745
Jalkot,GREEN GRAM,2016,4472,4695,223,4.9865831842576025
Mumbai,Sugar,2015,2799,3022,223,7.96713111825652
Nashik-Devlali,Chavli (Pala),2016,404,627,223,55.198019801980195
Savner,Soybean,2016,3144,3367,223,7.092875318066158
Nagpur,Brinjal,2015,985,1208,223,22.639593908629443
Washim,Wheat(Husked),2014,1400,1623,223,15.928571428571429
Mangaon(Bhadav),Paddy-Unhusked,2014,1300,1523,223,17.153846153846153
Rahuri-Vambori,Soybean,2015,3566,3789,223,6.25350532809871
Rahata,Bottle Gourd,2014,233,456,223,95.70815450643777
Manora,Wheat(Husked),2016,1585,1808,223,14.069400630914826
Shrirampur,Cucumber,2016,1000,1223,223,22.3
Mantha,Gram,2015,4060,4283,223,5.4926108374384235
Karanja,Sorgum(Jawar),2015,1322,1545,223,16.86838124054463
Dound,Bajri,2014,1389,1612,223,16.05471562275018
Shevgaon-Bodhegaon,Pigeon Pea (Tur),2015,8536,8759,223,2.612464854732896
Lasalgaon-Vinchur,Wheat(Husked),2016,1734,1957,223,12.860438292964245
Nagpur,Green-Peas,2015,1768,1991,223,12.613122171945701
Shrirampur,Water Melon,2016,923,1146,223,24.160346695557962
Shrirampur,Soybean,2015,2966,3189,223,7.518543492919758
Nagbhid,Paddy-Unhusked,2016,2043,2266,223,10.915320606950562
Kurdwadi,Wheat(Husked),2016,2000,2223,223,11.15
Satara,Cabbage,2015,286,509,223,77.97202797202797
Partur,Wheat(Husked),2015,1578,1801,223,14.131812420785804
Parola,Wheat(Husked),2016,1367,1590,223,16.313094367227507
Ramtek,Tomato,2016,941,1164,223,23.69819341126461
Ner Parasopant,Pigeon Pea (Tur),2016,7674,7897,223,2.905916080271045
Anajngaon Surji,Sorgum(Jawar),2015,1113,1336,223,20.035938903863432
Umared,CORIANDER (DRY),2016,5531,5753,222,4.013740734044476
Vai,Bottle Gourd,2015,1011,1233,222,21.958456973293767
Shrirampur,Cucumber,2016,956,1178,222,23.221757322175733
Kopargaon,Soybean,2016,3728,3950,222,5.954935622317596
Murum,Gram,2016,5378,5600,222,4.1279285979918185
Patur,Wheat(Husked),2014,1300,1522,222,17.076923076923077
Dhule,Black Gram,2015,5390,5612,222,4.1187384044526905
Mantha,Wheat(Husked),2014,1425,1647,222,15.578947368421053
Chakur,Gram,2016,4097,4319,222,5.418598974859654
Jamkhed,Gram,2015,3175,3397,222,6.9921259842519685
Barshi-Vairag,Gram,2014,1995,2217,222,11.12781954887218
Patan,Flower,2014,1311,1533,222,16.933638443935926
Kalmeshwar,Walvad,2015,2801,3023,222,7.925740806854694
Lonar,Sorgum(Jawar),2016,1579,1801,222,14.059531348955035
Pulgaon,Soybean,2016,3300,3522,222,6.7272727272727275
Narkhed,Cotton,2016,4687,4909,222,4.736505227224237
Akola,Maize,2015,1120,1342,222,19.821428571428573
Kalmeshwar,Tomato,2015,971,1193,222,22.86302780638517
Sailu,Soybean,2015,3758,3980,222,5.907397551889303
Latur,Bajri,2016,1632,1854,222,13.602941176470589
Kalmeshwar,Flower,2016,834,1056,222,26.618705035971225
Tasgaon,Soybean,2014,2896,3118,222,7.665745856353591
Dondaicha,Sorgum(Jawar),2015,1332,1554,222,16.666666666666668
Indapur,Bajri,2016,1678,1900,222,13.230035756853397
Sangamner,Gram,2016,4036,4258,222,5.500495540138751
Barshi,Fodder,2016,798,1020,222,27.81954887218045
Rajura,Cotton,2016,4242,4464,222,5.233380480905233
Nashik,Spinach,2016,258,480,222,86.04651162790698
Nampur,Bajri,2016,1387,1609,222,16.005767844268206
Sillod,Soybean,2016,3411,3633,222,6.508355321020229
Manmad,Maize,2014,976,1198,222,22.74590163934426
Lasur Station,Bajri,2016,1632,1854,222,13.602941176470589
Kalmeshwar,Orange,2015,407,629,222,54.54545454545455
Barshi,Green Gram,2016,6578,6800,222,3.3748859835816356
Kundalwadi,Gram,2016,4121,4343,222,5.387041980101917
Shevgaon,Wheat(Husked),2016,1647,1869,222,13.479052823315119
Kalvan,Maize,2016,1293,1515,222,17.16937354988399
Ramtek,Jack Fruit,2016,814,1036,222,27.272727272727273
Morshi,Pigeon Pea (Tur),2014,4500,4722,222,4.933333333333334
Lonar,Gram,2015,3312,3534,222,6.702898550724638
Khed-Chakan,Potato,2016,1461,1683,222,15.195071868583161
Gondpimpri,Pigeon Pea (Tur),2015,5507,5729,222,4.0312329762120935
Shirur,Gram,2016,4034,4256,222,5.503222607833416
Shahada,Maize,2015,959,1181,222,23.149113660062564
Murbad,Paddy-Unhusked,2014,1678,1900,222,13.230035756853397
Jalgaon,Potato,2015,518,740,222,42.857142857142854
Wardha,Soybean,2014,2954,3176,222,7.515233581584292
Ramtek,Potato,2015,1157,1379,222,19.187554019014694
Patur,Sorgum(Jawar),2016,1260,1482,222,17.61904761904762
Shevgaon-Bodhegaon,Gram,2015,3111,3333,222,7.135969141755063
Karanja,Wheat(Husked),2014,1365,1587,222,16.263736263736263
Latur-Murud,Soybean,2016,3255,3477,222,6.820276497695852
Manmad,Wheat(Husked),2015,1463,1685,222,15.1742993848257
Ghatanji,Soybean,2016,3480,3702,222,6.379310344827586
Zarijamini,Pigeon Pea (Tur),2015,6170,6392,222,3.59805510534846
Mumbai,Cabbage,2015,556,778,222,39.92805755395683
Umarkhed-Danki,Soybean,2015,2956,3178,222,7.510148849797023
Jamkhed,Soybean,2016,2822,3044,222,7.8667611622962434
Dudhani,Sorgum(Jawar),2016,1747,1969,222,12.707498568975387
Shegaon,SORGUM(JAWAR),2016,1244,1466,222,17.84565916398714
Pandharpur,Sorgum(Jawar),2015,1850,2072,222,12.0
Yeola,Wheat(Husked),2015,1441,1663,222,15.405968077723802
Khed (Shel Pimpalgaon),Ladies Finger,2016,2869,3091,222,7.737887765772046
Vai,Tomato,2015,623,845,222,35.63402889245586
Shrirampur,Potato,2016,1326,1548,222,16.742081447963802
Amarawati,Dhemse,2016,1672,1894,222,13.277511961722489
Mantha,Gram,2016,3981,4203,222,5.5764883195177095
Purna,Sorgum(Jawar),2016,1384,1606,222,16.040462427745666
Loha,Sorgum(Jawar),2015,1100,1321,221,20.09090909090909
Mumbai,Sugar,2016,3574,3795,221,6.183547845551203
Chikhali,Sorgum(Jawar),2015,1206,1427,221,18.325041459369817
Mul,Paddy-Unhusked,2014,1792,2013,221,12.332589285714286
Ahmednagar,Wheat(Husked),2016,1845,2066,221,11.978319783197833
Shirur,Green Gram,2015,6342,6563,221,3.4847051403342792
Shrirampur,Cabbage,2016,700,921,221,31.571428571428573
Udgir,Gram,2015,4738,4959,221,4.664415365132967
Pune-Pimpri,Mango(Raw),2015,1136,1357,221,19.454225352112676
Kej,Bajri,2015,1413,1634,221,15.640481245576787
Pandharpur,Sorgum(Jawar),2015,1684,1905,221,13.123515439429928
Latur,Bajri,2015,1190,1411,221,18.571428571428573
Nagpur,Flower,2015,796,1017,221,27.763819095477388
Anajngaon Surji,Sorgum(Jawar),2016,1293,1514,221,17.09203402938902
Washim,Black Gram,2015,4244,4465,221,5.207351555136664
Chandur Rly.,Green Gram,2016,4856,5077,221,4.551070840197694
Amarawati,Wheat(Husked),2015,1637,1858,221,13.500305436774587
Sindkhed Raja,Soybean,2016,3500,3721,221,6.314285714285714
Kalmeshwar,Walvad,2014,3298,3519,221,6.701030927835052
Satana,Wheat(Husked),2015,1519,1740,221,14.549045424621461
Murbad,Ghosali(Bhaji),2015,3850,4071,221,5.740259740259741
Parli-Vaijnath,Soybean,2016,3739,3960,221,5.910671302487296
Bhokar,Wheat(Husked),2016,1429,1650,221,15.465360391882434
Dhule,MAIZE,2016,1007,1228,221,21.94637537239325
Buldhana,Gram,2016,4150,4371,221,5.325301204819277
Paithan,Wheat(Husked),2014,1379,1600,221,16.02610587382161
Manora,Gram,2014,3022,3243,221,7.313037723362012
Ulhasnagar,Sugarcane,2016,317,538,221,69.71608832807571
Amarawati-Fruit And Vegetables,Tomato,2016,643,864,221,34.3701399688958
Morshi,Soybean,2014,3001,3222,221,7.364211929356881
Ausa,Safflower,2016,2476,2697,221,8.925686591276252
Murbad,Ghosali(Bhaji),2014,2943,3164,221,7.509344206591913
Manwat,Cotton,2016,4449,4670,221,4.967408406383457
Vaijapur,Gram,2016,4013,4234,221,5.507101918764017
Sillod,Soybean,2016,3529,3750,221,6.26239727968263
Sakri,BAJRI,2016,1185,1406,221,18.649789029535864
Ner Parasopant,Soybean,2016,2625,2846,221,8.41904761904762
Osmanabad,Cabbage,2016,500,721,221,44.2
Vaijapur,MAIZE,2016,987,1208,221,22.391084093211752
Ner Parasopant,Soybean,2016,3460,3681,221,6.38728323699422
Tuljapur,Green Gram,2014,7093,7314,221,3.1157479204849854
Dhule,Bajri,2015,1265,1486,221,17.470355731225297
Kopargaon,Sorgum(Jawar),2015,1319,1540,221,16.755117513267628
Ner Parasopant,Soybean,2015,3068,3289,221,7.203389830508475
Sangali,Soybean,2016,3763,3984,221,5.872973691203827
Shevgaon-Bodhegaon,Bajri,2014,1124,1345,221,19.661921708185055
Sangli-Miraj,Wheat(Unhusked),2016,3655,3876,221,6.046511627906977
Amarawati,Pigeon Pea (Tur),2016,8352,8573,221,2.646072796934866
Nashik-Devlali,Spinach,2016,257,478,221,85.99221789883268
Shrirampur,Potato,2015,808,1029,221,27.35148514851485
Nagpur,Chavli (Shenga ),2014,1108,1329,221,19.945848375451263
Lonar,Gram,2016,5419,5639,220,4.059789629082856
Kopargaon,MAIZE,2016,989,1209,220,22.24469160768453
Murbad,Brinjal,2015,2567,2787,220,8.570315543435918
Anajngaon Surji,Banana,2016,960,1180,220,22.916666666666668
Kalmeshwar,Methi (Bhaji),2016,1220,1440,220,18.0327868852459
Bhokar,Gram,2016,5215,5435,220,4.218600191754554
Ahmednagar,Black Gram,2014,4740,4960,220,4.641350210970464
Nagpur,Jack Fruit,2016,713,933,220,30.855539971949508
Gondiya,Paddy-Unhusked,2016,1458,1678,220,15.089163237311386
Umarga,Pigeon Pea (Tur),2016,6680,6900,220,3.2934131736526946
Nagpur,Jack Fruit,2015,1068,1288,220,20.59925093632959
Dhule,Horse Gram,2014,2075,2295,220,10.602409638554217
Jalgaon,Soybean,2015,3180,3400,220,6.918238993710692
Buldhana-Dhad,Maize,2016,1350,1570,220,16.296296296296298
Buldhana,Sorgum(Jawar),2016,1140,1360,220,19.29824561403509
Akole,Maize,2015,1380,1600,220,15.942028985507246
Sindkhed Raja,Sorgum(Jawar),2016,1370,1590,220,16.05839416058394
Beed,Green Gram,2014,7523,7743,220,2.924365279808587
Akhadabalapur,Soybean,2015,3257,3477,220,6.754682222904513
Latur-Murud,Sorgum(Jawar),2016,1477,1697,220,14.895057549085985
Bhivandi,Rice(Paddy-Hus),2015,1455,1675,220,15.120274914089347
Gondpimpri,Gram,2016,3680,3900,220,5.978260869565218
Malegaon (Washim),Soybean,2016,3604,3824,220,6.1043285238623755
Kalmeshwar,Ladies Finger,2015,1488,1708,220,14.78494623655914
Nagpur,Ladies Finger,2014,1142,1362,220,19.26444833625219
Shrirampur,Maize,2014,876,1096,220,25.114155251141554
Shevgaon-Bodhegaon,Pigeon Pea (Tur),2016,6953,7173,220,3.164101826549691
Amarawati,Tomato,2015,1150,1370,220,19.130434782608695
Patan,Flower,2015,780,1000,220,28.205128205128204
Ahmedpur,Sesamum,2016,5067,5287,220,4.341819617130452
Buldhana,Soybean,2016,3686,3906,220,5.968529571351058
Raver,Green Gram,2016,5145,5365,220,4.275996112730807
Chopda,Sorgum(Jawar),2015,1217,1437,220,18.0772391125719
Rahuri-Vambori,Bajri,2014,1369,1589,220,16.070124178232287
Kalmeshwar,Green Chilli,2015,2908,3128,220,7.565337001375516
Solapur,Coriander  ,2015,100,320,220,220.0
Dhamangaon-Rly,Wheat(Husked),2015,1300,1520,220,16.923076923076923
Indapur-Bhigwan,Sunflower,2014,2470,2690,220,8.906882591093117
Latur,Sorgum(Jawar),2016,1566,1786,220,14.048531289910601
Kalmeshwar,Flower,2014,834,1054,220,26.378896882494004
Jalna,Maize,2016,1227,1447,220,17.929910350448246
Chandur Rly.,Soybean,2016,3398,3618,220,6.474396703943496
Koregaon,Gram,2015,4120,4340,220,5.339805825242719
Jalgaon,Green Gram,2015,7215,7435,220,3.049203049203049
Purna,Gram,2015,3197,3417,220,6.88145136065061
Kada (Ashti),Sorgum(Jawar),2015,1535,1755,220,14.332247557003257
Nagpur,Raddish,2016,590,810,220,37.28813559322034
Nagpur,Raddish,2016,920,1140,220,23.91304347826087
Washim,Wheat(Husked),2015,1460,1680,220,15.068493150684931
Jalgaon Jamod-Aasalgaon,Sorgum(Jawar),2015,1200,1420,220,18.333333333333332
Dhule,Maize,2016,1220,1440,220,18.0327868852459
Jintur-Bori,Soybean,2015,3122,3342,220,7.046764894298526
Pusad,Soybean,2015,3280,3500,220,6.7073170731707314
Chandrapur-Ganjwad,Cucumber,2016,480,700,220,45.833333333333336
Patan,Tomato,2014,890,1110,220,24.719101123595507
Nagpur,Rice(Paddy-Hus),2014,3225,3445,220,6.821705426356589
Ramtek,LADIES FINGER,2016,790,1010,220,27.848101265822784
Shrirampur,Bajri,2015,1228,1448,220,17.91530944625407
Karad,Cabbage,2015,400,620,220,55.0
Bhivandi,Potato,2016,916,1136,220,24.017467248908297
Nagpur,Cucumber,2014,1608,1828,220,13.681592039800995
Chikhali,Sorgum(Jawar),2016,1186,1406,220,18.54974704890388
Umarga,Soybean,2015,3331,3551,220,6.604623236265386
Shrirampur,Flower,2015,600,820,220,36.666666666666664
Kalyan,Tomato,2015,960,1180,220,22.916666666666668
Pune-Pimpri,Flower,2015,1160,1380,220,18.96551724137931
Akhadabalapur,Gram,2016,5100,5320,220,4.313725490196078
Nagpur,Cucumber,2015,1444,1664,220,15.23545706371191
Pathardi,Bajri,2014,1255,1475,220,17.529880478087648
Kalyan,Bitter Gourd,2015,840,1060,220,26.19047619047619
Nagpur,Spinach,2015,813,1033,220,27.060270602706026
Anajngaon Surji,Gram,2014,2410,2630,220,9.12863070539419
Savner,Gram,2015,4472,4692,220,4.919499105545617
Ramtek,Raddish,2016,481,701,220,45.73804573804574
Shrirampur,Wheat(Husked),2015,1428,1648,220,15.406162464985995
Mauda,Paddy-Unhusked,2016,2080,2300,220,10.576923076923077
Nagpur,Ground Nut Pods (Dry),2014,2372,2592,220,9.27487352445194
Amarawati,Spinach,2016,1440,1660,220,15.277777777777779
Alibag,Rice(Paddy-Hus),2015,2113,2333,220,10.411736867013724
Murbad,Bottle Gourd,2015,3780,4000,220,5.8201058201058204
Pune-Pimpri,Chavli (Shenga ),2016,1700,1920,220,12.941176470588236
Maregaon,COTTON,2016,4683,4903,220,4.6978432628656845
Kalmeshwar,Bottle Gourd,2016,632,852,220,34.81012658227848
Buldhana,Soybean,2015,3400,3620,220,6.470588235294118
Anajngaon Surji,Black Gram,2014,4455,4675,220,4.938271604938271
Patan,FLOWER,2016,730,950,220,30.136986301369863
Amarawati,Bitter Gourd,2016,2000,2220,220,11.0
Patan,Flower,2016,1040,1260,220,21.153846153846153
Gangapur,Bajri,2015,1179,1398,219,18.575063613231553
Nagpur,Beet Root,2014,1062,1281,219,20.62146892655367
Nagpur,Ladies Finger,2015,1083,1302,219,20.221606648199447
Dudhani,Gram,2015,4464,4683,219,4.905913978494624
Vaijapur,Bajri,2016,1530,1749,219,14.313725490196079
Rahuri-Vambori,Sorgum(Jawar),2015,1577,1796,219,13.88712745719721
Beed,Wheat(Husked),2016,1834,2053,219,11.941112322791712
Buldhana,Sorgum(Jawar),2016,1325,1544,219,16.528301886792452
Mumbai,Potato,2015,958,1177,219,22.860125260960334
Murbad,Bitter Gourd,2015,4369,4588,219,5.0125886930647745
Lasalgaon-Vinchur,Maize,2015,1179,1398,219,18.575063613231553
Akot,Gram,2015,3857,4076,219,5.677988073632357
Malegaon (Washim),Soybean,2016,3109,3328,219,7.0440656159536825
Kurdwadi,Maize,2016,1727,1946,219,12.680949623624782
Chandrapur,Soybean,2016,3393,3612,219,6.45446507515473
Ghatanji,Ground Nut Pods (Dry),2015,5132,5351,219,4.2673421667965705
Nandgaon,Bajri,2015,1232,1451,219,17.775974025974026
Nagpur,Beet Root,2014,1285,1504,219,17.042801556420233
Kopargaon,Soybean,2014,2837,3056,219,7.719421924568206
Sengaon,Soybean,2016,3513,3732,219,6.23398804440649
Kalvan,Soybean,2016,3539,3758,219,6.188188753885278
Kalmeshwar,Bottle Gourd,2016,443,662,219,49.43566591422122
Mumbai,Sugar,2016,3654,3873,219,5.993431855500821
Pune-Pimpri,Cabbage,2014,873,1092,219,25.085910652920962
Barshi,Fodder,2015,564,783,219,38.829787234042556
Malkapur,Wheat(Husked),2015,1527,1746,219,14.341846758349705
Mumbai,Cabbage,2014,707,926,219,30.975954738330977
Risod,Soybean,2015,3050,3269,219,7.180327868852459
Washim,Sorgum(Jawar),2016,1094,1313,219,20.018281535648995
Aurangabad,Potato,2016,1396,1615,219,15.687679083094556
Vaijapur,Gram,2015,4079,4298,219,5.3689629811228246
Vaijapur,Sorgum(Jawar),2016,1457,1676,219,15.030885380919697
Malegaon,Bajri,2015,1271,1490,219,17.230527143981117
Rahuri-Vambori,Ground Nut Pods (Dry),2015,4875,5094,219,4.492307692307692
Gevrai,Bajri,2014,1228,1447,219,17.83387622149837
Pusad,Wheat(Husked),2016,1621,1840,219,13.5101789019124
Tumsar,Jaggery,2016,2181,2400,219,10.041265474552958
Nandgaon Khandeshwar,Wheat(Husked),2016,1491,1710,219,14.688128772635816
Latur,Bajri,2016,1501,1720,219,14.59027315123251
Nagpur,Dhemse,2015,1112,1331,219,19.694244604316548
Khed-Chakan,Cabbage,2015,574,793,219,38.153310104529616
Lonar,Gram,2016,4134,4353,219,5.297532656023222
Sangali,Wheat(Unhusked),2016,3906,4125,219,5.606758832565284
Dhamangaon-Rly,Soybean,2015,3038,3257,219,7.2086899275839365
Manmad,Gram,2016,3938,4157,219,5.561198577958354
Khamgaon,Wheat(Husked),2014,1291,1510,219,16.96359411309063
Lasalgaon,Maize,2015,1243,1462,219,17.61866452131939
Lasalgaon-Vinchur,Maize,2015,1114,1333,219,19.658886894075405
Chandrapur-Ganjwad,Cabbage,2016,343,562,219,63.84839650145773
Washim,Wheat(Husked),2014,1467,1686,219,14.928425357873211
Samudrapur,Cotton,2016,4352,4571,219,5.032169117647059
Ahmedpur,Sunflower,2016,3548,3767,219,6.1724915445321304
Lonar,Soybean,2014,3137,3356,219,6.981192221868027
Wardha,Wheat(Husked),2016,1581,1800,219,13.851992409867172
Mandhal,Paddy-Unhusked,2015,1871,2090,219,11.704970603955104
Ahmedpur,Sunflower,2014,2541,2760,219,8.618654073199528
Tuljapur,Green Gram,2016,4237,4456,219,5.168751475100307
Mumbai,Elephant Root,2015,1415,1633,218,15.406360424028268
Sangali,BAJRI,2016,1590,1808,218,13.71069182389937
Murbad,Ghosali(Bhaji),2015,4363,4581,218,4.9965619986247995
Kalmeshwar,Cluster Bean,2015,1505,1723,218,14.485049833887043
Dhamangaon-Rly,Wheat(Husked),2015,1200,1418,218,18.166666666666668
Sinner,Bajri,2015,1328,1546,218,16.41566265060241
Amarawati,Wheat(Husked),2015,1674,1892,218,13.022700119474313
Amalner,Sorgum(Jawar),2014,1343,1561,218,16.232315711094564
Mantha,SOYBEAN,2016,2445,2663,218,8.916155419222903
Ramtek,Brinjal,2015,943,1161,218,23.117709437963946
Satana,Wheat(Husked),2015,1485,1703,218,14.68013468013468
Kalamb (Os),Pigeon Pea (Tur),2016,5510,5728,218,3.956442831215971
Malegaon (Washim),Gram,2016,5375,5593,218,4.055813953488372
Majalgaon,Green Gram,2016,4850,5068,218,4.494845360824742
Kalmeshwar,Spinach,2015,986,1204,218,22.10953346855984
Kalyan,TOMATO,2016,709,927,218,30.7475317348378
Karad,BRINJAL,2016,570,788,218,38.24561403508772
Gangapur,Sorgum(Jawar),2015,1497,1715,218,14.562458249833
Washim-Ansing,Green Gram,2016,4863,5081,218,4.482829529097265
Umarkhed,Soybean,2015,2935,3153,218,7.427597955706985
Amarawati,Melon,2016,641,859,218,34.009360374414975
Panvel,Bottle Gourd,2016,1018,1236,218,21.414538310412574
Amarawati,Brinjal,2015,1127,1345,218,19.343389529724934
Shevgaon-Bodhegaon,Gram,2015,3933,4151,218,5.542842613780829
Shahada,Wheat(Husked),2015,1477,1695,218,14.759647935003386
Rahuri-Songaon,Wheat(Husked),2016,1427,1645,218,15.276804484933427
Rahata,CABBAGE,2016,227,445,218,96.0352422907489
Mumbai,Sugar,2016,3560,3778,218,6.123595505617978
Buldhana-Dhad,Soybean,2016,3496,3714,218,6.2356979405034325
Khamgaon,Wheat(Husked),2015,1333,1551,218,16.35408852213053
Vaijapur,Pigeon Pea (Tur),2016,8000,8218,218,2.725
Chopda,Wheat(Husked),2015,1231,1449,218,17.709179528838344
Shirur,Sorgum(Jawar),2016,1607,1825,218,13.565650280024892
Jafrabad,Maize,2015,1169,1387,218,18.648417450812662
Kalvan,Soybean,2015,3510,3728,218,6.210826210826211
Murbad,Ladies Finger,2015,4306,4524,218,5.062703204830469
Jintur,Gram,2016,4038,4256,218,5.398712233779099
Shevgaon,Pigeon Pea (Tur),2015,4873,5091,218,4.473630207264518
Dondaicha,Bajri,2015,985,1203,218,22.131979695431472
Chakur,Soybean,2016,3858,4076,218,5.6505961638154485
Vani,Soybean,2014,2854,3072,218,7.6384022424667135
Hingoli,Soybean,2016,2764,2982,218,7.88712011577424
Sailu,Gram,2015,4032,4250,218,5.406746031746032
Bhivandi,Other Vegetables,2016,943,1161,218,23.117709437963946
Akola,Wheat(Husked),2016,1508,1726,218,14.456233421750664
Kopargaon,Wheat(Husked),2015,1475,1693,218,14.779661016949152
Umarkhed-Danki,Soybean,2016,3373,3591,218,6.463089238067003
Shrirampur,Water Melon,2015,713,931,218,30.575035063113603
Amalner,MAIZE,2016,1059,1277,218,20.585457979225684
Kalmeshwar,Chavli (Shenga ),2015,2813,3031,218,7.749733380732314
Bhandara,Soybean,2016,3090,3308,218,7.055016181229774
Lasalgaon-Vinchur,Maize,2015,1055,1273,218,20.66350710900474
Sindi,Wheat(Husked),2015,1230,1448,218,17.723577235772357
Loha,Gram,2014,2232,2450,218,9.767025089605735
Dhule,Soybean,2015,3454,3672,218,6.311522872032426
Shevgaon-Bodhegaon,Pigeon Pea (Tur),2016,8317,8535,218,2.6211374293615486
Shahada,Wheat(Husked),2016,1712,1930,218,12.733644859813085
Mohol,Wheat(Husked),2016,1825,2043,218,11.945205479452055
Amarawati,Soybean,2014,3025,3243,218,7.206611570247934
Kalmeshwar,Tomato,2015,1318,1536,218,16.540212443095598
Nagpur,Jack Fruit,2015,1483,1700,217,14.632501685772084
Solapur,Jaggery,2015,2368,2585,217,9.16385135135135
Shrirampur,Bajri,2015,1212,1429,217,17.904290429042906
Amalner,Gram,2016,6867,7084,217,3.1600407747196737
Amalner,Sorgum(Jawar),2015,1238,1455,217,17.52827140549273
Barshi,Wheat(Husked),2016,1660,1877,217,13.072289156626505
Chandur Rly.,Gram,2016,5035,5252,217,4.309831181727905
Nandura,Wheat(Husked),2016,1438,1655,217,15.090403337969402
Kalmeshwar,Methi (Bhaji),2015,1608,1825,217,13.49502487562189
Shirpur,Sorgum(Jawar),2016,1405,1622,217,15.444839857651246
Shirur,Indian Bean,2015,3183,3400,217,6.81746779767515
Malkapur,Bajri,2015,1224,1441,217,17.72875816993464
Kopargaon,Wheat(Husked),2016,1503,1720,217,14.437791084497672
Lonar,Soybean,2016,2804,3021,217,7.738944365192582
Amarawati-Fruit And Vegetables,Potato,2016,1321,1538,217,16.426949280847843
Jamkhed,Bajri,2016,1428,1645,217,15.196078431372548
Chandur Rly.,Gram,2015,3961,4178,217,5.478414541782378
Barshi,Coriander (Dry),2014,10234,10451,217,2.1203830369357046
Mahagaon,Cotton,2016,4433,4650,217,4.895104895104895
Chakur,Black Gram,2016,6693,6910,217,3.24219333632153
Mantha,Gram,2016,4633,4850,217,4.683790200733866
Tumsar,GRAM,2016,8418,8635,217,2.577809455927774
Jalgaon Jamod-Aasalgaon,Wheat(Husked),2015,1325,1542,217,16.37735849056604
Chandur Rly.,Soybean,2015,3095,3312,217,7.011308562197092
Jalna,Maize,2014,887,1104,217,24.46448703494927
Nandura,Black Gram,2016,8783,9000,217,2.470681999316862
Akhadabalapur,Soybean,2015,3281,3498,217,6.613837244742457
Tumsar,Linseed,2015,4110,4327,217,5.2798053527980535
Raver,Wheat(Husked),2015,1483,1700,217,14.632501685772084
Raver,GRAM,2016,5150,5367,217,4.213592233009709
Ghansawangi,Bajri,2016,1233,1450,217,17.59935117599351
Ghansawangi,Bajri,2016,1583,1800,217,13.708149084017688
Buldhana,Gram,2015,4083,4300,217,5.314719568944404
Raver,Green Gram,2016,5478,5695,217,3.9612997444322744
Koregaon,Ghevda Seed,2015,3700,3917,217,5.864864864864865
Khed (Shel Pimpalgaon),Cluster Bean,2016,2989,3206,217,7.259953161592506
Shevgaon-Bodhegaon,Sorgum(Jawar),2014,1573,1790,217,13.795295613477432
Latur,Soybean,2015,3140,3357,217,6.910828025477707
Indapur-Bhigwan,Soybean,2015,3267,3484,217,6.642179369452097
Kada,Gram,2015,3545,3762,217,6.1212976022567
Pune-Pimpri,Onion,2016,752,969,217,28.856382978723403
Khamgaon,Wheat(Husked),2015,1350,1567,217,16.074074074074073
Jafrabad,Wheat(Husked),2014,1250,1467,217,17.36
Washim,Sorgum(Jawar),2015,1206,1423,217,17.993366500829186
Sakri,Bajri,2016,1380,1597,217,15.72463768115942
Buldhana,Soybean,2015,3038,3255,217,7.142857142857143
Nagbhid,Paddy-Unhusked,2016,1669,1886,217,13.001797483523069
Ner Parasopant,SOYBEAN,2016,2556,2773,217,8.48982785602504
Nagpur,Carrot,2016,671,888,217,32.3397913561848
Amarawati,Potato,2015,912,1129,217,23.79385964912281
Sillod-Bharadi,Bajri,2014,1100,1317,217,19.727272727272727
Amarawati,Potato,2015,679,896,217,31.95876288659794
Mangrulpeer,Sorgum(Jawar),2016,1191,1408,217,18.21998320738875
Nilanga,Black Gram,2014,4966,5183,217,4.36971405557793
Kille Dharur,Pigeon Pea (Tur),2016,5234,5451,217,4.145968666411922
Kalmeshwar,Coriander  ,2016,696,913,217,31.17816091954023
Kille Dharur,Gram,2016,3971,4188,217,5.4646184840090655
Narkhed,Cotton,2016,4532,4749,217,4.788172992056487
Mumbai,Arvi,2015,875,1092,217,24.8
Akola,Soybean,2015,3044,3261,217,7.128777923784494
Baramati,SOYBEAN,2016,2688,2905,217,8.072916666666666
Lasalgaon,Sorgum(Jawar),2015,1404,1621,217,15.455840455840455
Shegaon,Sorgum(Jawar),2015,1016,1233,217,21.358267716535433
Nagpur,Pumpkin,2016,725,942,217,29.93103448275862
Amarawati-Fruit And Vegetables,CARROT,2016,2000,2217,217,10.85
Akola,Sorgum(Jawar),2015,1119,1336,217,19.3923145665773
Shirpur,Bajri,2015,1037,1254,217,20.925747348119575
Udgir,Jaggery,2015,2054,2271,217,10.56475170399221
Ner Parasopant,Black Gram,2016,5994,6211,217,3.620286953620287
Chalisgaon,Sunflower,2015,2733,2950,217,7.9399926820343945
Nira,Jaggery,2015,2850,3067,217,7.614035087719298
Tumsar,Gram,2014,2556,2773,217,8.48982785602504
Jamkhed,Soybean,2014,3000,3217,217,7.233333333333333
Chandrapur-Ganjwad,Chavli (Shenga ),2014,722,939,217,30.05540166204986
Umared,Mustard,2015,3346,3563,217,6.485355648535565
Karad,Cabbage,2015,458,675,217,47.379912663755455
Buldhana,Maize,2016,1100,1317,217,19.727272727272727
Phaltan,Maize,2015,1325,1541,216,16.30188679245283
Kalamnuri,Pigeon Pea (Tur),2016,8444,8660,216,2.55802936996684
Amarawati,Green Gram,2016,6850,7066,216,3.153284671532847
Tumsar,Lentil,2014,3260,3476,216,6.625766871165644
Rahata,Cucumber,2016,392,608,216,55.10204081632653
Kille Dharur,Wheat(Husked),2014,1421,1637,216,15.200562983814216
Lasalgaon,Maize,2015,1071,1287,216,20.168067226890756
Chalisgaon,Sunflower,2014,2767,2983,216,7.806288398988074
Parli-Vaijnath,Soybean,2016,3556,3772,216,6.074240719910011
Lasalgaon-Vinchur,MAIZE,2016,1034,1250,216,20.889748549323016
Chandrapur-Ganjwad,Potato,2015,679,895,216,31.811487481590575
Mumbai,Elephant Root,2016,1969,2185,216,10.970035551041137
Daryapur,Soybean,2015,3117,3333,216,6.929740134744947
Chopda,Soybean,2014,3128,3344,216,6.90537084398977
Anajngaon Surji,BANANA,2016,617,833,216,35.00810372771475
Dondaicha,Bajri,2016,1319,1535,216,16.376042456406367
Lonar,Sorgum(Jawar),2016,1262,1478,216,17.11568938193344
Aurangabad,Potato,2016,1234,1450,216,17.504051863857374
Chopda,Wheat(Husked),2016,1484,1700,216,14.555256064690028
Shegaon,Wheat(Husked),2016,1490,1706,216,14.496644295302014
Barshi,Coriander (Dry),2014,7567,7783,216,2.854499801770847
Buldhana-Dhad,Soybean,2016,3282,3498,216,6.581352833638026
Shegaon,Wheat(Husked),2016,1504,1720,216,14.361702127659575
Nagpur,Capsicum,2015,772,988,216,27.979274611398964
Jalgaon Jamod-Aasalgaon,Wheat(Husked),2015,1317,1533,216,16.40091116173121
Achalpur,Gram,2016,3950,4166,216,5.468354430379747
Kada,Gram,2016,4917,5133,216,4.392922513727883
Lonar,GREEN GRAM,2016,5225,5441,216,4.133971291866029
Amarawati,Pigeon Pea (Tur),2016,6525,6741,216,3.310344827586207
Malkapur,Sorgum(Jawar),2015,1183,1399,216,18.258664412510566
Murbad,Brinjal,2014,3046,3262,216,7.091267235718976
Panvel,CUCUMBER,2016,1917,2133,216,11.267605633802816
Pune-Pimpri,Cucumber,2016,752,968,216,28.72340425531915
Nagpur,Pumpkin,2016,876,1092,216,24.65753424657534
Manora,Soybean,2016,3467,3683,216,6.230170175944621
Lonar,Pigeon Pea (Tur),2016,8659,8875,216,2.494514378103707
Vai,Tomato,2015,815,1031,216,26.503067484662576
Amarawati,Bitter Gourd,2016,2006,2222,216,10.767696909272184
Vaduj,Ghevda Seed,2015,4256,4472,216,5.075187969924812
Karad,Cabbage,2014,442,658,216,48.86877828054298
Shirpur,Sorgum(Jawar),2015,1449,1665,216,14.906832298136646
Majalgaon,Wheat(Husked),2015,1364,1580,216,15.835777126099707
Aheri,Pigeon Pea (Tur),2016,7817,8033,216,2.7632083919662276
Parli-Vaijnath,Green Gram,2016,4704,4920,216,4.591836734693878
Ner Parasopant,Soybean,2015,3351,3567,216,6.445837063563116
Armori-Desaiganj,Paddy-Unhusked,2015,1489,1705,216,14.5063801208865
Kalyan,Onion,2016,845,1061,216,25.562130177514792
Pachora,Gram,2016,4093,4309,216,5.277302711947227
Sillod-Bharadi,Mustard,2016,3279,3495,216,6.587374199451052
Partur,Wheat(Husked),2015,1385,1601,216,15.5956678700361
Dhamangaon-Rly,Gram,2014,2367,2583,216,9.125475285171103
Umari,Ground Nut Pods (Dry),2016,4852,5068,216,4.451772464962902
Karad,FLOWER,2016,456,672,216,47.36842105263158
Paithan,Wheat(Husked),2015,1615,1831,216,13.374613003095975
Kalyan,Bajri,2016,1767,1983,216,12.224108658743633
Partur,Gram,2014,1925,2141,216,11.220779220779221
Devala,Bajri,2016,1380,1596,216,15.652173913043478
Pandharkawada,Gram,2016,3796,4012,216,5.690200210748156
Koregaon,Sorgum(Jawar),2014,1517,1733,216,14.238628872775214
Dhule,Sorgum(Jawar),2015,1318,1534,216,16.38846737481032
Barshi,Pigeon Pea (Tur),2014,3768,3984,216,5.732484076433121
Dudhani,Pigeon Pea (Tur),2015,9757,9973,216,2.2137952239417853
Akkolkot,Gram,2015,3308,3524,216,6.52962515114873
Karad,BOTTLE GOURD,2016,376,592,216,57.4468085106383
Sangrampur,Maize,2015,917,1133,216,23.555070883315157
Ghansawangi,Soybean,2015,3117,3333,216,6.929740134744947
Lasalgaon,Maize,2016,1269,1485,216,17.02127659574468
Karad,Carrot,2015,942,1158,216,22.929936305732483
Pathardi,Sorgum(Jawar),2015,1547,1763,216,13.96250808015514
Mumbai-Fruit Market,Water Melon,2016,342,558,216,63.1578947368421
Amarawati-Fruit And Vegetables,Tomato,2016,1617,1833,216,13.358070500927644
Kalamb (Os),BAJRI,2016,1082,1298,216,19.963031423290204
Shirpur,MAIZE,2016,1014,1230,216,21.301775147928993
Kalmeshwar,Soybean,2016,3515,3730,215,6.116642958748222
Indapur (Nimgaon Ketki),Sorgum(Jawar),2015,1151,1366,215,18.679409209383145
Ner Parasopant,Pigeon Pea (Tur),2016,8394,8609,215,2.561353347629259
Paithan,Gram,2016,5238,5453,215,4.104620084001527
Sailu,Pigeon Pea (Tur),2016,6234,6449,215,3.4488290022457493
Vaijapur,Pigeon Pea (Tur),2016,7309,7524,215,2.9415788753591463
Ambejogai,Soybean,2015,3500,3715,215,6.142857142857143
Rahuri-Vambori,Sorgum(Jawar),2014,1913,2128,215,11.238891792995295
Shrirampur,Bor,2016,811,1026,215,26.51048088779285
Lasalgaon,Sorgum(Jawar),2015,1496,1711,215,14.371657754010695
Ausa,Safflower,2016,2591,2806,215,8.297954457738324
Lasalgaon,Sorgum(Jawar),2014,1853,2068,215,11.602806260118726
Shrirampur,Potato,2015,825,1040,215,26.060606060606062
Ner Parasopant,Soybean,2015,3331,3546,215,6.454518162713899
Sangamner,Sorgum(Jawar),2015,1740,1955,215,12.35632183908046
Parbhani,Sorgum(Jawar),2015,1553,1768,215,13.844172569220863
Kalmeshwar,Methi (Bhaji),2015,893,1108,215,24.076147816349383
Mangrulpeer,Wheat(Husked),2016,1591,1806,215,13.513513513513514
Murbad,Ghevda,2015,3271,3486,215,6.572913482115561
Kalamb (Os),Sesamum,2014,8512,8727,215,2.525845864661654
Kalmeshwar,Coriander  ,2015,3326,3541,215,6.4642212868310285
Ramtek,Potato,2015,1077,1292,215,19.96285979572888
Tumsar,Wheat(Husked),2016,1438,1653,215,14.951321279554938
Nagpur,Pumpkin,2016,531,746,215,40.48964218455744
Pusad,Sorgum(Jawar),2014,1322,1537,215,16.263237518910742
Patan,Brinjal,2015,783,998,215,27.458492975734355
Pulgaon,Soybean,2016,3626,3841,215,5.929398786541643
Kalmeshwar,Cucumber,2015,1280,1495,215,16.796875
Kalvan,Gram,2015,3407,3622,215,6.31053712943939
Jalgaon,Gram,2016,6171,6386,215,3.4840382433965322
Jalgaon,Squash Gourd,2015,623,838,215,34.51043338683788
Ambejogai,Gram,2016,4182,4397,215,5.141080822572931
Nanded,Gram,2014,2190,2405,215,9.817351598173516
Kej,Sorgum(Jawar),2016,1828,2043,215,11.761487964989058
Achalpur,Wheat(Husked),2015,1463,1678,215,14.69583048530417
Wardha,Cotton,2015,4118,4333,215,5.220981058766392
Rahata,Gram,2014,2207,2422,215,9.741730856366107
Partur,Bajri,2015,1301,1516,215,16.52574942352037
Kalmeshwar,Chavli (Shenga ),2015,1237,1452,215,17.38075990299111
Barshi,Squash Gourd,2016,371,586,215,57.95148247978437
Ner Parasopant,Soybean,2014,3067,3282,215,7.010107597000326
Jalgaon Jamod-Aasalgaon,Maize,2016,1071,1286,215,20.07469654528478
Nagpur,Chavli (Pala),2016,808,1023,215,26.60891089108911
Karanja,Wheat(Husked),2014,1317,1532,215,16.324981017463934
Bhiwapur,Wheat(Husked),2016,1400,1615,215,15.357142857142858
Shrirampur,Potato,2016,985,1200,215,21.82741116751269
Shegaon,Mustard,2015,2950,3165,215,7.288135593220339
Yawal,Maize,2015,1093,1308,215,19.670631290027448
Raver,Bajri,2014,1262,1477,215,17.0364500792393
Kalamb (Os),Soybean,2016,3554,3769,215,6.049521665728756
Chandrapur-Ganjwad,Cabbage,2016,215,430,215,100.0
Kalmeshwar,Green Chilli,2015,2204,2419,215,9.754990925589837
Kalmeshwar,Green Chilli,2015,2952,3167,215,7.2831978319783195
Lasalgaon-Vinchur,Sorgum(Jawar),2016,1479,1694,215,14.5368492224476
Pune-Pimpri,Cabbage,2015,725,940,215,29.655172413793103
Sinner,Bajri,2015,1100,1315,215,19.545454545454547
Digras,Pigeon Pea (Tur),2016,8289,8504,215,2.5937990107371216
Ashti-Karanja,Wheat(Husked),2016,1404,1619,215,15.313390313390313
Ahmednagar,Bajri,2015,1460,1675,215,14.726027397260275
Barshi,Fodder,2015,442,657,215,48.64253393665158
Yeola,Pigeon Pea (Tur),2015,5181,5396,215,4.149778035128354
Nagpur,Bottle Gourd,2016,540,755,215,39.81481481481482
Anajngaon Surji,Soybean,2014,2810,3025,215,7.6512455516014235
Murum,Gram,2016,6357,6572,215,3.382098474123014
Morshi,Gram,2015,3082,3297,215,6.975989617131733
Barshi,Lemon,2015,363,578,215,59.22865013774105
Nagpur,Cucumber,2015,1500,1715,215,14.333333333333334
Rahata,Cabbage,2016,419,634,215,51.31264916467781
Amarawati,Spinach,2016,2214,2429,215,9.71093044263776
Rahata,Carrot,2016,1571,1786,215,13.685550604710375
Nagpur,Brinjal,2014,927,1142,215,23.19309600862999
Dound,Bajri,2015,1372,1587,215,15.670553935860058
Jintur,Sorgum(Jawar),2016,1527,1741,214,14.01440733464309
Anajngaon Surji,Wheat(Husked),2014,1404,1618,214,15.242165242165242
Chakur,Soybean,2016,3303,3517,214,6.478958522555253
Jintur,Soybean,2016,3378,3592,214,6.335109532267614
Ahmednagar,Soybean,2015,3100,3314,214,6.903225806451613
Kalmeshwar,Brinjal,2016,475,689,214,45.05263157894737
Bhivandi,Wheat(Husked),2015,1629,1843,214,13.136893799877225
Digras,Pigeon Pea (Tur),2015,6407,6621,214,3.3400967691587327
Rahuri-Vambori,Sorgum(Jawar),2015,1357,1571,214,15.770081061164333
Dhule,Soybean,2016,3577,3791,214,5.982667039418507
Chikhali,Maize,2016,1109,1323,214,19.296663660955815
Paithan,Soybean,2016,2651,2865,214,8.072425499811391
Gevrai,Bajri,2016,1520,1734,214,14.078947368421053
Akluj,Potato,2015,813,1027,214,26.322263222632227
Satana,Wheat(Husked),2014,1465,1679,214,14.607508532423209
Jalna,Wheat(Husked),2015,1574,1788,214,13.595933926302415
Satana,Maize,2014,937,1151,214,22.838847385272146
Beed,Bajri,2016,1512,1726,214,14.153439153439153
Mumbai,Tomato,2016,748,962,214,28.609625668449198
Chopda,Black Gram,2014,4791,5005,214,4.466708411605093
Devala,Bajri,2014,1283,1497,214,16.679657053780204
Mohol,Pigeon Pea (Tur),2014,3113,3327,214,6.8743976871185355
Raver,Sorgum(Jawar),2014,1183,1397,214,18.08960270498732
Amarawati,Bajri,2016,1788,2002,214,11.968680089485458
Ahmednagar,Wheat(Husked),2014,1571,1785,214,13.621896880967537
Khamgaon,Sunflower,2016,2998,3212,214,7.138092061374249
Vaijapur,Maize,2014,907,1121,214,23.594266813671446
Amarawati,Cluster Bean,2016,3500,3714,214,6.114285714285714
Parbhani,Cotton,2016,4699,4913,214,4.5541604596722705
Mandhal,Gram,2015,4016,4230,214,5.328685258964144
Ulhasnagar,Banana,2016,313,527,214,68.370607028754
Tumsar,Linseed,2014,3693,3907,214,5.794746818304901
Pathari,Sorgum(Jawar),2015,1636,1850,214,13.080684596577017
Amarawati,Carrot,2016,2543,2757,214,8.415257569799449
Akola,Sorgum(Jawar),2016,1349,1563,214,15.86360266864344
Buldhana,Soybean,2014,2906,3120,214,7.364074328974535
Mul,Paddy-Unhusked,2016,1880,2094,214,11.382978723404255
Shirpur,Bajri,2016,1361,1575,214,15.723732549595885
Rahata,Potato,2015,700,914,214,30.571428571428573
Pathardi,Cotton,2014,3800,4014,214,5.631578947368421
Manora,Soybean,2016,3557,3771,214,6.016305875737982
Akhadabalapur,Pigeon Pea (Tur),2014,4000,4214,214,5.35
Latur,Safflower,2016,2719,2933,214,7.870540639941155
Chandrapur-Ganjwad,Flower,2015,243,457,214,88.06584362139918
Malkapur,Maize,2016,1384,1598,214,15.46242774566474
Pune-Pimpri,Cabbage,2016,1267,1481,214,16.890292028413576
Amarawati-Fruit And Vegetables,Cabbage,2016,1329,1543,214,16.102332580887886
Ambejogai,Soybean,2016,3875,4089,214,5.52258064516129
Malkapur,Black Gram,2015,5615,5829,214,3.811219946571683
Ner Parasopant,Soybean,2014,3026,3240,214,7.0720423000660935
Kalmeshwar,Green Chilli,2015,2227,2441,214,9.609339919173776
Kalyan,Bottle Gourd,2015,743,957,214,28.802153432032302
Kalyan,Cabbage,2015,686,900,214,31.19533527696793
Amarawati,Brinjal,2016,1418,1632,214,15.091678420310297
Murtizapur,Soybean,2016,3190,3404,214,6.70846394984326
Murbad,Ghosali(Bhaji),2015,3243,3457,214,6.598828245451743
Shrirampur,Mango(Raw),2015,786,1000,214,27.2264631043257
Shrirampur,Bajri,2015,1322,1536,214,16.187594553706504
Fulambri,Cotton,2016,4407,4621,214,4.855911050601316
Chikhali,Maize,2015,1091,1305,214,19.615032080659944
Amarawati-Fruit And Vegetables,Cucumber,2016,2157,2371,214,9.921186833565137
Amalner,Bajri,2014,1078,1292,214,19.851576994434136
Vaijapur,Gram,2016,4221,4435,214,5.0698886519782045
Rajura,Soybean,2015,3391,3604,213,6.281332940135653
Kalamb (Os),Soybean,2014,3087,3300,213,6.899902818270165
Mumbai-Fruit Market,CHIKOO,2016,1655,1868,213,12.870090634441087
Mumbai-Fruit Market,Chikoo,2016,1279,1492,213,16.653635652853794
Umarkhed,Soybean,2016,3250,3463,213,6.553846153846154
Murbad,Tomato,2014,2800,3013,213,7.607142857142857
Ramtek,Tomato,2016,830,1043,213,25.662650602409638
Amarawati-Fruit And Vegetables,Beet Root,2016,1480,1693,213,14.391891891891891
Murbad,Ghosali(Bhaji),2015,1351,1564,213,15.766099185788304
Mumbai,Tomato,2016,775,988,213,27.483870967741936
Parli-Vaijnath,Green Gram,2016,4622,4835,213,4.608394634357421
Gevrai,Gram,2016,4001,4214,213,5.323669082729317
Telhara,Soybean,2016,3333,3546,213,6.390639063906391
Mul,Paddy-Unhusked,2016,1826,2039,213,11.664841182913472
Aurangabad,BOTTLE GOURD,2016,404,617,213,52.722772277227726
Indapur (Nimgaon Ketki),Bajri,2016,1400,1613,213,15.214285714285714
Wardha,Gram,2014,2496,2709,213,8.533653846153847
Satana,MAIZE,2016,1057,1270,213,20.151371807000945
Ahmedpur,Gram,2014,1996,2209,213,10.67134268537074
Sonpeth,Wheat(Husked),2016,1883,2096,213,11.311736590547
Barshi,Cucumber,2016,165,378,213,129.0909090909091
Aurangabad,Maize,2014,858,1071,213,24.825174825174827
Akot,Sorgum(Jawar),2015,1350,1563,213,15.777777777777779
Pune-Pimpri,Cluster Bean,2014,4067,4280,213,5.237275633144824
Jalgaon,Cluster Bean,2016,5073,5286,213,4.198698994677706
Nagpur,Wheat(Husked),2015,1835,2048,213,11.607629427792915
Barshi,Water Melon,2016,282,495,213,75.53191489361703
Ner Parasopant,Soybean,2015,3367,3580,213,6.326106326106326
Akot,Green Gram,2016,6900,7113,213,3.0869565217391304
Ner Parasopant,Gram,2016,4984,5197,213,4.273675762439807
Buldhana,Gram,2015,3950,4163,213,5.3924050632911396
Vani,Cotton,2015,4076,4289,213,5.225711481844946
Akola,Soybean,2014,3058,3271,213,6.965336821451929
Solapur,Papai,2015,523,736,213,40.72657743785851
Satara,Tomato,2016,409,622,213,52.07823960880196
Pachora,Maize,2016,1222,1435,213,17.430441898527004
Phaltan,Jaggery,2014,2744,2957,213,7.762390670553936
Sangamner,Wheat(Husked),2014,1425,1638,213,14.947368421052632
Dondaicha,Sorgum(Jawar),2015,1392,1605,213,15.301724137931034
Nandura,Wheat(Husked),2015,1361,1574,213,15.65025716385011
Dudhani,Sorgum(Jawar),2015,1725,1938,213,12.347826086956522
Baramati,Jaggery,2016,2451,2664,213,8.69033047735618
Nandura,Sorgum(Jawar),2015,1048,1261,213,20.32442748091603
Balapur,Soybean,2015,3200,3413,213,6.65625
Dudhani,Sorgum(Jawar),2016,1808,2021,213,11.780973451327434
Sangamner,Wheat(Husked),2016,1629,1842,213,13.075506445672191
Shrirampur,Ground Nut Pods (Dry),2015,2291,2504,213,9.297250109122654
Shrirampur,Water Melon,2015,829,1042,213,25.69360675512666
Ausa,Sorgum(Jawar),2015,1512,1725,213,14.087301587301587
Sangrampur,Wheat(Husked),2015,1173,1386,213,18.15856777493606
Chopda,SORGUM(JAWAR),2016,1460,1673,213,14.58904109589041
Washim,Black Gram,2014,4025,4238,213,5.291925465838509
Vaduj,Sorgum(Jawar),2015,2050,2263,213,10.390243902439025
Nanded,Pigeon Pea (Tur),2015,5800,6013,213,3.6724137931034484
Telhara,Gram,2016,5550,5763,213,3.8378378378378377
Mandhal,Soybean,2014,2893,3106,213,7.362599377808503
Nagpur,Mosambi,2016,1558,1771,213,13.671373555840821
Jalna,Maize,2016,1234,1447,213,17.26094003241491
Amalner,Maize,2015,1269,1482,213,16.78486997635934
Kalvan,Ground Nut Pods (Dry),2016,4475,4688,213,4.759776536312849
Nilanga,Soybean,2016,3590,3803,213,5.933147632311978
Kalyan,Tomato,2015,1550,1763,213,13.741935483870968
Pune-Pimpri,Ghosali(Bhaji),2015,2687,2900,213,7.927056196501675
Jalgaon Jamod-Aasalgaon,Soybean,2015,3481,3694,213,6.118931341568515
Lasur Station,Soybean,2015,3509,3721,212,6.0416072955257905
Khamgaon,Maize,2015,935,1147,212,22.67379679144385
Nagpur,Paddy-Unhusked,2016,1767,1979,212,11.997736276174306
Karmala,Maize,2016,1538,1750,212,13.784135240572171
Anajngaon Surji,Banana,2016,488,700,212,43.442622950819676
Nagpur,Capsicum,2015,1628,1840,212,13.022113022113022
Umared,Coriander (Dry),2016,7199,7411,212,2.944853451868315
Nagpur,Mango(Raw),2015,1268,1480,212,16.7192429022082
Pusad,Sorgum(Jawar),2016,1545,1757,212,13.72168284789644
Kada (Ashti),Bajri,2016,1388,1600,212,15.27377521613833
Khed-Chakan,Potato,2016,1363,1575,212,15.553925165077036
Amarawati,Beet Root,2016,1082,1294,212,19.593345656192238
Nanded,Pigeon Pea (Tur),2016,8129,8341,212,2.607946856931972
Amarawati,Cabbage,2015,1138,1350,212,18.629173989455186
Jintur,Cotton,2015,4160,4372,212,5.096153846153846
Shrirampur,Flower,2016,773,985,212,27.42561448900388
Sinner,Sorgum(Jawar),2015,1330,1542,212,15.93984962406015
Himayatnagar,Pigeon Pea (Tur),2016,7114,7326,212,2.980039359010402
Shrirampur,Potato,2016,1000,1212,212,21.2
Savner,GROUND NUT PODS (DRY),2016,3608,3820,212,5.875831485587583
Indapur (Nimgaon Ketki),Sorgum(Jawar),2016,1626,1838,212,13.038130381303812
Shrirampur,Cabbage,2016,638,850,212,33.22884012539185
Manmad,Gram,2016,5566,5778,212,3.8088393819619117
Mehkar,Wheat(Husked),2016,1525,1737,212,13.901639344262295
Nagbhid,Paddy-Unhusked,2016,2050,2262,212,10.341463414634147
Sinner,Wheat(Husked),2015,1662,1874,212,12.755716004813477
Kurdwadi,Gram,2015,2638,2850,212,8.036391205458681
Mukhed,Soybean,2016,2669,2881,212,7.943049831397527
Nagpur,Cluster Bean,2014,1584,1796,212,13.383838383838384
Nagpur,Cabbage,2015,373,585,212,56.83646112600536
Tumsar,Castor Seed,2014,2843,3055,212,7.456911712979247
Shrirampur,Carrot,2016,800,1012,212,26.5
Dhamangaon-Rly,Soybean,2016,3458,3670,212,6.130711393869289
Nagpur,Spinach,2016,472,684,212,44.91525423728814
Nagpur,Ladies Finger,2015,1356,1568,212,15.634218289085545
Nagpur,Pumpkin,2016,541,753,212,39.186691312384475
Amarawati,Dhemse,2015,1813,2025,212,11.693325979040265
Devala,Bajri,2016,1260,1472,212,16.825396825396826
Patur,Wheat(Husked),2016,1653,1865,212,12.825166364186328
Jafrabad,COTTON,2016,4744,4956,212,4.4688026981450255
Akole,Maize,2016,1388,1600,212,15.27377521613833
Ghatanji,Soybean,2014,3013,3225,212,7.036176568204447
Jintur,Soybean,2016,3180,3392,212,6.666666666666667
Baramati,Maize,2015,1338,1550,212,15.844544095665173
Ashti (Jalna),Pigeon Pea (Tur),2015,8136,8348,212,2.6057030481809242
Nanded,Gram,2015,3136,3348,212,6.760204081632653
Malkapur,Wheat(Husked),2016,1588,1800,212,13.350125944584383
Mumbai,Elephant Root,2015,1796,2008,212,11.804008908685969
Kalyan,Potato,2015,740,952,212,28.64864864864865
Savner,Gram,2015,3034,3246,212,6.987475280158207
Morshi,Gram,2015,3938,4150,212,5.383443372270188
Nagpur,Raddish,2015,396,608,212,53.535353535353536
Nagpur,Small Gourd,2014,1308,1520,212,16.207951070336392
Nagpur,Small Gourd,2014,1092,1304,212,19.413919413919412
Kalyan,Bottle Gourd,2016,1082,1294,212,19.593345656192238
Sangamner,Wheat(Husked),2014,1510,1722,212,14.039735099337749
Alibag,Paddy-Unhusked,2015,1580,1792,212,13.417721518987342
Mumbai,Potato,2015,842,1054,212,25.17814726840855
Sengaon,Soybean,2016,3483,3695,212,6.086706861900661
Manora,Wheat(Husked),2016,1594,1806,212,13.299874529485571
Bhokar,Wheat(Husked),2016,1488,1700,212,14.24731182795699
Parli-Vaijnath,Ground Nut Pods (Dry),2014,3058,3270,212,6.932635709614127
Hadgaon-Tamsa,Soybean,2016,3363,3575,212,6.303895331549212
Dudhani,Gram,2014,2038,2250,212,10.40235525024534
Telhara,Black Gram,2014,3788,4000,212,5.59662090813094
Dondaicha,Bajri,2014,1306,1518,212,16.232771822358345
Nagpur,Math (Bhaji),2014,1580,1792,212,13.417721518987342
Karanja,Sorgum(Jawar),2016,1493,1705,212,14.19959812458138
Aurangabad,Maize,2014,886,1098,212,23.927765237020317
Anajngaon Surji,Banana,2016,838,1050,212,25.29832935560859
Gangakhed,Soybean,2016,3504,3716,212,6.050228310502283
Karanja,Sorgum(Jawar),2015,1290,1502,212,16.434108527131784
Yeola,Bajri,2016,1369,1581,212,15.485756026296567
Rajura,Pigeon Pea (Tur),2016,7875,8087,212,2.6920634920634923
Chandrapur,Gram,2015,3950,4162,212,5.367088607594937
Udgir,Tamarind Seed,2015,1490,1702,212,14.228187919463087
Amalner,Wheat(Husked),2016,1614,1826,212,13.135068153655514
Mumbai,Green Chilli,2016,1017,1229,212,20.845624385447394
Mumbai,Ladies Finger,2016,840,1052,212,25.238095238095237
Kopargaon,Wheat(Husked),2014,1432,1644,212,14.804469273743017
Chikhali,Soybean,2015,3243,3455,212,6.537156953438174
Ramtek,Cucumber,2016,700,911,211,30.142857142857142
Daryapur,Sorgum(Jawar),2015,1386,1597,211,15.223665223665224
Shegaon,Green Gram,2016,6416,6627,211,3.2886533665835413
Devala,Maize,2015,1081,1292,211,19.518963922294173
Manwat,Soybean,2016,3077,3288,211,6.857328566785831
Nagbhid,Paddy-Unhusked,2016,1641,1852,211,12.858013406459476
Nagbhid,Paddy-Unhusked,2015,1842,2053,211,11.454940282301846
Taloda,Maize,2014,1022,1233,211,20.645792563600782
Nandurbar,Maize,2015,1088,1299,211,19.393382352941178
Mumbai-Onion And Potato Mkt,ONION,2016,635,846,211,33.22834645669291
Kalmeshwar,Brinjal,2016,577,788,211,36.5684575389948
Dondaicha,Green Gram,2015,6469,6680,211,3.2617096923790383
Amarawati,Sunflower,2015,2733,2944,211,7.720453713867545
Anajngaon Surji,Gram,2014,2497,2708,211,8.450140168201843
Manora,Wheat(Husked),2014,1339,1550,211,15.758028379387603
Gangapur,Sorgum(Jawar),2016,1661,1872,211,12.703190848886214
Tumsar,Black Gram,2015,4050,4261,211,5.209876543209877
Murbad,Bottle Gourd,2015,2411,2622,211,8.751555371215263
Vaduj,SORGUM(JAWAR),2016,2256,2467,211,9.352836879432624
Jalna,Wheat(Husked),2016,1887,2098,211,11.181770005299416
Maregaon,Cotton,2016,4270,4481,211,4.941451990632318
Gevrai,Mustard,2015,3108,3319,211,6.788931788931789
Ramtek,Ladies Finger,2016,1389,1600,211,15.190784737221023
Vai,Tomato,2015,843,1054,211,25.029655990510083
Shahada,Wheat(Husked),2014,1533,1744,211,13.76386170906719
Kalmeshwar,Ladies Finger,2014,2512,2723,211,8.39968152866242
Nagpur,Dhemse,2015,1254,1465,211,16.82615629984051
Khamgaon,Wheat(Husked),2015,1227,1438,211,17.19641401792991
Risod,Black Gram,2015,6206,6417,211,3.399935546245569
Khamgaon,Ground Nut Pods (Dry),2014,3256,3467,211,6.480343980343981
Washim,Sorgum(Jawar),2015,1157,1368,211,18.236819360414867
Jafrabad,Gram,2015,3200,3411,211,6.59375
Pathari,Wheat(Husked),2014,1400,1611,211,15.071428571428571
Patan,Ladies Finger,2015,1099,1310,211,19.199272065514105
Murbad,Ladies Finger,2015,3526,3737,211,5.984117980714691
Karanja,Soybean,2016,3455,3666,211,6.107091172214182
Murbad,Tomato,2015,2739,2950,211,7.7035414384811975
Shirpur,Maize,2015,1206,1417,211,17.495854063018243
Ramtek,Pumpkin,2015,878,1089,211,24.031890660592254
Chalisgaon,Sorgum(Jawar),2016,1236,1447,211,17.071197411003237
Chalisgaon,Sorgum(Jawar),2015,1164,1375,211,18.127147766323024
Beed,Gram,2016,5951,6162,211,3.54562258443959
Nagpur,Wal Bhaji,2015,1256,1467,211,16.79936305732484
Jalgaon,Sorgum(Jawar),2016,1572,1783,211,13.422391857506362
Ner Parasopant,Soybean,2016,3475,3686,211,6.071942446043166
Vani,Cotton,2014,3840,4051,211,5.494791666666667
Vani,Soybean,2016,3372,3583,211,6.257413997627521
Beed,Bajri,2016,1608,1819,211,13.121890547263682
Kalyan,Potato,2016,1192,1403,211,17.701342281879196
Amarawati,Bitter Gourd,2015,2211,2422,211,9.543193125282677
Kej,Sorgum(Jawar),2016,1762,1973,211,11.975028376844495
Jintur-Bori,Soybean,2016,3344,3555,211,6.309808612440191
Mangrulpeer,Sorgum(Jawar),2015,1130,1341,211,18.672566371681416
Amarawati-Fruit And Vegetables,Flower,2016,2178,2389,211,9.687786960514233
Morshi,Gram,2015,2828,3039,211,7.461103253182461
Vaijapur,Ground Nut Pods (Dry),2015,4476,4687,211,4.7140303842716715
Nagpur,Chavli (Pala),2014,912,1123,211,23.135964912280702
Yeola,Bajri,2014,1251,1462,211,16.866506794564348
Nagpur,Green Chilli,2015,1470,1681,211,14.353741496598639
Amarawati,Flower,2015,2078,2289,211,10.153994225216554
Yeola,Maize,2014,954,1165,211,22.11740041928721
Amalner,Bajri,2015,1305,1516,211,16.168582375478927
Sangamner,Gram,2015,4028,4239,211,5.2383316782522344
Shrirampur,Carrot,2016,842,1053,211,25.05938242280285
Satana,Wheat(Husked),2015,1441,1652,211,14.642609299097849
Akola,Sorgum(Jawar),2015,1210,1421,211,17.43801652892562
Indapur,Bajri,2016,1800,2011,211,11.722222222222221
Vaduj,Ghevda Seed,2014,3356,3567,211,6.2872467222884385
Malkapur,Sorgum(Jawar),2014,1200,1410,210,17.5
Pusad,Soybean,2016,3133,3343,210,6.7028407277369935
Barshi,Fodder,2015,238,448,210,88.23529411764706
Shrirampur,Bottle Gourd,2016,619,829,210,33.92568659127625
Lasur Station,Soybean,2014,2943,3153,210,7.135575942915392
Mandhal,PADDY-UNHUSKED,2016,1650,1860,210,12.727272727272727
Buldhana-Dhad,Soybean,2016,3649,3859,210,5.755001370238421
Nandurbar,Pigeon Pea (Tur),2015,4780,4990,210,4.393305439330544
Bhokar,Pigeon Pea (Tur),2014,4322,4532,210,4.858861638130495
Tasgaon,Soybean,2014,2970,3180,210,7.070707070707071
Manchar,Cluster Bean,2015,4000,4210,210,5.25
Chalisgaon,Soybean,2014,3000,3210,210,7.0
Mangalwedha,BAJRI,2016,1222,1432,210,17.18494271685761
Parli-Vaijnath,Bajri,2015,1514,1724,210,13.870541611624835
Bhiwapur,Soybean,2016,3400,3610,210,6.176470588235294
Ulhasnagar,Sugarcane,2016,300,510,210,70.0
Manchar,Beet Root,2015,1300,1510,210,16.153846153846153
Yeola,Gram,2016,5243,5453,210,4.005340453938585
Sonpeth,Soybean,2014,3156,3366,210,6.653992395437262
Loha,Gram,2016,4547,4757,210,4.618429733890477
Akhadabalapur,Soybean,2015,3270,3480,210,6.422018348623853
Shrirampur-Belapur,Wheat(Husked),2015,1385,1595,210,15.16245487364621
Nandurbar,Soybean,2016,3444,3654,210,6.097560975609756
Chimur,Soybean,2014,3030,3240,210,6.930693069306931
Sengaon,Soybean,2016,2824,3034,210,7.436260623229462
Dondaicha,Maize,2016,1250,1460,210,16.8
Ausa,Sorgum(Jawar),2016,1474,1684,210,14.246947082767978
Patur,Soybean,2016,3443,3653,210,6.099331977926227
Nagbhid,PADDY-UNHUSKED,2016,1726,1936,210,12.16685979142526
Ghansawangi,Sorgum(Jawar),2016,1650,1860,210,12.727272727272727
Jamner,Cotton,2015,3750,3960,210,5.6
Karad,Cabbage,2015,570,780,210,36.8421052631579
Ausa,Safflower,2015,2299,2509,210,9.134406263592867
Morshi,Pigeon Pea (Tur),2014,4462,4672,210,4.7064096817570595
Nagpur,Wheat(Husked),2015,1835,2045,210,11.444141689373296
Pathardi,Sorgum(Jawar),2015,1569,1779,210,13.38432122370937
Rahuri-Vambori,Soybean,2016,3313,3523,210,6.3386658617567155
Aurangabad,Potato,2014,2084,2294,210,10.076775431861805
Akole,Soybean,2014,2750,2960,210,7.636363636363637
Nagpur,Ghosali(Bhaji),2016,815,1025,210,25.766871165644172
Hingoli,Soybean,2015,3131,3341,210,6.70712232513574
Khed (Shel Pimpalgaon),Green Chilli,2014,1774,1984,210,11.837655016910936
Pathari,Soybean,2016,3351,3561,210,6.266786034019695
Rahata,Shevga,2015,3470,3680,210,6.051873198847262
Rahata,Bottle Gourd,2016,260,470,210,80.76923076923077
Sinner,Wheat(Husked),2015,1580,1790,210,13.291139240506329
Nagbhid,Paddy-Unhusked,2014,2307,2517,210,9.102730819245775
Parbhani,Gram,2016,4071,4281,210,5.158437730287399
Pathari,Soybean,2015,3130,3340,210,6.7092651757188495
Kalmeshwar,Gram,2015,3188,3398,210,6.587202007528231
Kalamb (Yawatmal),Soybean,2016,3140,3350,210,6.687898089171974
Kalamb (Os),Sorgum(Jawar),2016,1595,1805,210,13.16614420062696
Mantha,Sorgum(Jawar),2015,1148,1358,210,18.29268292682927
Amarawati,Dhemse,2016,1590,1800,210,13.20754716981132
Palghar(Bevur),Wheat(Husked),2016,1985,2195,210,10.57934508816121
Nandurbar,Bajri,2015,1034,1244,210,20.309477756286267
Kalmeshwar,Raddish,2016,345,555,210,60.869565217391305
Amarawati,Cluster Bean,2015,2880,3090,210,7.291666666666667
Amarawati-Fruit And Vegetables,Spinach,2016,1437,1647,210,14.613778705636744
Gangapur,Pigeon Pea (Tur),2016,6997,7207,210,3.001286265542375
Yawal,Gram,2014,2917,3127,210,7.199177236887213
Aurangabad,Bajri,2014,1307,1516,209,15.990818668706963
Kalvan,Bajri,2015,1156,1365,209,18.079584775086506
Chandrapur,Soybean,2016,3685,3894,209,5.6716417910447765
Parola,Bajri,2015,1260,1469,209,16.58730158730159
Panvel,Cucumber,2016,1333,1542,209,15.678919729932483
Bhivandi,Onion,2016,1320,1529,209,15.833333333333334
Chandur Bajar,Wheat(Husked),2015,1408,1617,209,14.84375
Kej,Sorgum(Jawar),2015,2074,2283,209,10.077145612343298
Anajngaon Surji,Sorgum(Jawar),2014,1283,1492,209,16.289945440374122
Pathardi,Bajri,2016,1345,1554,209,15.53903345724907
Kopargaon,Sorgum(Jawar),2016,1274,1483,209,16.405023547880692
Akola,Sorgum(Jawar),2016,1690,1899,209,12.366863905325443
Purna,Wheat(Husked),2015,1473,1682,209,14.188730482009504
Amalner,Maize,2016,1256,1465,209,16.64012738853503
Sindkhed Raja,Soybean,2016,3627,3836,209,5.762338020402536
Bhokar,Sorgum(Jawar),2015,1332,1541,209,15.69069069069069
Sillod,Cotton,2014,3818,4027,209,5.474070193818753
Satara,Bottle Gourd,2016,455,664,209,45.934065934065934
Amarawati-Fruit And Vegetables,CAPSICUM,2016,1452,1661,209,14.393939393939394
Udgir,Green Gram,2015,8441,8650,209,2.4760099514275558
Nira,Jaggery,2015,3007,3216,209,6.9504489524442965
Mul,Paddy-Unhusked,2015,1885,2094,209,11.087533156498674
Majalgaon,COTTON,2016,4691,4900,209,4.45534001279045
Ner Parasopant,Soybean,2015,3019,3228,209,6.9228221265319645
Mumbai,Elephant Root,2015,1965,2174,209,10.636132315521628
Partur,Bajri,2016,1441,1650,209,14.50381679389313
Mahur,Soybean,2015,3291,3500,209,6.350653296870252
Yeotmal,Cotton,2015,4054,4263,209,5.155402072027627
Ramtek,Tomato,2016,905,1114,209,23.093922651933703
Ramtek,Tomato,2016,855,1064,209,24.444444444444443
Nagpur,Wal Bhaji,2015,1165,1374,209,17.93991416309013
Bhokar,Soybean,2015,3378,3587,209,6.187092954410894
Vaijapur,Bajri,2016,1582,1791,209,13.211125158027812
Ahmedpur,SUNFLOWER,2016,2763,2972,209,7.564241766196163
Ausa,Maize,2016,1255,1464,209,16.653386454183266
Devala,Bajri,2015,1281,1490,209,16.315378610460577
Kurdwadi-Modnimb,BAJRI,2016,1393,1602,209,15.003589375448671
Barshi,Black Gram,2015,5141,5350,209,4.065356934448551
Devala,Horse Gram,2015,3355,3564,209,6.229508196721311
Mohol,Wheat(Husked),2015,1355,1564,209,15.424354243542435
Shevgaon-Bodhegaon,Green Gram,2016,4582,4791,209,4.5613269314709735
Devala,WHEAT(HUSKED),2016,1784,1993,209,11.715246636771301
Pandharkawada,Pigeon Pea (Tur),2015,6606,6815,209,3.163790493490766
Gangapur,Sorgum(Jawar),2015,1462,1671,209,14.295485636114911
Darwha,Soybean,2014,3048,3257,209,6.8569553805774275
Pune,Bajri,2015,1773,1982,209,11.787930062041736
Digras,Wheat(Husked),2016,1588,1797,209,13.161209068010075
Nandura,Wheat(Husked),2015,1270,1479,209,16.456692913385826
Nandurbar,Sorgum(Jawar),2015,1212,1421,209,17.244224422442244
Sinner,Maize,2015,1251,1460,209,16.706634692246205
Dound,Lemon,2015,200,409,209,104.5
Nandurbar,Ground Nut Pods (Dry),2015,2768,2977,209,7.550578034682081
Vai,Bottle Gourd,2015,1018,1227,209,20.530451866404714
Ausa,Jaggery,2015,1967,2176,209,10.625317742755465
Nagpur,Capsicum,2015,1717,1926,209,12.17239370995923
Ramtek,Onion,2016,792,1001,209,26.38888888888889
Nagpur,Dhemse,2014,1733,1942,209,12.0600115406809
Khed (Shel Pimpalgaon),Green Chilli,2016,2810,3019,209,7.437722419928826
Parola,Bajri,2016,1257,1466,209,16.626889419252187
Partur,Bajri,2015,1392,1601,209,15.014367816091953
Washim,Sorgum(Jawar),2016,1183,1392,209,17.666948436179204
Pachora,Wheat(Husked),2016,1520,1729,209,13.75
Umared,Pigeon Pea (Tur),2015,7440,7648,208,2.795698924731183
Kalyan,Potato,2015,500,708,208,41.6
Maregaon,Cotton,2016,4310,4518,208,4.825986078886311
Mantha,Sorgum(Jawar),2016,1675,1883,208,12.417910447761194
Umared,Linseed,2015,4700,4908,208,4.425531914893617
Achalpur,Soybean,2014,3060,3268,208,6.7973856209150325
Mumbai-Fruit Market,Water Melon,2016,384,592,208,54.166666666666664
Mumbai,Squash Gourd,2015,638,846,208,32.60188087774295
Karad,Flower,2016,522,730,208,39.84674329501916
Rahuri-Vambori,Bajri,2014,1331,1539,208,15.627347858752817
Kalyan,GHEVDA,2016,1417,1625,208,14.678899082568808
Ahmedpur,Ground Nut Pods (Dry),2015,5875,6083,208,3.5404255319148934
Mumbai,Elephant Root,2016,2068,2276,208,10.058027079303676
Lasalgaon-Niphad,Wheat(Husked),2016,1628,1836,208,12.776412776412776
Mumbai,Elephant Root,2016,1915,2123,208,10.861618798955613
Kalmeshwar,Flower,2016,596,804,208,34.899328859060404
Rahuri-Vambori,Sorgum(Jawar),2015,1160,1368,208,17.93103448275862
Rajura,Pigeon Pea (Tur),2015,7421,7629,208,2.8028567578493466
Rahuri-Vambori,Wheat(Husked),2015,1395,1603,208,14.910394265232975
Amarawati,Gram,2015,3886,4094,208,5.352547606793618
Kannad,Bajri,2015,1204,1412,208,17.27574750830565
Patan,Tomato,2016,697,905,208,29.842180774748925
Mumbai,Cabbage,2015,496,704,208,41.935483870967744
Yeola,MAIZE,2016,1047,1255,208,19.866284622731616
Amarawati,Maize,2016,1521,1729,208,13.675213675213675
Yawal,Onion,2016,460,668,208,45.21739130434783
Ralegaon,Gram,2015,3015,3223,208,6.8988391376451075
Rahata,Shevga,2016,521,729,208,39.923224568138195
Pusad,Wheat(Husked),2015,1532,1740,208,13.577023498694517
Pusad,Bajri,2016,1767,1975,208,11.77136389360498
Shrirampur,MAIZE,2016,943,1151,208,22.057264050901377
Ralegaon,Cotton,2015,3938,4146,208,5.281868969019807
Mumbai,Cabbage,2015,525,733,208,39.61904761904762
Mumbai,Cabbage,2014,736,944,208,28.26086956521739
Karad,Cabbage,2016,485,693,208,42.88659793814433
Karad,Bottle Gourd,2015,775,983,208,26.838709677419356
Kannad,Bajri,2016,1337,1545,208,15.557217651458489
Khed (Shel Pimpalgaon),LADIES FINGER,2016,1992,2200,208,10.441767068273093
Mumbai,Squash Gourd,2014,656,864,208,31.70731707317073
Mehkar,Maize,2016,1407,1615,208,14.783226723525232
Alibag,Paddy-Unhusked,2015,1415,1623,208,14.69964664310954
Alibag,Paddy-Unhusked,2015,1467,1675,208,14.178595773687798
Mumbai,Squash Gourd,2014,648,856,208,32.098765432098766
Achalpur,Wheat(Husked),2015,1442,1650,208,14.424410540915396
Kannad,Wheat(Husked),2015,1541,1749,208,13.497728747566516
Akola,Sorgum(Jawar),2015,1318,1526,208,15.781487101669196
Parli-Vaijnath,Sorgum(Jawar),2014,1563,1771,208,13.307741522712732
Nandura,Sorgum(Jawar),2015,1095,1303,208,18.995433789954337
Nagpur,Beet Root,2015,616,824,208,33.76623376623377
Chalisgaon,Maize,2014,1022,1230,208,20.35225048923679
Parli-Vaijnath,Sorgum(Jawar),2015,1375,1583,208,15.127272727272727
Dondaicha-Sindkheda,Wheat(Husked),2016,1529,1737,208,13.603662524525834
Nagpur,Small Gourd,2014,977,1185,208,21.289662231320367
Nagpur,Brinjal,2014,704,912,208,29.545454545454547
Barshi,Green Gram,2015,6175,6383,208,3.3684210526315788
Vaijapur,Bajri,2015,1326,1534,208,15.686274509803921
Nagpur,Coriander  ,2015,720,928,208,28.88888888888889
Gevrai,Cotton,2015,4027,4235,208,5.165135336478769
Vai,Tomato,2015,1004,1212,208,20.717131474103585
Nagpur,Tomato,2016,800,1008,208,26.0
Bhokar,COTTON,2016,4755,4963,208,4.374342797055731
Nagpur,Chavli (Shenga ),2014,916,1124,208,22.707423580786028
Sangrampur,Wheat(Husked),2014,1492,1700,208,13.941018766756033
Panvel,Ghosali(Bhaji),2016,2000,2208,208,10.4
Dhule,Pigeon Pea (Tur),2016,5336,5544,208,3.898050974512744
Jalgaon,Black Gram,2014,4812,5020,208,4.322527015793849
Vai,Flower,2015,588,796,208,35.374149659863946
Nagpur,Flower,2015,824,1032,208,25.24271844660194
Panvel,Cabbage,2016,617,825,208,33.71150729335494
Bhusaval,Black Gram,2014,3912,4120,208,5.316973415132924
Vita,Tomato,2016,281,489,208,74.02135231316726
Hadgaon-Tamsa,Soybean,2016,3335,3543,208,6.2368815592203894
Digras,Gram,2016,5446,5654,208,3.8193169298567757
Hanegaon,Green Gram,2016,4806,5014,208,4.327923429047025
Basmat (Kurunda),Soybean,2016,2601,2809,208,7.996924259900038
Nagpur,Cabbage,2015,368,576,208,56.52173913043478
Vai,Flower,2015,770,978,208,27.01298701298701
Chalisgaon,Bajri,2015,1090,1298,208,19.08256880733945
Nandura,Sorgum(Jawar),2016,1287,1495,208,16.161616161616163
Nagpur,Melon,2016,728,936,208,28.571428571428573
Pune,Bajri,2016,1986,2193,207,10.422960725075528
Nandgaon Khandeshwar,Soybean,2015,3020,3227,207,6.854304635761589
Yeotmal,Gram,2014,2407,2614,207,8.599916909015372
Sangamner,Sorgum(Jawar),2015,1648,1855,207,12.560679611650485
Gevrai,Sunflower,2015,3215,3422,207,6.438569206842923
Nagpur,Flower,2014,835,1042,207,24.790419161676645
Bhokar,Gram,2016,4025,4232,207,5.142857142857143
Navapur,Green Chilli,2016,4913,5120,207,4.213311622226746
Khamgaon,Ground Nut Pods (Dry),2014,3277,3484,207,6.316753127860848
Raver,Gram,2015,3913,4120,207,5.290058778430871
Amarawati,Capsicum,2016,1920,2127,207,10.78125
Varora,Cotton,2015,3906,4113,207,5.299539170506913
Murum,Wheat(Husked),2015,1907,2114,207,10.854745673833246
Achalpur,SOYBEAN,2016,2585,2792,207,8.007736943907156
Malegaon,Maize,2015,1293,1500,207,16.009280742459396
Pune-Pimpri,Beet Root,2016,2162,2369,207,9.574468085106384
Shevgaon,Wheat(Husked),2015,1540,1747,207,13.441558441558442
Kalamb (Os),Tamarind,2016,7467,7674,207,2.772197669746886
Jalgaon,Banana,2014,287,494,207,72.12543554006969
Nandura,Sorgum(Jawar),2016,1230,1437,207,16.829268292682926
Jalgaon,SOYBEAN,2016,2486,2693,207,8.3266291230893
Solapur,Banana,2016,912,1119,207,22.69736842105263
Buldhana-Dhad,MAIZE,2016,1006,1213,207,20.576540755467196
Ner Parasopant,Pigeon Pea (Tur),2015,6253,6460,207,3.310411002718695
Arvi,Gram,2015,3113,3320,207,6.649534211371667
Shirur,Gram,2016,5325,5532,207,3.887323943661972
Nagpur,Beet Root,2014,881,1088,207,23.496027241770715
Ambad(Vadi Godri),Maize,2015,1191,1398,207,17.38035264483627
Washim-Ansing,Soybean,2016,3665,3872,207,5.648021828103683
Lonar,Soybean,2015,3097,3304,207,6.683887633193413
Manwat,Sorgum(Jawar),2016,1600,1807,207,12.9375
Dondaicha-Sindkheda,Gram,2016,5779,5986,207,3.581934590759647
Malegaon,Pigeon Pea (Tur),2014,3916,4123,207,5.286006128702758
Rajura,Pigeon Pea (Tur),2016,6967,7174,207,2.9711497057557055
Palghar(Bevur),Onion,2015,3702,3909,207,5.591572123176661
Ulhasnagar,Sugarcane,2016,308,515,207,67.20779220779221
Bhandara,Rice(Paddy-Hus),2016,3022,3229,207,6.84976836532098
Devani,Gram,2016,4241,4448,207,4.880924310304174
Mumbai,Squash Gourd,2015,685,892,207,30.21897810218978
Mumbai,Squash Gourd,2015,385,592,207,53.76623376623377
Devala,Maize,2014,984,1191,207,21.036585365853657
Yawal,Onion,2016,226,433,207,91.59292035398231
Barshi,Fodder,2015,582,789,207,35.56701030927835
Yawal,Sorgum(Jawar),2016,1200,1407,207,17.25
Pune-Pimpri,Tomato,2016,757,964,207,27.344782034346103
Kalmeshwar,Cotton,2016,4284,4491,207,4.831932773109243
Amarawati,Spinach,2016,940,1147,207,22.02127659574468
Purna,Soybean,2014,3165,3372,207,6.540284360189573
Mudkhed,Gram,2016,5036,5243,207,4.110405083399524
Telhara,Sunflower,2015,2750,2957,207,7.527272727272727
Chopda,Maize,2014,904,1111,207,22.898230088495577
Jalna,Green Gram,2016,6543,6750,207,3.1636863823933976
Chandrapur-Ganjwad,Raddish,2015,586,793,207,35.32423208191126
Murtizapur,Wheat(Husked),2016,1561,1768,207,13.260730301089046
Himayatnagar,Sorgum(Jawar),2015,1043,1250,207,19.846596356663472
Nashik,Mint,2014,162,369,207,127.77777777777777
Shevgaon-Bodhegaon,Bajri,2015,1150,1357,207,18.0
Kalvan,Wheat(Husked),2016,1635,1842,207,12.660550458715596
Varud,Cotton,2015,3791,3998,207,5.460300712213137
Purna,Sorgum(Jawar),2016,1364,1571,207,15.175953079178885
Partur,Bajri,2016,1179,1386,207,17.557251908396946
Nagpur,Papai,2016,485,692,207,42.68041237113402
Chandur Bajar,Wheat(Husked),2016,1600,1807,207,12.9375
Rahuri-Vambori,Soybean,2016,3250,3457,207,6.369230769230769
Murbad,Capsicum,2014,4207,4413,206,4.896600903256477
Sengaon,Soybean,2016,3663,3869,206,5.623805623805624
Shegaon,Soybean,2014,2893,3099,206,7.120636017974421
Shrirampur,Mustard,2015,2961,3167,206,6.95710908476866
Kalmeshwar,Spinach,2016,468,674,206,44.01709401709402
Lasalgaon-Vinchur,Wheat(Husked),2015,1554,1760,206,13.256113256113256
Jintur,Sorgum(Jawar),2015,1105,1311,206,18.642533936651585
Majalgaon,Bajri,2016,1328,1534,206,15.512048192771084
Pune-Pimpri,Cabbage,2015,1026,1232,206,20.077972709551656
Shevgaon,Wheat(Husked),2015,1494,1700,206,13.788487282463185
Shahada,Wheat(Husked),2015,1558,1764,206,13.222079589216944
Ner Parasopant,Black Gram,2016,6465,6671,206,3.1863882443928846
Mantha,GREEN GRAM,2016,4269,4475,206,4.8254860623096745
Buldhana,Maize,2016,1122,1328,206,18.36007130124777
Amarawati-Fruit And Vegetables,Potato,2016,1429,1635,206,14.415675297410777
Digras,Gram,2016,4052,4258,206,5.08390918065153
Nashik,Spinach,2016,332,538,206,62.04819277108434
Lasalgaon,Maize,2016,1241,1447,206,16.59951651893634
Amarawati,Beet Root,2016,1312,1518,206,15.701219512195122
Ramtek,Spinach,2016,680,886,206,30.294117647058822
Dhule,Sorgum(Jawar),2016,1407,1613,206,14.641080312722103
Dondaicha,Maize,2015,1000,1206,206,20.6
Manora,Gram,2015,4010,4216,206,5.13715710723192
Manora,Wheat(Husked),2016,1500,1706,206,13.733333333333333
Mumbai,Tomato,2016,696,902,206,29.597701149425287
Sillod,Soybean,2016,3376,3582,206,6.101895734597156
Telhara,Cotton,2015,4108,4314,206,5.0146056475170395
Shegaon,Wheat(Husked),2016,1508,1714,206,13.660477453580901
Dondaicha,MAIZE,2016,1249,1455,206,16.493194555644514
Dhamangaon-Rly,GREEN GRAM,2016,4240,4446,206,4.8584905660377355
Shrirampur-Belapur,Bajri,2016,1041,1247,206,19.788664745437078
Kalyan,Potato,2015,722,928,206,28.53185595567867
Ahmedpur,Wheat(Husked),2015,1140,1346,206,18.07017543859649
Lasalgaon,Maize,2016,1224,1430,206,16.830065359477125
Kopargaon,Wheat(Husked),2016,1690,1896,206,12.189349112426035
Jalgaon,Sorgum(Jawar),2016,1758,1964,206,11.717861205915813
Nagbhid,Paddy-Unhusked,2016,2072,2278,206,9.942084942084943
Ner Parasopant,Gram,2015,4153,4359,206,4.960269684565374
Mantha,Gram,2015,3400,3606,206,6.0588235294117645
Amarawati,Cluster Bean,2016,1727,1933,206,11.928199189345687
Osmanabad,Soybean,2016,3545,3751,206,5.811001410437235
Akluj,Potato,2015,844,1050,206,24.407582938388625
Rahata,Gram,2015,3762,3968,206,5.475810738968634
Kada,Pigeon Pea (Tur),2015,5022,5228,206,4.1019514137793704
Malegaon,Maize,2015,1344,1550,206,15.327380952380953
Gangapur,Wheat(Husked),2015,1502,1708,206,13.715046604527297
Indapur,Banana,2015,458,664,206,44.97816593886463
Pandharkawada,Gram,2016,3958,4164,206,5.204648812531581
Rahata,BITTER GOURD,2016,988,1194,206,20.850202429149796
Rahata,Potato,2015,800,1006,206,25.75
Taloda,Gram,2014,3199,3405,206,6.439512347608628
Malegaon (Washim),Soybean,2016,3473,3679,206,5.931471350417507
Sengaon,Gram,2016,5952,6158,206,3.461021505376344
Gevrai,Bajri,2015,1255,1461,206,16.41434262948207
Washim,Sorgum(Jawar),2016,1261,1467,206,16.33624107850912
Gangapur,Pigeon Pea (Tur),2015,5594,5800,206,3.68251698248123
Morshi,Gram,2014,2222,2428,206,9.270927092709272
Raver,Sorgum(Jawar),2015,1217,1423,206,16.926869350862777
Varud-Rajura Bazar,Castor Seed,2015,3361,3566,205,6.099375185956561
Barshi-Vairag,Gram,2014,2060,2265,205,9.951456310679612
Manmad,Ladies Finger,2016,269,474,205,76.2081784386617
Kalmeshwar,Green Chilli,2015,2795,3000,205,7.334525939177102
Dhamangaon-Rly,Ground Nut Pods (Dry),2016,5125,5330,205,4.0
Malegaon,MAIZE,2016,1078,1283,205,19.01669758812616
Washim,Wheat(Husked),2015,1482,1687,205,13.832658569500675
Nagpur,Pumpkin,2016,759,964,205,27.009222661396574
Shirpur,Matki,2016,5206,5411,205,3.9377641183250094
Nagpur,Tomato,2014,1112,1317,205,18.43525179856115
Kej,Sorgum(Jawar),2014,1709,1914,205,11.995318899941486
Shrigonda,Wheat(Husked),2016,1666,1871,205,12.304921968787514
Aarni,Gram,2016,5402,5607,205,3.794890781192151
Nagpur,Math (Bhaji),2016,590,795,205,34.74576271186441
Sinner,Wheat(Husked),2014,1536,1741,205,13.346354166666666
Umarga,Bajri,2015,1239,1444,205,16.545601291364004
Chandrapur,Green Gram,2016,6100,6305,205,3.360655737704918
Raver,Maize,2016,1087,1292,205,18.859245630174794
Vai,Cabbage,2015,791,996,205,25.9165613147914
Savner,Gram,2016,7640,7845,205,2.683246073298429
Kalmeshwar,Walvad,2014,3995,4200,205,5.131414267834794
Shrirampur,Sorgum(Jawar),2016,1482,1687,205,13.832658569500675
Kalmeshwar,Spinach,2015,1118,1323,205,18.336314847942756
Pulgaon,Cotton,2015,3782,3987,205,5.420412480169222
Amarawati,Sunflower,2015,2742,2947,205,7.4762946754194015
Jalna,Soybean,2015,3179,3384,205,6.448568732305756
Shrirampur,Cucumber,2016,680,885,205,30.147058823529413
Jalna,Wheat(Husked),2014,1489,1694,205,13.76762928139691
Kalvan,Bajri,2015,1122,1327,205,18.270944741532976
Sengaon,Soybean,2016,3594,3799,205,5.7039510294936004
Umared,Lang,2015,1859,2064,205,11.027434104357182
Anajngaon Surji,Sorgum(Jawar),2015,1244,1449,205,16.479099678456592
Latur,Maize,2015,1369,1574,205,14.974433893352812
Morshi,Soybean,2016,3260,3465,205,6.288343558282208
Sonpeth,Soybean,2016,3500,3705,205,5.857142857142857
Kalmeshwar,Spinach,2016,622,827,205,32.958199356913184
Morshi,Soybean,2016,3117,3322,205,6.57683670195701
Sonpeth,Soybean,2016,3193,3398,205,6.420294393986846
Amarawati,Tomato,2016,556,761,205,36.8705035971223
Chikhali,Sorgum(Jawar),2016,1148,1353,205,17.857142857142858
Shegaon,Mustard,2015,3119,3324,205,6.572619429304265
Amarawati-Fruit And Vegetables,Beet Root,2016,1995,2200,205,10.275689223057643
Shevgaon-Bodhegaon,GRAM,2016,6556,6761,205,3.126906650396583
Vaijapur,Bajri,2015,1213,1418,205,16.900247320692497
Kalmeshwar,BOTTLE GOURD,2016,464,669,205,44.18103448275862
Patan,Brinjal,2016,833,1038,205,24.60984393757503
Devala,Bajri,2014,1257,1462,205,16.308671439936358
Shegaon,Wheat(Husked),2015,1277,1482,205,16.05324980422866
Akot,Wheat(Husked),2016,1548,1753,205,13.242894056847545
Nashik-Devlali,Melon,2016,860,1065,205,23.837209302325583
Akot,Wheat(Husked),2016,1572,1777,205,13.040712468193384
Hadgaon,Soybean,2016,3335,3540,205,6.146926536731634
Buldhana,Maize,2016,1090,1295,205,18.807339449541285
Karanja,Soybean,2016,3497,3702,205,5.862167572204747
Jintur,Soybean,2015,3241,3446,205,6.325208269052761
Nandura,Green Gram,2016,6765,6970,205,3.0303030303030303
Partur,Wheat(Husked),2014,1378,1583,205,14.876632801161103
Malegaon,Sorgum(Jawar),2015,1604,1809,205,12.780548628428928
Umarkhed,Soybean,2016,2648,2853,205,7.741691842900302
Vani,Cotton,2016,4288,4493,205,4.780783582089552
Umarga,Sorgum(Jawar),2015,1734,1939,205,11.82237600922722
Malegaon,Castor Seed,2016,2650,2855,205,7.735849056603773
Malegaon,Maize,2015,1107,1312,205,18.51851851851852
Shrirampur-Belapur,MAIZE,2016,935,1140,205,21.925133689839573
Udgir,Sorgum(Jawar),2015,994,1199,205,20.62374245472837
Rahata,Sorgum(Jawar),2016,1331,1536,205,15.401953418482345
Umarkhed,Soybean,2016,3456,3661,205,5.931712962962963
Nagpur,FLOWER,2016,550,755,205,37.27272727272727
Anajngaon Surji,Sorgum(Jawar),2014,1327,1531,204,15.373021853805577
Nagpur,Bottle Gourd,2016,548,752,204,37.22627737226277
Indapur-Bhigwan,Maize,2015,1437,1641,204,14.19624217118998
Chopda,Maize,2015,1230,1434,204,16.585365853658537
Murtizapur,Wheat(Husked),2015,1242,1446,204,16.42512077294686
Shrirampur,Water Melon,2016,800,1004,204,25.5
Nandurbar,Sorgum(Jawar),2016,1414,1618,204,14.427157001414427
Kalyan,Onion,2016,747,951,204,27.309236947791163
Nagpur,Raddish,2014,804,1008,204,25.37313432835821
Nagpur,Melon,2016,608,812,204,33.55263157894737
Nagpur,Math (Bhaji),2015,1081,1285,204,18.87141535615171
Nagpur,Small Gourd,2015,796,1000,204,25.628140703517587
Shrirampur,Cucumber,2015,957,1161,204,21.316614420062695
Nandurbar,Maize,2016,1301,1505,204,15.680245964642582
Telhara,Soybean,2016,3196,3400,204,6.382978723404255
Nagpur,Small Gourd,2015,1248,1452,204,16.346153846153847
Malkapur,Wheat(Husked),2015,1505,1709,204,13.554817275747508
Jintur,Wheat(Husked),2014,1525,1729,204,13.37704918032787
Nagpur,Raddish,2014,915,1119,204,22.295081967213115
Sangrampur,Wheat(Husked),2014,1250,1454,204,16.32
Amalner,Maize,2016,1236,1440,204,16.50485436893204
Loha,Green Gram,2016,4401,4605,204,4.635310156782549
Manmad,Wheat(Husked),2015,1425,1629,204,14.31578947368421
Kurdwadi,Maize,2015,1191,1395,204,17.12846347607053
Nagpur,Cabbage,2015,940,1144,204,21.70212765957447
Nagpur,Cabbage,2015,492,696,204,41.46341463414634
Aurangabad,Cabbage,2016,514,718,204,39.688715953307394
Mumbai,Elephant Root,2015,1985,2189,204,10.277078085642318
Ramtek,Cabbage,2016,686,890,204,29.737609329446062
Shrirampur,Potato,2014,1664,1868,204,12.259615384615385
Nagpur,Chavli (Pala),2015,669,873,204,30.493273542600896
Nagpur,Capsicum,2015,1759,1963,204,11.59749857873792
Nagpur,Beet Root,2015,1021,1225,204,19.980411361410383
Khamgaon,Neem-Seed,2016,890,1094,204,22.921348314606742
Jamkhed,Bajri,2016,1493,1697,204,13.663764233087743
Indapur (Nimgaon Ketki),Gram,2016,5833,6037,204,3.4973427052974455
Nagpur,Carrot,2015,944,1148,204,21.610169491525422
Nashik,Spinach,2015,188,392,204,108.51063829787235
Nagpur,Brinjal,2015,612,816,204,33.333333333333336
Satara,Cabbage,2016,357,561,204,57.142857142857146
Malkapur,Maize,2015,1386,1590,204,14.718614718614718
Kopargaon,Wheat(Husked),2016,1567,1771,204,13.018506700701979
Shrirampur,Cucumber,2015,550,754,204,37.09090909090909
Sangali,Soybean,2016,3764,3968,204,5.419766206163656
Jawala-Bajar,Pigeon Pea (Tur),2016,7936,8140,204,2.5705645161290325
Barshi,Water Melon,2016,325,529,204,62.76923076923077
Kalmeshwar,Spinach,2016,600,804,204,34.0
Ahmedpur,Maize,2014,1144,1348,204,17.832167832167833
Varora,COTTON,2016,4659,4863,204,4.3786220218931104
Sillod,Maize,2016,1192,1396,204,17.114093959731544
Kalmeshwar,Green Chilli,2014,2454,2658,204,8.312958435207824
Karanja,Sorgum(Jawar),2015,1144,1348,204,17.832167832167833
Nagpur,Jack Fruit,2015,1277,1481,204,15.974941268598277
Palghar(Bevur),Wheat(Husked),2015,1919,2123,204,10.630536737884315
Buldhana-Dhad,Maize,2016,1475,1679,204,13.830508474576272
Mangrulpeer,Wheat(Husked),2014,1308,1512,204,15.596330275229358
Rajura,Gram,2016,5829,6033,204,3.4997426659804427
Nagpur,Pumpkin,2015,867,1071,204,23.529411764705884
Nagpur,Bottle Gourd,2014,788,992,204,25.888324873096447
Akot,Soybean,2015,3099,3303,204,6.582768635043562
Nagpur,Chavli (Pala),2016,600,804,204,34.0
Nagpur,Brinjal,2014,988,1192,204,20.647773279352226
Kalmeshwar,Spinach,2016,534,738,204,38.20224719101124
Ner Parasopant,Pigeon Pea (Tur),2016,6147,6351,204,3.3186920448999513
Vai,Cabbage,2015,824,1028,204,24.75728155339806
Ner Parasopant,Green Gram,2016,4976,5180,204,4.09967845659164
Shrirampur,Potato,2015,991,1195,204,20.585267406659938
Varud,MAIZE,2016,1085,1289,204,18.80184331797235
Jalna-Badnapur,Cotton,2015,4038,4242,204,5.052005943536404
Sailu,Wheat(Husked),2015,1513,1717,204,13.48314606741573
Nagpur,Small Gourd,2015,1077,1281,204,18.941504178272982
Mumbai,Cabbage,2016,524,728,204,38.93129770992366
Nagpur,Cluster Bean,2015,1436,1640,204,14.206128133704736
Telhara,Wheat(Husked),2015,1243,1447,204,16.411906677393404
Kalmeshwar,Orange,2014,915,1119,204,22.295081967213115
Vai,Brinjal,2015,1025,1229,204,19.902439024390244
Shahada,Sorgum(Jawar),2015,1346,1550,204,15.156017830609212
Gangapur,Gram,2015,2534,2737,203,8.011049723756907
Shevgaon,Bajri,2016,1017,1220,203,19.960668633235006
Ner Parasopant,Soybean,2015,3701,3904,203,5.48500405295866
Latur-Murud,Sorgum(Jawar),2015,1558,1761,203,13.029525032092426
Amarawati,Sunflower,2015,2729,2932,203,7.43862220593624
Nanded,Gram,2015,4144,4347,203,4.898648648648648
Kalmeshwar,Soybean,2015,2953,3156,203,6.8743650524889945
Pune-Pimpri,Tomato,2016,678,881,203,29.941002949852507
Chopda,Ground Nut Pods (Dry),2016,3978,4181,203,5.10306686777275
Achalpur,Soybean,2016,3432,3635,203,5.914918414918415
Amarawati,Maize,2016,1550,1753,203,13.096774193548388
Ner Parasopant,Soybean,2016,3251,3454,203,6.244232543832667
Kalvan,Bajri,2014,1132,1335,203,17.93286219081272
Chikhali,Soybean,2015,3001,3204,203,6.7644118627124294
Vaijapur,Bajri,2016,1827,2030,203,11.11111111111111
Hingoli,Soybean,2014,3186,3389,203,6.371625863151287
Umarkhed-Danki,Soybean,2016,2667,2870,203,7.611548556430447
Ner Parasopant,Gram,2016,3839,4042,203,5.287835373795259
Nandura,Maize,2016,1153,1356,203,17.606244579358197
Rahuri-Vambori,Sorgum(Jawar),2015,1333,1536,203,15.22880720180045
Mangalwedha,Wheat(Unhusked),2015,3047,3250,203,6.662290777814244
Shevgaon,Bajri,2016,1519,1722,203,13.36405529953917
Sillod,Soybean,2016,3000,3203,203,6.766666666666667
Kalmeshwar,Tomato,2014,904,1107,203,22.45575221238938
Bhokar,Soybean,2016,3421,3624,203,5.933937445191464
Tumsar,Green Gram,2016,4771,4974,203,4.254873192202893
Amarawati,Wheat(Husked),2015,1732,1935,203,11.72055427251732
Jamner,Maize,2016,1430,1633,203,14.195804195804195
Shrirampur,Pigeon Pea (Tur),2015,4006,4209,203,5.067398901647529
Nagpur,Raddish,2014,912,1115,203,22.25877192982456
Nandura,Sorgum(Jawar),2014,1127,1330,203,18.012422360248447
Dhule,Maize,2014,928,1131,203,21.875
Jafrabad,Soybean,2015,3029,3232,203,6.701881809177946
Kopargaon,Sorgum(Jawar),2016,1518,1721,203,13.372859025032938
Gangapur,Sorgum(Jawar),2016,1733,1936,203,11.713791113675708
Khamgaon,Maize,2014,838,1041,203,24.22434367541766
Kalmeshwar,Chavli (Shenga ),2015,989,1192,203,20.525783619817997
Karanja,Soybean,2016,3538,3741,203,5.737704918032787
Kalamb (Os),Gram,2016,4208,4411,203,4.824144486692015
Amalner,Gram,2014,2322,2525,203,8.742463393626185
Gevrai,Wheat(Husked),2015,1498,1701,203,13.551401869158878
Gevrai,Bajri,2016,1610,1813,203,12.608695652173912
Nandurbar,Wheat(Husked),2014,1432,1635,203,14.175977653631286
Ambejogai,Soybean,2016,3578,3781,203,5.673560648406931
Kalmeshwar,Ladies Finger,2015,905,1108,203,22.430939226519335
Amalner,Gram,2016,6179,6382,203,3.285321249393106
Nandura,Wheat(Husked),2016,1416,1619,203,14.336158192090396
Gangapur,Sorgum(Jawar),2016,1699,1902,203,11.948204826368451
Nandura,Sorgum(Jawar),2014,1104,1307,203,18.38768115942029
Ulhasnagar,Onion,2016,589,791,202,34.29541595925297
Pachora,Maize,2016,915,1117,202,22.07650273224044
Akluj,Banana,2016,131,333,202,154.19847328244273
Taloda,Maize,2016,1200,1402,202,16.833333333333332
Amarawati,Pigeon Pea (Tur),2016,8687,8889,202,2.3253136871186832
Solapur,Pigeon Pea (Tur),2014,4490,4692,202,4.498886414253898
Bhiwapur,Soybean,2016,3488,3690,202,5.791284403669724
Buldhana,Soybean,2015,3050,3252,202,6.622950819672131
Chikhali,SORGUM(JAWAR),2016,1198,1400,202,16.86143572621035
Kalmeshwar,Bottle Gourd,2015,575,777,202,35.130434782608695
Mangrulpeer,Sorgum(Jawar),2015,1185,1387,202,17.046413502109704
Nagpur,Cluster Bean,2015,988,1190,202,20.445344129554655
Yeola,Bajri,2015,1273,1475,202,15.868028279654359
Junnar-Otur,Walvad,2016,280,482,202,72.14285714285714
Mohol,Wheat(Husked),2014,1385,1587,202,14.584837545126353
Jalna,Maize,2016,1305,1507,202,15.478927203065133
Rajura,Cotton,2015,3884,4086,202,5.200823892893924
Kej,Sorgum(Jawar),2016,1615,1817,202,12.507739938080496
Mumbai,Tomato,2016,552,754,202,36.594202898550726
Mahur,Cotton,2015,3935,4137,202,5.133418043202033
Lonar,Soybean,2015,3388,3590,202,5.962219598583235
Purna,Sorgum(Jawar),2016,1317,1519,202,15.33788914198937
Mehkar,Sorgum(Jawar),2016,1318,1520,202,15.326251896813353
Barshi,Fodder,2016,802,1004,202,25.18703241895262
Khamgaon,Wheat(Husked),2016,1654,1856,202,12.212817412333736
Varud-Rajura Bazar,Soybean,2016,3111,3313,202,6.493089038894246
Dondaicha-Sindkheda,Maize,2016,1150,1352,202,17.565217391304348
Mul,Paddy-Unhusked,2015,1803,2005,202,11.20354963948974
Mehkar,Sorgum(Jawar),2016,1114,1316,202,18.132854578096946
Nandurbar,Black Gram,2014,4588,4790,202,4.402789886660854
Pathardi,Sorgum(Jawar),2015,1541,1743,202,13.108371187540557
Amarawati,Linseed,2016,4388,4590,202,4.6034639927073835
Malegaon,Bajri,2015,1255,1457,202,16.095617529880478
Solapur,Banana,2016,103,305,202,196.11650485436894
Tumsar,Sarsav,2015,2567,2769,202,7.869107908063888
Murtizapur,Wheat(Husked),2016,1463,1665,202,13.807245386192754
Taloda,Sorgum(Jawar),2015,1093,1295,202,18.48124428179323
Lonand,Bajri,2016,1413,1615,202,14.29582448690729
Mehkar,Wheat(Husked),2016,1519,1721,202,13.298222514812377
Akluj,Math (Bhaji),2016,205,407,202,98.53658536585365
Barshi,Cluster Bean,2014,248,450,202,81.45161290322581
Dhule,Cowpea,2015,3728,3930,202,5.418454935622318
Barshi,Wheat(Husked),2016,1834,2036,202,11.014176663031625
Shirur,Bajri,2015,1321,1523,202,15.291445874337622
Beed,Bajri,2016,1618,1820,202,12.484548825710753
Mangaon(Bhadav),Paddy-Unhusked,2015,1275,1476,201,15.764705882352942
Gevrai,Cotton,2015,3958,4159,201,5.078322385042951
Karanja,Wheat(Husked),2014,1402,1603,201,14.336661911554922
Rahuri-Vambori,Ground Nut Pods (Dry),2015,4316,4517,201,4.657089898053753
Solapur,Cabbage,2015,226,427,201,88.93805309734513
Jalgaon,Wheat(Husked),2016,1514,1715,201,13.276089828269486
Shevgaon,Sorgum(Jawar),2015,1630,1831,201,12.331288343558283
Ahmednagar,PIGEON PEA (TUR),2016,5051,5252,201,3.9794100178182537
Dound,Lemon,2015,250,451,201,80.4
Chikhali,Sorgum(Jawar),2015,1061,1262,201,18.944392082940624
Akot,Gram,2016,6542,6743,201,3.072454906756344
Anajngaon Surji,Sorgum(Jawar),2016,1238,1439,201,16.235864297253634
Nandura,Sorgum(Jawar),2016,1368,1569,201,14.692982456140351
Nashik,Mint,2014,170,371,201,118.23529411764706
Nagpur,TOMATO,2016,694,895,201,28.962536023054756
Kurdwadi-Modnimb,Bajri,2016,1483,1684,201,13.553607552258935
Mumbai,Sugar,2015,2365,2566,201,8.498942917547568
Pusad,Sesamum,2015,5650,5851,201,3.5575221238938055
Amalner,Wheat(Husked),2016,1622,1823,201,12.392108508014797
Chopda,Maize,2016,1203,1404,201,16.708229426433917
Shrirampur,Maize,2014,1121,1322,201,17.93041926851026
Vaijapur,Maize,2015,1052,1253,201,19.106463878326995
Pandharkawada,Soybean,2015,3293,3494,201,6.103856665654418
Indapur-Bhigwan,Green Gram,2016,4950,5151,201,4.0606060606060606
Sangrampur-Varvatbakal,Sorgum(Jawar),2016,1350,1551,201,14.88888888888889
Pathari,Sorgum(Jawar),2015,1624,1825,201,12.376847290640393
Sangamner,Bajri,2016,1451,1652,201,13.852515506547208
Kannad,Sorgum(Jawar),2015,1422,1623,201,14.135021097046414
Nandgaon,Pigeon Pea (Tur),2015,7200,7401,201,2.7916666666666665
Nandurbar,Soybean,2014,2976,3177,201,6.754032258064516
Nagpur,Paddy-Unhusked,2016,1730,1931,201,11.61849710982659
Malkapur,Sorgum(Jawar),2015,1247,1448,201,16.1186848436247
Chalisgaon,Soybean,2015,3078,3279,201,6.530214424951267
Yeola,Green Gram,2016,6114,6315,201,3.2875368007850834
Tumsar,Pigeon Pea (Tur),2016,6798,6999,201,2.9567519858781997
Jintur-Bori,Soybean,2015,3194,3395,201,6.293049467752035
Tuljapur,Gram,2015,3972,4173,201,5.0604229607250755
Kalmeshwar,Bottle Gourd,2015,869,1070,201,23.130034522439587
Murtizapur,Sorgum(Jawar),2014,1398,1599,201,14.377682403433477
Lonar,Soybean,2015,3338,3539,201,6.0215698022768125
Latur,Sorgum(Jawar),2016,1600,1801,201,12.5625
Kalmeshwar,Chavli (Shenga ),2015,2641,2842,201,7.610753502461189
Ner Parasopant,Soybean,2015,3072,3273,201,6.54296875
Bhusaval,Gram,2015,2897,3098,201,6.938211943389714
Chakur,Green Gram,2016,4613,4814,201,4.357251246477347
Kalamb (Os),Tamarind,2016,6516,6717,201,3.0847145488029466
Lonar,Wheat(Husked),2016,1765,1966,201,11.388101983002834
Rajura,Soybean,2015,3629,3830,201,5.538715899696887
Kolhapur-Malkapur,Bitter Gourd,2016,100,300,200,200.0
Shrirampur,Maize(Corn.),2015,800,1000,200,25.0
Bhokar,Wheat(Husked),2016,1513,1713,200,13.218770654329147
Tumsar,Pigeon Pea (Tur),2016,7100,7300,200,2.816901408450704
Kolhapur-Laxmipuri,Split Lentil,2016,7000,7200,200,2.857142857142857
Sindi (Selu),Sorgum(Jawar),2016,1000,1200,200,20.0
Chandrapur-Ganjwad,Onion,2016,628,828,200,31.84713375796178
Shrirampur,Papai,2016,733,933,200,27.285129604365622
Akkolkot,Wheat(Unhusked),2016,3500,3700,200,5.714285714285714
Bhokardan,Green Gram,2015,7800,8000,200,2.5641025641025643
Bhokardan-Pimpalgaon Renu,Gram,2016,3900,4100,200,5.128205128205129
Shrirampur,Water Melon,2016,754,954,200,26.52519893899204
Bhokar,Sorgum(Jawar),2016,1350,1550,200,14.814814814814815
Newasa,Gram,2016,4000,4200,200,5.0
Mantha,Sorgum(Jawar),2016,1650,1850,200,12.121212121212121
Palus,Cucumber,2016,1200,1400,200,16.666666666666668
Gangapur,Pigeon Pea (Tur),2015,8500,8700,200,2.3529411764705883
Shrirampur,Papai,2016,491,691,200,40.73319755600814
Kolhapur-Malkapur,Coriander  ,2016,300,500,200,66.66666666666667
Kolhapur-Malkapur,Cucumber,2016,200,400,200,100.0
Mantha,Safflower,2016,2400,2600,200,8.333333333333334
Udgir,Gram,2015,4800,5000,200,4.166666666666667
Shrirampur,Papai,2016,493,693,200,40.56795131845842
Bhokar,TURMERIC,2016,6150,6350,200,3.252032520325203
Tumsar,Castor Seed,2015,3000,3200,200,6.666666666666667
Shrirampur,Potato,2016,942,1142,200,21.231422505307854
Pune-Moshi,Beet Root,2016,1231,1431,200,16.246953696181965
Manwat,Soybean,2016,3500,3700,200,5.714285714285714
Achalpur,Green Gram,2015,5704,5904,200,3.506311360448808
Shrirampur,Water Melon,2016,750,950,200,26.666666666666668
Shrirampur,Water Melon,2016,862,1062,200,23.201856148491878
Kolhapur-Laxmipuri,BAJRI,2016,1906,2106,200,10.49317943336831
Sindkhed Raja,Soybean,2016,3525,3725,200,5.673758865248227
Malegaon (Washim),Sorgum(Jawar),2014,1500,1700,200,13.333333333333334
Vaduj,Soybean,2016,3600,3800,200,5.555555555555555
Vaduj,Sorgum(Jawar),2016,2100,2300,200,9.523809523809524
Vaduj,Maize,2016,1500,1700,200,13.333333333333334
Vaduj,Green Gram,2016,5000,5200,200,4.0
Vaduj,Green Gram,2016,4800,5000,200,4.166666666666667
Nandgaon Khandeshwar,Soybean,2015,3050,3250,200,6.557377049180328
Beed,Soybean,2016,3700,3900,200,5.405405405405405
Vaduj,Soybean,2016,3500,3700,200,5.714285714285714
Bhokar,Rice(Paddy-Hus),2016,1400,1600,200,14.285714285714286
Kolhapur-Laxmipuri,Bajri,2016,1900,2100,200,10.526315789473685
Kolhapur-Laxmipuri,Bajri,2016,1900,2100,200,10.526315789473685
Manchar,SMALL GOURD,2016,1000,1200,200,20.0
Kolhapur-Laxmipuri,COWPEA,2016,6800,7000,200,2.9411764705882355
Vaduj,Soybean,2016,3550,3750,200,5.633802816901408
Kolhapur-Laxmipuri,Cowpea,2016,6800,7000,200,2.9411764705882355
Vaduj,Soybean,2016,3500,3700,200,5.714285714285714
Nandgaon Khandeshwar,Wheat(Husked),2016,1516,1716,200,13.192612137203167
Pavani,Pigeon Pea (Tur),2016,6800,7000,200,2.9411764705882355
Rahata,Beet Root,2015,800,1000,200,25.0
Kolhapur-Laxmipuri,Paddy-Unhusked,2016,1850,2050,200,10.81081081081081
Kolhapur-Laxmipuri,SPLIT LENTIL,2016,6867,7067,200,2.91247997670016
Kolhapur-Laxmipuri,Spilt Gerrn Gram,2016,9113,9313,200,2.194666959288928
Sangali,Castor Seed,2016,2600,2800,200,7.6923076923076925
Malegaon,Castor Seed,2016,2600,2800,200,7.6923076923076925
Shrirampur,Papai,2016,492,692,200,40.65040650406504
Shrirampur,Mango(Raw),2015,771,971,200,25.940337224383917
Shrirampur,Papai,2016,500,700,200,40.0
Pune,Nolkol,2016,540,740,200,37.03703703703704
Ner Parasopant,Green Gram,2015,6400,6600,200,3.125
Barshi-Vairag,Wheat(Husked),2015,1968,2168,200,10.16260162601626
Mahur,Pigeon Pea (Tur),2016,7000,7200,200,2.857142857142857
Mahur,Gram,2016,4320,4520,200,4.62962962962963
Mahur,Cotton,2016,4000,4200,200,5.0
Ner Parasopant,Black Gram,2014,4300,4500,200,4.651162790697675
Mahur,Soybean,2014,2737,2937,200,7.307270734380709
Akkalkuwa,Sorgum(Jawar),2015,1200,1400,200,16.666666666666668
Akkalkuwa,Sorgum(Jawar),2015,1150,1350,200,17.391304347826086
Mahur,Cotton,2014,3713,3913,200,5.386479935362241
Shahapur,Bhagar/Vari,2015,2800,3000,200,7.142857142857143
Mahur,Cotton,2014,3762,3962,200,5.31632110579479
Akkalkuwa,Green Gram,2015,7300,7500,200,2.73972602739726
Mantha,Pigeon Pea (Tur),2014,3900,4100,200,5.128205128205129
Akkalkuwa,Wheat(Husked),2015,1200,1400,200,16.666666666666668
Shrirampur,Ladies Finger,2016,748,948,200,26.737967914438503
Mantha,Gram,2014,2050,2250,200,9.75609756097561
Dondaicha-Sindkheda,Ground Nut Pods (Dry),2016,3429,3629,200,5.832604257801108
Pune,Nolkol,2016,500,700,200,40.0
Manora,Wheat(Husked),2016,1500,1700,200,13.333333333333334
Shrirampur,Papai,2015,473,673,200,42.28329809725159
Mahagaon,Soybean,2015,3400,3600,200,5.882352941176471
Mahagaon,Gram,2015,3100,3300,200,6.451612903225806
Shrirampur,Papai,2015,519,719,200,38.53564547206166
Shrirampur,Papai,2015,516,716,200,38.75968992248062
Shrirampur,Papai,2015,659,859,200,30.349013657056144
Navapur,WAL PAPDI,2016,1180,1380,200,16.949152542372882
Manora,Wheat(Husked),2016,1442,1642,200,13.869625520110956
Ner Parasopant,Ground Nut Pods (Dry),2015,3900,4100,200,5.128205128205129
Mantha,Gram,2015,3750,3950,200,5.333333333333333
Gangakhed,Wheat(Husked),2016,1400,1600,200,14.285714285714286
Sangamner,Flower,2014,1350,1550,200,14.814814814814815
Shevgaon,Bajri,2016,1629,1829,200,12.277470841006753
Buldhana,Green Gram,2014,6300,6500,200,3.1746031746031744
Mauda,Soybean,2016,3200,3400,200,6.25
Palus,CABBAGE,2016,671,871,200,29.806259314456035
Akkolkot,Wheat(Unhusked),2015,2800,3000,200,7.142857142857143
Buldhana,Wheat(Husked),2014,1800,2000,200,11.11111111111111
Osmanabad,Sweet Potato,2015,3000,3200,200,6.666666666666667
Ner Parasopant,Soybean,2016,3584,3784,200,5.580357142857143
Palus,Bottle Gourd,2016,500,700,200,40.0
Ner Parasopant,Pigeon Pea (Tur),2016,8367,8567,200,2.390343014222541
Ner Parasopant,Ground Nut Pods (Dry),2016,4383,4583,200,4.563084645220169
Mantha,Soybean,2015,2900,3100,200,6.896551724137931
Majalgaon,Safflower,2016,2300,2500,200,8.695652173913043
Shevgaon,Wheat(Husked),2015,1490,1690,200,13.422818791946309
Shrirampur,Maize(Corn.),2016,800,1000,200,25.0
Varud-Rajura Bazar,PIGEON PEA (TUR),2016,6050,6250,200,3.3057851239669422
Buldhana,Green Gram,2016,5800,6000,200,3.4482758620689653
Ner Parasopant,Wheat(Husked),2015,1500,1700,200,13.333333333333334
Nandura,Sesamum,2016,5450,5650,200,3.669724770642202
Ner Parasopant,Wheat(Husked),2015,1200,1400,200,16.666666666666668
Palus,Carrot,2015,1800,2000,200,11.11111111111111
Ner Parasopant,Wheat(Husked),2015,1300,1500,200,15.384615384615385
Barshi-Vairag,Wheat(Husked),2016,1951,2151,200,10.251153254741158
Akkolkot,Black Gram,2014,5200,5400,200,3.8461538461538463
Aheri,Gram,2015,3000,3200,200,6.666666666666667
Pune-Pimpri,Bitter Gourd,2016,4600,4800,200,4.3478260869565215
Buldhana,Maize,2016,1467,1667,200,13.6332651670075
Ner Parasopant,Pigeon Pea (Tur),2015,6787,6987,200,2.946810078090467
Pavani,Black Gram,2016,8100,8300,200,2.4691358024691357
Mauda,Wheat(Husked),2016,1513,1713,200,13.218770654329147
Solapur,Hemp,2015,300,500,200,66.66666666666667
Akluj,Bajri,2016,1506,1706,200,13.280212483399735
Pandharkawada,Ground Nut Pods (Dry),2016,5000,5200,200,4.0
Bhiwapur,Green Gram,2015,6100,6300,200,3.278688524590164
Vaduj,Wheat(Husked),2015,1600,1800,200,12.5
Vaduj,Soybean,2015,3433,3633,200,5.825808330905913
Shrirampur,Squash Gourd,2016,300,500,200,66.66666666666667
Shevgaon-Bodhegaon,Pigeon Pea (Tur),2016,8360,8560,200,2.3923444976076556
Aarni,Green Gram,2015,6850,7050,200,2.9197080291970803
Vaduj,Gram,2016,5275,5475,200,3.7914691943127963
Sindkhed Raja,Bajri,2015,1200,1400,200,16.666666666666668
Manchar,Capsicum,2015,1500,1700,200,13.333333333333334
Sengaon,Ground Nut Pods (Dry),2016,5425,5625,200,3.686635944700461
Bhiwapur,Coriander (Dry),2015,6000,6200,200,3.3333333333333335
Sillod-Bharadi,WHEAT(HUSKED),2016,1650,1850,200,12.121212121212121
Mohol,Sorgum(Jawar),2015,1730,1930,200,11.560693641618498
Aarni,Sorgum(Jawar),2015,900,1100,200,22.22222222222222
Ausa,Bajri,2016,1601,1801,200,12.492192379762649
Ausa,Bajri,2016,1656,1856,200,12.077294685990339
Pune-Pimpri,Ghosali(Bhaji),2015,2900,3100,200,6.896551724137931
Bhiwapur,Green Gram,2015,6200,6400,200,3.225806451612903
Ghatanji,Gram,2016,3600,3800,200,5.555555555555555
Bhandara,Green Gram,2016,5983,6183,200,3.342804613070366
Sindkhed Raja,Maize,2016,1100,1300,200,18.181818181818183
Bhiwapur,Linseed,2015,4600,4800,200,4.3478260869565215
Ghatanji,Sorgum(Jawar),2015,900,1100,200,22.22222222222222
Kinwat,Soybean,2014,3038,3238,200,6.583278472679394
Manchar,Cabbage,2016,200,400,200,100.0
Pune-Pimpri,Curry Leaves,2015,200,400,200,100.0
Manchar,Carrot,2016,1075,1275,200,18.6046511627907
Manchar,Chavli (Shenga ),2016,1580,1780,200,12.658227848101266
Sindkhed Raja,Maize,2016,1200,1400,200,16.666666666666668
Kinwat,Soybean,2014,2800,3000,200,7.142857142857143
Ghoti,Cabbage,2016,800,1000,200,25.0
Rahata,Ginger (Fresh),2015,4500,4700,200,4.444444444444445
Patur,Wheat(Husked),2015,1480,1680,200,13.513513513513514
Varud,Cotton,2015,4300,4500,200,4.651162790697675
Patur,Sorgum(Jawar),2015,1325,1525,200,15.09433962264151
Gondpimpri,Pigeon Pea (Tur),2016,8000,8200,200,2.5
Khed-Chakan,Math (Bhaji),2016,400,600,200,50.0
Shrirampur,WATER MELON,2016,500,700,200,40.0
Shrirampur,WAL PAPDI,2016,650,850,200,30.76923076923077
Gondpimpri,Soybean,2015,3400,3600,200,5.882352941176471
Washi(Osmanabad),Soybean,2016,3400,3600,200,5.882352941176471
Manchar,Ladies Finger,2015,600,800,200,33.333333333333336
Tumsar,Linseed,2014,3690,3890,200,5.420054200542006
Gondpimpri,Soybean,2015,2850,3050,200,7.017543859649122
Bhivandi,Male Goat,2015,2500,2700,200,8.0
Washi(Osmanabad),Gram,2016,4000,4200,200,5.0
Washi(Osmanabad),Gram,2016,4033,4233,200,4.959087527894868
Khed-Chakan,Spinach,2016,300,500,200,66.66666666666667
Gondpimpri,Paddy-Unhusked,2015,1850,2050,200,10.81081081081081
Ghoti,Tomato,2016,800,1000,200,25.0
Bhivandi,Rice(Paddy-Hus),2015,1500,1700,200,13.333333333333334
Patur,Soybean,2015,3475,3675,200,5.755395683453237
Shrirampur,Squash Gourd,2016,524,724,200,38.16793893129771
Shirala,Soybean,2014,3100,3300,200,6.451612903225806
Washim,TURMERIC,2016,7000,7200,200,2.857142857142857
Khultabad,Maize,2016,1225,1425,200,16.3265306122449
Manchar,Flower,2015,600,800,200,33.333333333333336
Nanded,GREEN GRAM,2016,4100,4300,200,4.878048780487805
Bhivandi,Male Goat,2016,500,700,200,40.0
Osmanabad,Bottle Gourd,2014,767,967,200,26.07561929595828
Manchar,Cucumber,2015,700,900,200,28.571428571428573
Gondpimpri,Gram,2015,3800,4000,200,5.2631578947368425
Manchar,Cucumber,2015,1033,1233,200,19.36108422071636
Manchar,Cucumber,2015,600,800,200,33.333333333333336
Kinwat,Gram,2015,3450,3650,200,5.797101449275362
Kinwat,Gram,2015,4000,4200,200,5.0
Kinwat,Gram,2015,3900,4100,200,5.128205128205129
Ghansawangi,Cotton,2014,3725,3925,200,5.369127516778524
Ghansawangi,Tamarind,2015,767,967,200,26.07561929595828
Bhiwapur,Soybean,2015,3100,3300,200,6.451612903225806
Bhiwapur,Soybean,2015,3500,3700,200,5.714285714285714
Ghansawangi,Tamarind,2015,950,1150,200,21.05263157894737
Ghansawangi,Soybean,2015,3200,3400,200,6.25
Achalpur,Gram,2014,2335,2535,200,8.565310492505354
Kolhapur,Awala,2015,3100,3300,200,6.451612903225806
Ghansawangi,Soybean,2015,3100,3300,200,6.451612903225806
Ghansawangi,Sorgum(Jawar),2015,1500,1700,200,13.333333333333334
Nira-Saswad,Ghevda Seed,2016,2700,2900,200,7.407407407407407
Ghansawangi,Sorgum(Jawar),2015,1350,1550,200,14.814814814814815
Kolhapur,Awala,2015,2000,2200,200,10.0
Bhokar,Green Gram,2014,6304,6504,200,3.1725888324873095
Ghansawangi,Neem-Seed,2015,400,600,200,50.0
Vaduj,Cowpea,2016,3000,3200,200,6.666666666666667
Bhiwapur,Soybean,2015,3100,3300,200,6.451612903225806
Malkapur,Maize,2014,926,1126,200,21.598272138228943
Malkapur,Bajri,2014,1100,1300,200,18.181818181818183
Gevrai,Cotton,2016,4600,4800,200,4.3478260869565215
Kolhapur-Laxmipuri,Bajri,2014,1500,1700,200,13.333333333333334
Kolhapur-Laxmipuri,Bajri,2014,1700,1900,200,11.764705882352942
Shrirampur,Shevga,2016,528,728,200,37.878787878787875
Shrirampur,Shevga,2016,674,874,200,29.673590504451038
Sindkhed Raja,Soybean,2016,3500,3700,200,5.714285714285714
Vaduj,Ghevda Seed,2016,1500,1700,200,13.333333333333334
Solapur,Hemp,2015,200,400,200,100.0
Malegaon (Washim),Sorgum(Jawar),2016,1500,1700,200,13.333333333333334
Malegaon (Washim),Sorgum(Jawar),2016,1400,1600,200,14.285714285714286
Kolhapur-Laxmipuri,Split Lentil,2014,6400,6600,200,3.125
Mauda,Wheat(Husked),2016,1450,1650,200,13.793103448275861
Kinwat,Soybean,2016,3367,3567,200,5.94000594000594
Shrirampur,Water Melon,2016,800,1000,200,25.0
Shrirampur,Water Melon,2016,800,1000,200,25.0
Kinwat,Soybean,2015,3400,3600,200,5.882352941176471
Kinwat,Gram,2015,3700,3900,200,5.405405405405405
Kinwat,Gram,2015,4000,4200,200,5.0
Kinwat,Ground Nut Pods (Dry),2015,4900,5100,200,4.081632653061225
Kinwat,Ground Nut Pods (Dry),2015,4867,5067,200,4.109307581672488
Kinwat,Ground Nut Pods (Dry),2015,4500,4700,200,4.444444444444445
Kinwat,Maize,2015,1150,1350,200,17.391304347826086
Ghansawangi,Soybean,2016,3400,3600,200,5.882352941176471
Kinwat,Pigeon Pea (Tur),2015,5100,5300,200,3.9215686274509802
Shrirampur,Water Melon,2016,771,971,200,25.940337224383917
Malkapur,Black Gram,2016,12000,12200,200,1.6666666666666667
Ghansawangi,Sorgum(Jawar),2016,1600,1800,200,12.5
Kinwat,Sorgum(Jawar),2015,1100,1300,200,18.181818181818183
Kinwat,Soybean,2015,3067,3267,200,6.521030322791001
Bhiwapur,Pigeon Pea (Tur),2015,5500,5700,200,3.6363636363636362
Kinwat,Wheat(Husked),2015,1233,1433,200,16.220600162206
Kinwat,Sorgum(Jawar),2016,1000,1200,200,20.0
Sindkhed Raja,Maize,2016,1100,1300,200,18.181818181818183
Solapur,Green Peas (Dry),2015,5400,5600,200,3.7037037037037037
Ghansawangi,Sorgum(Jawar),2016,1600,1800,200,12.5
Ghansawangi,Sorgum(Jawar),2016,1610,1810,200,12.422360248447205
Rahata,Carrot,2015,1127,1327,200,17.74622892635315
Kinwat,Gram,2016,5300,5500,200,3.7735849056603774
Ghansawangi,SORGUM(JAWAR),2016,1600,1800,200,12.5
Ghansawangi,Bajri,2016,1500,1700,200,13.333333333333334
Sindkhed Raja,Neem-Seed,2016,500,700,200,40.0
Kinwat,Ground Nut Pods (Dry),2016,5000,5200,200,4.0
Ghansawangi,Wheat(Husked),2015,1750,1950,200,11.428571428571429
Achalpur,Black Gram,2014,4467,4667,200,4.477277815088426
Kinwat,Ground Nut Pods (Dry),2016,4922,5122,200,4.063388866314506
Kinwat,Pigeon Pea (Tur),2016,8400,8600,200,2.380952380952381
Buldhana-Dhad,Soybean,2016,3380,3580,200,5.9171597633136095
Nandurbar,Cluster Bean,2015,3401,3601,200,5.8806233460746835
Shrirampur,Pigeon Pea (Tur),2015,4075,4275,200,4.9079754601226995
Barshi,Kanda Pat,2015,300,500,200,66.66666666666667
Latur-Murud,Green Gram,2016,4925,5125,200,4.060913705583756
Latur-Murud,Wheat(Husked),2015,1300,1500,200,15.384615384615385
Shrirampur,Bottle Gourd,2016,800,1000,200,25.0
Shrirampur,Bottle Gourd,2016,378,578,200,52.91005291005291
Shrirampur,Bottle Gourd,2016,443,643,200,45.146726862302486
Barshi,Guava,2015,100,300,200,200.0
Chopda,Gram,2015,3134,3334,200,6.381620931716656
Pune-Pimpri,Tomato,2016,600,800,200,33.333333333333336
Shrirampur,CABBAGE,2016,233,433,200,85.83690987124463
Ulhasnagar,BANANA,2016,300,500,200,66.66666666666667
Sangrampur-Varvatbakal,Sorgum(Jawar),2016,1300,1500,200,15.384615384615385
Sangrampur-Varvatbakal,Wheat(Husked),2016,1575,1775,200,12.698412698412698
Barshi,Kanda Pat,2015,200,400,200,100.0
Barshi,Kanda Pat,2015,300,500,200,66.66666666666667
Chandrapur-Ganjwad,Coriander  ,2015,800,1000,200,25.0
Chandrapur-Ganjwad,Chavli (Shenga ),2015,1000,1200,200,20.0
Pombhurni,Soybean,2015,3000,3200,200,6.666666666666667
Barshi,Capsicum,2016,200,400,200,100.0
Chandrapur-Ganjwad,Flower,2015,400,600,200,50.0
Chandrapur-Ganjwad,Ladies Finger,2015,800,1000,200,25.0
Chimur,SOYBEAN,2016,2800,3000,200,7.142857142857143
Chimur,Pigeon Pea (Tur),2016,6800,7000,200,2.9411764705882355
Barshi,Lemon,2015,198,398,200,101.01010101010101
Chimur,Gram,2016,7400,7600,200,2.7027027027027026
Chimur,Soybean,2015,3311,3511,200,6.040471156750226
Shrirampur,Cabbage,2016,665,865,200,30.075187969924812
Yeola,Cotton,2014,3850,4050,200,5.194805194805195
Shrirampur,Cabbage,2016,423,623,200,47.28132387706856
Shrirampur,Cabbage,2016,584,784,200,34.24657534246575
Chimur,Paddy-Unhusked,2015,1800,2000,200,11.11111111111111
Chandrapur-Ganjwad,Cluster Bean,2015,400,600,200,50.0
Chopda,Pigeon Pea (Tur),2015,4433,4633,200,4.511617414843221
Chandrapur-Ganjwad,Chavli (Pala),2014,900,1100,200,22.22222222222222
Barshi,Coriander  ,2015,300,500,200,66.66666666666667
Vaijapur,Bajri,2014,1167,1367,200,17.13796058269066
Vaijapur,Ground Nut Pods (Dry),2014,2780,2980,200,7.194244604316546
Chandrapur-Ganjwad,Ladies Finger,2014,778,978,200,25.70694087403599
Vaijapur,Ground Nut Pods (Dry),2014,3150,3350,200,6.349206349206349
Pusad,Pigeon Pea (Tur),2015,5267,5467,200,3.7972280235428135
Barshi,Coriander (Dry),2016,9533,9733,200,2.0979754536871917
Nashik,Spinach,2015,200,400,200,100.0
Pombhurni,Soybean,2016,3000,3200,200,6.666666666666667
Nashik,Spinach,2015,250,450,200,80.0
Sangrampur,Wheat(Husked),2015,1138,1338,200,17.57469244288225
Pombhurni,Soybean,2016,3000,3200,200,6.666666666666667
Yawal,Onion,2016,300,500,200,66.66666666666667
Chopda,Sesamum,2016,6000,6200,200,3.3333333333333335
Pombhurni,Soybean,2016,3000,3200,200,6.666666666666667
Nashik-Devlali,Banana,2016,810,1010,200,24.691358024691358
Sangrampur-Varvatbakal,Maize,2016,1175,1375,200,17.02127659574468
Chandrapur-Ganjwad,Beet Root,2015,600,800,200,33.333333333333336
Mangrulpeer,WHEAT(HUSKED),2016,1665,1865,200,12.012012012012011
Pune-Pimpri,Spinach,2016,500,700,200,40.0
Chandrapur-Ganjwad,Cabbage,2015,300,500,200,66.66666666666667
Sangrampur-Varvatbakal,Maize,2015,1000,1200,200,20.0
Shrirampur,Bor,2016,840,1040,200,23.80952380952381
Chandrapur-Ganjwad,Cabbage,2015,350,550,200,57.142857142857146
Barshi,Cluster Bean,2016,200,400,200,100.0
Shrirampur,Bottle Gourd,2016,800,1000,200,25.0
Shrirampur,Bottle Gourd,2016,763,963,200,26.212319790301443
Shrirampur,Bottle Gourd,2016,800,1000,200,25.0
Shrirampur,Bottle Gourd,2016,768,968,200,26.041666666666668
Shrirampur,Bottle Gourd,2016,905,1105,200,22.099447513812155
Chandrapur-Ganjwad,Carrot,2015,800,1000,200,25.0
Chimur,Gram,2015,3380,3580,200,5.9171597633136095
Shrirampur,Cabbage,2016,664,864,200,30.120481927710845
Shrirampur,Cabbage,2016,523,723,200,38.24091778202677
Barshi,Spinach,2015,300,500,200,66.66666666666667
Ahmednagar,Soybean,2016,3700,3900,200,5.405405405405405
Chandur Bajar,Wheat(Husked),2015,1400,1600,200,14.285714285714286
Mangrulpeer,Wheat(Husked),2014,1283,1483,200,15.58846453624318
Chandrapur-Ganjwad,Jack Fruit(Raw),2016,800,1000,200,25.0
Barshi,Shepu,2015,300,500,200,66.66666666666667
Chandrapur-Ganjwad,Spinach,2016,600,800,200,33.333333333333336
Lasur Station,Cotton,2014,3800,4000,200,5.2631578947368425
Shrirampur,Flower,2016,504,704,200,39.682539682539684
Barshi,Shevga,2015,300,500,200,66.66666666666667
Chandrapur-Ganjwad,Raddish,2016,800,1000,200,25.0
Shrirampur,Flower,2016,505,705,200,39.603960396039604
Chandrapur-Ganjwad,Potato,2016,1500,1700,200,13.333333333333334
Barshi,Spinach,2015,100,300,200,200.0
Udgir,Sesamum,2016,7200,7400,200,2.7777777777777777
Barshi,Spinach,2015,200,400,200,100.0
Shrirampur,Cabbage,2016,268,468,200,74.6268656716418
Shrirampur,Flower,2016,892,1092,200,22.42152466367713
Lasur Station,Cotton,2015,4000,4200,200,5.0
Barshi,Spinach,2015,100,300,200,200.0
Shrirampur,Cucumber,2016,700,900,200,28.571428571428573
Chandrapur-Ganjwad,Potato,2016,1448,1648,200,13.812154696132596
Purna,Gram,2016,4762,4962,200,4.199916001679966
Shrirampur,Flower,2016,864,1064,200,23.14814814814815
Barshi,Spinach,2015,300,500,200,66.66666666666667
Barshi,Spinach,2015,200,400,200,100.0
Shrirampur,FLOWER,2016,419,619,200,47.7326968973747
Barshi,Spinach,2015,200,400,200,100.0
Barshi,Spinach,2015,300,500,200,66.66666666666667
Shrirampur,Flower,2016,617,817,200,32.414910858995135
Lasur Station,Green Gram,2016,3900,4100,200,5.128205128205129
Yeola,Cotton,2015,3850,4050,200,5.194805194805195
Yeola,Cotton,2015,3850,4050,200,5.194805194805195
Chandur Bajar,Wheat(Husked),2015,1400,1600,200,14.285714285714286
Shrirampur-Belapur,Maize,2015,1056,1256,200,18.939393939393938
Shrirampur,Cabbage,2016,365,565,200,54.794520547945204
Chimur,Gram,2015,3300,3500,200,6.0606060606060606
Barshi,Methi (Bhaji),2015,100,300,200,200.0
Vaduj,Sorgum(Jawar),2015,2175,2375,200,9.195402298850574
Chandrapur-Ganjwad,Math (Bhaji),2015,300,500,200,66.66666666666667
Latur,Maize,2016,1500,1700,200,13.333333333333334
Osmanabad,SWEET POTATO,2016,800,1000,200,25.0
Barshi,Mosambi,2015,400,600,200,50.0
Barshi,CORIANDER (DRY),2016,6250,6450,200,3.2
Osmanabad,Sesamum,2016,6100,6300,200,3.278688524590164
Barshi,Mosambi,2015,200,400,200,100.0
Chandrapur-Ganjwad,Pappaya (Bhaji),2015,500,700,200,40.0
Chandrapur-Ganjwad,Pumpkin,2015,500,700,200,40.0
Barshi,Bottle Gourd,2016,300,500,200,66.66666666666667
Chandrapur-Ganjwad,Small Gourd,2015,400,600,200,50.0
Shrirampur,Carrot,2016,857,1057,200,23.337222870478413
Shrirampur,Carrot,2016,769,969,200,26.00780234070221
Chandrapur-Ganjwad,Small Gourd,2015,700,900,200,28.571428571428573
Chandrapur-Ganjwad,Spinach,2015,485,685,200,41.23711340206186
Vita,Brinjal,2014,1000,1200,200,20.0
Pune-Moshi,Sweet Potato,2016,2300,2500,200,8.695652173913043
Chandrapur-Ganjwad,Spinach,2015,300,500,200,66.66666666666667
Barshi,Rajgira,2015,200,400,200,100.0
Purna,Cotton,2015,3750,3950,200,5.333333333333333
Vita,Tomato,2014,1000,1200,200,20.0
Chandur Bajar,Sorgum(Jawar),2016,1208,1408,200,16.556291390728475
Chandrapur-Ganjwad,Carrot,2016,1300,1500,200,15.384615384615385
Chandrapur-Ganjwad,Chavli (Pala),2016,500,700,200,40.0
Chandrapur-Ganjwad,Dhemse,2016,600,800,200,33.333333333333336
Sangrampur,Maize,2015,950,1150,200,21.05263157894737
Ahmednagar,Jaggery,2015,2350,2550,200,8.51063829787234
Navapur,Pigeon Pea (Tur),2016,6264,6464,200,3.1928480204342273
Barshi,Mosambi,2016,350,550,200,57.142857142857146
Nandurbar,Matki,2016,6689,6889,200,2.989983555090447
Chalisgaon,Matki,2016,4300,4500,200,4.651162790697675
Shrirampur,Potato,2015,900,1100,200,22.22222222222222
Shrirampur,Potato,2015,650,850,200,30.76923076923077
Tasgaon,Wheat(Husked),2015,2100,2300,200,9.523809523809524
Shevgaon,Bajri,2015,1214,1414,200,16.474464579901152
Palam,Pigeon Pea (Tur),2016,8500,8700,200,2.3529411764705883
Shrirampur,Potato,2015,776,976,200,25.77319587628866
Shrirampur,Potato,2015,675,875,200,29.62962962962963
Shrirampur,Potato,2015,657,857,200,30.441400304414003
Pune-Pimpri,Cluster Bean,2014,4425,4625,200,4.519774011299435
Akhadabalapur,Sorgum(Jawar),2015,1300,1500,200,15.384615384615385
Akhadabalapur,Pigeon Pea (Tur),2015,5245,5445,200,3.813155386081983
Baramati,Soybean,2016,3150,3350,200,6.349206349206349
Barshi,Methi (Bhaji),2016,200,400,200,100.0
Koregaon,Coriander (Dry),2015,9500,9700,200,2.1052631578947367
Koregaon,Gram,2015,4300,4500,200,4.651162790697675
Koregaon,Gram,2015,3104,3304,200,6.443298969072165
Rahata,Bottle Gourd,2014,280,480,200,71.42857142857143
Akhadabalapur,Green Gram,2015,5000,5200,200,4.0
Akhadabalapur,Gram,2015,3300,3500,200,6.0606060606060606
Dhule,Matki,2016,5500,5700,200,3.6363636363636362
Dhule,Ladies Finger,2016,2400,2600,200,8.333333333333334
Koregaon,Potato,2015,725,925,200,27.586206896551722
Koregaon,Potato,2015,800,1000,200,25.0
Vaijapur,Ground Nut Pods (Dry),2016,4456,4656,200,4.488330341113106
Akhadabalapur,Castor Seed,2015,3000,3200,200,6.666666666666667
Koregaon,Sorgum(Jawar),2015,1600,1800,200,12.5
Manora,Wheat(Husked),2014,1350,1550,200,14.814814814814815
Manora,Wheat(Husked),2014,1450,1650,200,13.793103448275861
Vai,Goosefoot,2015,400,600,200,50.0
Aheri,Pigeon Pea (Tur),2016,6980,7180,200,2.865329512893983
Ahmedpur,Hemp-Seed,2016,2000,2200,200,10.0
Sangamner,Soybean,2015,3000,3200,200,6.666666666666667
Akhadabalapur,Gram,2016,8000,8200,200,2.5
Chandrapur-Ganjwad,Ladies Finger,2016,1300,1500,200,15.384615384615385
Barshi,Water Melon,2016,288,488,200,69.44444444444444
Manora,Wheat(Husked),2016,1500,1700,200,13.333333333333334
Barshi,Water Melon,2016,300,500,200,66.66666666666667
Chalisgaon,Pigeon Pea (Tur),2014,4000,4200,200,5.0
Osmanabad,Gram,2016,7591,7791,200,2.6346989856408904
Akhadabalapur,Cotton,2016,4300,4500,200,4.651162790697675
Akhadabalapur,COTTON,2016,4722,4922,200,4.235493434985176
Akhadabalapur,Wheat(Husked),2015,1520,1720,200,13.157894736842104
Osmanabad,Gram,2016,6200,6400,200,3.225806451612903
Barshi,Spinach,2016,225,425,200,88.88888888888889
Barshi,Shevga,2016,300,500,200,66.66666666666667
Barshi,Shepu,2016,400,600,200,50.0
Vai,Coriander  ,2015,400,600,200,50.0
Lonand,Gram,2016,3667,3867,200,5.45404963185165
Phaltan,Jaggery,2015,2300,2500,200,8.695652173913043
Shrirampur-Belapur,Gram,2015,2500,2700,200,8.0
Shrirampur,Potato,2015,600,800,200,33.333333333333336
Pune,Banana(Raw),2015,750,950,200,26.666666666666668
Pune,Banana(Raw),2015,800,1000,200,25.0
Barshi,Shepu,2016,200,400,200,100.0
Manora,Sorgum(Jawar),2016,1600,1800,200,12.5
Tasgaon,Ghevda Seed,2015,3000,3200,200,6.666666666666667
Digras,Sesamum,2016,6185,6385,200,3.2336297493936943
Tasgaon,Gram,2015,3600,3800,200,5.555555555555555
Barshi,SUNFLOWER,2016,2600,2800,200,7.6923076923076925
Barshi,Raddish,2016,200,400,200,100.0
Tasgaon,Soybean,2015,3600,3800,200,5.555555555555555
Koregaon,Cowpea,2014,3600,3800,200,5.555555555555555
Dhule,Kanda Pat,2016,800,1000,200,25.0
Dhule,Green Chilli,2016,2300,2500,200,8.695652173913043
Tasgaon,GREEN GRAM,2016,5300,5500,200,3.7735849056603774
Vai,Onion,2016,600,800,200,33.333333333333336
Barshi,Spinach,2014,200,400,200,100.0
Dhadgaon,Bhagar/Vari,2016,1500,1700,200,13.333333333333334
Barshi,Kanda Pat,2016,300,500,200,66.66666666666667
Paithan,Bajri,2016,1382,1582,200,14.47178002894356
Chandrapur,Small Gourd,2015,400,600,200,50.0
Ahmednagar,Chillies(Red),2015,5800,6000,200,3.4482758620689653
Pune-Pimpri,POTATO,2016,2600,2800,200,7.6923076923076925
Devala,Green Gram,2016,6061,6261,200,3.2997855139415937
Nashik,Grapes,2015,200,400,200,100.0
Shegaon,PIGEON PEA (TUR),2016,4872,5072,200,4.105090311986864
Barshi,Bitter Gourd,2015,300,500,200,66.66666666666667
Barshi,Green Chilli,2016,400,600,200,50.0
Kurdwadi,Pigeon Pea (Tur),2016,8033,8233,200,2.4897298643097225
Kurdwadi,Tamarind,2016,6500,6700,200,3.076923076923077
Pune-Pimpri,Potato,2016,1400,1600,200,14.285714285714286
Dhule,Carrot,2016,800,1000,200,25.0
Nashik-Devlali,Papai,2016,500,700,200,40.0
Loha,Gram,2015,3850,4050,200,5.194805194805195
Chandrapur,Horse Gram,2016,2300,2500,200,8.695652173913043
Loha,Sunflower,2014,2700,2900,200,7.407407407407407
Pune-Pimpri,Shevga,2016,3750,3950,200,5.333333333333333
Chandrapur,Onion,2016,600,800,200,33.333333333333336
Sangrampur,Wheat(Husked),2014,1225,1425,200,16.3265306122449
Chandrapur,Onion,2016,600,800,200,33.333333333333336
Pune-Pimpri,Snake Gourd,2016,1800,2000,200,11.11111111111111
Kurdwadi-Modnimb,GREEN GRAM,2016,3800,4000,200,5.2631578947368425
Sindi,Wheat(Husked),2015,1250,1450,200,16.0
Chandrapur,Pumpkin,2016,800,1000,200,25.0
Udgir,Black Gram,2016,8300,8500,200,2.4096385542168677
Shrirampur,BOTTLE GOURD,2016,489,689,200,40.899795501022496
Shrirampur,Water Melon,2015,660,860,200,30.303030303030305
Shrirampur,Water Melon,2015,583,783,200,34.305317324185246
Shrirampur,Water Melon,2015,689,889,200,29.027576197387518
Dhamangaon-Rly,Cotton,2015,4200,4400,200,4.761904761904762
Koregaon,Gram,2016,5250,5450,200,3.8095238095238093
Koregaon,Gram,2016,9000,9200,200,2.2222222222222223
Pune-Pimpri,Chavli (Pala),2014,3000,3200,200,6.666666666666667
Koregaon,Wheat(Husked),2016,1700,1900,200,11.764705882352942
Barshi,Brinjal,2014,183,383,200,109.2896174863388
Shevgaon,Bajri,2014,1068,1268,200,18.726591760299627
Pune-Pimpri,Carrot,2014,1600,1800,200,12.5
Korpana,Soybean,2015,3400,3600,200,5.882352941176471
Chandrapur,Banana,2015,750,950,200,26.666666666666668
Osmanabad,Kharbuj,2016,900,1100,200,22.22222222222222
Kurdwadi,Lemon,2014,150,350,200,133.33333333333334
Chandrapur,Cabbage,2015,400,600,200,50.0
Barshi,Kanda Pat,2014,233,433,200,85.83690987124463
Ulhasnagar,Sugarcane,2016,300,500,200,66.66666666666667
Chandrapur,Carrot,2015,800,1000,200,25.0
Udgir,Tamarind Seed,2015,1500,1700,200,13.333333333333334
Nashik-Devlali,Spinach,2016,120,320,200,166.66666666666666
Barshi,Methi (Bhaji),2014,200,400,200,100.0
Barshi,Kanda Pat,2016,300,500,200,66.66666666666667
Barshi,Kanda Pat,2016,300,500,200,66.66666666666667
Lohara,Gram,2015,4195,4395,200,4.767580452920143
Pune-Pimpri,Lentil,2016,4900,5100,200,4.081632653061225
Dhamangaon-Rly,Wheat(Husked),2015,1200,1400,200,16.666666666666668
Barshi,Shepu,2014,300,500,200,66.66666666666667
Shrirampur,Water Melon,2015,692,892,200,28.90173410404624
Barshi,Spinach,2014,100,300,200,200.0
Barshi,Kanda Pat,2016,260,460,200,76.92307692307692
Yawal,Cotton,2016,4124,4324,200,4.849660523763337
Shrirampur,Water Melon,2015,800,1000,200,25.0
Barshi,Methi (Bhaji),2015,100,300,200,200.0
Umarkhed,Wheat(Husked),2015,1400,1600,200,14.285714285714286
Vaduj,Sorgum(Jawar),2015,2100,2300,200,9.523809523809524
Amarawati,Spinach,2015,1600,1800,200,12.5
Patan,Cabbage,2014,677,877,200,29.542097488921712
Umarkhed-Danki,Wheat(Husked),2015,1400,1600,200,14.285714285714286
Umarkhed-Danki,Wheat(Husked),2015,1400,1600,200,14.285714285714286
Umarkhed-Danki,Soybean,2015,3400,3600,200,5.882352941176471
Nagpur,Chavli (Pala),2015,800,1000,200,25.0
Nagpur,Chavli (Pala),2015,900,1100,200,22.22222222222222
Nagpur,Chavli (Pala),2015,881,1081,200,22.701475595913735
Panvel,Ladies Finger,2016,2200,2400,200,9.090909090909092
Panvel,RIDGE GOURD,2016,2300,2500,200,8.695652173913043
Anajngaon Surji,Wheat(Husked),2014,1398,1598,200,14.30615164520744
Nagpur,Castor Seed,2015,3000,3200,200,6.666666666666667
Panvel,Ridge Gourd,2016,1700,1900,200,11.764705882352942
Panvel,SNAKE GOURD,2016,900,1100,200,22.22222222222222
Nagpur,Carrot,2015,978,1178,200,20.449897750511248
Panvel,Snake Gourd,2016,850,1050,200,23.529411764705884
Panvel,Snake Gourd,2016,1450,1650,200,13.793103448275861
Shrirampur,Cabbage,2014,736,936,200,27.17391304347826
Shrirampur,Cabbage,2014,541,741,200,36.96857670979667
Shrirampur,Cabbage,2014,275,475,200,72.72727272727273
Shrirampur,Cabbage,2014,223,423,200,89.68609865470852
Panvel,Tomato,2016,500,700,200,40.0
Patan,Cabbage,2014,736,936,200,27.17391304347826
Pune-Manjri,Custard Apple,2016,6216,6416,200,3.2175032175032174
Umarkhed-Danki,Wheat(Husked),2015,1400,1600,200,14.285714285714286
Anajngaon Surji,Banana,2015,700,900,200,28.571428571428573
Nagpur,Cucumber,2015,932,1132,200,21.459227467811157
Panvel,Cucumber,2016,1125,1325,200,17.77777777777778
Panvel,FLOWER,2016,1140,1340,200,17.54385964912281
Umarkhed-Danki,Soybean,2016,3600,3800,200,5.555555555555555
Umarkhed-Danki,Soybean,2016,3550,3750,200,5.633802816901408
Umarkhed-Danki,Pigeon Pea (Tur),2016,5500,5700,200,3.6363636363636362
Umarkhed-Danki,Pigeon Pea (Tur),2016,8500,8700,200,2.3529411764705883
Panvel,GHEVDA,2016,1360,1560,200,14.705882352941176
Panvel,GHOSALI(BHAJI),2016,1633,1833,200,12.24739742804654
Umarkhed-Danki,Ground Nut Pods (Dry),2016,5067,5267,200,3.9471087428458653
Amarawati,Pumpkin,2015,800,1000,200,25.0
Jalna-Badnapur,Soybean,2014,3150,3350,200,6.349206349206349
Umarkhed-Danki,Gram,2016,6033,6233,200,3.315100281783524
Umarkhed-Danki,Gram,2016,4977,5177,200,4.018485031143259
Ratanagari,Sweet Potato,2014,2800,3000,200,7.142857142857143
Panvel,LADIES FINGER,2016,2475,2675,200,8.080808080808081
Anajngaon Surji,Banana,2015,700,900,200,28.571428571428573
Umarkhed-Danki,Wheat(Husked),2015,1400,1600,200,14.285714285714286
Amarawati,Potato,2015,600,800,200,33.333333333333336
Amarawati,Pumpkin,2015,1075,1275,200,18.6046511627907
Mumbai,Ridge Gourd,2016,2400,2600,200,8.333333333333334
Amarawati,Spinach,2015,1100,1300,200,18.181818181818183
Nagpur,Dhemse,2015,1000,1200,200,20.0
Shrirampur,Bottle Gourd,2014,786,986,200,25.44529262086514
Nagpur,Pumpkin,2014,744,944,200,26.881720430107528
Nagpur,Pumpkin,2014,896,1096,200,22.321428571428573
Sillod-Bharadi,Bajri,2016,1470,1670,200,13.605442176870747
Ramtek,Squash Gourd,2016,1686,1886,200,11.862396204033216
Sillod-Bharadi,Gram,2015,3600,3800,200,5.555555555555555
Nagpur,Parwar,2014,932,1132,200,21.459227467811157
Jamner-Neri,Cotton,2015,3750,3950,200,5.333333333333333
Ramtek,Small Gourd,2016,1800,2000,200,11.11111111111111
Ramtek,Shevga,2016,867,1067,200,23.06805074971165
Amarawati,Bajri,2016,1920,2120,200,10.416666666666666
Ramtek,Raddish,2016,800,1000,200,25.0
Parbhani,Gram,2015,3951,4151,200,5.062009617818274
Parbhani,Gram,2015,4300,4500,200,4.651162790697675
Amarawati,Beet Root,2016,1086,1286,200,18.41620626151013
Amarawati,Beet Root,2016,1686,1886,200,11.862396204033216
Amarawati,Beet Root,2016,1543,1743,200,12.961762799740765
Amarawati,Beet Root,2016,938,1138,200,21.321961620469082
Nagpur,Green Gram,2014,5200,5400,200,3.8461538461538463
Jawala-Bajar,Sorgum(Jawar),2015,1550,1750,200,12.903225806451612
Jawala-Bajar,Sorgum(Jawar),2015,1600,1800,200,12.5
Ramtek,Pumpkin,2016,567,767,200,35.27336860670194
Nagpur,Raddish,2014,904,1104,200,22.123893805309734
Ramtek,Zendu,2016,1133,1333,200,17.6522506619594
Nagpur,Beet Root,2015,982,1182,200,20.36659877800407
Amarawati,Tomato,2015,940,1140,200,21.27659574468085
Amarawati,Sunflower,2015,6300,6500,200,3.1746031746031744
Amarawati,Sunflower,2015,2718,2918,200,7.358351729212656
Amarawati,Sunflower,2015,2750,2950,200,7.2727272727272725
Nagpur,Brinjal,2015,1242,1442,200,16.10305958132045
Anajngaon Surji,Banana,2014,705,905,200,28.368794326241133
Shrirampur,Bottle Gourd,2014,586,786,200,34.129692832764505
Shrirampur,Bottle Gourd,2014,504,704,200,39.682539682539684
Paranda,Wheat(Husked),2015,1600,1800,200,12.5
Amarawati,Tomato,2015,1000,1200,200,20.0
Amarawati,Tomato,2015,2600,2800,200,7.6923076923076925
Nagpur,Bitter Gourd,2015,1680,1880,200,11.904761904761905
Amarawati,Tomato,2015,1350,1550,200,14.814814814814815
Shrirampur,Bottle Gourd,2014,675,875,200,29.62962962962963
Jamkhed,Gram,2015,3690,3890,200,5.420054200542006
Ratanagari,Bottle Gourd,2014,800,1000,200,25.0
Partur,Gram,2016,5234,5434,200,3.8211692777990063
Nagpur,Bottle Gourd,2015,433,633,200,46.18937644341801
Nagpur,Bottle Gourd,2015,480,680,200,41.666666666666664
Nagpur,Bottle Gourd,2015,809,1009,200,24.721878862793574
Nagpur,Black Gram,2015,3800,4000,200,5.2631578947368425
Nagpur,Cucumber,2015,742,942,200,26.954177897574123
Panvel,Carrot,2016,2000,2200,200,10.0
Kalyan,Banana,2015,600,800,200,33.333333333333336
Panvel,Snake Gourd,2015,2000,2200,200,10.0
Jalgaon Jamod-Aasalgaon,Wheat(Husked),2016,1400,1600,200,14.285714285714286
Amarawati,Cabbage,2015,800,1000,200,25.0
Amarawati,Cabbage,2015,1022,1222,200,19.569471624266146
Amarawati,Cabbage,2015,1000,1200,200,20.0
Amarawati,Cabbage,2015,875,1075,200,22.857142857142858
Kalyan,Green-Peas,2014,3100,3300,200,6.451612903225806
Kalyan,Ghevda,2014,2200,2400,200,9.090909090909092
Amarawati,Carrot,2015,1250,1450,200,16.0
Amarawati,Carrot,2015,2333,2533,200,8.572653236176597
Panvel,Ridge Gourd,2015,3333,3533,200,6.0006000600060005
Kalyan,Elephant Root,2014,1600,1800,200,12.5
Kalyan,Cluster Bean,2014,2000,2200,200,10.0
Panvel,Ridge Gourd,2015,3800,4000,200,5.2631578947368425
Amarawati,Cluster Bean,2015,1800,2000,200,11.11111111111111
Kalyan,Capsicum,2014,3000,3200,200,6.666666666666667
Amarawati,Cucumber,2015,800,1000,200,25.0
Amarawati,Cucumber,2015,1400,1600,200,14.285714285714286
Jalgaon Jamod-Aasalgaon,Wheat(Husked),2016,1400,1600,200,14.285714285714286
Jalgaon Jamod-Aasalgaon,Wheat(Husked),2016,1400,1600,200,14.285714285714286
Amarawati,Dhemse,2015,1500,1700,200,13.333333333333334
Amarawati,Dhemse,2015,1743,1943,200,11.474469305794607
Jalgaon Jamod-Aasalgaon,Wheat(Husked),2016,1350,1550,200,14.814814814814815
Nagpur,Linseed,2015,4300,4500,200,4.651162790697675
Amarawati,Brinjal,2015,1111,1311,200,18.001800180018
Panvel,Ghosali(Bhaji),2015,2000,2200,200,10.0
Panvel,Ghosali(Bhaji),2015,1950,2150,200,10.256410256410257
Rahuri,Wheat(Husked),2016,1450,1650,200,13.793103448275861
Kalyan,Tomato,2014,2200,2400,200,9.090909090909092
Kalyan,Tomato,2014,1600,1800,200,12.5
Kalyan,Small Gourd,2014,1100,1300,200,18.181818181818183
Panvel,Ghosali(Bhaji),2015,2500,2700,200,8.0
Shrirampur,Papai,2014,700,900,200,28.571428571428573
Hadgaon,Soybean,2016,2800,3000,200,7.142857142857143
Panvel,Ghosali(Bhaji),2015,2000,2200,200,10.0
Kalyan,Ridge Gourd,2014,2000,2200,200,10.0
Amarawati,Brinjal,2015,787,987,200,25.412960609911053
Panvel,Ladies Finger,2015,3000,3200,200,6.666666666666667
Amarawati,Bitter Gourd,2015,1900,2100,200,10.526315789473685
Amarawati,Bitter Gourd,2015,2400,2600,200,8.333333333333334
Amarawati,Bitter Gourd,2015,1800,2000,200,11.11111111111111
Mumbai,Cabbage,2016,388,588,200,51.54639175257732
Mumbai,Cabbage,2016,315,515,200,63.492063492063494
Kalyan,Guava,2014,1800,2000,200,11.11111111111111
Jalgaon Jamod-Aasalgaon,Sorgum(Jawar),2016,1350,1550,200,14.814814814814815
Amarawati,Brinjal,2015,1100,1300,200,18.181818181818183
Patan,Flower,2015,800,1000,200,25.0
Kalyan,Cabbage,2014,700,900,200,28.571428571428573
Nagpur,Dhemse,2015,1296,1496,200,15.432098765432098
Kalyan,Bor,2014,1600,1800,200,12.5
Kalvan,Ground Nut Pods (Dry),2015,4270,4470,200,4.68384074941452
Amarawati,Lemon,2015,800,1000,200,25.0
Jalna,Sunflower,2015,2800,3000,200,7.142857142857143
Patan,Cabbage,2015,733,933,200,27.285129604365622
Panvel,Brinjal,2016,2317,2517,200,8.631851532153647
Panvel,CABBAGE,2016,617,817,200,32.414910858995135
Panvel,CARROT,2016,1260,1460,200,15.873015873015873
Panvel,CLUSTER BEAN,2016,1600,1800,200,12.5
Shrirampur,Flower,2014,548,748,200,36.496350364963504
Shrirampur,Flower,2014,641,841,200,31.201248049921997
Shrirampur,Flower,2014,525,725,200,38.095238095238095
Shrirampur,Flower,2014,505,705,200,39.603960396039604
Nagpur,Flower,2015,1276,1476,200,15.67398119122257
Solapur,GREEN PEAS (DRY),2016,2850,3050,200,7.017543859649122
Amarawati,Maize(Corn.),2015,300,500,200,66.66666666666667
Shrirampur,Cucumber,2014,761,961,200,26.281208935611037
Shrirampur,Cucumber,2014,652,852,200,30.67484662576687
Panvel,Cabbage,2016,629,829,200,31.79650238473768
Amarawati,Math (Bhaji),2015,911,1111,200,21.95389681668496
Amarawati,Math (Bhaji),2015,1343,1543,200,14.892032762472077
Anajngaon Surji,Sorgum(Jawar),2015,1240,1440,200,16.129032258064516
Kalvan,Pigeon Pea (Tur),2015,9250,9450,200,2.1621621621621623
Amarawati,Ladies Finger,2015,3050,3250,200,6.557377049180328
Nagpur,Ghosali(Bhaji),2015,588,788,200,34.01360544217687
Kalvan,Pigeon Pea (Tur),2016,7084,7284,200,2.82326369282891
Panvel,Snake Gourd,2015,2000,2200,200,10.0
Nagpur,Jack Fruit,2015,1208,1408,200,16.556291390728475
Amarawati,Dhemse,2015,2000,2200,200,10.0
Anajngaon Surji,Sunflower,2015,2900,3100,200,6.896551724137931
Panvel,Tomato,2015,1500,1700,200,13.333333333333334
Panvel,Tomato,2015,1300,1500,200,15.384615384615385
Rahuri-Vambori,Bajri,2014,1420,1620,200,14.084507042253522
Mumbai,Chavli (Shenga ),2016,3000,3200,200,6.666666666666667
Panvel,BITTER GOURD,2016,2183,2383,200,9.161704076958314
Amarawati,Flower,2015,1600,1800,200,12.5
Amarawati,Guava,2015,800,1000,200,25.0
Panvel,BOTTLE GOURD,2016,950,1150,200,21.05263157894737
Panvel,BRINJAL,2016,1350,1550,200,14.814814814814815
Jalkot,SOYBEAN,2016,2587,2787,200,7.730962504831852
Panvel,Bitter Gourd,2016,1750,1950,200,11.428571428571429
Jalna,Green Gram,2015,6654,6854,200,3.005710850616171
Jalna,Green Gram,2015,6600,6800,200,3.0303030303030303
Panvel,Bottle Gourd,2016,729,929,200,27.434842249657063
Panvel,Bottle Gourd,2016,1150,1350,200,17.391304347826086
Nagpur,Ghosali(Bhaji),2015,771,971,200,25.940337224383917
Ramtek,Pumpkin,2016,792,992,200,25.252525252525253
Ramtek,Pumpkin,2016,889,1089,200,22.49718785151856
Ramtek,Pumpkin,2016,790,990,200,25.31645569620253
Ramtek,Mosambi,2015,1933,2133,200,10.346611484738748
Junnar (Narayangaon),Shepu,2016,101,301,200,198.01980198019803
Amarawati-Fruit And Vegetables,Carrot,2016,1800,2000,200,11.11111111111111
Murbad,Ladies Finger,2015,2750,2950,200,7.2727272727272725
Murbad,Ladies Finger,2015,3587,3787,200,5.575689991636465
Kalamb (Os),Sesamum,2015,7467,7667,200,2.6784518548279093
Amarawati-Fruit And Vegetables,Carrot,2016,2240,2440,200,8.928571428571429
Tuljapur,Sorgum(Jawar),2016,1950,2150,200,10.256410256410257
Ramtek,Jack Fruit,2015,1000,1200,200,20.0
Amarawati-Fruit And Vegetables,Carrot,2016,1000,1200,200,20.0
Ramtek,Karvand,2015,800,1000,200,25.0
Ramtek,Chavli (Pala),2016,1800,2000,200,11.11111111111111
Pune,Jack Fruit(Raw),2015,433,633,200,46.18937644341801
Murud,Rice(Paddy-Hus),2015,1500,1700,200,13.333333333333334
Murud,Rice(Paddy-Hus),2015,1500,1700,200,13.333333333333334
Murbad,Tomato,2015,2820,3020,200,7.092198581560283
Amarawati-Fruit And Vegetables,Capsicum,2016,1800,2000,200,11.11111111111111
Murud,Rice(Paddy-Hus),2015,1500,1700,200,13.333333333333334
Ramtek,Chavli (Pala),2016,800,1000,200,25.0
Murud,Paddy-Unhusked,2015,1500,1700,200,13.333333333333334
Ramtek,Lemon,2015,800,1000,200,25.0
Ramtek,Chavli (Pala),2016,800,1000,200,25.0
Junnar,Potato,2016,1800,2000,200,11.11111111111111
Umarkhed,Gram,2016,5007,5207,200,3.994407829039345
Murbad,Ghosali(Bhaji),2015,1750,1950,200,11.428571428571429
Murbad,Capsicum,2015,5850,6050,200,3.4188034188034186
Ramtek,Cluster Bean,2015,800,1000,200,25.0
Sillod,Sorgum(Jawar),2015,1400,1600,200,14.285714285714286
Sillod,Sorgum(Jawar),2015,900,1100,200,22.22222222222222
Amarawati-Fruit And Vegetables,Dhemse,2016,1000,1200,200,20.0
Murbad,Brinjal,2015,1420,1620,200,14.084507042253522
Ramtek,Cluster Bean,2016,800,1000,200,25.0
Murum,Wheat(Unhusked),2014,3500,3700,200,5.714285714285714
Ramtek,Chillies(Red),2016,1000,1200,200,20.0
Amarawati,Math (Bhaji),2016,2771,2971,200,7.217610970768676
Murbad,Capsicum,2015,5667,5867,200,3.5292041644609142
Umarkhed,Gram,2016,6033,6233,200,3.315100281783524
Amarawati-Fruit And Vegetables,Cucumber,2016,2100,2300,200,9.523809523809524
Amarawati-Fruit And Vegetables,Cucumber,2016,1667,1867,200,11.997600479904019
Amarawati-Fruit And Vegetables,Cucumber,2016,1606,1806,200,12.453300124533001
Murbad,Ghevda,2015,4000,4200,200,5.0
Murbad,Ghevda,2015,3250,3450,200,6.153846153846154
Umarkhed,Pigeon Pea (Tur),2016,8700,8900,200,2.2988505747126435
Umarkhed,Pigeon Pea (Tur),2016,8800,9000,200,2.272727272727273
Ramtek,Chikoo,2016,800,1000,200,25.0
Ramtek,Chavli (Shenga ),2016,920,1120,200,21.73913043478261
Ramtek,Chavli (Pala),2016,1000,1200,200,20.0
Umari,Wheat(Husked),2016,1350,1550,200,14.814814814814815
Ramtek,Potato,2016,1800,2000,200,11.11111111111111
Sillod,Soybean,2015,3300,3500,200,6.0606060606060606
Sillod,GRAM,2016,7800,8000,200,2.5641025641025643
Umarkhed,Sorgum(Jawar),2015,1400,1600,200,14.285714285714286
Umarkhed,Sorgum(Jawar),2015,1400,1600,200,14.285714285714286
Amarawati-Fruit And Vegetables,BITTER GOURD,2016,2060,2260,200,9.70873786407767
Amarawati-Fruit And Vegetables,BEET ROOT,2016,1409,1609,200,14.194464158977999
Murbad,Paddy-Unhusked,2016,1450,1650,200,13.793103448275861
Murbad,Paddy-Unhusked,2016,1450,1650,200,13.793103448275861
Murbad,Paddy-Unhusked,2016,1450,1650,200,13.793103448275861
Murbad,Paddy-Unhusked,2016,1450,1650,200,13.793103448275861
Murbad,Paddy-Unhusked,2016,1450,1650,200,13.793103448275861
Murbad,Paddy-Unhusked,2016,1450,1650,200,13.793103448275861
Sillod,Castor Seed,2016,2700,2900,200,7.407407407407407
Kada (Ashti),Maize,2015,1100,1300,200,18.181818181818183
Kada (Ashti),Gram,2015,3000,3200,200,6.666666666666667
Ramtek,Squash Gourd,2015,1800,2000,200,11.11111111111111
Murtizapur,Sunflower,2014,2649,2849,200,7.550018875047187
Kada,Maize,2016,1300,1500,200,15.384615384615385
Sillod,Castor Seed,2016,3000,3200,200,6.666666666666667
Umarkhed,Wheat(Husked),2015,1400,1600,200,14.285714285714286
Kada,Sunflower,2015,3300,3500,200,6.0606060606060606
Umarkhed,Wheat(Husked),2015,1400,1600,200,14.285714285714286
Sillod,BLACK GRAM,2016,5900,6100,200,3.389830508474576
Amarawati-Fruit And Vegetables,Beet Root,2016,1038,1238,200,19.26782273603083
Umarkhed,Gram,2015,2900,3100,200,6.896551724137931
Amarawati-Fruit And Vegetables,Bitter Gourd,2016,2820,3020,200,7.092198581560283
Amarawati,Pumpkin,2016,914,1114,200,21.88183807439825
Amarawati,Pumpkin,2016,1286,1486,200,15.552099533437014
Amarawati,Pumpkin,2016,1155,1355,200,17.316017316017316
Amarawati,Pumpkin,2016,1027,1227,200,19.474196689386563
Amarawati,Pumpkin,2016,867,1067,200,23.06805074971165
Sillod,Wheat(Husked),2015,1300,1500,200,15.384615384615385
Kalamb (Os),Black Gram,2015,5307,5507,200,3.7686074995289243
Amarawati-Fruit And Vegetables,Cabbage,2016,731,931,200,27.359781121751027
Ramtek,Bitter Gourd,2016,1914,2114,200,10.449320794148381
Umarkhed,Wheat(Husked),2014,1400,1600,200,14.285714285714286
Umarkhed,Gram,2015,2900,3100,200,6.896551724137931
Umarkhed,Wheat(Husked),2014,1500,1700,200,13.333333333333334
Amarawati-Fruit And Vegetables,Bitter Gourd,2016,3000,3200,200,6.666666666666667
Umarkhed,Wheat(Husked),2015,1400,1600,200,14.285714285714286
Amarawati-Fruit And Vegetables,Beet Root,2016,1100,1300,200,18.181818181818183
Ramtek,Potato,2015,1000,1200,200,20.0
Amarawati-Fruit And Vegetables,Beet Root,2016,900,1100,200,22.22222222222222
Umarkhed,Wheat(Husked),2014,1400,1600,200,14.285714285714286
Ramtek,Raddish,2015,815,1015,200,24.539877300613497
Amarawati-Fruit And Vegetables,Beet Root,2016,1580,1780,200,12.658227848101266
Amarawati-Fruit And Vegetables,GREEN CHILLI,2016,1404,1604,200,14.245014245014245
Amarawati-Fruit And Vegetables,Green-Peas,2016,1757,1957,200,11.383039271485487
Amarawati-Fruit And Vegetables,Green-Peas,2016,1886,2086,200,10.604453870625663
Murbad,Bitter Gourd,2015,2186,2386,200,9.149130832570906
Sillod,Safflower,2016,3000,3200,200,6.666666666666667
Nagpur,Bottle Gourd,2014,723,923,200,27.662517289073307
Nagpur,Bottle Gourd,2014,685,885,200,29.197080291970803
Umarga,Sesamum,2015,6200,6400,200,3.225806451612903
Nagpur,Beet Root,2014,968,1168,200,20.66115702479339
Jawala-Bajar,Wheat(Husked),2016,1750,1950,200,11.428571428571429
Ramtek,Maize(Corn.),2016,800,1000,200,25.0
Ramtek,Lemon,2016,1800,2000,200,11.11111111111111
Solapur,Rajgira,2014,300,500,200,66.66666666666667
Amarawati,Coriander  ,2016,1200,1400,200,16.666666666666668
Umarkhed-Danki,Sorgum(Jawar),2015,1400,1600,200,14.285714285714286
Sillod,Pigeon Pea (Tur),2016,6800,7000,200,2.9411764705882355
Ramtek,Bottle Gourd,2015,1950,2150,200,10.256410256410257
Kalamb (Yawatmal),Soybean,2016,3100,3300,200,6.451612903225806
Amarawati,Cucumber,2016,1960,2160,200,10.204081632653061
Amarawati-Fruit And Vegetables,Tomato,2016,1143,1343,200,17.497812773403325
Amarawati-Fruit And Vegetables,Tomato,2016,800,1000,200,25.0
Mumbai-Fruit Market,Melon,2016,2100,2300,200,9.523809523809524
Kalamb (Yawatmal),Pigeon Pea (Tur),2016,5800,6000,200,3.4482758620689653
Parshiwani,Paddy-Unhusked,2016,2000,2200,200,10.0
Mumbai-Fruit Market,Orange,2016,1588,1788,200,12.594458438287154
Ambad(Vadi Godri),Wheat(Husked),2015,1575,1775,200,12.698412698412698
Amarawati,Carrot,2016,1764,1964,200,11.337868480725623
Amarawati,Carrot,2016,2082,2282,200,9.606147934678194
Sillod,Gram,2015,3800,4000,200,5.2631578947368425
Sillod,Sugarcane,2016,2800,3000,200,7.142857142857143
Kalmeshwar,Walvad,2014,2138,2338,200,9.354536950420954
Ramtek,Potato,2016,1800,2000,200,11.11111111111111
Ramtek,Potato,2016,1818,2018,200,11.001100110011
Nagpur,Flower,2014,835,1035,200,23.952095808383234
Sillod,Soybean,2016,3388,3588,200,5.903187721369539
Amarawati,Brinjal,2016,971,1171,200,20.597322348094746
Amarawati,Brinjal,2016,1710,1910,200,11.695906432748538
Sillod,Gram,2015,3800,4000,200,5.2631578947368425
Kalmeshwar,Flower,2014,1235,1435,200,16.194331983805668
Nagpur,Cabbage,2014,642,842,200,31.152647975077883
Ramtek,POTATO,2016,1775,1975,200,11.267605633802816
Jawala-Bajar,Sorgum(Jawar),2016,1400,1600,200,14.285714285714286
Nagpur,Chavli (Pala),2014,854,1054,200,23.4192037470726
Nagpur,Carrot,2014,1000,1200,200,20.0
Rajura,Cotton,2016,4300,4500,200,4.651162790697675
Amarawati,Capsicum,2016,1900,2100,200,10.526315789473685
Amarawati,Capsicum,2016,2533,2733,200,7.895775759968417
Ramtek,Melon,2016,1000,1200,200,20.0
Mumbai-Fruit Market,BANANA,2016,1000,1200,200,20.0
Jintur,Gram,2015,4200,4400,200,4.761904761904762
Ramtek,Jack Fruit,2016,800,1000,200,25.0
Sillod,Other Spices,2016,5800,6000,200,3.4482758620689653
Murbad,Ladies Finger,2014,3600,3800,200,5.555555555555555
Amarawati,Harbara(Pendi),2016,1000,1200,200,20.0
Murbad,Brinjal,2014,2233,2433,200,8.956560680698612
Murbad,Capsicum,2014,2500,2700,200,8.0
Umarkhed-Danki,Gram,2014,2900,3100,200,6.896551724137931
Amarawati-Fruit And Vegetables,Methi (Bhaji),2016,2229,2429,200,8.972633467922835
Amarawati-Fruit And Vegetables,Methi (Bhaji),2016,3000,3200,200,6.666666666666667
Amarawati-Fruit And Vegetables,Methi (Bhaji),2016,1100,1300,200,18.181818181818183
Amarawati-Fruit And Vegetables,Melon,2016,1800,2000,200,11.11111111111111
Amarawati-Fruit And Vegetables,Melon,2016,600,800,200,33.333333333333336
Ramtek,DHEMSE,2016,1867,2067,200,10.712372790573111
Sillod,Safflower,2015,1900,2100,200,10.526315789473685
Amarawati-Fruit And Vegetables,Ladies Finger,2016,1867,2067,200,10.712372790573111
Umarkhed,Soybean,2016,3600,3800,200,5.555555555555555
Amarawati,Ladies Finger,2016,3169,3369,200,6.311139160618492
Amarawati,Ladies Finger,2016,2860,3060,200,6.993006993006993
Amarawati,Ladies Finger,2016,2453,2653,200,8.153281695882592
Umarkhed,Soybean,2016,3486,3686,200,5.737234652897303
Amarawati,Ladies Finger,2016,1967,2167,200,10.167768174885612
Sillod,Safflower,2015,2000,2200,200,10.0
Murbad,Bitter Gourd,2015,3604,3804,200,5.549389567147614
Murbad,Brinjal,2014,1500,1700,200,13.333333333333334
Amarawati,Green-Peas,2016,1787,1987,200,11.19194180190263
Sillod,Mustard,2016,3025,3225,200,6.6115702479338845
Amarawati-Fruit And Vegetables,Pumpkin,2016,800,1000,200,25.0
Amarawati,Dhemse,2016,2133,2333,200,9.376465072667605
Amarawati,Dhemse,2016,973,1173,200,20.554984583761563
Amarawati,Flower,2016,3100,3300,200,6.451612903225806
Amarawati,Flower,2016,800,1000,200,25.0
Ramtek,Brinjal,2015,629,829,200,31.79650238473768
Amarawati,Flower,2016,1200,1400,200,16.666666666666668
Pune,Nolkol,2015,500,700,200,40.0
Umarkhed-Danki,Gram,2015,2900,3100,200,6.896551724137931
Umarkhed-Danki,Gram,2015,2900,3100,200,6.896551724137931
Mumbai-Fruit Market,Water Melon,2016,888,1088,200,22.52252252252252
Jintur,Safflower,2016,2200,2400,200,9.090909090909092
Ramtek,Ground Nut Pods (Dry),2016,2800,3000,200,7.142857142857143
Murum,PIGEON PEA (TUR),2016,5448,5648,200,3.671071953010279
Sillod,Mustard,2015,2300,2500,200,8.695652173913043
Sillod,Mustard,2016,3167,3367,200,6.315124723713294
Ramtek,Capsicum,2015,829,1029,200,24.125452352231605
Amarawati-Fruit And Vegetables,Papai,2016,600,800,200,33.333333333333336
Umarkhed-Danki,Wheat(Husked),2014,1425,1625,200,14.035087719298245
Umarkhed-Danki,Wheat(Husked),2014,1400,1600,200,14.285714285714286
Murbad,Bottle Gourd,2014,800,1000,200,25.0
Rahuri,Wheat(Husked),2016,1400,1600,200,14.285714285714286
Amarawati,Beet Root,2015,2800,3000,200,7.142857142857143
Shrirampur,Papai,2014,965,1165,200,20.72538860103627
Jafrabad,Sorgum(Jawar),2016,900,1100,200,22.22222222222222
Mumbai,Beet Root,2015,700,900,200,28.571428571428573
Jafrabad,Gram,2016,3875,4075,200,5.161290322580645
Rahata,Papai,2016,550,750,200,36.36363636363637
Jafrabad,Green Gram,2016,4275,4475,200,4.678362573099415
Jafrabad,Green Gram,2016,4500,4700,200,4.444444444444445
Jafrabad,Maize,2016,1200,1400,200,16.666666666666668
Aurangabad,Math (Bhaji),2014,500,700,200,40.0
Shrirampur,Cucumber,2015,962,1162,200,20.79002079002079
Jafrabad,Pigeon Pea (Tur),2016,7400,7600,200,2.7027027027027026
Jafrabad,Soybean,2016,3300,3500,200,6.0606060606060606
Akole,Maize,2015,1400,1600,200,14.285714285714286
Jafrabad,Wheat(Husked),2016,1500,1700,200,13.333333333333334
Jafrabad,Wheat(Husked),2016,1333,1533,200,15.003750937734434
Shrirampur,Cucumber,2015,779,979,200,25.673940949935815
Mumbai,Cabbage,2015,578,778,200,34.602076124567475
Jalgaon,Papai,2014,1357,1557,200,14.738393515106853
Mumbai,Cabbage,2015,571,771,200,35.02626970227671
Jalgaon,Pigeon Pea (Tur),2014,3800,4000,200,5.2631578947368425
Ratanagari,Potato,2016,1500,1700,200,13.333333333333334
Sinner,Rice(Paddy-Hus),2016,1300,1500,200,15.384615384615385
Jafrabad,Cotton,2016,4179,4379,200,4.785833931562575
Jafrabad,Cotton,2016,4100,4300,200,4.878048780487805
Jafrabad,Pigeon Pea (Tur),2015,4850,5050,200,4.123711340206185
Akole,Soybean,2014,3000,3200,200,6.666666666666667
Akole,Gram,2014,3000,3200,200,6.666666666666667
Jafrabad,Sorgum(Jawar),2015,900,1100,200,22.22222222222222
Jafrabad,Sorgum(Jawar),2015,950,1150,200,21.05263157894737
Solapur,SPINACH,2016,100,300,200,200.0
Jafrabad,Sorgum(Jawar),2015,1000,1200,200,20.0
Kej,Green Gram,2015,7020,7220,200,2.849002849002849
Jafrabad,Sorgum(Jawar),2015,950,1150,200,21.05263157894737
Nagpur,Ghosali(Bhaji),2016,900,1100,200,22.22222222222222
Jafrabad,Sorgum(Jawar),2015,900,1100,200,22.22222222222222
Jafrabad,Soybean,2015,3206,3406,200,6.238303181534622
Akole,Gram,2015,3100,3300,200,6.451612903225806
Umared,Sorgum(Jawar),2016,1857,2057,200,10.770059235325794
Jafrabad,Soybean,2015,3467,3667,200,5.768676088837612
Aurangabad,Awala,2015,1600,1800,200,12.5
Jafrabad,Soybean,2015,3333,3533,200,6.0006000600060005
Jafrabad,Wheat(Husked),2015,1207,1407,200,16.570008285004143
Jafrabad,Wheat(Husked),2015,1367,1567,200,14.630577907827359
Rahata,Lemon,2016,3250,3450,200,6.153846153846154
Aurangabad,Sweet Potato,2014,1000,1200,200,20.0
Jafrabad,Wheat(Husked),2015,1379,1579,200,14.5032632342277
Karanja,Bajri,2015,1575,1775,200,12.698412698412698
Nagpur,Capsicum,2016,1040,1240,200,19.23076923076923
Nagpur,Cabbage,2016,420,620,200,47.61904761904762
Shrirampur,Cabbage,2015,550,750,200,36.36363636363637
Karad,Potato,2015,1000,1200,200,20.0
Karad,Lemon,2015,800,1000,200,25.0
Karad,Flower,2015,600,800,200,33.333333333333336
Nagpur,Small Gourd,2015,954,1154,200,20.964360587002098
Nagpur,Small Gourd,2015,1196,1396,200,16.722408026755854
Shrirampur,Cabbage,2015,500,700,200,40.0
Shrirampur,Cabbage,2015,373,573,200,53.61930294906166
Shrirampur,Cabbage,2015,420,620,200,47.61904761904762
Shrirampur,Cabbage,2015,463,663,200,43.196544276457885
Shrirampur,Cabbage,2015,648,848,200,30.864197530864196
Nagpur,CHAVLI (PALA),2016,625,825,200,32.0
Kalyan,Banana(Raw),2015,2300,2500,200,8.695652173913043
Shrirampur,Cabbage,2015,300,500,200,66.66666666666667
Nagpur,Raddish,2015,640,840,200,31.25
Nagpur,Raddish,2015,696,896,200,28.735632183908045
Nagpur,Pumpkin,2015,567,767,200,35.27336860670194
Nagpur,Pumpkin,2015,684,884,200,29.239766081871345
Karad,Brinjal,2015,700,900,200,28.571428571428573
Shrirampur,Cabbage,2015,609,809,200,32.84072249589491
Karad,Bottle Gourd,2015,611,811,200,32.733224222585925
Nagpur,Spinach,2015,688,888,200,29.069767441860463
Nagpur,Sweet Potato,2015,800,1000,200,25.0
Nagpur,Ambat Chuka,2016,800,1000,200,25.0
Nagpur,BEET ROOT,2016,800,1000,200,25.0
Atpadi,Sorgum(Jawar),2016,1700,1900,200,11.764705882352942
Karad,Water Melon,2016,800,1000,200,25.0
Atpadi,Maize,2016,1700,1900,200,11.764705882352942
Karad,Water Melon,2016,650,850,200,30.76923076923077
Atpadi,Maize,2016,1400,1600,200,14.285714285714286
Atpadi,Bajri,2016,1600,1800,200,12.5
Nagpur,Brinjal,2016,300,500,200,66.66666666666667
Atpadi,BAJRI,2016,1600,1800,200,12.5
Atpadi,Sorgum(Jawar),2015,1700,1900,200,11.764705882352942
Atpadi,Sorgum(Jawar),2015,1850,2050,200,10.81081081081081
Nagpur,Bottle Gourd,2016,455,655,200,43.956043956043956
Atpadi,Maize,2015,1400,1600,200,14.285714285714286
Atpadi,Maize,2015,1400,1600,200,14.285714285714286
Atpadi,Bajri,2014,1500,1700,200,13.333333333333334
Nagpur,Beet Root,2016,965,1165,200,20.72538860103627
Karad,Sweet Potato,2015,1000,1200,200,20.0
Karad,Squash Gourd,2015,800,1000,200,25.0
Karad,Snake Gourd,2015,1000,1200,200,20.0
Nagpur,BOTTLE GOURD,2016,611,811,200,32.733224222585925
Jafrabad,Pigeon Pea (Tur),2015,4400,4600,200,4.545454545454546
Jafrabad,Maize,2015,1150,1350,200,17.391304347826086
Shrirampur,Cabbage,2015,619,819,200,32.31017770597738
Vaduj,Bajri,2015,1467,1667,200,13.6332651670075
Rahata,Potato,2015,800,1000,200,25.0
Rahata,Potato,2015,789,989,200,25.34854245880862
Naigaon,Pigeon Pea (Tur),2016,6600,6800,200,3.0303030303030303
Aurangabad,Papai,2016,300,500,200,66.66666666666667
Hingoli,Gram,2016,4134,4334,200,4.837929366231253
Aurangabad,Math (Bhaji),2016,500,700,200,40.0
Sailu,Soybean,2015,3270,3470,200,6.116207951070336
Rahata,Small Gourd,2015,1820,2020,200,10.989010989010989
Solapur,Goosefoot,2015,150,350,200,133.33333333333334
Khed (Shel Pimpalgaon),Bitter Gourd,2014,600,800,200,33.333333333333336
Aurangabad,Spinach,2016,250,450,200,80.0
Vaduj,Ghevda Seed,2014,3678,3878,200,5.43773790103317
Aurangabad,Carrot,2016,578,778,200,34.602076124567475
Nagpur,Tomato,2016,743,943,200,26.917900403768506
Indapur,Pigeon Pea (Tur),2015,3100,3300,200,6.451612903225806
Nagpur,Raddish,2016,813,1013,200,24.600246002460025
Nagpur,RADDISH,2016,650,850,200,30.76923076923077
Nagpur,Pumpkin,2016,600,800,200,33.333333333333336
Aurangabad,Bajri,2016,1550,1750,200,12.903225806451612
Indapur,Jaggery,2016,3200,3400,200,6.25
Vaduj,Ghevda Seed,2015,2400,2600,200,8.333333333333334
Vaduj,Gram,2015,3700,3900,200,5.405405405405405
Jafrabad,Gram,2015,3563,3763,200,5.613247263541959
Sillod-Bharadi,Soybean,2016,3613,3813,200,5.535566011624689
Hadgaon-Tamsa,Soybean,2015,3336,3536,200,5.995203836930456
Hadgaon-Tamsa,SOYBEAN,2016,2800,3000,200,7.142857142857143
Morshi,Gram,2015,3913,4113,200,5.111167901865576
Sillod-Bharadi,Soybean,2016,3067,3267,200,6.521030322791001
Morshi,Pigeon Pea (Tur),2015,7038,7238,200,2.841716396703609
Morshi,Pigeon Pea (Tur),2015,6988,7188,200,2.862049227246709
Hadgaon-Tamsa,Soybean,2016,2800,3000,200,7.142857142857143
Hadgaon-Tamsa,Wheat(Husked),2016,1600,1800,200,12.5
Pune-Manjri,Lemon,2016,400,600,200,50.0
Hingna,Gram,2015,3500,3700,200,5.714285714285714
Nampur,Green Gram,2016,3700,3900,200,5.405405405405405
Morshi,Green Gram,2016,5000,5200,200,4.0
Sailu,Pigeon Pea (Tur),2016,7200,7400,200,2.7777777777777777
Morshi,Soybean,2016,3188,3388,200,6.273525721455458
Vaduj,Gram,2015,3300,3500,200,6.0606060606060606
Washim,Mustard,2014,3700,3900,200,5.405405405405405
Khed (Shel Pimpalgaon),Green Chilli,2015,2562,2762,200,7.8064012490242
Akluj,Wheat(Husked),2016,2001,2201,200,9.995002498750624
Washim,Mustard,2014,2800,3000,200,7.142857142857143
Aurangabad,Tomato,2016,396,596,200,50.505050505050505
Aurangabad,Sweet Potato,2015,1000,1200,200,20.0
Rahata,Sweet Potato,2015,2300,2500,200,8.695652173913043
Aurangabad,Spinach,2015,600,800,200,33.333333333333336
Shrirampur,Flower,2015,795,995,200,25.157232704402517
Aurangabad,Coriander  ,2015,300,500,200,66.66666666666667
Aurangabad,Carrot,2015,1800,2000,200,11.11111111111111
Indapur-Bhigwan,Sunflower,2016,3011,3211,200,6.642311524410495
Aurangabad,Carrot,2015,667,867,200,29.985007496251875
Nagpur,Green Gram,2016,5800,6000,200,3.4482758620689653
Shrirampur,Flower,2015,575,775,200,34.78260869565217
Shrirampur,Flower,2015,457,657,200,43.7636761487965
Nagpur,Green Gram,2016,5800,6000,200,3.4482758620689653
Shrirampur,Flower,2015,413,613,200,48.426150121065376
Aurangabad,Cabbage,2015,400,600,200,50.0
Rahata,Sweet Potato,2015,1300,1500,200,15.384615384615385
Aurangabad,Cabbage,2015,364,564,200,54.94505494505494
Jafrabad,Soybean,2014,3008,3208,200,6.648936170212766
Shrirampur,Flower,2015,825,1025,200,24.242424242424242
Shrirampur,Flower,2015,450,650,200,44.44444444444444
Jafrabad,Wheat(Husked),2014,1400,1600,200,14.285714285714286
Jafrabad,Castor Seed,2015,2900,3100,200,6.896551724137931
Jafrabad,Gram,2015,3200,3400,200,6.25
Shrirampur,Flower,2015,413,613,200,48.426150121065376
Jafrabad,Gram,2015,3100,3300,200,6.451612903225806
Nagpur,Linseed,2016,4800,5000,200,4.166666666666667
Nagpur,Math (Bhaji),2016,1000,1200,200,20.0
Shrirampur,Flower,2015,496,696,200,40.32258064516129
Umared,Coriander (Dry),2016,7933,8133,200,2.5211143325349803
Indapur,Sesamum,2016,6600,6800,200,3.0303030303030303
Khamgaon,Sesamum,2016,5331,5531,200,3.7516413430876008
Aurangabad,Papai,2015,300,500,200,66.66666666666667
Nagpur,Papai,2016,493,693,200,40.56795131845842
Nagpur,Papai,2016,500,700,200,40.0
Murtizapur,Safflower,2015,2401,2601,200,8.329862557267806
Aurangabad,Melon,2015,600,800,200,33.333333333333336
Aurangabad,Melon,2015,600,800,200,33.333333333333336
Aurangabad,Math (Bhaji),2015,400,600,200,50.0
Aurangabad,Maize(Corn.),2015,544,744,200,36.76470588235294
Aurangabad,Maize(Corn.),2015,500,700,200,40.0
Indapur-Bhigwan,Coriander (Dry),2015,7000,7200,200,2.857142857142857
Indapur-Bhigwan,Horse Gram,2015,2800,3000,200,7.142857142857143
Rahata,Bor,2016,1000,1200,200,20.0
Khamgaon,Other Oil Seeds,2015,3000,3200,200,6.666666666666667
Nagpur,Nolkol,2016,700,900,200,28.571428571428573
Shrirampur,Ghosali(Bhaji),2015,500,700,200,40.0
Nagpur,Melon,2016,867,1067,200,23.06805074971165
Shrirampur,Flower,2015,419,619,200,47.7326968973747
Shrirampur,Cabbage,2015,506,706,200,39.52569169960474
Shrirampur,Cabbage,2015,570,770,200,35.08771929824562
Manchar,Pavtta,2015,4000,4200,200,5.0
Panvel,Brinjal,2015,2300,2500,200,8.695652173913043
Shrirampur,Water Melon,2014,818,1018,200,24.449877750611247
Kalyan,Apple,2016,1000,1200,200,20.0
Kalyan,Wheat(Husked),2015,2033,2233,200,9.837678307919331
Jalgaon Jamod-Aasalgaon,Maize,2015,1000,1200,200,20.0
Jalgaon Jamod-Aasalgaon,Sorgum(Jawar),2015,1257,1457,200,15.910898965791567
Jalgaon Jamod-Aasalgaon,Sorgum(Jawar),2015,1000,1200,200,20.0
Kalyan,Tomato,2015,1400,1600,200,14.285714285714286
Jalgaon Jamod-Aasalgaon,Sorgum(Jawar),2015,1129,1329,200,17.71479185119575
Panvel,Brinjal,2015,1100,1300,200,18.181818181818183
Kalyan,Bajri,2016,1750,1950,200,11.428571428571429
Kalyan,Squash Gourd,2015,600,800,200,33.333333333333336
Kalyan,Sorgum(Jawar),2015,2200,2400,200,9.090909090909092
Kalyan,Small Gourd,2015,2000,2200,200,10.0
Kalyan,Cabbage,2015,1000,1200,200,20.0
Amarawati,Math (Bhaji),2014,1345,1545,200,14.869888475836431
Panvel,Brinjal,2015,2200,2400,200,9.090909090909092
Kalyan,Cabbage,2015,757,957,200,26.42007926023778
Mumbai,BEET ROOT,2016,400,600,200,50.0
Jalgaon Jamod-Aasalgaon,Green Gram,2015,5875,6075,200,3.404255319148936
Panvel,Bottle Gourd,2015,600,800,200,33.333333333333336
Kalyan,Ridge Gourd,2015,4000,4200,200,5.0
Panvel,Bitter Gourd,2015,3200,3400,200,6.25
Jalgaon Jamod-Aasalgaon,Wheat(Husked),2014,1300,1500,200,15.384615384615385
Kalyan,Carrot,2016,1100,1300,200,18.181818181818183
Patan,BITTER GOURD,2016,1300,1500,200,15.384615384615385
Panvel,Bitter Gourd,2015,3129,3329,200,6.391818472355385
Kalyan,Bottle Gourd,2016,1138,1338,200,17.57469244288225
Panvel,Bitter Gourd,2015,3100,3300,200,6.451612903225806
Rahuri,Potato,2016,1800,2000,200,11.11111111111111
Panvel,Bitter Gourd,2015,3000,3200,200,6.666666666666667
Jalgaon Jamod-Aasalgaon,Wheat(Husked),2014,1317,1517,200,15.186028853454822
Kalyan,Bor,2016,1350,1550,200,14.814814814814815
Jalgaon Jamod-Aasalgaon,Green Gram,2015,5400,5600,200,3.7037037037037037
Panvel,Flower,2015,900,1100,200,22.22222222222222
Panvel,Flower,2015,800,1000,200,25.0
Mumbai,Beet Root,2016,800,1000,200,25.0
Panvel,Bottle Gourd,2015,1317,1517,200,15.186028853454822
Mumbai,Beet Root,2016,800,1000,200,25.0
Kalyan,Cabbage,2015,1000,1200,200,20.0
Shrirampur,Cabbage,2015,308,508,200,64.93506493506493
Kalyan,Shevga,2015,2000,2200,200,10.0
Kalyan,Ridge Gourd,2015,2200,2400,200,9.090909090909092
Jalgaon Jamod-Aasalgaon,Gram,2014,2020,2220,200,9.900990099009901
Kalyan,Ghevda,2015,1833,2033,200,10.911074740861975
Ratanagari,Green-Peas,2015,1000,1200,200,20.0
Jalgaon Jamod-Aasalgaon,Sunflower,2015,3000,3200,200,6.666666666666667
Panvel,Cucumber,2015,1450,1650,200,13.793103448275861
Amarawati,Black Gram,2014,5000,5200,200,4.0
Kalyan,Carrot,2015,1600,1800,200,12.5
Panvel,Cucumber,2015,1800,2000,200,11.11111111111111
Jalgaon Jamod-Aasalgaon,Wheat(Husked),2015,1313,1513,200,15.232292460015232
Kalyan,Indian Bean,2015,3800,4000,200,5.2631578947368425
Kalyan,Ghevda,2015,2400,2600,200,8.333333333333334
Mumbai,Squash Gourd,2015,878,1078,200,22.779043280182233
Panvel,Flower,2015,1800,2000,200,11.11111111111111
Jalgaon Jamod-Aasalgaon,Wheat(Husked),2015,1325,1525,200,15.09433962264151
Jalgaon Jamod-Aasalgaon,Wheat(Husked),2015,1243,1443,200,16.090104585679807
Kalyan,Cucumber,2015,1300,1500,200,15.384615384615385
Kalyan,Elephant Root,2015,1660,1860,200,12.048192771084338
Panvel,Flower,2015,1100,1300,200,18.181818181818183
Kalyan,Elephant Root,2015,1840,2040,200,10.869565217391305
Kalyan,Cucumber,2015,800,1000,200,25.0
Shrirampur,Potato,2014,1629,1829,200,12.277470841006753
Mumbai,Squash Gourd,2015,778,978,200,25.70694087403599
Kalyan,Capsicum,2015,2800,3000,200,7.142857142857143
Panvel,Cabbage,2015,767,967,200,26.07561929595828
Kalyan,Potato,2015,1000,1200,200,20.0
Panvel,Brinjal,2015,1950,2150,200,10.256410256410257
Kalyan,Potato,2015,500,700,200,40.0
Panvel,Brinjal,2015,2000,2200,200,10.0
Panvel,Brinjal,2015,1400,1600,200,14.285714285714286
Anajngaon Surji,Sunflower,2016,2800,3000,200,7.142857142857143
Jalgaon Jamod-Aasalgaon,Sorgum(Jawar),2015,1140,1340,200,17.54385964912281
Panvel,Cabbage,2015,1000,1200,200,20.0
Kalyan,Onion,2015,1450,1650,200,13.793103448275861
Mumbai,Squash Gourd,2015,729,929,200,27.434842249657063
Panvel,Cabbage,2015,600,800,200,33.333333333333336
Kalyan,Matki,2015,9000,9200,200,2.2222222222222223
Jalgaon Jamod-Aasalgaon,Soybean,2015,3080,3280,200,6.4935064935064934
Mumbai,ARVI,2016,1150,1350,200,17.391304347826086
Jalgaon Jamod-Aasalgaon,Soybean,2015,3129,3329,200,6.391818472355385
Jalgaon Jamod-Aasalgaon,Soybean,2015,3000,3200,200,6.666666666666667
Ratanagari,Green-Peas,2015,1000,1200,200,20.0
Mumbai,Squash Gourd,2015,417,617,200,47.961630695443645
Jalgaon Jamod-Aasalgaon,Gram,2014,2300,2500,200,8.695652173913043
Jalgaon Jamod-Aasalgaon,Maize,2014,1000,1200,200,20.0
Kalyan,Curry Leaves,2016,2500,2700,200,8.0
Alibag,Rice(Paddy-Hus),2015,1500,1700,200,13.333333333333334
Jalgaon Jamod,Soybean,2015,3100,3300,200,6.451612903225806
Alibag,Paddy-Unhusked,2015,1500,1700,200,13.333333333333334
Alibag,Paddy-Unhusked,2015,1500,1700,200,13.333333333333334
Jalgaon Jamod,Soybean,2015,2950,3150,200,6.779661016949152
Jalgaon Jamod,Soybean,2015,3100,3300,200,6.451612903225806
Mumbai,Horse Gram,2015,3000,3200,200,6.666666666666667
Alibag,Rice(Paddy-Hus),2015,1500,1700,200,13.333333333333334
Alibag,Rice(Paddy-Hus),2015,2203,2403,200,9.078529278256923
Pathardi,Pigeon Pea (Tur),2014,4800,5000,200,4.166666666666667
Jalgaon Jamod,Soybean,2015,3100,3300,200,6.451612903225806
Alibag,Rice(Paddy-Hus),2015,1500,1700,200,13.333333333333334
Alibag,Rice(Paddy-Hus),2015,1500,1700,200,13.333333333333334
Alibag,Rice(Paddy-Hus),2015,3172,3372,200,6.305170239596469
Kannad,Gram,2015,3300,3500,200,6.0606060606060606
Shrirampur,Bottle Gourd,2015,465,665,200,43.01075268817204
Shrirampur,Bottle Gourd,2015,690,890,200,28.985507246376812
Shrirampur,Bottle Gourd,2015,671,871,200,29.806259314456035
Anajngaon Surji,Banana,2016,988,1188,200,20.242914979757085
Jalgaon Jamod-Aasalgaon,Wheat(Husked),2015,1314,1514,200,15.220700152207002
Jalgaon Jamod,Sorgum(Jawar),2015,1200,1400,200,16.666666666666668
Jalgaon Jamod,Soybean,2015,3000,3200,200,6.666666666666667
Alibag,Rice(Paddy-Hus),2014,1500,1700,200,13.333333333333334
Jalgaon Jamod,Gram,2014,2050,2250,200,9.75609756097561
Shrirampur,Papai,2014,571,771,200,35.02626970227671
Kalyan,Bijli,2015,2000,2200,200,10.0
Pathardi,Cotton,2015,4050,4250,200,4.938271604938271
Kannad,Gram,2016,3700,3900,200,5.405405405405405
Jalgaon Jamod,Pigeon Pea (Tur),2014,4400,4600,200,4.545454545454546
Alibag,Rice(Paddy-Hus),2014,1500,1700,200,13.333333333333334
Alibag,Rice(Paddy-Hus),2014,1500,1700,200,13.333333333333334
Panvel,Ghosali(Bhaji),2015,2350,2550,200,8.51063829787234
Shrirampur,Papai,2014,542,742,200,36.90036900369004
Nagpur,Math (Bhaji),2015,2167,2367,200,9.229349330872173
Alibag,Rice(Paddy-Hus),2014,1500,1700,200,13.333333333333334
Jalgaon Jamod,Soybean,2014,2900,3100,200,6.896551724137931
Jalgaon Jamod,Wheat(Husked),2014,1314,1514,200,15.220700152207002
Jalgaon Jamod,Pigeon Pea (Tur),2015,4067,4267,200,4.917629702483403
Alibag,Paddy-Unhusked,2015,1478,1678,200,13.531799729364005
Alibag,Paddy-Unhusked,2015,1500,1700,200,13.333333333333334
Jalgaon Jamod,Sorgum(Jawar),2015,1300,1500,200,15.384615384615385
Sillod-Bharadi,Maize,2016,1360,1560,200,14.705882352941176
Armori-Desaiganj,Paddy-Unhusked,2015,1596,1796,200,12.531328320802006
Jalgaon Jamod,Soybean,2015,3050,3250,200,6.557377049180328
Kalyan,Indian Bean,2016,7600,7800,200,2.6315789473684212
Shrirampur,Bottle Gourd,2015,544,744,200,36.76470588235294
Shrirampur,Bottle Gourd,2015,725,925,200,27.586206896551722
Shrirampur,Bottle Gourd,2015,640,840,200,31.25
Shrirampur,Bottle Gourd,2015,521,721,200,38.38771593090211
Jalgaon Jamod,Maize,2016,1100,1300,200,18.181818181818183
Jalgaon Jamod,Maize,2016,1400,1600,200,14.285714285714286
Jalgaon Jamod,Maize,2016,1100,1300,200,18.181818181818183
Jalgaon Jamod,Maize,2016,1150,1350,200,17.391304347826086
Panvel,Ghosali(Bhaji),2014,1757,1957,200,11.383039271485487
Jalgaon Jamod,Maize,2016,1100,1300,200,18.181818181818183
Jalgaon Jamod,Maize,2016,1000,1200,200,20.0
Panvel,Snake Gourd,2014,2420,2620,200,8.264462809917354
Jalgaon Jamod,Sorgum(Jawar),2016,1400,1600,200,14.285714285714286
Jalgaon Jamod,Sorgum(Jawar),2016,1200,1400,200,16.666666666666668
Jalgaon Jamod,Wheat(Husked),2016,1450,1650,200,13.793103448275861
Nagpur,Paddy-Unhusked,2015,1600,1800,200,12.5
Shrirampur,Bottle Gourd,2015,783,983,200,25.54278416347382
Jalgaon Jamod,Green Gram,2016,4400,4600,200,4.545454545454546
Nagpur,Parwar,2015,709,909,200,28.208744710860366
Nagpur,Parwar,2015,731,931,200,27.359781121751027
Panvel,Cucumber,2014,1757,1957,200,11.383039271485487
Umarga,Wheat(Unhusked),2014,3017,3217,200,6.629101756711965
Shrirampur,Bottle Gourd,2015,490,690,200,40.816326530612244
Shrirampur,Bottle Gourd,2015,500,700,200,40.0
Kalyan,Bottle Gourd,2015,1000,1200,200,20.0
Jalgaon Jamod,Wheat(Husked),2015,1300,1500,200,15.384615384615385
Kalyan,Tomato,2016,1140,1340,200,17.54385964912281
Kalyan,Tomato,2016,750,950,200,26.666666666666668
Kalyan,Elephant Root,2015,1600,1800,200,12.5
Shrirampur,Bottle Gourd,2015,767,967,200,26.07561929595828
Kalyan,Brinjal,2015,2000,2200,200,10.0
Jalgaon Jamod,Gram,2016,3750,3950,200,5.333333333333333
Shrirampur,Bottle Gourd,2015,710,910,200,28.169014084507044
Jalgaon Jamod,Gram,2016,3400,3600,200,5.882352941176471
Kalyan,Potato,2016,1180,1380,200,16.949152542372882
Lasalgaon,Sunflower,2016,2901,3100,199,6.859703550499828
Telhara,Soybean,2015,3223,3422,199,6.174371703381942
Solapur,Gram,2015,4220,4419,199,4.7156398104265405
Ausa,Safflower,2015,2654,2853,199,7.498116051243406
Sillod-Bharadi,Wheat(Husked),2016,1500,1699,199,13.266666666666667
Shirpur,Maize,2014,929,1128,199,21.420882669537136
Hingna,Gram,2015,2801,3000,199,7.104605498036416
Sailu,Soybean,2016,3440,3639,199,5.784883720930233
Hingoli,Green Gram,2016,5001,5200,199,3.9792041591681664
Shegaon,Mustard,2015,3206,3405,199,6.207111665626949
Jamner-Neri,Maize,2016,1420,1619,199,14.014084507042254
Manmad,Bajri,2015,1193,1392,199,16.680637049455154
Sangamner,Wheat(Husked),2016,1737,1936,199,11.456534254461715
Rahata,Gram,2016,3940,4139,199,5.050761421319797
Sangamner,Soybean,2016,3427,3626,199,5.806828129559381
Washim-Ansing,Soybean,2016,3673,3872,199,5.417914511298666
Sangali,Bajri,2016,1519,1718,199,13.100724160631994
Digras,Gram,2015,3152,3351,199,6.313451776649746
Majalgaon,Wheat(Husked),2014,1319,1518,199,15.08718726307809
Pathardi,Bajri,2016,1283,1482,199,15.510522213561964
Karanja,Sorgum(Jawar),2014,1409,1608,199,14.123491838183108
Nandura,Wheat(Husked),2015,1377,1576,199,14.451706608569353
Baramati,Jaggery,2015,2426,2625,199,8.20280296784831
Ambejogai,Sorgum(Jawar),2014,2059,2258,199,9.664885866925692
Ambejogai,Black Gram,2016,6001,6200,199,3.3161139810031663
Dondaicha-Sindkheda,Gram,2016,3884,4083,199,5.123583934088568
Palghar(Bevur),Potato,2016,1004,1203,199,19.820717131474105
Dondaicha-Sindkheda,Bajri,2016,1435,1634,199,13.867595818815332
Udgir,Green Gram,2015,7062,7261,199,2.8178986122911356
Jafrabad,Maize,2015,1080,1279,199,18.425925925925927
Pathari,Bajri,2016,1351,1550,199,14.72982975573649
Kille Dharur,Wheat(Husked),2016,1935,2134,199,10.28423772609819
Jintur-Bori,Wheat(Husked),2014,1400,1599,199,14.214285714285714
Dhule,Cowpea,2014,3362,3561,199,5.9190957763236165
Jalna,Wheat(Husked),2015,1563,1762,199,12.731925783749201
Jalna,Neem-Seed,2015,538,737,199,36.98884758364312
Bhokar,Soybean,2016,3459,3658,199,5.753107834634287
Parli-Vaijnath,Soybean,2015,3699,3898,199,5.379832387131657
Bhokar,Sorgum(Jawar),2016,1318,1517,199,15.098634294385432
Jalna,Cotton,2014,3994,4193,199,4.9824737105658485
Sinner,Pigeon Pea (Tur),2014,3123,3322,199,6.372078130003202
Vaijapur,Wheat(Husked),2015,1407,1606,199,14.143567874911158
Devala,Green Gram,2014,7770,7969,199,2.561132561132561
Bhiwapur,COTTON,2016,4650,4849,199,4.279569892473118
Chikhali,Wheat(Husked),2014,1446,1645,199,13.76210235131397
Indapur,Banana,2015,601,800,199,33.11148086522463
Satana,Maize,2015,1290,1488,198,15.348837209302326
Sangamner,Bajri,2015,1411,1609,198,14.032600992204111
Rahuri-Vambori,Bajri,2015,1300,1498,198,15.23076923076923
Sangamner,Wheat(Husked),2016,1712,1910,198,11.565420560747663
Aamgaon,Paddy-Unhusked,2014,1645,1843,198,12.036474164133738
Parli-Vaijnath,Sorgum(Jawar),2015,1422,1620,198,13.924050632911392
Jamkhed,Gram,2015,3688,3886,198,5.368763557483731
Chandrapur,Soybean,2016,3344,3542,198,5.921052631578948
Mumbai,Cucumber,2016,575,773,198,34.43478260869565
Manora,Wheat(Husked),2016,1594,1792,198,12.421580928481808
Solapur,Sorgum(Jawar),2016,1804,2002,198,10.975609756097562
Chimur,Paddy-Unhusked,2015,1803,2001,198,10.98169717138103
Nandura,Sesamum,2015,6595,6793,198,3.0022744503411674
Majalgaon,Sunflower,2014,2751,2949,198,7.1973827699018535
Vaijapur,Sorgum(Jawar),2015,1292,1490,198,15.325077399380804
Ner Parasopant,Soybean,2015,3384,3582,198,5.851063829787234
Kalmeshwar,Flower,2016,594,792,198,33.333333333333336
Akot,Soybean,2015,3344,3542,198,5.921052631578948
Manchar,Bottle Gourd,2015,449,647,198,44.097995545657014
Kalmeshwar,Raddish,2015,614,812,198,32.24755700325733
Mandhal,Soybean,2015,3367,3565,198,5.880605880605881
Nagpur,Tomato,2015,1542,1740,198,12.84046692607004
Kalmeshwar,Walvad,2016,1038,1236,198,19.07514450867052
Baramati,Jaggery,2016,2453,2651,198,8.071748878923767
Partur,Wheat(Husked),2015,1462,1660,198,13.543091655266759
Murtizapur,Wheat(Husked),2016,1426,1624,198,13.884992987377279
Chandur Bajar,Sorgum(Jawar),2016,1305,1503,198,15.172413793103448
Amarawati,Bajri,2015,1610,1808,198,12.298136645962733
Kalyan,Cabbage,2015,792,990,198,25.0
Chopda,Sunflower,2014,2575,2773,198,7.689320388349515
Mumbai,Green Peas (Dry),2015,2631,2829,198,7.525655644241733
Himayatnagar,Cotton,2016,4329,4527,198,4.573804573804574
Yeotmal,Cotton,2014,3758,3956,198,5.2687599787120805
Jintur,Sorgum(Jawar),2016,1621,1819,198,12.214682294879704
Jintur,Sorgum(Jawar),2016,1519,1717,198,13.0348913759052
Ahmedpur,Sunflower,2015,3572,3770,198,5.543113101903695
Nilanga,Sorgum(Jawar),2015,1130,1328,198,17.52212389380531
Digras,Soybean,2014,3044,3242,198,6.504599211563732
Kannad,Pigeon Pea (Tur),2015,4662,4860,198,4.2471042471042475
Kalamb (Os),Bajri,2014,1393,1591,198,14.213926776740847
Nagpur,Tomato,2014,842,1040,198,23.51543942992874
Parbhani,Pigeon Pea (Tur),2016,6075,6273,198,3.259259259259259
Paithan,Gram,2016,4008,4206,198,4.940119760479042
Nagpur,Cabbage,2016,309,507,198,64.07766990291262
Jafrabad,Cotton,2016,4179,4377,198,4.737975592246949
Nandura,Maize,2015,1009,1207,198,19.62338949454906
Pulgaon,Pigeon Pea (Tur),2015,6751,6949,198,2.9328988298029923
Ner Parasopant,Soybean,2014,2958,3156,198,6.693711967545639
Dhule,Sorgum(Jawar),2015,1319,1516,197,14.935557240333585
Nagpur,Cabbage,2014,838,1035,197,23.50835322195704
Himayatnagar,Pigeon Pea (Tur),2016,7877,8074,197,2.500952139139266
Kalmeshwar,Brinjal,2016,332,529,197,59.33734939759036
Mantha,Green Gram,2016,4562,4759,197,4.318281455501973
Umarga,Sunflower,2015,3436,3633,197,5.733410942956927
Kannad,Bajri,2016,1474,1671,197,13.364993215739485
Amalner,Gram,2016,4881,5078,197,4.036058184798197
Chopda,Maize,2014,924,1121,197,21.32034632034632
Kalyan,Elephant Root,2016,2207,2404,197,8.926144086995922
Gangapur,Wheat(Husked),2015,1516,1713,197,12.994722955145118
Solapur,Papai,2016,965,1162,197,20.414507772020727
Aurangabad,Cabbage,2015,348,545,197,56.60919540229885
Dhadgaon,Bhagar/Vari,2016,1503,1700,197,13.107119095143048
Anajngaon Surji,Sorgum(Jawar),2015,1327,1524,197,14.845516201959306
Pune-Pimpri,Onion,2016,684,881,197,28.801169590643276
Pune-Manjri,Cabbage,2016,316,513,197,62.34177215189873
Yeotmal,Black Gram,2016,6496,6693,197,3.0326354679802954
Sinner,Soybean,2016,3552,3749,197,5.546171171171171
Chalisgaon,SORGUM(JAWAR),2016,1080,1277,197,18.24074074074074
Jafrabad,Soybean,2014,3024,3221,197,6.514550264550264
Manmad,Cluster Bean,2016,460,657,197,42.82608695652174
Chandrapur,Soybean,2015,3190,3387,197,6.175548589341693
Jalgaon,Banana,2014,232,429,197,84.91379310344827
Kalmeshwar,Bottle Gourd,2016,391,588,197,50.38363171355499
Armori-Desaiganj,Paddy-Unhusked,2015,1482,1679,197,13.29284750337382
Purna,Soybean,2016,3708,3905,197,5.312837108953614
Akot,Wheat(Husked),2015,1324,1521,197,14.879154078549849
Lasur Station,Gram,2016,4000,4197,197,4.925
Latur,Soybean,2015,3169,3366,197,6.216472073209214
Pombhurni,Paddy-Unhusked,2016,1965,2162,197,10.025445292620866
Shevgaon,Cotton,2015,3788,3985,197,5.200633579725449
Achalpur,Pigeon Pea (Tur),2014,4941,5138,197,3.9870471564460637
Nilanga,Sorgum(Jawar),2016,1258,1455,197,15.659777424483307
Mehkar,Sorgum(Jawar),2016,1167,1364,197,16.8808911739503
Paithan,Wheat(Husked),2015,1524,1721,197,12.926509186351707
Khamgaon,Cotton,2015,3798,3995,197,5.186940494997367
Patur,Wheat(Husked),2015,1323,1520,197,14.890400604686318
Mehkar,Wheat(Husked),2016,1578,1775,197,12.484157160963244
Savner,MAIZE,2016,1092,1289,197,18.04029304029304
Jalna,Black Gram,2014,5013,5210,197,3.9297825653301417
Ambejogai,Soybean,2015,3134,3331,197,6.285896617740907
Nashik,Mint,2016,348,545,197,56.60919540229885
Sinner,Maize,2015,1032,1229,197,19.089147286821706
Buldhana,Soybean,2016,3418,3615,197,5.763604447045055
Nagpur,BRINJAL,2016,443,640,197,44.46952595936794
Gevrai,Sorgum(Jawar),2015,1466,1663,197,13.437926330150068
Lasalgaon-Vinchur,Bajri,2015,1201,1398,197,16.4029975020816
Patan,Tomato,2015,535,731,196,36.63551401869159
Pusad,Wheat(Husked),2015,1543,1739,196,12.70252754374595
Amarawati-Fruit And Vegetables,LADIES FINGER,2016,1725,1921,196,11.36231884057971
Bhandara,Rice(Paddy-Hus),2016,3091,3287,196,6.340989970883209
Ner Parasopant,Soybean,2016,3732,3928,196,5.251875669882101
Nagpur,Beet Root,2015,881,1077,196,22.24744608399546
Amalner,Gram,2015,3870,4066,196,5.064599483204135
Sangamner,Gram,2016,3986,4182,196,4.917210235825389
Jafrabad,Maize,2015,1167,1363,196,16.795201371036846
Shirur,Sorgum(Jawar),2016,1594,1790,196,12.296110414052698
Nagpur,Green Chilli,2014,1000,1196,196,19.6
Jamkhed,Bajri,2014,1302,1498,196,15.053763440860216
Hadgaon,SOYBEAN,2016,2800,2996,196,7.0
Barshi,Bajri,2015,1393,1589,196,14.07035175879397
Nagpur,Carrot,2015,996,1192,196,19.67871485943775
Jafrabad,Cotton,2015,4002,4198,196,4.897551224387806
Mumbai,Cucumber,2016,581,777,196,33.734939759036145
Purna,Soybean,2015,3338,3534,196,5.871779508687837
Yeola,Wheat(Husked),2015,1441,1637,196,13.601665510062457
Kalmeshwar,Bottle Gourd,2016,635,831,196,30.866141732283463
Nagpur,Bottle Gourd,2015,532,728,196,36.8421052631579
Rajura,Pigeon Pea (Tur),2015,5012,5208,196,3.910614525139665
Raver,Sorgum(Jawar),2015,1279,1475,196,15.324472243940578
Barshi,Lemon,2015,368,564,196,53.26086956521739
Shegaon,Sorgum(Jawar),2015,1002,1198,196,19.560878243512974
Nagpur,Jack Fruit,2015,1177,1373,196,16.65250637213254
Nagpur,Tomato,2015,1002,1198,196,19.560878243512974
Phaltan,Jaggery,2015,2550,2746,196,7.686274509803922
Barshi,Green Chilli,2015,200,396,196,98.0
Kalmeshwar,Coriander  ,2014,3216,3412,196,6.0945273631840795
Nandura,Sorgum(Jawar),2015,1097,1293,196,17.866909753874204
Beed,Pigeon Pea (Tur),2016,5425,5621,196,3.6129032258064515
Mumbai,Squash Gourd,2014,732,928,196,26.775956284153004
Tuljapur,Pigeon Pea (Tur),2015,5640,5836,196,3.475177304964539
Hingoli,Soybean,2015,3531,3727,196,5.550835457377514
Akola,Wheat(Husked),2016,1512,1708,196,12.962962962962964
Kalmeshwar,Walvad,2015,1716,1912,196,11.421911421911421
Nagpur,Tomato,2015,790,986,196,24.810126582278482
Buldhana-Dhad,Soybean,2016,3409,3605,196,5.749486652977413
Raver,Wheat(Husked),2016,1612,1808,196,12.158808933002481
Jawala-Bajar,Gram,2016,4668,4864,196,4.1988003427592115
Buldhana,Soybean,2016,3370,3566,196,5.816023738872404
Sinner,Maize,2014,953,1149,196,20.566631689401888
Murum,Sorgum(Jawar),2015,1958,2154,196,10.010214504596528
Buldhana,Sorgum(Jawar),2015,1117,1313,196,17.54700089525515
Gangakhed,Soybean,2016,3748,3944,196,5.229455709711846
Tasgaon,SORGUM(JAWAR),2016,1706,1902,196,11.48886283704572
Shevgaon,Sorgum(Jawar),2015,1347,1543,196,14.550853749072012
Nagpur,Brinjal,2016,560,756,196,35.0
Shevgaon-Bodhegaon,Gram,2016,5266,5462,196,3.7219901253323204
Buldhana,Soybean,2016,3234,3430,196,6.0606060606060606
Jalna,Soybean,2016,3224,3420,196,6.079404466501241
Pachora,Gram,2016,6316,6512,196,3.103229892336922
Rahata,Soybean,2014,3048,3244,196,6.430446194225722
Sillod,Soybean,2014,3008,3204,196,6.51595744680851
Lasalgaon,Maize,2015,1073,1269,196,18.266542404473437
Khed-Chakan,Cabbage,2016,379,575,196,51.715039577836414
Nagpur,Pumpkin,2015,504,700,196,38.888888888888886
Amarawati-Fruit And Vegetables,Tomato,2016,836,1032,196,23.444976076555022
Ner Parasopant,Black Gram,2015,8170,8366,196,2.3990208078335375
Ramtek,Flower,2015,861,1057,196,22.764227642276424
Umared,Soybean,2016,3200,3396,196,6.125
Jamkhed,Gram,2015,3615,3810,195,5.394190871369295
Kej,Bajri,2016,1424,1619,195,13.6938202247191
Malegaon (Washim),Soybean,2015,3332,3527,195,5.85234093637455
Indapur,Maize,2016,1186,1381,195,16.441821247892076
Kalmeshwar,Flower,2015,534,729,195,36.51685393258427
Balapur,Soybean,2016,3395,3590,195,5.743740795287187
Pune-Pimpri,BEET ROOT,2016,1289,1484,195,15.12800620636152
Malegaon,Maize,2015,1026,1221,195,19.005847953216374
Gangapur,Bajri,2014,1245,1440,195,15.662650602409638
Shahada,Soybean,2016,3468,3663,195,5.622837370242214
Dondaicha,Sorgum(Jawar),2014,1405,1600,195,13.87900355871886
Nandurbar,Cluster Bean,2014,4575,4770,195,4.262295081967213
Vaijapur,Bajri,2015,1210,1405,195,16.115702479338843
Sindkhed Raja,Soybean,2016,3780,3975,195,5.158730158730159
Ramtek,Ladies Finger,2016,919,1114,195,21.218715995647443
Kopargaon,Wheat(Husked),2016,1567,1762,195,12.444160816847479
Nagpur,Flower,2016,319,514,195,61.12852664576803
Baramati,Sunflower,2015,3132,3327,195,6.226053639846743
Manmad,Pigeon Pea (Tur),2015,7976,8171,195,2.4448345035105317
Aurangabad,Potato,2015,473,668,195,41.22621564482029
Nagpur,Sweet Potato,2016,910,1105,195,21.428571428571427
Shirpur,Bajri,2015,947,1142,195,20.591341077085534
Nandura,Maize,2015,973,1168,195,20.041109969167522
Jalgaon,Gram,2015,3385,3580,195,5.760709010339734
Gangapur,Wheat(Husked),2015,1519,1714,195,12.83739302172482
Bhokar,Turmeric,2015,7581,7776,195,2.5722200237435695
Indapur,Jaggery,2015,2092,2287,195,9.321223709369026
Bhiwapur,Soybean,2016,3325,3520,195,5.864661654135339
Nagpur,Carrot,2016,735,930,195,26.53061224489796
Pathari,Soybean,2014,2979,3174,195,6.545820745216516
Bhiwapur,Gram,2016,5750,5945,195,3.391304347826087
Sillod,MAIZE,2016,933,1128,195,20.90032154340836
Sangamner,Gram,2015,3638,3833,195,5.360087960417812
Hadgaon,Soybean,2016,3329,3524,195,5.85761489936918
Tuljapur,Gram,2015,3041,3236,195,6.412364353830976
Patur,Wheat(Husked),2016,1626,1821,195,11.992619926199263
Savali,Paddy-Unhusked,2015,1842,2037,195,10.586319218241043
Dondaicha-Sindkheda,Bajri,2016,1292,1487,195,15.092879256965944
Ausa,Safflower,2016,2606,2801,195,7.482732156561781
Mumbai-Onion And Potato Mkt,Onion,2016,458,653,195,42.5764192139738
Amarawati-Fruit And Vegetables,CLUSTER BEAN,2016,2389,2584,195,8.162411050648807
Mohol,Wheat(Husked),2015,1444,1639,195,13.504155124653739
Mehkar,Wheat(Husked),2015,1476,1671,195,13.211382113821138
Latur,Bajri,2015,1125,1320,195,17.333333333333332
Chalisgaon,Maize,2014,929,1124,195,20.990312163616792
Telhara,Soybean,2014,2780,2975,195,7.014388489208633
Taloda,Sorgum(Jawar),2016,1221,1416,195,15.97051597051597
Dhule,Maize,2014,1079,1274,195,18.072289156626507
Pune,Bajri,2016,2156,2351,195,9.044526901669759
Jafrabad,Cotton,2015,4140,4335,195,4.7101449275362315
Tasgaon,Maize,2015,1418,1613,195,13.75176304654443
Jalna,Jaggery,2015,2107,2302,195,9.254864736592312
Jalna,Wheat(Husked),2015,1455,1650,195,13.402061855670103
Nampur,Maize,2016,989,1184,195,19.716885743174924
Shevgaon,Wheat(Husked),2016,1677,1872,195,11.627906976744185
Telhara,Gram,2016,5208,5403,195,3.7442396313364057
Ramtek,Cabbage,2016,641,836,195,30.421216848673946
Vaijapur,Wheat(Husked),2016,1768,1963,195,11.029411764705882
Maregaon,Cotton,2016,4442,4636,194,4.367402071139127
Jintur,Green Gram,2016,6088,6282,194,3.1865965834428382
Jintur,Gram,2016,4061,4255,194,4.777148485594681
Pachora,Maize,2016,1243,1437,194,15.607401448109412
Udgir,Sorgum(Jawar),2015,1000,1194,194,19.4
Pandharkawada,Cotton,2014,3803,3997,194,5.101235866421247
Kalmeshwar,Chavli (Shenga ),2015,1956,2150,194,9.918200408997954
Rahata,Wheat(Husked),2015,1311,1505,194,14.797864225781845
Vaijapur,Sorgum(Jawar),2014,1163,1357,194,16.680997420464315
Chimur,Cotton,2016,4800,4994,194,4.041666666666667
Shevgaon-Bodhegaon,Sorgum(Jawar),2016,1623,1817,194,11.95317313616759
Nandurbar,Sorgum(Jawar),2015,1172,1366,194,16.552901023890787
Baramati,MAIZE,2016,1170,1364,194,16.581196581196583
Morshi,Soybean,2015,3281,3475,194,5.912831453825054
Balapur,Soybean,2015,3150,3344,194,6.158730158730159
Kalyan,Squash Gourd,2015,794,988,194,24.43324937027708
Karad,Bitter Gourd,2015,919,1113,194,21.109902067464635
Jalna,Maize,2015,1270,1464,194,15.275590551181102
Parola,Maize,2015,1185,1379,194,16.371308016877638
Rahuri-Vambori,Sorgum(Jawar),2016,1429,1623,194,13.57592722183345
Aurangabad,POTATO,2016,848,1042,194,22.87735849056604
Amarawati,Tomato,2015,1028,1222,194,18.8715953307393
Majalgaon,Sorgum(Jawar),2016,1599,1793,194,12.132582864290182
Kalyan,Squash Gourd,2015,725,919,194,26.75862068965517
Murbad,Capsicum,2015,3793,3987,194,5.114684945953072
Nagpur,Tomato,2015,1136,1330,194,17.077464788732396
Kannad,Sorgum(Jawar),2016,1560,1754,194,12.435897435897436
Kannad,Bajri,2015,1114,1308,194,17.414721723518852
Nagpur,Sweet Potato,2015,819,1013,194,23.68742368742369
Zarijamini,COTTON,2016,4651,4845,194,4.171145990109654
Khamgaon,Lemon,2015,74,268,194,262.1621621621622
Gevrai,Bajri,2016,1602,1796,194,12.109862671660425
Kopargaon,Bajri,2015,1280,1474,194,15.15625
Anajngaon Surji,Soybean,2015,3256,3450,194,5.958230958230958
Kopargaon,Maize,2014,903,1097,194,21.483942414174972
Koregaon,Gram,2015,3506,3700,194,5.533371363377068
Pune-Pimpri,Cabbage,2015,1113,1307,194,17.4303683737646
Dhule,Maize,2015,1258,1452,194,15.421303656597773
Nandura,Sorgum(Jawar),2016,1235,1429,194,15.708502024291498
Khamgaon,Wheat(Husked),2016,1671,1865,194,11.6098144823459
Nagpur,Tomato,2014,822,1016,194,23.600973236009732
Pathardi,Bajri,2015,1253,1447,194,15.482841181165204
Ramtek,Pumpkin,2015,688,882,194,28.197674418604652
Parli-Vaijnath,Gram,2014,2069,2263,194,9.376510391493476
Jintur-Bori,Sorgum(Jawar),2016,1589,1783,194,12.208936438011328
Shevgaon,Gram,2015,3225,3419,194,6.015503875968992
Sonpeth,Sorgum(Jawar),2016,1540,1734,194,12.597402597402597
Lonar,Sorgum(Jawar),2015,1210,1404,194,16.03305785123967
Ner Parasopant,Soybean,2015,3104,3298,194,6.25
Karad,Tomato,2016,437,631,194,44.39359267734554
Patur,Wheat(Husked),2015,1294,1488,194,14.992272024729521
Savner,Soybean,2014,3109,3303,194,6.239948536506915
Digras,Gram,2016,6094,6288,194,3.1834591401378405
Hadgaon,Soybean,2015,3344,3538,194,5.801435406698564
Ner Parasopant,Soybean,2014,3255,3449,194,5.960061443932411
Kalmeshwar,Flower,2015,691,885,194,28.075253256150507
Pathardi,Bajri,2015,1259,1453,194,15.409054805401112
Pathari,Sorgum(Jawar),2015,1650,1844,194,11.757575757575758
Kalmeshwar,Raddish,2016,525,719,194,36.95238095238095
Kalmeshwar,Ladies Finger,2015,1366,1560,194,14.202049780380673
Jalgaon,Black Gram,2015,5724,5918,194,3.3892382948986723
Dondaicha,Sorgum(Jawar),2015,1512,1706,194,12.83068783068783
Karad,Cabbage,2014,543,736,193,35.54327808471455
Pune-Manjri,Chavli (Pala),2016,869,1062,193,22.209436133486765
Gondpimpri,Soybean,2014,2770,2963,193,6.9675090252707585
Chalisgaon,Maize,2016,1394,1587,193,13.845050215208035
Kalmeshwar,Tomato,2015,1930,2123,193,10.0
Washim-Ansing,WHEAT(HUSKED),2016,1567,1760,193,12.316528398213146
Nashik,Raddish,2015,158,351,193,122.15189873417721
Parli-Vaijnath,Soybean,2015,3087,3280,193,6.252024619371558
Parli-Vaijnath,Sorgum(Jawar),2016,1470,1663,193,13.129251700680273
Yawal,Cotton,2015,4042,4235,193,4.774863928748145
Hingoli,Gram,2015,3969,4162,193,4.862685815066768
Nagpur,Carrot,2015,1022,1215,193,18.88454011741683
Tuljapur,Gram,2016,5077,5270,193,3.801457553673429
Ghansawangi,Gram,2016,4086,4279,193,4.723445912873226
Kalamb (Os),Sunflower,2015,3273,3466,193,5.8967308279865565
Washim,Black Gram,2016,7714,7907,193,2.5019445164635727
Amarawati,Bitter Gourd,2016,1240,1433,193,15.564516129032258
Kurdwadi-Modnimb,Maize,2016,1400,1593,193,13.785714285714286
Nagpur,Cabbage,2015,417,610,193,46.28297362110312
Pulgaon,Soybean,2016,3345,3538,193,5.769805680119582
Bhiwapur,Green Gram,2016,5875,6068,193,3.2851063829787233
Kalmeshwar,Chavli (Shenga ),2014,1192,1385,193,16.191275167785236
Jintur,Gram,2015,2626,2819,193,7.34958111195735
Amarawati-Fruit And Vegetables,Bitter Gourd,2016,1238,1431,193,15.589660743134088
Ahmedpur,Sunflower,2016,3465,3658,193,5.56998556998557
Kalmeshwar,Cabbage,2016,365,558,193,52.87671232876713
Washim,Soybean,2016,3818,4011,193,5.055002619172342
Nagpur,Cucumber,2016,700,893,193,27.571428571428573
Jamkhed,Soybean,2016,3196,3389,193,6.038798498122653
Latur,Bajri,2015,1298,1491,193,14.869029275808936
Kalmeshwar,FLOWER,2016,342,535,193,56.432748538011694
Malegaon (Washim),Wheat(Husked),2015,1430,1623,193,13.496503496503497
Kej,Wheat(Husked),2016,1512,1705,193,12.764550264550264
Palghar(Bevur),Potato,2015,1103,1296,193,17.497733454215776
Devala,Tamarind,2016,2361,2554,193,8.17450232952139
Beed,Gram,2015,4294,4487,193,4.494643688868188
Lonar,Soybean,2014,2979,3172,193,6.478684122188654
Savner,Wheat(Husked),2015,1290,1483,193,14.96124031007752
Solapur,Papai,2014,295,488,193,65.42372881355932
Amarawati,Math (Bhaji),2016,1807,2000,193,10.680686220254566
Nagpur,Mango(Raw),2015,1019,1212,193,18.940137389597645
Kalmeshwar,Green Chilli,2014,1534,1727,193,12.58148631029987
Beed,Gram,2015,4149,4342,193,4.65172330682092
Bhokar,GREEN GRAM,2016,4060,4253,193,4.753694581280788
Kalmeshwar,Wheat(Husked),2015,1450,1643,193,13.310344827586206
Amarawati-Fruit And Vegetables,Spinach,2016,1107,1300,193,17.434507678410117
Akluj,Potato,2015,863,1056,193,22.363847045191193
Bhokar,Sorgum(Jawar),2016,1321,1514,193,14.610143830431491
Pandharkawada,Gram,2016,4537,4730,193,4.253912276834913
Chimur,Gram,2016,5607,5800,193,3.4421259140360263
Pune-Pimpri,Flower,2015,938,1131,193,20.575692963752665
Jafrabad,Maize,2015,1088,1281,193,17.738970588235293
Nandura,Wheat(Husked),2015,1418,1611,193,13.610719322990127
Umarga,Soybean,2015,3601,3794,193,5.359622327131352
Mauda,Gram,2016,6250,6443,193,3.088
Chopda,Sorgum(Jawar),2016,1589,1782,193,12.146003775959723
Amalner,WHEAT(HUSKED),2016,1730,1923,193,11.15606936416185
Mandhal,Soybean,2015,3250,3443,193,5.938461538461539
Amarawati,Cucumber,2016,1750,1943,193,11.028571428571428
Akola,Sorgum(Jawar),2015,1123,1316,193,17.186108637577917
Ramtek,Potato,2015,1007,1200,193,19.16583912611718
Anajngaon Surji,Sorgum(Jawar),2015,1257,1449,192,15.274463007159904
Ramtek,Capsicum,2016,879,1071,192,21.843003412969285
Mumbai,Cabbage,2016,446,638,192,43.04932735426009
Telhara,Soybean,2016,3246,3438,192,5.914972273567468
Deglur,Gram,2016,4170,4362,192,4.60431654676259
Amalner,Wheat(Husked),2015,1256,1448,192,15.286624203821656
Kej,Gram,2016,3942,4134,192,4.87062404870624
Murbad,Capsicum,2015,5146,5338,192,3.7310532452390204
Beed,Bajri,2015,1331,1523,192,14.425244177310294
Mumbai,Tomato,2015,708,900,192,27.11864406779661
Mandhal,Soybean,2014,3029,3221,192,6.338725652030373
Washim-Ansing,Pigeon Pea (Tur),2016,6569,6761,192,2.922819302785812
Parbhani,Soybean,2015,3505,3697,192,5.477888730385164
Ghoti,Bitter Gourd,2014,2834,3026,192,6.774876499647142
Kopargaon,Wheat(Husked),2015,1532,1724,192,12.532637075718016
Rahata,Sorgum(Jawar),2015,1123,1315,192,17.09706144256456
Chikhali,Maize,2016,1321,1513,192,14.53444360333081
Pune-Pimpri,Onion,2014,1523,1715,192,12.606697307944845
Jintur-Bori,Sorgum(Jawar),2016,1513,1705,192,12.69001982815598
Umared,Lang,2016,2307,2499,192,8.322496749024708
Kinwat,Soybean,2015,3354,3546,192,5.724508050089446
Pusad,GREEN GRAM,2016,4843,5035,192,3.964484823456535
Nagpur,Math (Bhaji),2015,675,867,192,28.444444444444443
Barshi,Green Chilli,2016,352,544,192,54.54545454545455
Shevgaon-Bodhegaon,Sorgum(Jawar),2015,1366,1558,192,14.055636896046853
Nandurbar,Green Gram,2016,7051,7243,192,2.723018011629556
Amarawati-Fruit And Vegetables,Tomato,2016,1165,1357,192,16.48068669527897
Amarawati,Bajri,2016,1958,2150,192,9.805924412665986
Majalgaon,Soybean,2015,3095,3287,192,6.203554119547658
Gevrai,Maize,2016,1535,1727,192,12.50814332247557
Rahuri-Vambori,Bajri,2015,1273,1465,192,15.082482325216025
Gevrai,Bajri,2014,1290,1482,192,14.883720930232558
Karanja,Green Gram,2015,5477,5669,192,3.5055687420120503
Nandurbar,Soybean,2016,3454,3646,192,5.55877243775333
Khultabad,Cotton,2016,4146,4338,192,4.630969609261939
Nagpur,Beet Root,2015,584,776,192,32.87671232876713
Tumsar,Sarsav,2014,2694,2886,192,7.12694877505568
Nagpur,Brinjal,2015,604,796,192,31.788079470198674
Pulgaon,Cotton,2015,3980,4172,192,4.824120603015075
Chandur Bajar,Sorgum(Jawar),2016,1280,1472,192,15.0
Lasur Station,Bajri,2015,1271,1463,192,15.106215578284814
Amarawati-Fruit And Vegetables,TOMATO,2016,957,1149,192,20.062695924764892
Kalmeshwar,Bottle Gourd,2015,515,707,192,37.28155339805825
Parola,BAJRI,2016,997,1189,192,19.25777331995988
Ambejogai,Soybean,2015,3451,3643,192,5.563604752245726
Shevgaon,Pigeon Pea (Tur),2016,6829,7021,192,2.811539024747401
Gevrai,Cotton,2015,3600,3792,192,5.333333333333333
Shevgaon,Onion,2016,503,695,192,38.17097415506958
Manmad,Wheat(Husked),2015,1574,1766,192,12.198221092757306
Amarawati,Spinach,2015,833,1025,192,23.04921968787515
Shevgaon,Onion,2016,583,775,192,32.93310463121784
Digras,Soybean,2016,3867,4059,192,4.965089216446858
Nagpur,Pumpkin,2014,731,923,192,26.265389876880985
Amarawati-Fruit And Vegetables,Brinjal,2016,1308,1500,192,14.678899082568808
Ahmedpur,Soybean,2014,3006,3198,192,6.387225548902196
Karanja,Gram,2016,5635,5827,192,3.4072759538598048
Aurangabad,Gram,2014,3009,3200,191,6.347623795280824
Loha,Sorgum(Jawar),2015,1184,1375,191,16.131756756756758
Nagpur,Jack Fruit,2015,1396,1587,191,13.681948424068768
Kalmeshwar,Raddish,2016,544,735,191,35.11029411764706
Shevgaon-Bodhegaon,Bajri,2015,1400,1591,191,13.642857142857142
Phaltan,Maize,2015,1325,1516,191,14.415094339622641
Dhule,Bajri,2015,998,1189,191,19.138276553106213
Varud-Rajura Bazar,Soybean,2014,3142,3333,191,6.07893061744112
Ner Parasopant,Pigeon Pea (Tur),2016,6431,6622,191,2.969989115223138
Malegaon (Washim),Soybean,2016,3339,3530,191,5.720275531596286
Nagpur,Flower,2015,840,1031,191,22.738095238095237
Nashik,Mint,2016,289,480,191,66.08996539792388
Chandur Bajar,Sorgum(Jawar),2015,1227,1418,191,15.56642216788916
Ner Parasopant,Soybean,2015,3240,3431,191,5.895061728395062
Hingoli,Soybean,2016,3547,3738,191,5.384832252607838
Barshi,Wheat(Husked),2014,1521,1712,191,12.557527942143327
Chikhali,Maize,2015,1144,1335,191,16.695804195804197
Raver,Maize,2015,967,1158,191,19.751809720785936
Washim-Ansing,Soybean,2016,3225,3416,191,5.922480620155039
Rahata,Carrot,2016,927,1118,191,20.604099244875943
Jafrabad,Cotton,2015,4066,4257,191,4.6974913920314805
Ramtek,Brinjal,2015,750,941,191,25.466666666666665
Shrirampur,Bajri,2015,1204,1395,191,15.863787375415283
Barshi,Green Chilli,2015,195,386,191,97.94871794871794
Sinner,Wheat(Husked),2014,1602,1793,191,11.922596754057428
Telhara,Soybean,2016,3390,3581,191,5.6342182890855455
Shevgaon,Gram,2016,6041,6232,191,3.1617281906969046
Varud-Rajura Bazar,Wheat(Husked),2015,1219,1410,191,15.668580803937655
Nandurbar,Bajri,2015,1006,1197,191,18.986083499005964
Telhara,Wheat(Husked),2016,1569,1760,191,12.173358827278522
Yawal,Onion,2015,919,1110,191,20.783460282916213
Kille Dharur,Sorgum(Jawar),2016,1567,1758,191,12.188895979578813
Palghar(Bevur),Wheat(Husked),2015,1820,2011,191,10.494505494505495
Ghansawangi,COTTON,2016,4742,4933,191,4.027836355967946
Gangapur,Gram,2015,3936,4127,191,4.852642276422764
Ahmedpur,Wheat(Husked),2015,1164,1355,191,16.40893470790378
Shevgaon,Bajri,2016,1395,1586,191,13.691756272401435
Amarawati,Carrot,2016,2717,2908,191,7.029812292970187
Sindkhed Raja,Sorgum(Jawar),2016,1538,1729,191,12.418725617685306
Bhokar,Sorgum(Jawar),2014,1268,1459,191,15.063091482649842
Lasur Station,Maize,2014,942,1133,191,20.276008492569
Rahuri-Vambori,SORGUM(JAWAR),2016,2013,2204,191,9.488325881768505
Taloda,Maize,2015,1113,1304,191,17.16082659478886
Ramtek,Spinach,2016,700,891,191,27.285714285714285
Raver,Sorgum(Jawar),2016,1378,1569,191,13.86066763425254
Sangrampur,Wheat(Husked),2015,1218,1409,191,15.681444991789819
Chandvad,MAIZE,2016,1084,1275,191,17.619926199261993
Buldhana,Soybean,2016,3009,3200,191,6.347623795280824
Nagpur,Paddy-Unhusked,2016,1763,1954,191,10.83380601247873
Amarawati,Capsicum,2016,2809,3000,191,6.799572801708793
Gondiya,Paddy-Unhusked,2016,1644,1835,191,11.61800486618005
Kurdwadi-Modnimb,Maize,2015,1405,1596,191,13.594306049822064
Malegaon,Castor Seed,2016,2660,2851,191,7.180451127819549
Chandrapur,Soybean,2016,3313,3504,191,5.765167521883489
Ramtek,TOMATO,2016,709,900,191,26.939351198871652
Rahata,Ladies Finger,2014,3009,3200,191,6.347623795280824
Sailu,Pigeon Pea (Tur),2016,8075,8265,190,2.3529411764705883
Sangrampur,Sorgum(Jawar),2015,985,1175,190,19.289340101522843
Ner Parasopant,Pigeon Pea (Tur),2014,4703,4893,190,4.039974484371678
Pune-Pimpri,Onion,2015,963,1153,190,19.73001038421599
Ramtek,Potato,2016,1702,1892,190,11.163337250293772
Mehkar,Wheat(Husked),2016,1493,1683,190,12.726054922973878
Akhadabalapur,Soybean,2014,3065,3255,190,6.199021207177814
Kalmeshwar,Bottle Gourd,2015,498,688,190,38.15261044176707
Ghansawangi,Cotton,2015,4080,4270,190,4.6568627450980395
Taloda,Cotton,2014,3775,3965,190,5.033112582781457
Bhokardan,Black Gram,2016,5722,5912,190,3.320517301642782
Kille Dharur,SORGUM(JAWAR),2016,1765,1955,190,10.76487252124646
Jafrabad,Maize,2016,1310,1500,190,14.50381679389313
Pune-Pimpri,Bajri,2015,1970,2160,190,9.644670050761421
Shirpur,Bajri,2015,1025,1215,190,18.536585365853657
Sindi,Gram,2015,3850,4040,190,4.935064935064935
Jalgaon Jamod,Maize,2015,1070,1260,190,17.757009345794394
Manwat,SORGUM(JAWAR),2016,1925,2115,190,9.87012987012987
Dharangaon,Bajri,2016,1405,1595,190,13.523131672597865
Ghoti,Cabbage,2016,1042,1232,190,18.234165067178502
Pavani,Green Gram,2016,5460,5650,190,3.47985347985348
Beed,Bajri,2015,1331,1521,190,14.274981217129977
Akluj,Potato,2015,905,1095,190,20.994475138121548
Jalgaon,Cluster Bean,2016,4068,4258,190,4.670599803343166
Aarni,Ground Nut Pods (Dry),2015,5742,5932,190,3.308951584813654
Khed-Chakan,Cabbage,2016,262,452,190,72.51908396946565
Shrirampur,Maize,2015,959,1149,190,19.81230448383733
Parbhani,Soybean,2015,3508,3698,190,5.416191562143672
Anajngaon Surji,Banana,2015,700,890,190,27.142857142857142
Amalner,Bajri,2014,1200,1390,190,15.833333333333334
Anajngaon Surji,Banana,2015,590,780,190,32.20338983050848
Akot,Wheat(Husked),2016,1563,1753,190,12.156110044785668
Jafrabad,Maize,2016,1281,1471,190,14.83216237314598
Tumsar,Sarsav,2016,3078,3268,190,6.172839506172839
Gondiya,Paddy-Unhusked,2015,1440,1630,190,13.194444444444445
Jafrabad,Wheat(Husked),2015,1360,1550,190,13.970588235294118
Ahmednagar,Wheat(Husked),2016,1655,1845,190,11.48036253776435
Nashik,Spinach,2016,277,467,190,68.59205776173285
Khamgaon,Sorgum(Jawar),2015,1059,1249,190,17.94145420207743
Lasalgaon-Niphad,MAIZE,2016,1043,1233,190,18.21668264621285
Rahuri-Vambori,Sorgum(Jawar),2015,1164,1354,190,16.323024054982817
Aurangabad,Potato,2016,1429,1619,190,13.296011196641008
Nashik,Spinach,2015,200,390,190,95.0
Bhokar,Pigeon Pea (Tur),2015,7471,7661,190,2.543166912059965
Vaijapur,Bajri,2016,1549,1739,190,12.265978050355068
Amarawati,Pigeon Pea (Tur),2016,8701,8891,190,2.183657050913688
Sengaon,Gram,2016,4102,4292,190,4.631886884446612
Vai,Tomato,2016,685,875,190,27.73722627737226
Ramtek,Brinjal,2016,225,415,190,84.44444444444444
Newasa,Gram,2015,3260,3450,190,5.828220858895706
Sinner,Maize,2016,1313,1503,190,14.47067783701447
Nagpur,Tomato,2016,517,707,190,36.7504835589942
Ashti-Karanja,Wheat(Husked),2016,1467,1657,190,12.951601908657123
Sillod,Soybean,2016,3400,3590,190,5.588235294117647
Anajngaon Surji,Banana,2015,510,700,190,37.254901960784316
Islampur,Green Chilli,2016,309,499,190,61.48867313915858
Amarawati,Gram,2016,4380,4570,190,4.337899543378995
Akhadabalapur,Soybean,2016,3410,3600,190,5.571847507331379
Panvel,Cucumber,2014,1360,1550,190,13.970588235294118
Chimur,Soybean,2015,3250,3440,190,5.846153846153846
Dindori,Onion,2016,585,775,190,32.47863247863248
Jafrabad,Maize,2016,1305,1495,190,14.559386973180077
Nandura,Sorgum(Jawar),2015,1194,1384,190,15.912897822445562
Murbad,Ghosali(Bhaji),2015,5450,5640,190,3.4862385321100917
Telhara,Wheat(Husked),2016,1433,1623,190,13.258897418004187
Bhokar,Turmeric,2015,6974,7164,190,2.7244049326068254
Kalmeshwar,Green Chilli,2015,2879,3069,190,6.599513720041681
Kalmeshwar,Coriander  ,2014,1260,1450,190,15.079365079365079
Kalamb (Os),Sorgum(Jawar),2016,1500,1690,190,12.666666666666666
Sangrampur,Maize,2015,910,1100,190,20.87912087912088
Patan,Tomato,2015,790,980,190,24.050632911392405
Zarijamini,Pigeon Pea (Tur),2015,8210,8400,190,2.3142509135200973
Nagpur,Chavli (Pala),2015,905,1095,190,20.994475138121548
Ramtek,Flower,2016,705,895,190,26.95035460992908
Palghar(Bevur),Wheat(Husked),2016,2061,2250,189,9.170305676855895
Achalpur,Soybean,2016,3389,3578,189,5.576866332251401
Kada,Bajri,2015,1282,1471,189,14.742589703588143
Dondaicha-Sindkheda,Wheat(Husked),2016,1718,1907,189,11.0011641443539
Brahmpuri,Paddy-Unhusked,2016,1845,2034,189,10.24390243902439
Panvel,Ridge Gourd,2015,3122,3311,189,6.053811659192825
Chikhali,Sorgum(Jawar),2015,1190,1379,189,15.882352941176471
Shahada,Bajri,2015,1352,1541,189,13.979289940828401
Sillod-Bharadi,Wheat(Husked),2014,1350,1539,189,14.0
Udgir,Sorgum(Jawar),2015,1008,1197,189,18.75
Vaduj,Gram,2016,4767,4956,189,3.9647577092511015
Barshi,Cluster Bean,2015,254,443,189,74.40944881889764
Kalvan,Wheat(Husked),2016,1506,1695,189,12.549800796812749
Dondaicha,Sorgum(Jawar),2016,1576,1765,189,11.99238578680203
Achalpur,Wheat(Husked),2016,1762,1951,189,10.72644721906924
Tumsar,Linseed,2014,3654,3843,189,5.172413793103448
Panvel,Cabbage,2015,889,1078,189,21.25984251968504
Shrirampur,Bajri,2016,1582,1771,189,11.946902654867257
Pathari,Sorgum(Jawar),2015,1293,1482,189,14.617169373549883
Yeola,Bajri,2016,1301,1490,189,14.52728670253651
Barshi,Cluster Bean,2016,268,457,189,70.5223880597015
Chandrapur,Soybean,2015,3307,3496,189,5.715149682491684
Dondaicha,Bajri,2014,1173,1362,189,16.11253196930946
Dudhani,Maize,2016,1178,1367,189,16.044142614601018
Nagpur,Bottle Gourd,2015,544,733,189,34.74264705882353
Amarawati,Cabbage,2016,1958,2147,189,9.65270684371808
Ramtek,Pumpkin,2015,767,956,189,24.641460234680572
Patan,Tomato,2016,650,839,189,29.076923076923077
Ner Parasopant,Pigeon Pea (Tur),2015,6815,7004,189,2.7732942039618487
Mumbai,Squash Gourd,2015,515,704,189,36.699029126213595
Nilanga,Soybean,2014,3263,3452,189,5.792215752375115
Vaijapur,Green Gram,2014,7000,7189,189,2.7
Shrirampur-Belapur,Gram,2016,3703,3892,189,5.103969754253308
Vaduj,Gram,2014,2544,2733,189,7.429245283018868
Gangapur,Sorgum(Jawar),2016,1473,1662,189,12.830957230142566
Kalmeshwar,Methi (Bhaji),2016,394,583,189,47.96954314720812
Kannad,Gram,2015,2619,2808,189,7.216494845360825
Jalgaon Jamod-Aasalgaon,Wheat(Husked),2014,1378,1567,189,13.715529753265603
Anajngaon Surji,Soybean,2014,3022,3211,189,6.254136333553938
Bhandara,Rice(Paddy-Hus),2015,2460,2649,189,7.682926829268292
Yeola,Maize,2015,1122,1311,189,16.844919786096256
Jalgaon Jamod-Aasalgaon,Soybean,2015,3117,3306,189,6.063522617901829
Raver,Black Gram,2014,5541,5730,189,3.410936654033568
Mantha,Soybean,2016,3116,3305,189,6.065468549422336
Chandur Rly.,Gram,2016,3879,4068,189,4.872389791183295
Kej,Sorgum(Jawar),2016,1757,1946,189,10.756972111553784
Vai,Bottle Gourd,2015,867,1056,189,21.79930795847751
Yeotmal,Cotton,2015,3874,4063,189,4.878678368611254
Ahmedpur,Sunflower,2016,3330,3519,189,5.675675675675675
Patur,Wheat(Husked),2016,1718,1907,189,11.0011641443539
Kannad,Sorgum(Jawar),2014,1351,1540,189,13.989637305699482
Nagpur,Spinach,2014,946,1135,189,19.978858350951374
Malegaon,Bajri,2015,1251,1440,189,15.107913669064748
Amalner,Sorgum(Jawar),2015,1391,1580,189,13.587347232207046
Vai,Cabbage,2015,667,856,189,28.33583208395802
Amarawati,Tomato,2015,1537,1726,189,12.296681847755368
Amalner,Wheat(Husked),2015,1380,1569,189,13.695652173913043
Gangapur,Wheat(Husked),2015,1521,1709,188,12.360289283366207
Jafrabad,Maize,2016,975,1163,188,19.28205128205128
Udgir,Green Gram,2016,4495,4683,188,4.182424916573971
Barshi-Vairag,Wheat(Husked),2015,1930,2118,188,9.740932642487047
Shirur,Indian Bean,2015,2550,2738,188,7.372549019607843
Vaduj,Wheat(Husked),2016,1756,1944,188,10.70615034168565
Amarawati,Brinjal,2015,1375,1563,188,13.672727272727272
Jafrabad,MAIZE,2016,900,1088,188,20.88888888888889
Anajngaon Surji,Sorgum(Jawar),2015,1168,1356,188,16.095890410958905
Vaduj,Wheat(Husked),2016,1756,1944,188,10.70615034168565
Vaduj,Wheat(Husked),2016,1800,1988,188,10.444444444444445
Tumsar,Sarsav,2016,3237,3425,188,5.807846771702193
Sindi (Selu),Cotton,2016,4424,4612,188,4.249547920433996
Umarga,Wheat(Unhusked),2015,3265,3453,188,5.758039816232772
Kalmeshwar,Flower,2015,1931,2119,188,9.735888140859657
Shrigonda,Maize,2016,1394,1582,188,13.486370157819225
Karmala,Gram,2016,3825,4013,188,4.915032679738562
Tumsar,Black Gram,2015,4650,4838,188,4.043010752688172
Karad,Cabbage,2016,368,556,188,51.08695652173913
Pune,Bajri,2016,2098,2286,188,8.960915157292659
Morshi,Gram,2015,3850,4038,188,4.883116883116883
Rahata,Small Gourd,2016,3125,3313,188,6.016
Shirur,Bajri,2016,1601,1789,188,11.742660836976889
Kalmeshwar,Tomato,2014,2096,2284,188,8.969465648854962
Ghansawangi,Soybean,2014,3100,3288,188,6.064516129032258
Amarawati,Wheat(Husked),2016,1670,1858,188,11.25748502994012
Dudhani,Sorgum(Jawar),2015,2264,2452,188,8.303886925795053
Kalmeshwar,Pumpkin,2015,762,950,188,24.671916010498688
Palus,FLOWER,2016,675,863,188,27.85185185185185
Dudhani,Wheat(Husked),2015,1419,1607,188,13.24876673713883
Shirpur,Wheat(Husked),2016,1562,1750,188,12.03585147247119
Amarawati,Tomato,2016,1159,1347,188,16.22088006902502
Sindi (Selu),Cotton,2015,4117,4305,188,4.56643186786495
Shegaon,Wheat(Husked),2016,1517,1705,188,12.392880685563613
Armori,Paddy-Unhusked,2015,1532,1720,188,12.27154046997389
Ner Parasopant,Pigeon Pea (Tur),2016,5905,6093,188,3.1837425910245556
Gevrai,Cotton,2015,3577,3765,188,5.255800950517193
Manora,Wheat(Husked),2014,1425,1613,188,13.192982456140351
Mehkar,Wheat(Husked),2015,1268,1456,188,14.826498422712934
Kalyan,Squash Gourd,2015,650,838,188,28.923076923076923
Ner Parasopant,Gram,2015,3237,3425,188,5.807846771702193
Ausa,Maize,2016,1363,1551,188,13.793103448275861
Solapur,Pigeon Pea (Tur),2015,6747,6935,188,2.7864235956721504
Nagpur,Cabbage,2016,380,568,188,49.473684210526315
Ramtek,Ladies Finger,2016,1766,1954,188,10.645526613816534
Lonand,Sorgum(Jawar),2014,1550,1738,188,12.129032258064516
Jalgaon,Wal Papdi,2015,1375,1563,188,13.672727272727272
Malegaon,Sorgum(Jawar),2015,1530,1718,188,12.287581699346406
Partur,Soybean,2016,3351,3539,188,5.61026559236049
Murbad,Capsicum,2015,5656,5844,188,3.323903818953324
Jamkhed,Bajri,2014,1300,1488,188,14.461538461538462
Achalpur,WHEAT(HUSKED),2016,1765,1953,188,10.65155807365439
Raver,Maize,2014,867,1055,188,21.68396770472895
Nagpur,Ghosali(Bhaji),2015,500,688,188,37.6
Pune-Pimpri,Ghosali(Bhaji),2015,2500,2688,188,7.52
Jamkhed,Maize,2016,1356,1544,188,13.864306784660767
Jintur,Gram,2016,5280,5468,188,3.5606060606060606
Vai,Flower,2015,847,1035,188,22.195985832349468
Nagbhid,Wheat(Husked),2015,1925,2113,188,9.766233766233766
Balapur,Soybean,2016,3300,3488,188,5.696969696969697
Bhokar,Wheat(Husked),2015,1361,1549,188,13.81337252020573
Parbhani,Soybean,2014,2932,3120,188,6.412005457025921
Jamkhed,Bajri,2015,1300,1488,188,14.461538461538462
Jamkhed,Soybean,2014,2847,3035,188,6.603442219880576
Washim-Ansing,Green Gram,2016,4718,4906,188,3.9847392963119965
Washim-Ansing,Green Gram,2016,5278,5466,188,3.5619552860932173
Khamgaon,Sorgum(Jawar),2016,1309,1497,188,14.36210847975554
Aurangabad,Tomato,2016,298,486,188,63.08724832214765
Dhule,Sorgum(Jawar),2015,1689,1877,188,11.13084665482534
Tuljapur,Sorgum(Jawar),2015,1050,1238,188,17.904761904761905
Jawala-Bajar,Pigeon Pea (Tur),2016,8312,8500,188,2.2617901828681424
Savner,Soybean,2016,3026,3214,188,6.2128222075347
Jalgaon Jamod-Aasalgaon,Maize,2014,900,1088,188,20.88888888888889
Pulgaon,Soybean,2015,3701,3889,188,5.079708186976493
Malkapur,Wheat(Husked),2016,1672,1859,187,11.18421052631579
Manora,Wheat(Husked),2016,1588,1775,187,11.775818639798489
Nandura,Maize,2015,953,1140,187,19.62224554039874
Nagpur,Cabbage,2015,683,870,187,27.379209370424597
Chandur Bajar,Green Gram,2016,4517,4704,187,4.139915873367279
Chandur Bajar,Sorgum(Jawar),2016,1213,1400,187,15.416323165704863
Bhokar,Cotton,2015,3775,3962,187,4.953642384105961
Manchar,Cabbage,2014,188,375,187,99.46808510638297
Sailu,Soybean,2014,3148,3335,187,5.940279542566709
Dudhani,SORGUM(JAWAR),2016,2176,2363,187,8.59375
Amarawati,Pumpkin,2016,1063,1250,187,17.591721542803388
Himayatnagar,Cotton,2016,4213,4400,187,4.438642297650131
Newasa,Bajri,2016,1288,1475,187,14.51863354037267
Akhadabalapur,Gram,2015,3013,3200,187,6.206438765350149
Jintur,Sorgum(Jawar),2015,1534,1721,187,12.190352020860496
Parli-Vaijnath,Ground Nut Pods (Dry),2014,3351,3538,187,5.580423754103252
Kalmeshwar,Spinach,2014,1087,1274,187,17.2033118675253
Amarawati,Potato,2016,1333,1520,187,14.028507126781696
Indapur,Jaggery,2016,2375,2562,187,7.873684210526315
Nagpur,Raddish,2015,513,700,187,36.45224171539961
Amalner,Sorgum(Jawar),2015,1384,1571,187,13.511560693641618
Washim-Ansing,Soybean,2016,3469,3656,187,5.390602479100606
Khamgaon,Sorgum(Jawar),2016,1264,1451,187,14.794303797468354
Bhokar,Sorgum(Jawar),2016,1431,1618,187,13.067784765897974
Latur,Maize,2015,1183,1370,187,15.8072696534235
Akluj,Banana,2016,155,342,187,120.64516129032258
Malkapur,Maize,2015,1090,1277,187,17.155963302752294
Amarawati,Brinjal,2016,1094,1281,187,17.09323583180987
Pune-Pimpri,Cucumber,2016,2113,2300,187,8.849976336961666
Chimur,Paddy-Unhusked,2014,2014,2201,187,9.285004965243298
Khamgaon,Wheat(Husked),2016,1702,1889,187,10.987074030552291
Naigaon,Gram,2016,6863,7050,187,2.724755937636602
Amarawati,Brinjal,2016,1069,1256,187,17.492984097287184
Balapur,Gram,2015,3113,3300,187,6.007067137809187
Murbad,Bitter Gourd,2014,3244,3431,187,5.764488286066585
Aurangabad,Maize(Corn.),2015,613,800,187,30.505709624796086
Jalkot,SORGUM(JAWAR),2016,1079,1266,187,17.330861909175162
Tumsar,Pigeon Pea (Tur),2014,3438,3625,187,5.439208842350204
Malegaon,Pigeon Pea (Tur),2015,5425,5612,187,3.447004608294931
Shirur,Sorgum(Jawar),2015,1376,1563,187,13.590116279069768
Vaduj,Wheat(Husked),2015,1738,1925,187,10.759493670886076
Bhiwapur,Cotton,2016,4171,4358,187,4.4833373291776555
Udgir,Sorgum(Jawar),2016,1277,1464,187,14.643696162881755
Mehkar,Maize,2015,1000,1187,187,18.7
Murbad,Tomato,2014,1838,2025,187,10.174102285092491
Rajura,Pigeon Pea (Tur),2016,8149,8336,187,2.294760093262977
Dondaicha,Bajri,2015,1213,1400,187,15.416323165704863
Umarga,Pigeon Pea (Tur),2016,5547,5734,187,3.3711916351180817
Nandurbar,Sorgum(Jawar),2016,1371,1558,187,13.639679066374908
Udgir,Gram,2015,4562,4749,187,4.099079351161771
Umrane,Maize,2015,1300,1487,187,14.384615384615385
Akot,Sorgum(Jawar),2015,1217,1404,187,15.365653245686113
Dound,Maize,2016,1760,1947,187,10.625
Akola,Wheat(Husked),2015,1454,1641,187,12.861072902338377
Partur,Wheat(Husked),2016,1769,1956,187,10.570944036178632
Chandur Rly.,Gram,2016,6865,7052,187,2.7239621267297887
Chandur Rly.,Soybean,2015,3069,3256,187,6.093189964157706
Ahmednagar,Gram,2016,4219,4406,187,4.432329936003792
Sakri,Wheat(Husked),2016,1488,1675,187,12.567204301075268
Kalmeshwar,Wheat(Husked),2016,1458,1645,187,12.825788751714677
Dhule,Maize,2015,1112,1299,187,16.81654676258993
Kille Dharur,Wheat(Husked),2014,1407,1594,187,13.290689410092396
Kurdwadi-Modnimb,Wheat(Husked),2015,1629,1816,187,11.479435236341313
Amarawati,Tomato,2016,1541,1727,186,12.070084360804673
Amarawati,Green-Peas,2015,3157,3343,186,5.891669306303452
Ambejogai,Soybean,2016,3308,3494,186,5.62273276904474
Anajngaon Surji,Sorgum(Jawar),2014,1272,1458,186,14.622641509433961
Taloda,Sorgum(Jawar),2014,1505,1691,186,12.358803986710964
Vai,Cabbage,2016,1175,1361,186,15.829787234042554
Buldhana,Maize,2016,1453,1639,186,12.801101169993117
Rahata,Gram,2016,5135,5321,186,3.622200584225901
Lasalgaon-Vinchur,Wheat(Husked),2015,1475,1661,186,12.610169491525424
Jalgaon Jamod,Maize,2015,1093,1279,186,17.017383348581884
Murbad,Paddy-Unhusked,2016,1446,1632,186,12.863070539419088
Ahmedpur,Sorgum(Jawar),2016,1640,1826,186,11.341463414634147
Shrirampur,Bajri,2015,1253,1439,186,14.844373503591381
Amarawati,Capsicum,2016,1693,1879,186,10.986414648552865
Aurangabad,Tomato,2016,320,506,186,58.125
Wardha,Pigeon Pea (Tur),2014,4592,4778,186,4.050522648083624
Parli-Vaijnath,Cotton,2014,3860,4046,186,4.818652849740933
Kannad,Bajri,2015,1143,1329,186,16.27296587926509
Kinwat,Cotton,2015,3502,3688,186,5.311250713877784
Kalyan,Potato,2015,807,993,186,23.04832713754647
Jalgaon Jamod-Aasalgaon,Maize,2015,1050,1236,186,17.714285714285715
Jamkhed,Wheat(Husked),2016,2184,2370,186,8.516483516483516
Amarawati,Beet Root,2015,1500,1686,186,12.4
Amarawati,Potato,2016,1464,1650,186,12.704918032786885
Morshi,Gram,2016,4000,4186,186,4.65
Katol,Cotton,2016,4432,4618,186,4.196750902527076
Kalmeshwar,Chavli (Shenga ),2015,979,1165,186,18.998978549540347
Kinwat,Cotton,2015,3885,4071,186,4.787644787644788
Patan,Tomato,2015,745,931,186,24.966442953020135
Taloda,Maize,2016,1257,1443,186,14.797136038186158
Sinner,MAIZE,2016,1066,1252,186,17.4484052532833
Chalisgaon,Maize,2015,1200,1386,186,15.5
Parli-Vaijnath,Gram,2015,3416,3602,186,5.444964871194379
Udgir,Sorgum(Jawar),2016,1329,1515,186,13.99548532731377
Akhadabalapur,Cotton,2016,4367,4553,186,4.259216853675292
Kalmeshwar,Cabbage,2016,438,624,186,42.465753424657535
Chalisgaon,Sorgum(Jawar),2016,1408,1594,186,13.210227272727273
Amarawati,Papai,2016,767,953,186,24.2503259452412
Paithan,Gram,2015,3688,3874,186,5.043383947939263
Bhivandi,Onion,2016,850,1036,186,21.88235294117647
Rahuri-Vambori,Sorgum(Jawar),2015,1523,1709,186,12.212738017071569
Indapur-Bhigwan,Maize,2015,1280,1466,186,14.53125
Jintur-Bori,Sorgum(Jawar),2015,1178,1364,186,15.789473684210526
Palghar(Bevur),Wheat(Husked),2015,1919,2105,186,9.69254820218864
Sindi,Wheat(Husked),2016,1339,1525,186,13.890963405526513
Chikhali,Sorgum(Jawar),2015,1161,1347,186,16.020671834625322
Mohol,Wheat(Husked),2015,1443,1629,186,12.88981288981289
Armori-Desaiganj,Paddy-Unhusked,2016,1658,1844,186,11.218335343787697
Khed-Chakan,Cabbage,2016,306,492,186,60.78431372549019
Jalgaon Jamod-Aasalgaon,Soybean,2015,3064,3250,186,6.070496083550914
Bhandara,Pigeon Pea (Tur),2016,7625,7811,186,2.439344262295082
Achalpur,Wheat(Husked),2014,1455,1641,186,12.783505154639176
Panvel,Ghosali(Bhaji),2014,914,1100,186,20.35010940919037
Shevgaon-Bodhegaon,Bajri,2016,1596,1782,186,11.654135338345865
Dhule,Sorgum(Jawar),2015,1115,1301,186,16.681614349775785
Telhara,Pigeon Pea (Tur),2014,4130,4316,186,4.50363196125908
Kopargaon,Bajri,2016,1471,1657,186,12.644459551325628
Beed,Soybean,2016,3550,3736,186,5.23943661971831
Navapur,Gram,2016,4414,4600,186,4.213864975079293
Shevgaon-Bodhegaon,Bajri,2014,1274,1460,186,14.599686028257457
Akola,Safflower,2016,1975,2161,186,9.417721518987342
Vaijapur,Ground Nut Pods (Dry),2016,5300,5486,186,3.509433962264151
Khamgaon,Sunflower,2015,2969,3155,186,6.2647356012125295
Kolhapur-Laxmipuri,Bajri,2016,1842,2028,186,10.09771986970684
Shirur,Indian Bean,2016,3543,3729,186,5.249788314987299
Panvel,Snake Gourd,2015,1800,1986,186,10.333333333333334
Vaduj,BLACK GRAM,2016,6271,6457,186,2.9660341253388616
Jafrabad,Wheat(Husked),2015,1198,1384,186,15.525876460767947
Purna,Soybean,2014,3162,3348,186,5.882352941176471
Udgir,Gram,2016,5267,5453,186,3.531422061894817
Barshi,Bitter Gourd,2015,263,448,185,70.34220532319392
Baramati,Maize,2015,1056,1241,185,17.518939393939394
Kalamb (Os),Black Gram,2016,6198,6383,185,2.984833817360439
Kalyan,Potato,2015,656,841,185,28.201219512195124
Khamgaon,Wheat(Husked),2015,1267,1452,185,14.601420678768745
Paithan,Soybean,2014,5117,5302,185,3.6153996482313855
Varud-Rajura Bazar,Green Chilli,2016,1070,1255,185,17.289719626168225
Panvel,Bottle Gourd,2015,1129,1314,185,16.386182462356068
Ramtek,ONION,2016,986,1171,185,18.76267748478702
Armori-Desaiganj,Paddy-Unhusked,2016,1745,1930,185,10.601719197707736
Karanja,Bajri,2016,5775,5960,185,3.2034632034632033
Sangrampur,Sorgum(Jawar),2014,992,1177,185,18.649193548387096
Parbhani,Sorgum(Jawar),2015,1552,1737,185,11.920103092783505
Aurangabad,Cabbage,2014,396,581,185,46.717171717171716
Manchar,Kanda Pat,2015,458,643,185,40.39301310043668
Zarijamini,Cotton,2015,3913,4098,185,4.727830309225658
Amarawati,Papai,2016,490,675,185,37.755102040816325
Chimur,Gram,2016,4907,5092,185,3.7701243122070514
Ausa,Safflower,2016,2552,2737,185,7.2492163009404385
Nagpur,Carrot,2016,586,771,185,31.56996587030717
Shirur,Sorgum(Jawar),2015,1381,1566,185,13.396089790007242
Vaduj,Green Gram,2016,5030,5215,185,3.6779324055666005
Ner Parasopant,Pigeon Pea (Tur),2016,8008,8193,185,2.31018981018981
Jamkhed,Bajri,2014,1318,1503,185,14.036418816388467
Bhandara,Wheat(Husked),2015,1394,1579,185,13.27116212338594
Akole,Soybean,2016,2815,3000,185,6.571936056838366
Purna,Wheat(Husked),2016,1486,1671,185,12.449528936742935
Chopda,Bajri,2016,1567,1752,185,11.805998723675813
Taloda,Wheat(Husked),2015,1552,1737,185,11.920103092783505
Ramtek,Onion,2016,929,1114,185,19.91388589881593
Gevrai,Cotton,2014,3820,4005,185,4.842931937172775
Mumbai,Tomato,2016,663,848,185,27.90346907993967
Ner Parasopant,Pigeon Pea (Tur),2015,8766,8951,185,2.110426648414328
Akot,Wheat(Husked),2016,1668,1853,185,11.091127098321342
Umarkhed,Soybean,2015,3150,3335,185,5.873015873015873
Amarawati,Carrot,2016,1100,1285,185,16.818181818181817
Patur,Sorgum(Jawar),2016,1408,1593,185,13.139204545454545
Barshi,Green Chilli,2016,278,463,185,66.54676258992805
Sangrampur-Varvatbakal,Sorgum(Jawar),2016,1300,1485,185,14.23076923076923
Majalgaon,Cotton,2014,3836,4021,185,4.822732012513034
Nagpur,Pumpkin,2015,756,941,185,24.47089947089947
Kalyan,Bottle Gourd,2015,767,952,185,24.11994784876141
Kinwat,Soybean,2015,2986,3171,185,6.195579370395177
Dhule,Soybean,2016,3281,3466,185,5.6385248399878085
Patur,Gram,2016,4710,4895,185,3.9278131634819533
Sonpeth,Gram,2016,4077,4262,185,4.537650233014471
Sinner,GROUND NUT PODS (DRY),2016,4196,4381,185,4.408960915157293
Vai,Bottle Gourd,2015,941,1126,185,19.659936238044633
Khed (Shel Pimpalgaon),Cluster Bean,2016,4267,4452,185,4.335598781345207
Jintur-Bori,Wheat(Husked),2015,1538,1723,185,12.028608582574773
Aurangabad,Papai,2015,469,654,185,39.44562899786781
Ahmedpur,Soybean,2015,3565,3750,185,5.189340813464236
Chikhali,Wheat(Husked),2015,1292,1477,185,14.318885448916408
Murbad,Brinjal,2015,2262,2447,185,8.178603006189213
Udgir,Gram,2016,4360,4545,185,4.243119266055046
Kalmeshwar,Ladies Finger,2015,1230,1415,185,15.040650406504065
Devani,Gram,2016,5067,5252,185,3.6510755871324254
Majalgaon,Soybean,2015,3238,3423,185,5.713403335392218
Paithan,Sorgum(Jawar),2015,1437,1622,185,12.874043145441894
Amalner,GROUND NUT PODS (DRY),2016,4028,4213,185,4.592850049652433
Sengaon,Soybean,2016,3101,3286,185,5.965817478232828
Barshi,MAIZE,2016,1081,1266,185,17.113783533765034
Umarkhed,Gram,2016,5388,5573,185,3.433556050482554
Kalmeshwar,COTTON,2016,4738,4923,185,3.904601097509498
Vaijapur,LINSEED,2016,2040,2225,185,9.068627450980392
Malkapur,Sorgum(Jawar),2014,1070,1255,185,17.289719626168225
Panvel,Cabbage,2015,633,817,184,29.067930489731438
Sailu,Soybean,2016,3401,3585,184,5.410173478388709
Kalmeshwar,Cluster Bean,2015,1690,1874,184,10.887573964497042
Umared,Pigeon Pea (Tur),2015,6694,6878,184,2.7487302061547654
Chandur Bajar,Sorgum(Jawar),2016,1333,1517,184,13.803450862715678
Ghoti,Cabbage,2014,975,1159,184,18.871794871794872
Indapur (Nimgaon Ketki),Sorgum(Jawar),2016,1750,1934,184,10.514285714285714
Jalgaon,GRAM,2016,8204,8388,184,2.242808386153096
Nagpur,Ghosali(Bhaji),2015,724,908,184,25.414364640883978
Ahmedpur,Maize,2015,1234,1418,184,14.910858995137763
Ramtek,Onion,2016,872,1056,184,21.10091743119266
Pune,Bajri,2015,1758,1942,184,10.466439135381115
Nandura,Bajri,2014,1162,1346,184,15.834767641996558
Aurangabad,Carrot,2016,610,794,184,30.16393442622951
Ahmedpur,Soybean,2015,3605,3789,184,5.104022191400833
Shevgaon-Bodhegaon,Bajri,2016,1520,1704,184,12.105263157894736
Umarga,Bajri,2015,1318,1502,184,13.960546282245827
Kalvan,Bajri,2016,1412,1596,184,13.031161473087819
Gevrai,Bajri,2016,1680,1864,184,10.952380952380953
Pusad,Sorgum(Jawar),2016,1345,1529,184,13.680297397769516
Jalna,Wheat(Husked),2014,1467,1651,184,12.542603953646898
Manmad,Wheat(Husked),2015,1396,1580,184,13.180515759312321
Mehkar,Wheat(Husked),2016,1463,1647,184,12.576896787423102
Varud-Rajura Bazar,Sorgum(Jawar),2014,1401,1585,184,13.133476088508209
Kopargaon,Bajri,2016,1483,1667,184,12.407282535401214
Morshi,Pigeon Pea (Tur),2016,5931,6115,184,3.1023436182768505
Nagpur,Cabbage,2014,572,756,184,32.16783216783217
Shahada,Wheat(Husked),2016,1676,1860,184,10.978520286396181
Yeola,Wheat(Husked),2015,1483,1667,184,12.407282535401214
Sonpeth,Sorgum(Jawar),2016,1578,1762,184,11.660329531051964
Amarawati-Fruit And Vegetables,Flower,2016,1754,1938,184,10.4903078677309
Aurangabad,Potato,2015,584,768,184,31.506849315068493
Nagpur,Bottle Gourd,2014,762,946,184,24.146981627296586
Pathardi,Bajri,2015,1259,1443,184,14.614773629864972
Karad,Cabbage,2016,324,508,184,56.79012345679013
Jalgaon Jamod-Aasalgaon,Sorgum(Jawar),2015,1033,1217,184,17.81219748305905
Murbad,Ghosali(Bhaji),2015,3333,3517,184,5.5205520552055205
Raver,Maize,2015,1189,1373,184,15.475189234650967
Amarawati,Tomato,2016,1258,1442,184,14.626391096979333
Dhadgaon,Bhagar/Vari,2016,1591,1775,184,11.565053425518542
Ausa,Gram,2015,3313,3497,184,5.553878659824932
Palghar(Bevur),Wheat(Husked),2015,1798,1982,184,10.233592880978865
Lasalgaon-Vinchur,Bajri,2015,1346,1530,184,13.670133729569093
Mantha,Soybean,2014,2791,2975,184,6.5926191329272665
Ausa,Linseed,2015,4734,4918,184,3.886776510350655
Mumbai,Cabbage,2016,331,515,184,55.58912386706949
Amarawati-Fruit And Vegetables,Beet Root,2016,1533,1717,184,12.002609262883235
Nagpur,Spinach,2014,680,864,184,27.058823529411764
Kej,Sesamum,2016,6267,6451,184,2.936014041806287
Washim-Ansing,Pigeon Pea (Tur),2016,6529,6713,184,2.8181957420738244
Kalyan,Cabbage,2016,758,942,184,24.274406332453825
Fulambri,COTTON,2016,4713,4897,184,3.904095056227456
Sillod,Bajri,2016,1341,1525,184,13.72110365398956
Akot,Maize,2016,1094,1278,184,16.819012797074954
Junnar-Otur,Bottle Gourd,2016,168,352,184,109.52380952380952
Umarkhed,Cotton,2014,3821,4005,184,4.815493326354358
Panvel,Cabbage,2016,783,967,184,23.499361430395915
Nagpur,Chavli (Pala),2016,496,680,184,37.096774193548384
Patan,Cabbage,2015,754,938,184,24.40318302387268
Kej,Rala,2015,1061,1245,184,17.342130065975496
Kalyan,Wheat(Husked),2015,2133,2317,184,8.626347866854196
Tumsar,Wheat(Husked),2014,1331,1515,184,13.82419233658903
Karad,Flower,2015,433,617,184,42.494226327944574
Balapur,Sorgum(Jawar),2015,1117,1300,183,16.38316920322292
Mahagaon,Cotton,2015,3900,4083,183,4.6923076923076925
Amarawati-Fruit And Vegetables,Carrot,2016,867,1050,183,21.10726643598616
Morshi,Gram,2016,4000,4183,183,4.575
Shirur,Bajri,2016,1549,1732,183,11.814073595868303
Pune,Bajri,2015,1871,2054,183,9.780865847140566
Jalgaon Jamod-Aasalgaon,Sorgum(Jawar),2015,1067,1250,183,17.150890346766637
Amarawati-Fruit And Vegetables,CUCUMBER,2016,1742,1925,183,10.505166475315729
Digras,Wheat(Husked),2016,1519,1702,183,12.047399605003292
Patur,GREEN GRAM,2016,4467,4650,183,4.09670920080591
Telhara,Black Gram,2014,4467,4650,183,4.09670920080591
Amarawati-Fruit And Vegetables,Beet Root,2016,817,1000,183,22.399020807833537
Bhokardan,Maize,2016,1328,1511,183,13.78012048192771
Amarawati,Maize,2016,1725,1908,183,10.608695652173912
Karad,Cabbage,2014,467,650,183,39.186295503211994
Jalgaon Jamod-Aasalgaon,Wheat(Husked),2016,1417,1600,183,12.914608327452363
Gangapur,Pigeon Pea (Tur),2015,4945,5128,183,3.7007077856420625
Amarawati-Fruit And Vegetables,Brinjal,2016,1667,1850,183,10.977804439112177
Partur,Sorgum(Jawar),2015,1215,1398,183,15.061728395061728
Partur,Soybean,2015,3607,3790,183,5.073468256168561
Bori,Wheat(Husked),2016,1500,1683,183,12.2
Patan,Cabbage,2016,625,808,183,29.28
Indapur,Bajri,2015,1268,1451,183,14.43217665615142
Nagpur,Carrot,2015,1017,1200,183,17.99410029498525
Kolhapur,Sweet Potato,2015,917,1100,183,19.95637949836423
Shevgaon-Bodhegaon,Sorgum(Jawar),2016,1613,1796,183,11.34531928084315
Ner Parasopant,Soybean,2015,3084,3267,183,5.933852140077821
Dhule,Sorgum(Jawar),2015,1718,1901,183,10.651920838183935
Pusad,Sorgum(Jawar),2016,1513,1696,183,12.09517514871117
Sangrampur,Gram,2014,2350,2533,183,7.787234042553192
Phaltan,Maize,2016,1467,1650,183,12.474437627811861
Kalmeshwar,Cabbage,2015,465,648,183,39.354838709677416
Gevrai,Soybean,2016,3260,3443,183,5.613496932515337
Kalyan,Brinjal,2015,1350,1533,183,13.555555555555555
Morshi,Soybean,2016,3300,3483,183,5.545454545454546
Dhule,Soybean,2014,2945,3128,183,6.213921901528013
Morshi,Gram,2014,2289,2472,183,7.99475753604194
Gangapur,Bajri,2016,1696,1879,183,10.790094339622641
Karad,Cabbage,2016,287,470,183,63.76306620209059
Kurdwadi-Modnimb,Maize,2015,1222,1405,183,14.97545008183306
Ambejogai,Soybean,2016,3550,3733,183,5.154929577464789
Murbad,Paddy-Unhusked,2016,1450,1633,183,12.620689655172415
Taloda,Maize,2015,1070,1253,183,17.102803738317757
Achalpur,Wheat(Husked),2016,1609,1792,183,11.37352392790553
Khamgaon,Sunflower,2015,3050,3233,183,6.0
Amarawati,Bajri,2015,1323,1506,183,13.832199546485262
Ashti (Jalna),Bajri,2015,1347,1530,183,13.585746102449889
Udgir,Gram,2016,4401,4584,183,4.158145875937287
Gangapur,Wheat(Husked),2014,1544,1727,183,11.852331606217616
Sangrampur,Wheat(Husked),2015,1317,1500,183,13.895216400911162
Nandura,Bajri,2014,1237,1420,183,14.793856103476152
Murbad,Bottle Gourd,2015,2600,2783,183,7.038461538461538
Solapur,Banana,2016,210,393,183,87.14285714285714
Manchar,Pavtta,2015,2567,2750,183,7.128944292948968
Amarawati,Cluster Bean,2015,2050,2233,183,8.926829268292684
Kej,Black Gram,2015,8384,8567,183,2.1827290076335877
Pandharpur,Wheat(Husked),2015,1493,1676,183,12.257200267916947
Umari,Soybean,2016,3774,3957,183,4.848966613672496
Kalmeshwar,Walvad,2015,2270,2453,183,8.061674008810572
Panvel,Flower,2015,1717,1900,183,10.65812463599301
Jafrabad,Sorgum(Jawar),2015,950,1133,183,19.263157894736842
Panvel,Ridge Gourd,2015,1667,1850,183,10.977804439112177
Washim,Sorgum(Jawar),2014,1457,1640,183,12.560054907343858
Dound,Maize,2016,1639,1822,183,11.165344722391703
Kej,MAIZE,2016,1114,1297,183,16.427289048473966
Naigaon,Pigeon Pea (Tur),2016,6359,6542,183,2.877810976568643
Kalyan,Bajri,2016,1750,1933,183,10.457142857142857
Shrirampur-Belapur,Maize,2016,942,1125,183,19.426751592356688
Mumbai,TOMATO,2016,465,648,183,39.354838709677416
Jafrabad,Cotton,2015,3725,3908,183,4.912751677852349
Bhandara,Rice(Paddy-Hus),2016,2977,3160,183,6.147127981189117
Akot,Sorgum(Jawar),2016,1179,1362,183,15.521628498727736
Chikhali,Maize,2016,1266,1449,183,14.454976303317535
Khamgaon,Maize,2016,1150,1333,183,15.91304347826087
Aurangabad,Carrot,2014,1717,1900,183,10.65812463599301
Malkapur,Maize,2016,1245,1428,183,14.698795180722891
Mandhal,Green Gram,2016,5277,5460,183,3.467879476975554
Shahapur,Paddy-Unhusked,2015,1390,1573,183,13.16546762589928
Washim,Sorgum(Jawar),2016,1300,1483,183,14.076923076923077
Panvel,Flower,2014,1300,1483,183,14.076923076923077
Shirpur,Maize,2015,1019,1202,183,17.958783120706574
Panvel,Bottle Gourd,2014,1417,1600,183,12.914608327452363
Panvel,Snake Gourd,2014,2117,2300,183,8.644307982994803
Nilanga,Soybean,2016,3525,3708,183,5.191489361702128
Panvel,Tomato,2014,1200,1383,183,15.25
Kalyan,Cabbage,2015,614,797,183,29.80456026058632
Sengaon,Green Gram,2016,4988,5170,182,3.648757016840417
Taloda,Wheat(Husked),2014,1497,1679,182,12.157648630594522
Jafrabad,Wheat(Husked),2015,1218,1400,182,14.942528735632184
Nashik-Devlali,Spinach,2016,136,318,182,133.8235294117647
Amarawati,Ground Nut Pods (Dry),2014,3479,3661,182,5.231388329979879
Kalmeshwar,Spinach,2015,1181,1363,182,15.410668924640136
Rahata,Wheat(Husked),2016,1495,1677,182,12.173913043478262
Mantha,Soybean,2015,3229,3411,182,5.636419944255187
Malegaon,Soybean,2016,3436,3618,182,5.296856810244471
Baramati,Sunflower,2015,3044,3226,182,5.978975032851511
Nandura,Bajri,2016,1207,1389,182,15.07870753935377
Lonar,Sorgum(Jawar),2015,1082,1264,182,16.820702402957487
Devala,Cowpea,2014,2468,2650,182,7.374392220421393
Ramtek,Orange,2015,491,673,182,37.06720977596741
Akhadabalapur,Gram,2015,3435,3617,182,5.298398835516739
Satara,BOTTLE GOURD,2016,496,678,182,36.693548387096776
Amarawati,Bajri,2015,1303,1485,182,13.967766692248658
Malegaon (Washim),Green Gram,2016,4923,5105,182,3.6969327645744463
Sailu,Sorgum(Jawar),2016,1546,1728,182,11.772315653298836
Rajura,Pigeon Pea (Tur),2016,8129,8311,182,2.238897773403863
Amarawati-Fruit And Vegetables,Brinjal,2016,1059,1241,182,17.186024551463646
Barshi,Soybean,2014,2970,3152,182,6.127946127946128
Malkapur,Sorgum(Jawar),2015,1225,1407,182,14.857142857142858
Shevgaon-Bodhegaon,Sorgum(Jawar),2016,1661,1843,182,10.957254665863937
Jafrabad,SOYBEAN,2016,2456,2638,182,7.41042345276873
Parbhani,Gram,2016,4038,4220,182,4.507181773155027
Telhara,Soybean,2015,3585,3767,182,5.076708507670851
Murum,Gram,2016,6191,6373,182,2.939751251817154
Rahata,Lemon,2015,3591,3773,182,5.0682261208577
Manmad,Bajri,2015,1343,1525,182,13.551749813849591
Ramtek,Potato,2016,800,982,182,22.75
Kalmeshwar,Raddish,2015,513,695,182,35.4775828460039
Chakur,GRAM,2016,8317,8499,182,2.1882890465312013
Pune-Pimpri,Cabbage,2014,771,953,182,23.605706874189366
Rahuri-Songaon,Wheat(Husked),2016,1413,1595,182,12.880396319886765
Phaltan,Jaggery,2015,2230,2412,182,8.161434977578475
Majalgaon,Pigeon Pea (Tur),2014,4600,4782,182,3.9565217391304346
Amarawati,Math (Bhaji),2016,1259,1441,182,14.455917394757744
Manmad,MAIZE,2016,1078,1260,182,16.883116883116884
Kalmeshwar,Tomato,2015,1626,1808,182,11.193111931119311
Mehkar,Maize,2016,1223,1405,182,14.881439084219133
Mangalwedha,Maize,2016,1261,1443,182,14.43298969072165
Khed (Shel Pimpalgaon),Green Chilli,2014,3100,3282,182,5.870967741935484
Sangli-Phale Bhajipalam,Water Melon,2015,45,227,182,404.44444444444446
Umared,Soybean,2016,2957,3139,182,6.1548867095028745
Vai,Cabbage,2015,685,867,182,26.56934306569343
Amarawati,Coriander  ,2016,756,938,182,24.074074074074073
Lasalgaon,Maize,2016,1318,1500,182,13.808801213960546
Newasa,Wheat(Husked),2014,1432,1614,182,12.70949720670391
Ner Parasopant,Gram,2015,3935,4116,181,4.5997458703939005
Barshi,Mango,2015,205,386,181,88.29268292682927
Savner,Soybean,2014,2771,2952,181,6.531937928545651
Manmad,Bajri,2015,1408,1589,181,12.855113636363637
Nagpur,Bottle Gourd,2015,519,700,181,34.8747591522158
Nagpur,Raddish,2015,592,773,181,30.574324324324323
Amalner,Green Gram,2016,5764,5945,181,3.140180430256766
Beed,Bajri,2015,1280,1461,181,14.140625
Latur-Murud,Sorgum(Jawar),2016,1565,1746,181,11.565495207667732
Himayatnagar,Wheat(Husked),2015,1260,1441,181,14.365079365079366
Chopda,Maize,2014,924,1105,181,19.58874458874459
Jafrabad,Maize,2015,1044,1225,181,17.337164750957854
Sonpeth,Wheat(Husked),2016,1713,1894,181,10.566258026853474
Sangrampur-Varvatbakal,Maize,2016,1025,1206,181,17.658536585365855
Bhokar,Sorgum(Jawar),2016,1421,1602,181,12.737508796622096
Indapur-Bhigwan,MAIZE,2016,1375,1556,181,13.163636363636364
Lasur Station,Bajri,2015,1323,1504,181,13.681027966742253
Umarga,Gram,2015,4213,4394,181,4.296225967244244
Jalna,Maize,2014,954,1135,181,18.9727463312369
Yeola,Bajri,2016,1748,1929,181,10.354691075514873
Amarawati,Brinjal,2016,914,1095,181,19.803063457330417
Dhamangaon-Rly,Cotton,2016,4311,4492,181,4.198561818603572
Jalgaon,CORIANDER (DRY),2016,6992,7173,181,2.5886727688787183
Korpana,Cotton,2015,3867,4048,181,4.6806309800879236
Jintur,Black Gram,2014,4852,5033,181,3.7304204451772467
Raver,Sorgum(Jawar),2015,1133,1314,181,15.975286849073257
Khamgaon,Bajri,2014,1093,1274,181,16.55992680695334
Kalamb (Yawatmal),Cotton,2014,3843,4024,181,4.709862086911267
Aurangabad,Papai,2015,500,681,181,36.2
Malkapur,Black Gram,2015,7088,7269,181,2.5536117381489842
Nagpur,Potato,2015,721,902,181,25.104022191400833
Raver,Maize,2015,967,1148,181,18.717683557394
Akhadabalapur,Soybean,2015,3055,3236,181,5.924713584288052
Hingoli,Soybean,2016,3559,3740,181,5.085698229839843
Dound,Bajri,2015,1311,1492,181,13.806254767353165
Wardha,Cotton,2016,4458,4639,181,4.060116644235083
Umared,Soybean,2014,2988,3169,181,6.057563587684069
Umared,Linseed,2015,4592,4773,181,3.941637630662021
Amarawati,Beet Root,2016,813,994,181,22.263222632226324
Palghar(Bevur),Wheat(Husked),2015,1942,2123,181,9.320288362512873
Jalna,Maize,2015,1313,1494,181,13.785224676313785
Nagpur,Spinach,2016,233,414,181,77.6824034334764
Nagpur,Pumpkin,2015,565,746,181,32.0353982300885
Nashik,Spinach,2016,178,359,181,101.68539325842697
Shahada,Sorgum(Jawar),2015,1359,1540,181,13.318616629874908
Shevgaon,Cotton,2015,3715,3896,181,4.8721399730821
Bhandara,Wheat(Husked),2015,1496,1677,181,12.098930481283423
Tumsar,Green Gram,2015,6545,6726,181,2.7654698242933535
Ahmednagar,Bajri,2015,1616,1797,181,11.200495049504951
Beed,Sorgum(Jawar),2016,1608,1789,181,11.256218905472636
Umarga,Wheat(Husked),2014,1388,1569,181,13.040345821325648
Mandhal,Gram,2016,5667,5848,181,3.193929768837127
Jalgaon,Cluster Bean,2015,3164,3345,181,5.720606826801517
Shegaon,Sorgum(Jawar),2015,1025,1206,181,17.658536585365855
Parli-Vaijnath,Gram,2015,3541,3722,181,5.111550409488845
Gondpimpri,Pigeon Pea (Tur),2015,5200,5381,181,3.480769230769231
Nandura,Sorgum(Jawar),2016,1438,1619,181,12.58692628650904
Kada,Bajri,2015,1250,1431,181,14.48
Pune-Pimpri,Cabbage,2016,542,723,181,33.39483394833948
Patan,Brinjal,2015,703,884,181,25.746799431009958
Kalmeshwar,Flower,2015,1263,1444,181,14.330958036421219
Varud,Pigeon Pea (Tur),2016,5900,6081,181,3.0677966101694913
Savner,Gram,2014,2370,2550,180,7.594936708860759
Jafrabad,Sorgum(Jawar),2016,1240,1420,180,14.516129032258064
Mohol,Gram,2015,3407,3587,180,5.283240387437629
Ambad(Vadi Godri),Soybean,2015,3000,3180,180,6.0
Khamgaon,Sunflower,2015,2966,3146,180,6.068779501011464
Telhara,Gram,2016,4169,4349,180,4.317582153993763
Chalisgaon,Sorgum(Jawar),2016,1398,1578,180,12.875536480686696
Murbad,Brinjal,2015,1780,1960,180,10.112359550561798
Ramtek,Cabbage,2016,635,815,180,28.346456692913385
Umarga,Sorgum(Jawar),2014,1477,1657,180,12.186865267433987
Baramati,Maize,2015,1384,1564,180,13.00578034682081
Mandhal,Paddy-Unhusked,2014,1770,1950,180,10.169491525423728
Kalmeshwar,Chavli (Shenga ),2014,2088,2268,180,8.620689655172415
Murbad,Bitter Gourd,2015,5240,5420,180,3.435114503816794
Ausa,Bajri,2016,1371,1551,180,13.12910284463895
Washim,Sorgum(Jawar),2015,1440,1620,180,12.5
Murbad,Bitter Gourd,2015,3172,3352,180,5.674653215636822
Panvel,Flower,2015,940,1120,180,19.148936170212767
Panvel,Cucumber,2015,2120,2300,180,8.49056603773585
Nashik-Devlali,Ambat Chuka,2016,166,346,180,108.43373493975903
Phaltan,Jaggery,2015,2635,2815,180,6.83111954459203
Shirpur,Sorgum(Jawar),2015,1354,1534,180,13.293943870014772
Shegaon,Wheat(Husked),2015,1335,1515,180,13.48314606741573
Murbad,Ghosali(Bhaji),2014,1980,2160,180,9.090909090909092
Achalpur,Wheat(Husked),2015,1575,1755,180,11.428571428571429
Panvel,Bottle Gourd,2015,1180,1360,180,15.254237288135593
Akot,Soybean,2015,3120,3300,180,5.769230769230769
Phaltan,Potato,2016,1730,1910,180,10.404624277456648
Panvel,Snake Gourd,2015,1920,2100,180,9.375
Udgir,Sorgum(Jawar),2014,995,1175,180,18.09045226130653
Panvel,Tomato,2015,2040,2220,180,8.823529411764707
Shevgaon,Wheat(Husked),2016,1677,1857,180,10.73345259391771
Pune-Manjri,Curry Leaves,2016,4320,4500,180,4.166666666666667
Panvel,Brinjal,2014,1920,2100,180,9.375
Balapur,Wheat(Husked),2016,1540,1720,180,11.688311688311689
Gevrai,Maize,2015,1001,1181,180,17.982017982017982
Jafrabad,Soybean,2015,3100,3280,180,5.806451612903226
Lonar,Sorgum(Jawar),2014,1210,1390,180,14.87603305785124
Murbad,Capsicum,2015,4720,4900,180,3.8135593220338984
Ghansawangi,Soybean,2014,3080,3260,180,5.8441558441558445
Jalgaon Jamod-Aasalgaon,Soybean,2015,3129,3309,180,5.752636625119846
Rahata,Soybean,2015,3530,3710,180,5.09915014164306
Ahmednagar,Green Gram,2016,7340,7520,180,2.4523160762942777
Dondaicha,Bajri,2015,1044,1224,180,17.24137931034483
Kalyan,Orange,2016,1420,1600,180,12.67605633802817
Vaduj,Cowpea,2014,3160,3340,180,5.69620253164557
Akhadabalapur,Gram,2015,3090,3270,180,5.825242718446602
Ramtek,Orange,2015,600,780,180,30.0
Aurangabad,Cabbage,2016,460,640,180,39.130434782608695
Umared,Lang,2016,2167,2347,180,8.306414397784955
Akhadabalapur,Soybean,2015,3200,3380,180,5.625
Murbad,Ladies Finger,2015,3460,3640,180,5.202312138728324
Telhara,Gram,2015,3969,4149,180,4.535147392290249
Koregaon,Sorgum(Jawar),2015,1760,1940,180,10.227272727272727
Patan,Flower,2016,620,800,180,29.032258064516128
Umared,Sorgum(Jawar),2014,1770,1950,180,10.169491525423728
Murbad,Ghosali(Bhaji),2015,3360,3540,180,5.357142857142857
Amarawati,Ladies Finger,2016,1047,1227,180,17.191977077363898
Kej,Bajri,2015,1564,1744,180,11.508951406649617
Kolhapur,SNAKE GOURD,2016,300,480,180,60.0
Amarawati,Tomato,2015,1180,1360,180,15.254237288135593
Bhokar,Turmeric,2014,4425,4605,180,4.067796610169491
Nagpur,Spinach,2015,533,713,180,33.771106941838646
Partur,Wheat(Husked),2014,1384,1564,180,13.00578034682081
Parshiwani,Gram,2016,3980,4160,180,4.522613065326633
Amarawati,Capsicum,2016,1180,1360,180,15.254237288135593
Amarawati,Beet Root,2016,1407,1587,180,12.793176972281449
Murbad,Tomato,2015,2260,2440,180,7.964601769911504
Rahata,Gram,2016,3856,4036,180,4.668049792531121
Rahata,Ground Nut Pods (Dry),2016,4080,4260,180,4.411764705882353
Kalyan,Cabbage,2015,760,940,180,23.68421052631579
Taloda,Maize,2014,966,1146,180,18.633540372670808
Osmanabad,Wheat(Husked),2014,1477,1657,180,12.186865267433987
Chimur,Gram,2016,4010,4190,180,4.488778054862843
Pune-Pimpri,Cabbage,2016,610,790,180,29.508196721311474
Sinner,Rice(Paddy-Hus),2016,1321,1501,180,13.626040878122634
Shrirampur,Bajri,2014,1340,1520,180,13.432835820895523
Amarawati,Wheat(Husked),2016,1703,1883,180,10.569583088667057
Kalyan,Cabbage,2016,816,996,180,22.058823529411764
Paithan,WHEAT(HUSKED),2016,2019,2199,180,8.915304606240714
Amarawati,Cabbage,2016,1860,2040,180,9.67741935483871
Patur,Sorgum(Jawar),2015,1130,1310,180,15.929203539823009
Vaijapur,Cowpea,2016,4900,5080,180,3.673469387755102
Pune-Pimpri,Beet Root,2015,840,1020,180,21.428571428571427
Umarga,Sunflower,2014,2910,3090,180,6.185567010309279
Murbad,Capsicum,2015,3580,3760,180,5.027932960893855
Amarawati-Fruit And Vegetables,Bitter Gourd,2016,1987,2167,180,9.058882737795672
Patur,Soybean,2015,3070,3250,180,5.863192182410423
Murbad,Ghevda,2015,5340,5520,180,3.3707865168539324
Nagpur,Pumpkin,2014,685,865,180,26.277372262773724
Sindi,Wheat(Husked),2016,1350,1530,180,13.333333333333334
Kalmeshwar,Ladies Finger,2015,1564,1744,180,11.508951406649617
Bhivandi,Rice(Paddy-Hus),2015,1590,1770,180,11.320754716981131
Parbhani,Gram,2015,4008,4187,179,4.466067864271457
Sinner,Bajri,2015,1242,1421,179,14.412238325281804
Udgir,Sorgum(Jawar),2016,1283,1462,179,13.951675759937647
Umarga,Pigeon Pea (Tur),2016,8333,8512,179,2.1480859234369376
Chikhali,Maize,2016,1194,1373,179,14.991624790619765
Kada,Wheat(Husked),2015,1709,1888,179,10.473961380924518
Khed (Shel Pimpalgaon),Brinjal,2014,1429,1608,179,12.526242127361792
Bhokar,Wheat(Husked),2014,1338,1517,179,13.378176382660687
Pusad,Sorgum(Jawar),2016,1477,1656,179,12.119160460392688
Khamgaon,Maize,2016,1156,1335,179,15.484429065743944
Patur,Sorgum(Jawar),2015,1421,1600,179,12.596762843068262
Vani,Gram,2014,1992,2171,179,8.985943775100402
Nandura,Maize,2015,1006,1185,179,17.793240556660038
Morshi,Soybean,2016,3205,3384,179,5.585023400936038
Shevgaon,Wheat(Husked),2014,1461,1640,179,12.251882272416154
Ahmednagar,Bajri,2016,1825,2004,179,9.808219178082192
Aurangabad,Papai,2016,284,463,179,63.028169014084504
Amarawati,Cucumber,2016,1371,1550,179,13.056163384390956
Loha,Sorgum(Jawar),2015,1530,1709,179,11.699346405228757
Shirpur,Sorgum(Jawar),2016,1767,1946,179,10.130164119977362
Telhara,Soybean,2016,3488,3667,179,5.131880733944954
Murbad,Paddy-Unhusked,2014,1707,1886,179,10.486233157586408
Lasalgaon-Vinchur,Maize,2016,1305,1484,179,13.71647509578544
Dhule,Matki,2015,6707,6886,179,2.6688534367079173
Amarawati-Fruit And Vegetables,Tomato,2016,984,1163,179,18.191056910569106
Shevgaon-Bodhegaon,Gram,2016,4277,4456,179,4.185176525602057
Amalner,Sorgum(Jawar),2016,1571,1750,179,11.394016549968173
Shevgaon-Bodhegaon,Gram,2016,4973,5152,179,3.5994369595817415
Rajura,Cotton,2014,3824,4003,179,4.680962343096234
Buldhana,Soybean,2015,3270,3449,179,5.474006116207951
Kalmeshwar,Walvad,2015,1688,1867,179,10.604265402843602
Jalgaon,Chavli (Shenga ),2014,4550,4729,179,3.934065934065934
Indapur,Bajri,2015,1412,1591,179,12.677053824362606
Chikhali,Maize,2016,1211,1390,179,14.781172584640792
Savner,Sorgum(Jawar),2015,1163,1342,179,15.391229578675839
Bhokar,SORGUM(JAWAR),2016,1404,1583,179,12.749287749287749
Nandgaon,Sorgum(Jawar),2015,1468,1647,179,12.193460490463215
Sillod,Soybean,2015,3164,3343,179,5.657395701643489
Pachora,MAIZE,2016,1055,1234,179,16.966824644549764
Umared,Linseed,2015,4630,4809,179,3.8660907127429804
Kej,Safflower,2015,3001,3180,179,5.964678440519827
Kalmeshwar,Spinach,2015,500,679,179,35.8
Mehkar,Sorgum(Jawar),2015,1147,1326,179,15.605928509154316
Hinganghat,WHEAT(HUSKED),2016,1734,1913,179,10.322952710495963
Ausa,Black Gram,2014,5034,5212,178,3.5359555025824396
Ghoti,Bitter Gourd,2016,1200,1378,178,14.833333333333334
Sakri,Maize,2016,1326,1504,178,13.423831070889895
Kalmeshwar,Methi (Bhaji),2015,1776,1954,178,10.022522522522523
Rahuri-Vambori,Wheat(Husked),2015,1509,1687,178,11.795891318754142
Murbad,Bitter Gourd,2015,5433,5611,178,3.2762746180747286
Murbad,Bitter Gourd,2015,5579,5757,178,3.1905359383402043
Nagpur,Flower,2015,509,687,178,34.9705304518664
Ausa,Safflower,2016,2635,2813,178,6.755218216318785
Tuljapur,Gram,2016,4177,4355,178,4.261431649509217
Kalmeshwar,Ladies Finger,2014,1995,2173,178,8.922305764411028
Nampur,Bajri,2016,1546,1724,178,11.513583441138422
Sangrampur,Maize,2014,888,1066,178,20.045045045045047
Aurangabad,Carrot,2016,545,723,178,32.6605504587156
Barshi,Bitter Gourd,2014,195,373,178,91.28205128205128
Nandgaon Khandeshwar,Wheat(Husked),2016,1538,1716,178,11.573472041612483
Purna,Soybean,2015,3075,3253,178,5.788617886178862
Armori-Desaiganj,Paddy-Unhusked,2015,1470,1648,178,12.108843537414966
Latur,Sorgum(Jawar),2016,1614,1792,178,11.028500619578686
Umarkhed-Danki,Gram,2016,5378,5556,178,3.309780587579026
Jalgaon Jamod-Aasalgaon,Soybean,2014,3061,3239,178,5.815093106827834
Jalgaon Jamod-Aasalgaon,Wheat(Husked),2014,1311,1489,178,13.577421815408085
Vai,Cabbage,2015,715,893,178,24.895104895104897
Digras,SOYBEAN,2016,2598,2776,178,6.851424172440339
Vaduj,Gram,2016,4139,4317,178,4.30055568978014
Dudhani,Wheat(Husked),2015,1496,1674,178,11.898395721925134
Solapur,Papai,2014,285,463,178,62.45614035087719
Basmat (Kurunda),SOYBEAN,2016,2628,2806,178,6.773211567732115
Vai,Brinjal,2015,544,722,178,32.720588235294116
Basmat,Soybean,2015,3142,3320,178,5.665181413112667
Pathardi,Cotton,2015,3731,3909,178,4.770838917180381
Pathardi,Sorgum(Jawar),2015,1550,1728,178,11.483870967741936
Kej,Bajri,2015,1507,1685,178,11.81154611811546
Jafrabad,Cotton,2014,3829,4007,178,4.64873335074432
Taloda,Maize,2016,1158,1336,178,15.3713298791019
Tumsar,Castor Seed,2015,3230,3408,178,5.510835913312693
Malegaon (Washim),Wheat(Husked),2015,1473,1651,178,12.08418194161575
Pachora,Sorgum(Jawar),2016,1357,1535,178,13.117170228445099
Vaduj,Sorgum(Jawar),2016,2200,2378,178,8.090909090909092
Tumsar,Wheat(Husked),2015,1284,1462,178,13.862928348909657
Malegaon (Washim),Soybean,2016,3576,3754,178,4.977628635346756
Barshi-Vairag,Soybean,2015,3558,3736,178,5.002810567734683
Sangamner,Sorgum(Jawar),2015,1728,1906,178,10.300925925925926
Karad,Jaggery,2016,3765,3943,178,4.727755644090306
Karad,Tomato,2016,383,561,178,46.47519582245431
Vaduj,Soybean,2014,3144,3322,178,5.661577608142494
Jafrabad,Maize,2015,1139,1317,178,15.62774363476734
Vaduj,Soybean,2014,3122,3300,178,5.701473414477899
Brahmpuri,Paddy-Unhusked,2016,2050,2228,178,8.682926829268293
Amarawati,Sunflower,2015,2750,2928,178,6.472727272727273
Vani,Cotton,2016,4381,4559,178,4.062999315224834
Pune-Pimpri,Beet Root,2016,1211,1389,178,14.698596201486374
Rahata,Carrot,2015,1033,1211,178,17.23136495643756
Mehkar,Sorgum(Jawar),2015,1128,1306,178,15.78014184397163
Jawala-Bajar,Pigeon Pea (Tur),2016,8179,8357,178,2.1763051717813915
Yeola,Bajri,2015,1382,1560,178,12.879884225759769
Amarawati,Gram,2016,6582,6760,178,2.704345183834701
Taloda,Wheat(Husked),2015,1346,1524,178,13.224368499257057
Nira,Jaggery,2015,2917,3095,178,6.102159753171066
Solapur,Soybean,2015,3504,3682,178,5.079908675799087
Parshiwani,Paddy-Unhusked,2015,1842,2020,178,9.66340933767644
Kej,Soybean,2016,3045,3223,178,5.845648604269294
Kej,Sorgum(Jawar),2016,1561,1739,178,11.402946828955798
Vaduj,Gram,2015,2778,2956,178,6.407487401007919
Bhokardan,Cotton,2016,4199,4377,178,4.2391045487020715
Purna,Wheat(Husked),2015,1437,1614,177,12.31732776617954
Nilanga,Wheat(Husked),2015,1453,1630,177,12.18169304886442
Indapur,Bajri,2016,1826,2003,177,9.693318729463307
Chopda,Gram,2014,2545,2722,177,6.954813359528488
Khamgaon,Green Gram,2015,5254,5431,177,3.368861819566045
Dhule,Sorgum(Jawar),2016,1330,1507,177,13.308270676691729
Lasur Station,Soybean,2015,3673,3850,177,4.818949087939014
Gangapur,Pigeon Pea (Tur),2015,5195,5372,177,3.4071222329162656
Devala,Black Gram,2015,8013,8190,177,2.208910520404343
Gangakhed,Soybean,2015,3560,3737,177,4.97191011235955
Washim,Green Gram,2015,5830,6007,177,3.0360205831903944
Kalmeshwar,Cotton,2016,4316,4493,177,4.101019462465246
Parola,Bajri,2016,1614,1791,177,10.966542750929367
Nagpur,Beet Root,2015,588,765,177,30.102040816326532
Patan,TOMATO,2016,685,862,177,25.83941605839416
Yeola,Wheat(Husked),2015,1530,1707,177,11.568627450980392
Patan,Flower,2015,667,844,177,26.53673163418291
Yawal,Maize,2016,1054,1231,177,16.793168880455408
Ausa,Sunflower,2014,2988,3165,177,5.923694779116466
Ramtek,Tomato,2016,652,829,177,27.14723926380368
Vai,Cabbage,2016,930,1107,177,19.032258064516128
Satana,Bajri,2015,1344,1521,177,13.169642857142858
Vai,Cucumber,2015,818,995,177,21.638141809290953
Vaduj,Wheat(Husked),2016,1767,1944,177,10.0169779286927
Nandura,BAJRI,2016,1220,1397,177,14.508196721311476
Amarawati-Fruit And Vegetables,Cucumber,2016,1176,1353,177,15.051020408163266
Amalner,Bajri,2016,1537,1714,177,11.51594014313598
Kalmeshwar,Bottle Gourd,2016,451,628,177,39.246119733924616
Telhara,Gram,2014,2419,2596,177,7.317073170731708
Shirur,Sorgum(Jawar),2015,1346,1523,177,13.150074294205051
Malkapur,MAIZE,2016,1107,1284,177,15.989159891598916
Amalner,Maize,2015,1100,1277,177,16.09090909090909
Wardha,Soybean,2015,3318,3495,177,5.334538878842676
Kolhapur-Laxmipuri,Maize,2016,1669,1846,177,10.605152786099461
Mehkar,Sorgum(Jawar),2015,986,1163,177,17.95131845841785
Nashik,Mint,2016,250,427,177,70.8
Mehkar,Soybean,2015,3072,3249,177,5.76171875
Murbad,Cabbage,2015,1856,2033,177,9.536637931034482
Dondaicha-Sindkheda,Bajri,2016,1411,1588,177,12.54429482636428
Jalkot,Soybean,2016,3648,3825,177,4.8519736842105265
Bhandara,Wheat(Husked),2014,1410,1587,177,12.553191489361701
Vaijapur,Maize,2016,975,1152,177,18.153846153846153
Panvel,Brinjal,2014,1067,1244,177,16.588566073102154
Tumsar,Sarsav,2016,3402,3579,177,5.202821869488536
Ramtek,Cabbage,2016,401,578,177,44.13965087281795
Murbad,Bottle Gourd,2015,2000,2177,177,8.85
Pandharpur,BANANA,2016,664,841,177,26.656626506024097
Parbhani,Sorgum(Jawar),2015,1550,1727,177,11.419354838709678
Amarawati,Cabbage,2016,1146,1323,177,15.44502617801047
Vai,Bottle Gourd,2015,856,1033,177,20.677570093457945
Kinwat,Gram,2015,3167,3344,177,5.588885380486265
Kalyan,Onion,2016,547,724,177,32.35831809872029
Jalgaon,Gram,2014,2728,2905,177,6.488269794721408
Osmanabad,Wheat(Husked),2016,1952,2129,177,9.067622950819672
Aurangabad,Papai,2015,408,585,177,43.38235294117647
Vaduj,Sorgum(Jawar),2015,2467,2644,177,7.174706120794487
Sakri,Bajri,2016,1077,1254,177,16.434540389972145
Hingoli,Soybean,2016,3641,3818,177,4.8613018401538035
Amarawati,Brinjal,2015,967,1144,177,18.30403309203723
Amalner,Maize,2016,1259,1436,177,14.058776806989675
Pune-Pimpri,Ridge Gourd,2014,3592,3769,177,4.927616926503341
Tumsar,Wheat(Husked),2014,1375,1552,177,12.872727272727273
Ausa,Safflower,2015,2504,2681,177,7.068690095846645
Barshi-Vairag,Wheat(Husked),2015,1895,2071,176,9.287598944591029
Indapur (Nimgaon Ketki),Bajri,2016,1675,1851,176,10.507462686567164
Pandharpur,Gram,2016,4003,4179,176,4.396702473145141
Savner,Wheat(Husked),2016,1472,1648,176,11.956521739130435
Satana,Wheat(Husked),2015,1528,1704,176,11.518324607329843
Kalmeshwar,Cabbage,2016,354,530,176,49.717514124293785
Akhadabalapur,Soybean,2016,3400,3576,176,5.176470588235294
Mumbai-Onion And Potato Mkt,POTATO,2016,1094,1270,176,16.087751371115175
Deglur,Green Gram,2016,6200,6376,176,2.838709677419355
Dondaicha,Chillies(Red),2014,2078,2254,176,8.46968238691049
Chikhali,Wheat(Husked),2015,1438,1614,176,12.239221140472878
Amalner,Wheat(Husked),2016,1738,1914,176,10.126582278481013
Solapur,Banana,2016,139,315,176,126.61870503597122
Chalisgaon,Wheat(Husked),2015,1399,1575,176,12.580414581844174
Nagpur,Cabbage,2016,424,600,176,41.509433962264154
Indapur-Bhigwan,Sunflower,2016,2825,3001,176,6.230088495575221
Tumsar,Paddy-Unhusked,2015,1656,1832,176,10.628019323671497
Akhadabalapur,Soybean,2014,3026,3202,176,5.816259087904825
Mumbai,Cabbage,2014,488,664,176,36.0655737704918
Indapur-Bhigwan,Sunflower,2015,2700,2876,176,6.518518518518518
Kalmeshwar,Cluster Bean,2015,1807,1983,176,9.739900387382402
Shevgaon,Wheat(Husked),2015,1468,1644,176,11.989100817438691
Pandharpur,Banana,2015,732,908,176,24.043715846994534
Nagpur,Tomato,2015,661,837,176,26.626323751891075
Chandur Bajar,Wheat(Husked),2014,1400,1576,176,12.571428571428571
Ambejogai,Sorgum(Jawar),2014,2168,2344,176,8.118081180811808
Phaltan,Potato,2016,1062,1238,176,16.572504708097927
Hingoli,Soybean,2015,3153,3329,176,5.581985410719949
Pathardi,Gram,2015,4131,4307,176,4.260469619946744
Shevgaon-Bodhegaon,Bajri,2016,1521,1697,176,11.571334648257725
Lonar,Wheat(Husked),2015,1379,1555,176,12.762871646120377
Patur,Sorgum(Jawar),2016,1372,1548,176,12.82798833819242
Lonar,Sorgum(Jawar),2015,1184,1360,176,14.864864864864865
Kalmeshwar,Orange,2014,1000,1176,176,17.6
Nashik-Devlali,Spinach,2016,384,560,176,45.833333333333336
Gevrai,Soybean,2016,3313,3489,176,5.312405674615152
Tumsar,Wheat(Husked),2014,1311,1487,176,13.424866514111365
Kannad,Bajri,2015,1092,1268,176,16.117216117216117
Chalisgaon,Bajri,2015,1173,1349,176,15.004262574595055
Karad,CABBAGE,2016,348,524,176,50.57471264367816
Pusad,Pigeon Pea (Tur),2014,4292,4468,176,4.100652376514446
Khed (Shel Pimpalgaon),Ladies Finger,2016,1263,1439,176,13.93507521773555
Pulgaon,Soybean,2015,3398,3574,176,5.179517363154797
Pathardi,Sorgum(Jawar),2016,1651,1827,176,10.660205935796487
Pune-Pimpri,Cabbage,2016,602,778,176,29.235880398671096
Partur,Gram,2015,3166,3342,176,5.559065066329754
Sangamner,Bajri,2016,1538,1714,176,11.443433029908972
Washim,Sorgum(Jawar),2015,1196,1372,176,14.715719063545151
Kille Dharur,Maize,2015,1548,1724,176,11.369509043927648
Manmad,Wheat(Husked),2016,1518,1694,176,11.594202898550725
Bori,SORGUM(JAWAR),2016,1837,2013,176,9.580838323353293
Partur,Cotton,2015,4151,4327,176,4.239942182606601
Panvel,Tomato,2015,1700,1875,175,10.294117647058824
Akola,Maize,2015,1063,1238,175,16.462841015992474
Chikhali,Maize,2016,1133,1308,175,15.445719329214475
Aurangabad,Awala,2015,600,775,175,29.166666666666668
Vaijapur,Nagali,2015,1375,1550,175,12.727272727272727
Tuljapur,Pigeon Pea (Tur),2016,8703,8878,175,2.0108008732620934
Yeotmal,COTTON,2016,4753,4928,175,3.681885125184094
Mandhal,Paddy-Unhusked,2014,1884,2059,175,9.288747346072187
Varora,Cotton,2015,3872,4047,175,4.519628099173554
Goregaon,Paddy-Unhusked,2014,1453,1628,175,12.044046799724708
Akole,MAIZE,2016,1392,1567,175,12.57183908045977
Akole,Maize,2016,1400,1575,175,12.5
Ghoti,Cabbage,2016,842,1017,175,20.783847980997624
Rahata,Bajri,2015,1133,1308,175,15.445719329214475
Telhara,Cotton,2016,4938,5113,175,3.5439449169704336
Pune-Pimpri,Chavli (Shenga ),2015,1750,1925,175,10.0
Pandharpur,Sorgum(Jawar),2015,1878,2053,175,9.318423855165069
Koregaon,Potato,2016,825,1000,175,21.21212121212121
Umarkhed,Wheat(Husked),2015,1400,1575,175,12.5
Akola,Sorgum(Jawar),2015,1307,1482,175,13.389441469013008
Bhandara,Rice(Paddy-Hus),2016,2600,2775,175,6.730769230769231
Nanded,Pigeon Pea (Tur),2015,6200,6375,175,2.8225806451612905
Murbad,Bottle Gourd,2015,2475,2650,175,7.070707070707071
Kinwat,Sorgum(Jawar),2015,1075,1250,175,16.27906976744186
Rahata,Gram,2015,3484,3659,175,5.022962112514351
Panvel,Bottle Gourd,2015,550,725,175,31.818181818181817
Lonand,Gram,2015,3350,3525,175,5.223880597014926
Jalkot,Soybean,2014,3076,3251,175,5.689206762028609
Panvel,Bottle Gourd,2015,750,925,175,23.333333333333332
Jalna,Wheat(Husked),2015,1572,1747,175,11.132315521628499
Brahmpuri,Paddy-Unhusked,2016,2178,2353,175,8.034894398530762
Khultabad,Cotton,2015,4100,4275,175,4.2682926829268295
Bhokardan,Cotton,2016,4147,4322,175,4.219918013021461
Panvel,Cabbage,2015,925,1100,175,18.91891891891892
Panvel,Cabbage,2015,1075,1250,175,16.27906976744186
Panvel,Cabbage,2015,925,1100,175,18.91891891891892
Jalna,Soybean,2015,3042,3217,175,5.752794214332676
Ramtek,Chavli (Pala),2016,825,1000,175,21.21212121212121
Panvel,Ghosali(Bhaji),2015,1825,2000,175,9.58904109589041
Ausa,Soybean,2015,3455,3630,175,5.065123010130246
Akkolkot,Wheat(Husked),2016,2026,2201,175,8.637709772951629
Chimur,Gram,2014,2520,2695,175,6.944444444444445
Murbad,Capsicum,2015,3250,3425,175,5.384615384615385
Sindkhed Raja,Soybean,2016,3600,3775,175,4.861111111111111
Sangamner,Green Gram,2016,6030,6205,175,2.902155887230514
Bhiwapur,Gram,2015,4013,4188,175,4.360827311238475
Ahmednagar,Maize(Corn.),2015,950,1125,175,18.42105263157895
Parli-Vaijnath,Sorgum(Jawar),2015,1507,1682,175,11.61247511612475
Ramtek,Gram,2016,3650,3825,175,4.794520547945205
Pathardi,Bajri,2014,1254,1429,175,13.955342902711324
Patan,Cabbage,2016,467,642,175,37.47323340471092
Satana,Bajri,2015,1304,1479,175,13.420245398773005
Patan,Green Chilli,2015,439,614,175,39.863325740318906
Sindkhed Raja,Neem-Seed,2016,350,525,175,50.0
Ausa,Soybean,2014,3167,3342,175,5.525734133249132
Kalyan,Carrot,2015,1250,1425,175,14.0
Shrirampur,BLACK GRAM,2016,4463,4638,175,3.9211292852341475
Kalyan,Cabbage,2015,658,833,175,26.595744680851062
Kalvan,Maize,2014,1065,1240,175,16.431924882629108
Jalgaon Jamod-Aasalgaon,Sorgum(Jawar),2014,1144,1319,175,15.297202797202797
Jalgaon Jamod,Maize,2016,1038,1213,175,16.859344894026975
Digras,Wheat(Husked),2016,1743,1918,175,10.040160642570282
Jalgaon Jamod,Soybean,2015,3288,3463,175,5.322384428223844
Mahagaon,Wheat(Husked),2016,1500,1675,175,11.666666666666666
Partur,Bajri,2015,1086,1261,175,16.114180478821364
Jalgaon Jamod,Soybean,2014,3006,3181,175,5.82168995342648
Jintur,Wheat(Husked),2016,1625,1800,175,10.76923076923077
Malegaon (Washim),Sorgum(Jawar),2015,1450,1625,175,12.068965517241379
Kalyan,Bottle Gourd,2015,725,900,175,24.137931034482758
Jalgaon,Banana,2015,260,435,175,67.3076923076923
Umarkhed-Danki,Wheat(Husked),2015,1400,1575,175,12.5
Umarkhed,Soybean,2016,3550,3725,175,4.929577464788732
Bhivandi,Wheat(Husked),2015,1375,1550,175,12.727272727272727
Murtizapur,Wheat(Husked),2016,1533,1708,175,11.415525114155251
Parbhani,Wheat(Husked),2016,1600,1775,175,10.9375
Chimur,Paddy-Unhusked,2014,1996,2171,175,8.76753507014028
Bhivandi,Wheat(Husked),2015,1575,1750,175,11.11111111111111
Umarkhed-Danki,Wheat(Husked),2015,1400,1575,175,12.5
Solapur,Pigeon Pea (Tur),2016,5666,5841,175,3.0885986586657252
Hadgaon-Tamsa,Soybean,2016,3338,3513,175,5.24266027561414
Parli-Vaijnath,Soybean,2014,3184,3359,175,5.4962311557788945
Bhokar,Sorgum(Jawar),2016,1325,1500,175,13.20754716981132
Jalna-Badnapur,Maize,2016,1150,1325,175,15.217391304347826
Ausa,Safflower,2015,2451,2626,175,7.139942880456957
Aurangabad,Potato,2015,608,783,175,28.782894736842106
Jalgaon Jamod-Aasalgaon,Wheat(Husked),2015,1175,1350,175,14.893617021276595
Jintur-Bori,Pigeon Pea (Tur),2014,4401,4576,175,3.9763690070438535
Patur,Sorgum(Jawar),2016,1343,1518,175,13.030528667163068
Patur,Sorgum(Jawar),2016,1517,1692,175,11.535926170072512
Buldhana,Soybean,2015,3500,3675,175,5.0
Patur,Wheat(Husked),2015,1421,1596,175,12.31527093596059
Kalmeshwar,Cabbage,2016,273,448,175,64.1025641025641
Kopargaon,Maize,2014,990,1165,175,17.67676767676768
Chikhali,Wheat(Husked),2015,1416,1591,175,12.358757062146893
Manmad,Maize,2015,1320,1495,175,13.257575757575758
Sillod,Soybean,2015,3225,3400,175,5.426356589147287
Karmala,Maize,2016,1576,1751,175,11.104060913705585
Amarawati,Green Chilli,2016,1383,1558,175,12.653651482284888
Amarawati,Carrot,2016,1400,1575,175,12.5
Manmad,Bajri,2015,1191,1366,175,14.693534844668346
Indapur,Pigeon Pea (Tur),2016,7338,7513,175,2.3848460070863995
Kinwat,Cotton,2016,4318,4493,175,4.052802223251505
Indapur (Nimgaon Ketki),Sorgum(Jawar),2016,1129,1304,175,15.500442869796279
Vaduj,Wheat(Husked),2016,1638,1813,175,10.683760683760683
Osmanabad,Ground Nut Pods (Dry),2014,2975,3150,175,5.882352941176471
Mangrulpeer,Black Gram,2015,5300,5475,175,3.30188679245283
Amarawati,Math (Bhaji),2015,2588,2763,175,6.761978361669243
Pune-Manjri,Green-Peas,2016,7450,7625,175,2.348993288590604
Kalyan,Onion,2016,633,808,175,27.646129541864138
Islampur,Brinjal,2016,153,328,175,114.37908496732027
Barshi-Vairag,Gram,2016,6250,6425,175,2.8
Varud-Rajura Bazar,MAIZE,2016,1200,1375,175,14.583333333333334
Nandgaon,Maize,2014,942,1117,175,18.577494692144374
Kalmeshwar,Flower,2015,1533,1708,175,11.415525114155251
Ramtek,Pumpkin,2015,700,875,175,25.0
Shrigonda,Bajri,2016,1725,1900,175,10.144927536231885
Barshi,Mosambi,2015,300,475,175,58.333333333333336
Shrirampur,Banana,2015,425,600,175,41.1764705882353
Kalamb (Os),Sunflower,2016,3134,3309,175,5.583918315252074
Vaduj,Gram,2015,3300,3475,175,5.303030303030303
Vaduj,Ghevda Seed,2015,3250,3425,175,5.384615384615385
Barshi,Custard Apple,2015,213,388,175,82.15962441314554
Chandur Bajar,Sorgum(Jawar),2016,1425,1600,175,12.280701754385966
Mauda,Wheat(Husked),2016,1475,1650,175,11.864406779661017
Morshi,Gram,2014,2275,2450,175,7.6923076923076925
Amarawati-Fruit And Vegetables,Pumpkin,2016,1200,1375,175,14.583333333333334
Sillod-Bharadi,Soybean,2015,2900,3075,175,6.0344827586206895
Barshi,Kanda Pat,2015,200,375,175,87.5
Amarawati-Fruit And Vegetables,Green Chilli,2016,1000,1175,175,17.5
Amarawati-Fruit And Vegetables,Cucumber,2016,1725,1900,175,10.144927536231885
Kannad,Wheat(Husked),2015,1467,1642,175,11.92910702113156
Chandur Bajar,Wheat(Husked),2015,1425,1600,175,12.280701754385966
Ghansawangi,Bajri,2014,1425,1600,175,12.280701754385966
Amarawati,Wheat(Husked),2016,1727,1902,175,10.13317892298784
Taloda,SORGUM(JAWAR),2016,1290,1465,175,13.565891472868216
Rahata,Potato,2016,1650,1825,175,10.606060606060606
Karanja,Sesamum,2015,6000,6175,175,2.9166666666666665
Ghansawangi,Cotton,2015,3725,3900,175,4.697986577181208
Umarkhed,Gram,2015,4900,5075,175,3.5714285714285716
Ashti (Jalna),Green Gram,2016,4495,4670,175,3.8932146829810903
Beed,Green Gram,2016,4850,5025,175,3.6082474226804124
Jafrabad,Soybean,2015,3413,3588,175,5.127453852915324
Kalyan,Bajri,2016,1858,2033,175,9.418729817007534
Vaijapur,Sorgum(Jawar),2015,1450,1625,175,12.068965517241379
Nanded,Green Gram,2016,6075,6250,175,2.880658436213992
Chikhali,Maize,2015,1013,1188,175,17.275419545903258
Umarkhed,Wheat(Husked),2015,1400,1575,175,12.5
Pandharkawada,Soybean,2015,3275,3450,175,5.343511450381679
Khamgaon,Ground Nut Pods (Dry),2014,3430,3605,175,5.1020408163265305
Sangali,Wheat(Unhusked),2016,3769,3944,175,4.643141416821438
Sangamner,Bajri,2014,1300,1475,175,13.461538461538462
Sindi (Selu),Sorgum(Jawar),2016,1000,1175,175,17.5
Chandrapur,Green Gram,2015,6000,6175,175,2.9166666666666665
Murtizapur,Wheat(Husked),2016,1622,1796,174,10.727496917385944
Mehkar,Sorgum(Jawar),2015,1154,1328,174,15.077989601386482
Telhara,Black Gram,2014,4223,4397,174,4.120293630120767
Nashik,Mint,2016,164,338,174,106.09756097560975
Ahmedpur,MAIZE,2016,1264,1438,174,13.765822784810126
Karad,Cabbage,2016,374,548,174,46.524064171122994
Nanded,Gram,2015,3869,4043,174,4.497286120444559
Jintur,Soybean,2015,3107,3281,174,5.600257483102672
Parli-Vaijnath,Sorgum(Jawar),2015,1523,1697,174,11.424819435325016
Nandgaon Khandeshwar,Wheat(Husked),2016,1438,1612,174,12.100139082058414
Kalmeshwar,Brinjal,2014,1672,1846,174,10.4066985645933
Bhivandi,Other Vegetables,2016,1102,1276,174,15.789473684210526
Kopargaon,Sorgum(Jawar),2016,1446,1620,174,12.033195020746888
Raver,Gram,2015,3742,3916,174,4.649919828968466
Pathari,Bajri,2016,1371,1545,174,12.691466083150985
Partur,Soybean,2015,3417,3591,174,5.092186128182616
Murum,Sorgum(Jawar),2016,2155,2329,174,8.074245939675174
Nandura,Sorgum(Jawar),2016,1253,1427,174,13.886671987230647
Jamkhed,Bajri,2014,1329,1503,174,13.09255079006772
Ausa,Safflower,2014,2286,2460,174,7.611548556430447
Gevrai,Bajri,2014,1268,1442,174,13.722397476340694
Nagpur,Flower,2015,570,744,174,30.526315789473685
Vaijapur,Bajri,2016,1701,1875,174,10.229276895943563
Shevgaon-Bodhegaon,Sorgum(Jawar),2016,1655,1829,174,10.513595166163142
Baramati,Maize,2014,1053,1227,174,16.524216524216524
Kalamb (Os),Sorgum(Jawar),2016,1534,1708,174,11.342894393741851
Hinganghat,Wheat(Husked),2016,1423,1597,174,12.227687983134224
Jalna,Jaggery,2016,2681,2855,174,6.490115628496829
Amarawati,Brinjal,2016,1033,1207,174,16.844143272023235
Armori-Desaiganj,Paddy-Unhusked,2014,1450,1624,174,12.0
Vaijapur,Wheat(Husked),2016,1673,1847,174,10.400478182904962
Pune-Pimpri,Onion,2016,604,778,174,28.807947019867548
Kalmeshwar,Green Chilli,2015,3196,3370,174,5.444305381727159
Udgir,Sorgum(Jawar),2014,990,1164,174,17.575757575757574
Aurangabad,Banana,2015,212,386,174,82.0754716981132
Parbhani,Green Gram,2016,4661,4835,174,3.7331044840163057
Amalner,Wheat(Husked),2016,1648,1822,174,10.558252427184467
Shevgaon-Bodhegaon,Pigeon Pea (Tur),2015,4785,4959,174,3.6363636363636362
Udgir,Wheat(Husked),2015,1312,1486,174,13.262195121951219
Kalmeshwar,BRINJAL,2016,341,515,174,51.02639296187683
Chandur Rly.,Soybean,2014,3086,3259,173,5.605962410887881
Akot,Soybean,2015,3213,3386,173,5.3843759726112665
Nagpur,Cabbage,2015,562,735,173,30.78291814946619
Nagpur,Brinjal,2015,665,838,173,26.015037593984964
Shevgaon-Bodhegaon,Wheat(Husked),2016,1803,1976,173,9.595119245701609
Khamgaon,Sorgum(Jawar),2016,1309,1482,173,13.216195569136746
Umarga,Sorgum(Jawar),2015,1462,1635,173,11.833105335157319
Zarijamini,Cotton,2015,3877,4050,173,4.462213051328346
Latur,Maize,2014,1079,1252,173,16.033364226135312
Samudrapur,Cotton,2016,4473,4646,173,3.867650346523586
Tuljapur,Sorgum(Jawar),2015,1082,1255,173,15.98890942698706
Aurangabad,Wheat(Husked),2014,1519,1692,173,11.389071757735353
Ner Parasopant,Wheat(Husked),2015,1293,1466,173,13.379737045630318
Shirur,Sorgum(Jawar),2015,1545,1718,173,11.197411003236246
Sailu,Gram,2016,4280,4453,173,4.042056074766355
Ner Parasopant,Gram,2015,3441,3614,173,5.027608253414705
Nagpur,Spinach,2015,527,700,173,32.82732447817837
Chakur,Gram,2016,4048,4221,173,4.273715415019763
Gangapur,Wheat(Husked),2015,1663,1836,173,10.402886349969934
Chalisgaon,Sunflower,2015,2807,2980,173,6.163163519771999
Khed-Chakan,Cabbage,2016,281,454,173,61.56583629893238
Taloda,Wheat(Husked),2015,1513,1686,173,11.434236615994713
Partur,Gram,2015,4199,4372,173,4.120028578232913
Bhokar,Cotton,2015,3670,3843,173,4.713896457765667
Karanja,Sorgum(Jawar),2016,1415,1588,173,12.226148409893993
Nagpur,Flower,2015,677,850,173,25.553914327917283
Jalna,Wheat(Husked),2015,1520,1693,173,11.381578947368421
Sillod,Soybean,2015,3400,3573,173,5.088235294117647
Partur,Sorgum(Jawar),2016,1284,1457,173,13.473520249221183
Malegaon,Maize,2015,1054,1227,173,16.413662239089184
Purna,SOYBEAN,2016,2601,2774,173,6.6512879661668585
Baramati,Pigeon Pea (Tur),2016,6375,6548,173,2.7137254901960786
Sillod-Bharadi,MAIZE,2016,981,1154,173,17.63506625891947
Murbad,Brinjal,2015,3367,3540,173,5.138105138105138
Jafrabad,Wheat(Husked),2015,1315,1488,173,13.155893536121672
Mehkar,Sorgum(Jawar),2016,1159,1332,173,14.926660914581536
Murtizapur,Wheat(Husked),2015,1307,1480,173,13.236419280795715
Hingoli,Soybean,2015,3331,3504,173,5.193635544881417
Kej,Gram,2015,3873,4046,173,4.466821585334366
Sillod,Wheat(Husked),2016,1645,1818,173,10.516717325227964
Dondaicha,Sorgum(Jawar),2015,1702,1875,173,10.164512338425382
Chopda,Ground Nut Pods (Dry),2014,3311,3484,173,5.225007550588946
Sangali,WHEAT(UNHUSKED),2016,3491,3664,173,4.955600114580349
Khamgaon,Maize,2015,1125,1298,173,15.377777777777778
Sillod,Soybean,2016,3280,3453,173,5.274390243902439
Amarawati,Bajri,2015,1297,1470,173,13.338473400154202
Vaduj,Gram,2015,3933,4106,173,4.398677854055428
Mumbai,Curry Leaves,2016,1041,1214,173,16.618635926993274
Latur,Green Gram,2015,8100,8273,173,2.1358024691358026
Murbad,Ladies Finger,2015,3118,3291,173,5.54842847979474
Nampur,Pigeon Pea (Tur),2016,4297,4470,173,4.026064696299744
Kalmeshwar,Brinjal,2015,675,848,173,25.62962962962963
Lonar,Soybean,2015,3314,3487,173,5.220277610138805
Ramtek,BRINJAL,2016,327,500,173,52.90519877675841
Jintur,Wheat(Husked),2015,1465,1638,173,11.80887372013652
Malkapur,Bajri,2015,1072,1245,173,16.138059701492537
Washim,Sorgum(Jawar),2014,1456,1629,173,11.881868131868131
Kannad,Sorgum(Jawar),2015,1252,1425,173,13.817891373801917
Kalmeshwar,Flower,2014,1669,1842,173,10.3654883163571
Parli-Vaijnath,Sorgum(Jawar),2015,1739,1912,173,9.948246118458885
Amarawati,Tomato,2016,747,920,173,23.15930388219545
Sillod,Bajri,2016,1384,1556,172,12.427745664739884
Murtizapur,Wheat(Husked),2016,2533,2705,172,6.790367153572839
Bhokar,Wheat(Husked),2016,1614,1786,172,10.656753407682777
Jafrabad,Cotton,2015,3754,3926,172,4.581779435269047
Jalgaon Jamod-Aasalgaon,Wheat(Husked),2015,1307,1479,172,13.159908186687069
Jalna-Badnapur,Maize,2015,1103,1275,172,15.593834995466908
Ausa,Safflower,2014,2342,2514,172,7.344150298889838
Aurangabad,Cabbage,2015,321,493,172,53.58255451713396
Jamkhed,Wheat(Husked),2016,2193,2365,172,7.8431372549019605
Karad,TOMATO,2016,320,492,172,53.75
Patur,Sorgum(Jawar),2016,1564,1736,172,10.997442455242966
Kalvan,Maize,2015,1140,1312,172,15.087719298245615
Savner,Soybean,2015,2783,2955,172,6.180380883938196
Sindi (Selu),Cotton,2014,3903,4075,172,4.406866512938765
Sonpeth,Cotton,2016,4423,4595,172,3.8887632828397014
Chikhali,Sorgum(Jawar),2015,1200,1372,172,14.333333333333334
Amarawati,Spinach,2016,914,1086,172,18.818380743982495
Taloda,Wheat(Husked),2016,1617,1789,172,10.636982065553495
Solapur,Bajri,2016,1402,1574,172,12.268188302425107
Murtizapur,Wheat(Husked),2016,2126,2298,172,8.090310442144872
Khamgaon,Sorgum(Jawar),2015,1113,1285,172,15.45372866127583
Bhusaval,Sorgum(Jawar),2014,1213,1385,172,14.179719703215168
Navapur,Flower,2015,1011,1183,172,17.012858555885263
Savner,Wheat(Husked),2015,1329,1501,172,12.942061700526711
Jalgaon Jamod-Aasalgaon,Wheat(Husked),2016,1357,1529,172,12.675018422991894
Shahapur,Paddy-Unhusked,2015,1462,1634,172,11.764705882352942
Panvel,Tomato,2014,914,1086,172,18.818380743982495
Jintur,Sorgum(Jawar),2015,1308,1480,172,13.149847094801224
Mangrulpeer,Sorgum(Jawar),2014,1245,1417,172,13.815261044176706
Jintur,Soybean,2015,3433,3605,172,5.010195164579085
Nagpur,Ghosali(Bhaji),2016,514,686,172,33.463035019455255
Gangapur,Bajri,2015,1196,1368,172,14.381270903010034
Gondpimpri,Pigeon Pea (Tur),2015,3750,3922,172,4.586666666666667
Manchar,Shepu,2015,198,370,172,86.86868686868686
Kolhapur-Laxmipuri,Gr.Nut Kernels,2016,8624,8796,172,1.9944341372912802
Varud-Rajura Bazar,Wheat(Husked),2014,1331,1503,172,12.922614575507138
Parli-Vaijnath,Ground Nut Pods (Dry),2015,3631,3803,172,4.736987055907464
Jintur,Green Gram,2016,4141,4313,172,4.153586090316349
Dondaicha,Maize,2015,1372,1544,172,12.536443148688047
Shevgaon-Bodhegaon,Bajri,2016,1374,1546,172,12.518195050946142
Vasai,Paddy-Unhusked,2015,1490,1662,172,11.543624161073826
Kej,Bajri,2015,1385,1557,172,12.418772563176896
Gondpimpri,Gram,2015,3614,3786,172,4.759269507470946
Gadchiroli,Paddy-Unhusked,2016,1826,1998,172,9.419496166484118
Jalkot,Soybean,2016,3621,3793,172,4.750069041701187
Tuljapur,Maize,2015,1123,1295,172,15.316117542297418
Kalmeshwar,Methi (Bhaji),2015,988,1160,172,17.408906882591094
Gadchiroli,Paddy-Unhusked,2014,2040,2212,172,8.431372549019608
Chimur,Paddy-Unhusked,2015,1800,1972,172,9.555555555555555
Lasalgaon,Maize,2015,1329,1501,172,12.942061700526711
Ralegaon,Cotton,2016,4505,4677,172,3.8179800221975584
Gondpimpri,Soybean,2014,2882,3054,172,5.968077723802915
Umarga,Soybean,2016,3565,3737,172,4.82468443197756
Mehkar,Wheat(Husked),2016,1626,1798,172,10.578105781057811
Kalyan,Cabbage,2016,550,722,172,31.272727272727273
Nagpur,Pumpkin,2015,640,812,172,26.875
Shevgaon,Wheat(Husked),2016,1636,1808,172,10.513447432762836
Shirur,Bajri,2016,1659,1831,172,10.367691380349608
Chimur,Gram,2016,4063,4235,172,4.233325129214866
Sangamner,Soybean,2016,3758,3930,172,4.576902607770091
Kalvan,Wheat(Husked),2016,1677,1849,172,10.256410256410257
Dondaicha,Bajri,2014,1281,1453,172,13.427010148321624
Nandura,Bajri,2016,1495,1667,172,11.505016722408026
Jalgaon Jamod,Wheat(Husked),2014,1257,1429,172,13.683373110580748
Bhandara,Rice(Paddy-Hus),2016,2858,3030,172,6.018194541637508
Jalgaon Jamod,Maize,2014,914,1086,172,18.818380743982495
Digras,Soybean,2016,3140,3312,172,5.477707006369426
Beed,Sorgum(Jawar),2015,1585,1757,172,10.85173501577287
Tumsar,Other Cereals,2016,4087,4259,172,4.2084658673843895
Jawala-Bajar,Pigeon Pea (Tur),2016,8165,8337,172,2.106552357624005
Ausa,Safflower,2016,2702,2874,172,6.365655070318283
Jalgaon Jamod-Aasalgaon,Wheat(Husked),2015,1300,1471,171,13.153846153846153
Kalmeshwar,Cucumber,2014,1355,1526,171,12.619926199261993
Jalgaon Jamod-Aasalgaon,Maize,2016,1050,1221,171,16.285714285714285
Jalgaon Jamod-Aasalgaon,Wheat(Husked),2015,1300,1471,171,13.153846153846153
Shirur,Sorgum(Jawar),2015,1308,1479,171,13.073394495412844
Telhara,Gram,2014,2478,2649,171,6.900726392251816
Akot,Wheat(Husked),2015,1375,1546,171,12.436363636363636
Dharangaon,Black Gram,2016,7092,7263,171,2.4111675126903553
Hingoli,Soybean,2015,3191,3362,171,5.3588216859918525
Samudrapur,Cotton,2015,4187,4358,171,4.084069739670408
Vaduj,Bajri,2016,1629,1800,171,10.497237569060774
Sillod,Wheat(Husked),2016,1633,1804,171,10.471524800979791
Yeotmal,Ground Nut Pods (Dry),2015,5515,5686,171,3.100634632819583
Amarawati,Potato,2016,1434,1605,171,11.92468619246862
Murbad,Bottle Gourd,2014,1443,1614,171,11.85031185031185
Vaduj,Bajri,2016,1500,1671,171,11.4
Yeola,Bajri,2014,1272,1443,171,13.443396226415095
Telhara,Wheat(Husked),2015,1201,1372,171,14.238134887593672
Shirpur,Maize,2015,1040,1211,171,16.442307692307693
Jalna,Maize,2015,1098,1269,171,15.573770491803279
Amarawati,Sunflower,2015,2742,2913,171,6.236323851203501
Kalmeshwar,Tomato,2016,303,474,171,56.43564356435643
Nandura,Black Gram,2015,6986,7157,171,2.44775264815345
Shevgaon,Wheat(Husked),2014,1405,1576,171,12.170818505338078
Jalgaon,Bor,2015,1943,2114,171,8.800823468862584
Akhadabalapur,Gram,2016,3886,4057,171,4.400411734431292
Baramati,Maize,2016,1619,1790,171,10.562075355157505
Mumbai,Snake Gourd,2014,642,813,171,26.635514018691588
Nandgaon,Maize,2015,1273,1444,171,13.432835820895523
Chikhali,Sorgum(Jawar),2014,1284,1455,171,13.317757009345794
Kej,Wheat(Husked),2015,1943,2114,171,8.800823468862584
Umarkhed,Soybean,2016,3486,3657,171,4.905335628227195
Kalyan,Bottle Gourd,2016,792,963,171,21.59090909090909
Nanded,SOYBEAN,2016,2545,2716,171,6.719056974459725
Himayatnagar,Soybean,2016,3205,3376,171,5.335413416536661
Aurangabad,Maize(Corn.),2015,400,571,171,42.75
Chikhali,Maize,2016,1314,1485,171,13.013698630136986
Kalmeshwar,Ladies Finger,2015,1633,1804,171,10.471524800979791
Chikhali,Maize,2016,1147,1318,171,14.908456843940716
Chikhali,Bajri,2016,1461,1632,171,11.704312114989733
Sangamner,Sorgum(Jawar),2015,1950,2121,171,8.76923076923077
Latur-Murud,Gram,2015,3872,4043,171,4.416322314049586
Lonar,Wheat(Husked),2016,1624,1795,171,10.529556650246306
Kalvan,Soybean,2014,3205,3376,171,5.335413416536661
Gevrai,Cotton,2014,3873,4044,171,4.415182029434547
Chimur,Soybean,2016,3159,3330,171,5.413105413105413
Pandharpur,Sorgum(Jawar),2014,1864,2035,171,9.17381974248927
Vaduj,Soybean,2015,3243,3414,171,5.272895467160037
Bhokar,Wheat(Husked),2015,1350,1521,171,12.666666666666666
Jafrabad,Maize,2015,1250,1421,171,13.68
Chalisgaon,Maize,2015,1335,1506,171,12.808988764044944
Lonar,Soybean,2016,3564,3735,171,4.797979797979798
Kannad,Bajri,2015,1050,1221,171,16.285714285714285
Jalgaon Jamod-Aasalgaon,Sorgum(Jawar),2014,1100,1271,171,15.545454545454545
Sangrampur,Sorgum(Jawar),2015,975,1146,171,17.53846153846154
Manmad,Bajri,2016,1454,1625,171,11.760660247592847
Jalgaon Jamod-Aasalgaon,Gram,2014,2343,2514,171,7.298335467349552
Kalamb (Yawatmal),Cotton,2014,3884,4055,171,4.402677651905252
Manchar,Coriander  ,2015,456,626,170,37.280701754385966
Malkapur,Sorgum(Jawar),2016,1375,1545,170,12.363636363636363
Buldhana,Maize,2016,1433,1603,170,11.863224005582694
Dudhani,Sorgum(Jawar),2016,1853,2023,170,9.174311926605505
Murbad,Bottle Gourd,2015,2060,2230,170,8.25242718446602
Bhusaval,Gram,2016,3921,4091,170,4.335628666156593
Savner,Ground Nut Pods (Dry),2015,4156,4326,170,4.090471607314726
Mangalwedha,Green Gram,2014,4776,4946,170,3.559463986599665
Umarga,Bajri,2014,1145,1315,170,14.847161572052402
Kille Dharur,Soybean,2015,3130,3300,170,5.431309904153355
Rahata,Walvad,2015,920,1090,170,18.47826086956522
Chalisgaon,Maize,2016,1600,1770,170,10.625
Kalvan,Wheat(Husked),2016,1609,1779,170,10.565568676196396
Khed (Shel Pimpalgaon),Green Chilli,2015,2157,2327,170,7.881316643486324
Dhadgaon,Bhagar/Vari,2016,1530,1700,170,11.11111111111111
Gangapur,Wheat(Husked),2015,1599,1769,170,10.631644777986242
Manmad,Coriander  ,2016,568,738,170,29.929577464788732
Kannad,Bajri,2016,1468,1638,170,11.580381471389646
Mudkhed,Wheat(Husked),2016,1342,1512,170,12.667660208643815
Ghatanji,Pigeon Pea (Tur),2015,5554,5724,170,3.060857039971192
Barshi Takli,Cotton,2015,4130,4300,170,4.116222760290557
Devala,Maize,2015,1033,1203,170,16.456921587608907
Sangamner,Sorgum(Jawar),2014,1780,1950,170,9.55056179775281
Bhandara,Rice(Paddy-Hus),2014,3527,3697,170,4.819960306209243
Mumbai,Cabbage,2015,604,774,170,28.14569536423841
Kalyan,ONION,2016,639,809,170,26.604068857589983
Gadchiroli,Paddy-Unhusked,2014,2040,2210,170,8.333333333333334
Balapur,Soybean,2016,3570,3740,170,4.761904761904762
Dudhani,Wheat(Husked),2016,1626,1796,170,10.45510455104551
Kalvan,Wheat(Husked),2016,1495,1665,170,11.37123745819398
Varud-Rajura Bazar,Sorgum(Jawar),2015,1193,1363,170,14.249790444258172
Udgir,Green Gram,2015,7143,7313,170,2.379952400951981
Chimur,Gram,2016,4002,4172,170,4.2478760619690155
Pathardi,Green Gram,2016,4850,5020,170,3.5051546391752577
Pathardi,Bajri,2016,1263,1433,170,13.460015835312747
Pachora,Sunflower,2015,3207,3377,170,5.300904271905208
Hingoli,Wheat(Husked),2014,1465,1635,170,11.604095563139932
Kalamb (Os),Green Gram,2015,7552,7722,170,2.2510593220338984
Umarkhed-Danki,Soybean,2016,3513,3683,170,4.839168801594079
Sinner,Wheat(Husked),2015,1526,1696,170,11.140235910878113
Raver,Pigeon Pea (Tur),2016,7686,7856,170,2.2118136872235232
Jintur-Bori,Gram,2014,2317,2487,170,7.3370738023305995
Amarawati,Green Chilli,2015,1760,1930,170,9.659090909090908
Achalpur,Soybean,2015,3340,3510,170,5.089820359281437
Ramtek,Spinach,2016,410,580,170,41.46341463414634
Yeola,Bajri,2015,1295,1465,170,13.127413127413128
Ahmedpur,Sunflower,2016,2951,3121,170,5.760759064723822
Nagpur,Bottle Gourd,2015,465,635,170,36.55913978494624
Nagpur,Cabbage,2015,663,833,170,25.641025641025642
Himayatnagar,Soybean,2016,3270,3440,170,5.198776758409786
Naigaon,Sorgum(Jawar),2016,1400,1570,170,12.142857142857142
Vadgaon Peth,Cabbage,2015,363,533,170,46.83195592286501
Nagpur,Maize,2015,1242,1412,170,13.687600644122384
Parola,Wheat(Husked),2016,1300,1470,170,13.076923076923077
Nagpur,Spinach,2015,438,608,170,38.81278538812786
Kalmeshwar,Cabbage,2016,283,453,170,60.07067137809187
Telhara,Gram,2014,2408,2578,170,7.059800664451827
Jawala-Bajar,Wheat(Husked),2015,1620,1790,170,10.493827160493828
Amarawati,Cucumber,2016,1712,1882,170,9.929906542056075
Indapur,Banana,2016,666,836,170,25.525525525525527
Newasa,Wheat(Husked),2016,1520,1690,170,11.18421052631579
Akkolkot,Maize,2016,1272,1442,170,13.364779874213836
Jalgaon,Gram,2014,2986,3156,170,5.693235097119893
Sonpeth,SORGUM(JAWAR),2016,1981,2151,170,8.581524482584554
Achalpur,Wheat(Husked),2015,1548,1718,170,10.981912144702843
Akluj,Wheat(Husked),2015,1543,1713,170,11.01749837977965
Umarkhed,Cotton,2014,3871,4041,170,4.391630069749419
Nandura,Sorgum(Jawar),2015,1021,1191,170,16.65034280117532
Kalvan,Soybean,2015,3534,3704,170,4.810413129598189
Shrirampur,Bajri,2015,1477,1647,170,11.509817197020988
Akot,Cotton,2016,4871,5041,170,3.4900431122972697
Chikhali,Maize,2015,1056,1226,170,16.098484848484848
Jintur-Bori,Sorgum(Jawar),2016,1454,1624,170,11.691884456671252
Anajngaon Surji,Pigeon Pea (Tur),2014,4810,4980,170,3.5343035343035343
Shirur,Indian Bean,2016,3400,3570,170,5.0
Shirur,Gram,2015,2561,2731,170,6.6380320187426785
Pathardi,Sorgum(Jawar),2016,1586,1756,170,10.718789407313997
Washim,Sorgum(Jawar),2016,1513,1682,169,11.16986120290813
Dondaicha-Sindkheda,Wheat(Husked),2016,1492,1661,169,11.327077747989277
Armori-Desaiganj,Paddy-Unhusked,2015,1500,1669,169,11.266666666666667
Kalmeshwar,Methi (Bhaji),2014,1507,1676,169,11.214333112143331
Telhara,Soybean,2015,3253,3422,169,5.195204426683062
Indapur (Nimgaon Ketki),Wheat(Husked),2016,1351,1520,169,12.509252405625462
Tumsar,Other Cereals,2016,3801,3970,169,4.446198368850302
Ghatanji,COTTON,2016,4778,4947,169,3.537044788614483
Amarawati,Brinjal,2016,862,1031,169,19.605568445475637
Raver,Sorgum(Jawar),2014,1234,1403,169,13.695299837925445
Satara,TOMATO,2016,483,652,169,34.989648033126294
Kalyan,Bottle Gourd,2016,631,800,169,26.782884310618066
Majalgaon,Soybean,2015,3071,3240,169,5.503093454900684
Shirpur,Bajri,2015,990,1159,169,17.07070707070707
Barshi-Vairag,Soybean,2016,3525,3694,169,4.794326241134752
Ahmedpur,Sorgum(Jawar),2016,1618,1787,169,10.444993819530284
Barshi,Paddy-Unhusked,2014,1494,1663,169,11.311914323962517
Akkolkot,Bajri,2016,1296,1465,169,13.040123456790123
Rahuri-Vambori,Wheat(Husked),2016,1649,1818,169,10.248635536688901
Parbhani,Sorgum(Jawar),2016,1606,1775,169,10.523038605230386
Ghoti,Tomato,2014,806,975,169,20.967741935483872
Latur-Murud,Soybean,2015,3156,3325,169,5.354879594423321
Armori-Desaiganj,Paddy-Unhusked,2016,1733,1902,169,9.751875360646277
Amarawati,Gram,2015,4531,4700,169,3.72986095784595
Telhara,Cotton,2016,4219,4388,169,4.0056885517895235
Paithan,Gram,2015,3728,3897,169,4.533261802575107
Kalmeshwar,Tomato,2015,575,744,169,29.391304347826086
Satana,Bajri,2015,1396,1565,169,12.106017191977077
Bhiwapur,Paddy-Unhusked,2015,2163,2332,169,7.813222376329173
Bhiwapur,Soybean,2015,3500,3669,169,4.828571428571428
Samudrapur,Cotton,2015,3801,3970,169,4.446198368850302
Shahada,Black Gram,2014,5084,5253,169,3.3241542092840284
Pune-Pimpri,Onion,2016,644,813,169,26.242236024844722
Mul,Paddy-Unhusked,2015,1776,1945,169,9.515765765765765
Hingoli,Black Gram,2015,8099,8268,169,2.086677367576244
Himayatnagar,Sorgum(Jawar),2015,1040,1209,169,16.25
Jalgaon Jamod-Aasalgaon,Soybean,2014,3075,3244,169,5.495934959349594
Shevgaon-Bodhegaon,Sorgum(Jawar),2016,1662,1831,169,10.16847172081829
Bhokar,Soybean,2016,3415,3584,169,4.948755490483163
Nilanga,Soybean,2014,3150,3319,169,5.365079365079365
Savner,Soybean,2014,3065,3234,169,5.513866231647635
Kalamb (Os),Sorgum(Jawar),2016,1582,1751,169,10.6826801517067
Shegaon,Wheat(Husked),2015,1334,1503,169,12.668665667166417
Nagpur,Cucumber,2015,562,731,169,30.0711743772242
Kalamb (Os),Soybean,2016,3342,3511,169,5.056852184320766
Amarawati,Tomato,2016,862,1031,169,19.605568445475637
Shegaon,Wheat(Husked),2015,1343,1512,169,12.583767684288905
Gangapur,Bajri,2016,1748,1917,169,9.668192219679634
Murbad,Tomato,2015,2869,3038,169,5.890554200069711
Digras,Soybean,2015,3541,3710,169,4.772663089522734
Rahata,Sorgum(Jawar),2016,1442,1611,169,11.719833564493758
Amarawati,Green-Peas,2016,2408,2577,169,7.01827242524917
Shirur,Bajri,2016,1591,1760,169,10.622250157133879
Digras,Gram,2016,4033,4202,169,4.190428961071163
Aheri,Soybean,2015,3278,3446,168,5.1250762660158635
Ausa,Safflower,2015,2448,2616,168,6.862745098039215
Digras,Soybean,2016,3369,3537,168,4.986642920747997
Beed,Bajri,2015,1297,1465,168,12.952968388589051
Kannad,Bajri,2016,1476,1644,168,11.382113821138212
Sonpeth,Soybean,2015,3431,3599,168,4.896531623433401
Narkhed,Cotton,2015,4158,4326,168,4.040404040404041
Yeotmal,Cotton,2015,4005,4173,168,4.194756554307116
Sangali,SOYBEAN,2016,2800,2968,168,6.0
Satana,Maize,2015,1123,1291,168,14.959928762243988
Phaltan,Maize,2016,1333,1501,168,12.603150787696924
Barshi-Vairag,Wheat(Husked),2016,1970,2138,168,8.527918781725889
Tasgaon,Soybean,2015,3385,3553,168,4.963072378138848
Umared,Pigeon Pea (Tur),2014,3390,3558,168,4.95575221238938
Kalvan,Bajri,2015,1329,1497,168,12.641083521444695
Ghatanji,Soybean,2016,3389,3557,168,4.957214517556801
Kurdwadi-Modnimb,Maize,2015,1179,1347,168,14.249363867684478
Yeola,Maize,2014,975,1143,168,17.23076923076923
Jawala-Bajar,Wheat(Husked),2015,1514,1682,168,11.096433289299869
Mahagaon,SOYBEAN,2016,2696,2864,168,6.231454005934718
Umarga,Sorgum(Jawar),2014,1581,1749,168,10.62618595825427
Majalgaon,Safflower,2016,2269,2437,168,7.40414279418246
Dhamangaon-Rly,Wheat(Husked),2015,1340,1508,168,12.537313432835822
Mangrulpeer,Black Gram,2016,6763,6931,168,2.4841046872689634
Nandura,Maize,2014,1202,1370,168,13.976705490848586
Ghoti,Cabbage,2014,1609,1777,168,10.441267868241143
Kada,Bajri,2015,1295,1463,168,12.972972972972974
Beed,Soybean,2016,3544,3712,168,4.74040632054176
Parola,Wheat(Husked),2015,1369,1537,168,12.27173119065011
Amalner,Gram,2016,4122,4290,168,4.075691411935954
Parli-Vaijnath,Wheat(Husked),2015,1479,1647,168,11.359026369168356
Ausa,Sunflower,2014,3002,3170,168,5.596269153897402
Malegaon,Maize,2015,1055,1223,168,15.924170616113743
Kalmeshwar,Chavli (Shenga ),2015,1273,1440,167,13.118617439120188
Gevrai,Matki,2015,7100,7267,167,2.352112676056338
Vaduj,Ghevda Seed,2016,3000,3167,167,5.566666666666666
Achalpur,Gram,2014,2467,2634,167,6.769355492501013
Gevrai,Soybean,2015,3004,3171,167,5.559254327563249
Barshi,Fodder,2015,630,797,167,26.50793650793651
Gevrai,Soybean,2015,3049,3216,167,5.477205641193834
Jafrabad,Sorgum(Jawar),2015,933,1100,167,17.89924973204716
Chikhali,Wheat(Husked),2014,1338,1505,167,12.481315396113603
Narkhed,COTTON,2016,4736,4903,167,3.5261824324324325
Jafrabad,Sorgum(Jawar),2014,933,1100,167,17.89924973204716
Nandura,Sorgum(Jawar),2015,1011,1178,167,16.51829871414441
Nashik-Devlali,Kardai,2016,346,513,167,48.26589595375722
Kalyan,Potato,2016,922,1089,167,18.112798264642084
Kalyan,Potato,2016,700,867,167,23.857142857142858
Nashik,Mint,2016,278,445,167,60.07194244604317
Mandhal,Paddy-Unhusked,2015,1817,1984,167,9.190974133186572
Jalna,Wheat(Husked),2014,1408,1575,167,11.860795454545455
Kalyan,Sorgum(Jawar),2016,2000,2167,167,8.35
Nashik-Devlali,Kardai,2016,447,614,167,37.360178970917225
Telhara,Green Gram,2015,5433,5600,167,3.0738082090925825
Raver,Wheat(Husked),2015,1496,1663,167,11.163101604278076
Shegaon,Wheat(Husked),2015,1347,1514,167,12.397921306607275
Barshi,Capsicum,2015,248,415,167,67.33870967741936
Kalmeshwar,Brinjal,2015,517,684,167,32.30174081237911
Achalpur,Gram,2015,2833,3000,167,5.894811154253442
Bhokardan,Pigeon Pea (Tur),2016,6750,6917,167,2.474074074074074
Bori Arab,Pigeon Pea (Tur),2016,8022,8189,167,2.081775118424333
Vani,Cotton,2015,3888,4055,167,4.295267489711934
Sangli-Miraj,Wheat(Unhusked),2015,3790,3957,167,4.406332453825858
Shrirampur,Green Gram,2014,7392,7559,167,2.259199134199134
Indapur-Bhigwan,Sunflower,2015,2783,2950,167,6.000718648939992
Shirur,Ground Nut Pods (Dry),2014,2900,3067,167,5.758620689655173
Kada,Ground Nut Pods (Dry),2015,4150,4317,167,4.024096385542169
Karmala,MAIZE,2016,1120,1287,167,14.910714285714286
Amarawati,Green-Peas,2016,2000,2167,167,8.35
Umared,Sorgum(Jawar),2016,1733,1900,167,9.636468551644548
Gangakhed,Soybean,2015,3481,3648,167,4.79747199080724
Barshi-Vairag,Wheat(Husked),2014,1822,1989,167,9.165751920965972
Karad,Tomato,2015,650,817,167,25.692307692307693
Islampur,Flower,2016,182,349,167,91.75824175824175
Umarga,Wheat(Unhusked),2015,2810,2977,167,5.943060498220641
Amarawati,Brinjal,2014,950,1117,167,17.57894736842105
Kej,Sorgum(Jawar),2015,2028,2195,167,8.234714003944774
Shirur,Green Gram,2016,6100,6267,167,2.737704918032787
Navapur,Pigen-Pea (Bhaji),2016,2833,3000,167,5.894811154253442
Kalamb (Os),Sunflower,2016,3060,3227,167,5.457516339869281
Ner Parasopant,Pigeon Pea (Tur),2015,7001,7168,167,2.3853735180688473
Vasai,Paddy-Unhusked,2015,1488,1655,167,11.223118279569892
Vaduj,Bajri,2016,1711,1878,167,9.760374050263005
Amarawati,Cabbage,2015,833,1000,167,20.048019207683073
Osmanabad,Sweet Potato,2016,2233,2400,167,7.47872816838334
Kannad,Maize,2016,1233,1400,167,13.54420113544201
Amarawati,Cucumber,2015,1508,1675,167,11.074270557029177
Amarawati,Math (Bhaji),2016,813,980,167,20.541205412054122
Barshi,Kharbuj,2016,533,700,167,31.33208255159475
Washim,Green Gram,2016,5300,5467,167,3.150943396226415
Chandur Bajar,Sorgum(Jawar),2016,1300,1467,167,12.846153846153847
Kalyan,Rice(Paddy-Hus),2015,2033,2200,167,8.21446138711264
Pune-Pimpri,Walvad,2015,2333,2500,167,7.1581654522074585
Rahata,Small Gourd,2015,2233,2400,167,7.47872816838334
Rahata,Small Gourd,2015,1600,1767,167,10.4375
Pathari,Gram,2015,3189,3356,167,5.236751332706177
Kolhapur-Laxmipuri,Split Lentil,2016,5533,5700,167,3.0182541116934756
Shrirampur-Belapur,Soybean,2015,2933,3100,167,5.693828844186839
Sengaon,Ground Nut Pods (Dry),2016,5733,5900,167,2.912960055817199
Jalgaon,Cluster Bean,2015,3044,3211,167,5.486202365308804
Akhadabalapur,Green Gram,2016,4889,5056,167,3.415831458375946
Bhivandi,Wheat(Husked),2015,1513,1680,167,11.037673496364839
Achalpur,Wheat(Husked),2016,1738,1905,167,9.608745684695052
Kalmeshwar,Spinach,2015,1141,1308,167,14.636283961437336
Chimur,Cotton,2015,4000,4167,167,4.175
Murbad,Paddy-Unhusked,2014,1700,1867,167,9.823529411764707
Yawal,Maize,2015,1142,1309,167,14.623467600700526
Kalyan,Squash Gourd,2015,833,1000,167,20.048019207683073
Kalmeshwar,Soybean,2015,2992,3159,167,5.581550802139038
Vai,Cabbage,2015,973,1140,167,17.163412127440903
Jalgaon Jamod-Aasalgaon,Sorgum(Jawar),2015,1133,1300,167,14.739629302736098
Mumbai,Horse Gram,2016,3100,3267,167,5.387096774193548
Umared,Cotton,2015,4033,4200,167,4.140838085792214
Shevgaon,Wheat(Husked),2016,1597,1764,167,10.457107075767063
Vaijapur,Maize,2015,1024,1191,167,16.30859375
Pathardi,Green Gram,2016,4850,5017,167,3.443298969072165
Solapur,Gram,2015,4298,4465,167,3.8855281526291297
Jalgaon Jamod-Aasalgaon,MAIZE,2016,1050,1217,167,15.904761904761905
Yeola,Bajri,2015,1408,1575,167,11.860795454545455
Sillod-Bharadi,Soybean,2016,3500,3667,167,4.771428571428571
Koregaon,Gram,2016,6158,6325,167,2.7119194543683016
Jalgaon Jamod,Maize,2016,1100,1267,167,15.181818181818182
Kalyan,Bottle Gourd,2015,1200,1367,167,13.916666666666666
Mahagaon,Sorgum(Jawar),2016,1554,1721,167,10.746460746460746
Buldhana,Gram,2014,2000,2167,167,8.35
Kalmeshwar,Tomato,2016,245,412,167,68.16326530612245
Balapur,Green Gram,2016,3833,4000,167,4.356900600052178
Gondiya,Paddy-Unhusked,2014,1315,1482,167,12.699619771863118
Pune-Manjri,CURRY LEAVES,2016,3822,3989,167,4.369440083725798
Lonar,Soybean,2014,3151,3318,167,5.299904792129483
Lonar,Sorgum(Jawar),2015,1061,1228,167,15.739868049010367
Bhiwapur,Soybean,2015,3850,4017,167,4.337662337662338
Telhara,Sunflower,2015,2650,2817,167,6.30188679245283
Jafrabad,Soybean,2016,3650,3817,167,4.575342465753424
Washim,SORGUM(JAWAR),2016,1050,1217,167,15.904761904761905
Dondaicha,Sorgum(Jawar),2016,1492,1659,167,11.193029490616622
Jafrabad,Maize,2016,1000,1167,167,16.7
Kada,Bajri,2015,1194,1361,167,13.986599664991624
Panvel,Flower,2014,833,1000,167,20.048019207683073
Khamgaon,Wheat(Husked),2015,1535,1702,167,10.879478827361563
Bhokar,Soybean,2016,3519,3686,167,4.745666382495027
Panvel,Cabbage,2015,833,1000,167,20.048019207683073
Manchar,Kanda Pat,2015,584,751,167,28.595890410958905
Jafrabad,Sorgum(Jawar),2016,1150,1317,167,14.521739130434783
Dondaicha,Pigeon Pea (Tur),2016,5733,5900,167,2.912960055817199
Kinwat,Gram,2015,3933,4100,167,4.246122552758709
Rahata,Wheat(Husked),2015,1309,1476,167,12.757830404889228
Panvel,Snake Gourd,2015,2000,2167,167,8.35
Panvel,Brinjal,2015,1733,1900,167,9.636468551644548
Panvel,Bitter Gourd,2015,533,700,167,31.33208255159475
Shrirampur,Soybean,2016,3533,3700,167,4.726861024624965
Kalyan,Banana,2016,700,867,167,23.857142857142858
Jalgaon Jamod,Wheat(Husked),2015,1317,1483,166,12.604403948367501
Panvel,Bottle Gourd,2014,1167,1333,166,14.224507283633248
Rahata,Lemon,2016,4292,4458,166,3.8676607642124883
Sangrampur-Varvatbakal,Sorgum(Jawar),2016,1295,1461,166,12.818532818532818
Khultabad,MAIZE,2016,1042,1208,166,15.930902111324377
Chandrapur,Gram,2016,3875,4041,166,4.283870967741936
Karad,Snake Gourd,2015,667,833,166,24.887556221889056
Shirur,Bajri,2016,1232,1398,166,13.474025974025974
Kalmeshwar,Cotton,2015,3938,4104,166,4.215337734890808
Jalgaon Jamod,Wheat(Husked),2015,1297,1463,166,12.798766383962992
Mehkar,Wheat(Husked),2016,1618,1784,166,10.259579728059332
Sangrampur,Maize,2014,817,983,166,20.318237454100366
Kolhapur,Melon,2016,3967,4133,166,4.18452230904966
Indapur,Maize,2015,1154,1320,166,14.38474870017331
Panvel,Ridge Gourd,2014,1467,1633,166,11.315610088616223
Mohol,Maize,2016,1565,1731,166,10.60702875399361
Navapur,Brinjal,2016,1667,1833,166,9.958008398320336
Sinner,Maize,2014,1092,1258,166,15.2014652014652
Vaduj,Soybean,2016,3067,3233,166,5.412455167916531
Akole,Maize,2015,1367,1533,166,12.143379663496708
Shirur,Gram,2016,3985,4151,166,4.165621079046424
Gevrai,Green Gram,2016,5867,6033,166,2.829384694051474
Anajngaon Surji,Sorgum(Jawar),2015,1286,1452,166,12.908242612752721
Vaduj,Sorgum(Jawar),2015,2078,2244,166,7.988450433108758
Aheri,Green Gram,2016,5800,5966,166,2.8620689655172415
Pathardi,Sorgum(Jawar),2016,1578,1744,166,10.519645120405576
Baramati,Maize,2016,1384,1550,166,11.99421965317919
Ausa,Safflower,2016,2644,2810,166,6.278366111951589
Karanja,Sorgum(Jawar),2015,1191,1357,166,13.937867338371117
Ghoti,LADIES FINGER,2016,938,1104,166,17.69722814498934
Amarawati-Fruit And Vegetables,Green Chilli,2016,1767,1933,166,9.394453876627052
Akola,Sunflower,2016,2957,3123,166,5.613797768008117
Amarawati-Fruit And Vegetables,Methi (Bhaji),2016,856,1022,166,19.39252336448598
Amarawati-Fruit And Vegetables,Pumpkin,2016,767,933,166,21.642764015645373
Latur,Soybean,2015,3206,3372,166,5.177791640673736
Kalamnuri,Soybean,2016,2665,2831,166,6.228893058161351
Ner Parasopant,Gram,2016,5365,5531,166,3.0941286113699906
Kalyan,Bajri,2015,1567,1733,166,10.59349074664965
Jalgaon Jamod-Aasalgaon,Maize,2016,1167,1333,166,14.224507283633248
Vaduj,Soybean,2016,3456,3622,166,4.8032407407407405
Sakri,Bajri,2016,1453,1619,166,11.424638678596008
Sailu,Sorgum(Jawar),2014,1114,1280,166,14.901256732495511
Ralegaon,Cotton,2015,4207,4373,166,3.9458046113620155
Sillod,Maize,2015,1367,1533,166,12.143379663496708
Ghoti,Paddy-Unhusked,2014,2100,2266,166,7.904761904761905
Barshi,Brinjal,2016,109,275,166,152.29357798165137
Shrirampur-Belapur,Wheat(Husked),2015,1267,1433,166,13.101815311760063
Vaijapur,Gram,2014,2142,2308,166,7.749766573295985
Samudrapur,Cotton,2014,3974,4140,166,4.177151484650227
Akhadabalapur,Cotton,2016,4356,4522,166,3.810835629017447
Pune-Pimpri,Ginger (Fresh),2015,3667,3833,166,4.5268611944368695
Akhadabalapur,Soybean,2016,3367,3533,166,4.93020493020493
Patur,Wheat(Husked),2015,1417,1583,166,11.714890613973182
Amarawati,Carrot,2015,2167,2333,166,7.660359944623904
Dhamangaon-Rly,Wheat(Husked),2014,1321,1487,166,12.566237698713095
Lakhandur,Paddy-Unhusked,2015,1541,1707,166,10.772225827384815
Sengaon,Soybean,2016,3356,3522,166,4.946364719904649
Barshi-Vairag,Soybean,2016,3528,3694,166,4.705215419501134
Pulgaon,Cotton,2015,3862,4028,166,4.298291040911445
Malkapur,Maize,2015,1027,1193,166,16.163583252190847
Hingoli,Soybean,2015,3129,3295,166,5.30520933205497
Malkapur,Sorgum(Jawar),2015,1104,1270,166,15.03623188405797
Pune-Pimpri,Onion,2014,1917,2083,166,8.659363588941053
Chalisgaon,Sorgum(Jawar),2015,1200,1366,166,13.833333333333334
Nandura,ONION,2016,227,393,166,73.12775330396475
Pune-Pimpri,Onion,2014,1343,1509,166,12.360387192851825
Kalmeshwar,Ladies Finger,2014,808,974,166,20.544554455445546
Shevgaon-Bodhegaon,Sorgum(Jawar),2015,1348,1514,166,12.31454005934718
Panvel,Cabbage,2016,767,933,166,21.642764015645373
Vaijapur,Maize,2014,932,1098,166,17.811158798283262
Tumsar,Paddy-Unhusked,2016,1825,1991,166,9.095890410958905
Nagpur,Cabbage,2016,465,631,166,35.69892473118279
Aheri,Batbati,2015,3667,3833,166,4.5268611944368695
Chikhali,Mustard,2016,3617,3783,166,4.5894387614044785
Devala,MAIZE,2016,1097,1263,166,15.132178669097538
Jalgaon Jamod,Soybean,2014,3067,3233,166,5.412455167916531
Gondiya,Paddy-Unhusked,2016,1506,1672,166,11.02257636122178
Aurangabad,Potato,2015,642,808,166,25.856697819314643
Shrirampur-Belapur,Maize,2015,1117,1283,166,14.86123545210385
Akot,Wheat(Husked),2015,1305,1471,166,12.720306513409962
Amarawati,Papai,2015,1267,1433,166,13.101815311760063
Aurangabad,Papai,2015,526,692,166,31.55893536121673
Amarawati-Fruit And Vegetables,Spinach,2016,767,933,166,21.642764015645373
Aurangabad,Cabbage,2014,491,657,166,33.80855397148676
Panvel,Cucumber,2015,978,1144,166,16.973415132924334
Pune,Banana(Raw),2015,767,933,166,21.642764015645373
Vaduj,Wheat(Husked),2015,1456,1622,166,11.401098901098901
Kej,Black Gram,2014,5221,5387,166,3.1794675349549895
Tasgaon,Sorgum(Jawar),2016,1697,1863,166,9.781968179139659
Nashik,Spinach,2016,251,416,165,65.73705179282868
Mauda,Wheat(Husked),2016,1467,1632,165,11.247443762781186
Patur,Wheat(Husked),2016,1619,1784,165,10.19147621988882
Akola,Sorgum(Jawar),2016,1294,1459,165,12.751159196290573
Achalpur,Wheat(Husked),2014,1541,1706,165,10.707332900713823
Yawal,Onion,2016,399,564,165,41.35338345864662
Akot,Soybean,2015,3323,3488,165,4.965392717424014
Chikhali,Wheat(Husked),2015,1260,1425,165,13.095238095238095
Amalner,Bajri,2016,1589,1754,165,10.383889238514788
Paithan,Sorgum(Jawar),2016,1629,1794,165,10.128913443830571
Vai,Cabbage,2014,790,955,165,20.88607594936709
Amalner,Green Gram,2016,7000,7165,165,2.357142857142857
Parbhani,Wheat(Husked),2015,1498,1663,165,11.014686248331108
Khamgaon,Sorgum(Jawar),2016,1260,1425,165,13.095238095238095
Ramtek,FLOWER,2016,595,760,165,27.73109243697479
Gadchiroli,Paddy-Unhusked,2015,1771,1936,165,9.316770186335404
Umared,Mustard,2016,2900,3065,165,5.689655172413793
Osmanabad,Onion,2016,650,815,165,25.384615384615383
Osmanabad,Ground Nut Pods (Dry),2015,4950,5115,165,3.3333333333333335
Solapur,Papai,2015,435,600,165,37.93103448275862
Akola,Maize,2016,1440,1605,165,11.458333333333334
Lasalgaon-Niphad,Wheat(Husked),2015,1409,1574,165,11.710432931156848
Manmad,Maize,2014,1002,1167,165,16.46706586826347
Kurdwadi-Modnimb,Maize,2015,1148,1313,165,14.372822299651569
Chandur Rly.,Pigeon Pea (Tur),2015,9018,9183,165,1.829673985362608
Mahagaon,SORGUM(JAWAR),2016,1485,1650,165,11.11111111111111
Barshi,Paddy-Unhusked,2015,1327,1492,165,12.434061793519216
Udgir,Sorgum(Jawar),2015,916,1081,165,18.013100436681224
Mahagaon,Cotton,2015,4080,4245,165,4.044117647058823
Manmad,Sorgum(Jawar),2016,1444,1609,165,11.426592797783934
Lonar,Soybean,2016,3523,3688,165,4.683508373545274
Lonar,Soybean,2016,3530,3695,165,4.674220963172805
Washim,Soybean,2015,3114,3279,165,5.298651252408478
Bhokar,Wheat(Husked),2016,1548,1713,165,10.65891472868217
Lasur Station,Gram,2016,4009,4174,165,4.115739585931654
Nandurbar,Soybean,2015,3076,3241,165,5.364109232769831
Kalvan,Gram,2015,4004,4169,165,4.1208791208791204
Nanded,Gram,2016,4965,5130,165,3.323262839879154
Chalisgaon,Soybean,2015,3000,3165,165,5.5
Nandurbar,Maize,2016,1390,1555,165,11.870503597122303
Tumsar,Other Cereals,2014,1931,2096,165,8.544795442775763
Nandura,Maize,2015,1087,1252,165,15.179392824287028
Baramati,Banana,2014,1200,1365,165,13.75
Nagpur,CABBAGE,2016,325,490,165,50.76923076923077
Kalmeshwar,Brinjal,2015,981,1146,165,16.819571865443425
Morshi,Soybean,2015,3071,3236,165,5.372842722240312
Ner Parasopant,Gram,2015,3941,4105,164,4.161380360314641
Vaduj,Cowpea,2015,4043,4207,164,4.0563937670047
Purna,Wheat(Husked),2015,1344,1508,164,12.202380952380953
Kej,Gram,2015,3738,3902,164,4.387372926698769
Chopda,MAIZE,2016,1059,1223,164,15.486307837582626
Kalyan,Potato,2016,1292,1456,164,12.693498452012383
Shirur,Bajri,2016,1368,1532,164,11.988304093567251
Jalna,Wheat(Husked),2016,2071,2235,164,7.918879768227909
Gangapur,Wheat(Husked),2015,1580,1744,164,10.379746835443038
Ramtek,RADDISH,2016,491,655,164,33.40122199592668
Gadchiroli,Paddy-Unhusked,2016,1799,1963,164,9.116175653140633
Murbad,Brinjal,2015,2000,2164,164,8.2
Khamgaon,Sorgum(Jawar),2015,1001,1165,164,16.383616383616385
Wardha,Cotton,2015,3943,4107,164,4.15926959168146
Chandur Rly.,Soybean,2015,3254,3418,164,5.039950829748002
Akola,Sorgum(Jawar),2016,1321,1485,164,12.414837244511734
Partur,Sorgum(Jawar),2016,1705,1869,164,9.618768328445748
Kalmeshwar,Coriander  ,2015,884,1048,164,18.552036199095024
Chopda,Bajri,2016,1515,1679,164,10.825082508250825
Shahada,Sorgum(Jawar),2015,1284,1448,164,12.77258566978193
Jafrabad,Soybean,2015,3050,3214,164,5.377049180327869
Chakur,Soybean,2016,3565,3729,164,4.600280504908836
Dondaicha,Maize,2015,1033,1197,164,15.876089060987415
Yawal,Gram,2016,4109,4273,164,3.991238744220005
Shirur,Sorgum(Jawar),2014,1479,1643,164,11.088573360378634
Devala,Bajri,2015,1260,1424,164,13.015873015873016
Chopda,Sesamum,2015,6950,7114,164,2.3597122302158273
Hinganghat,Wheat(Husked),2016,1419,1583,164,11.557434813248767
Pulgaon,Cotton,2014,3872,4036,164,4.235537190082645
Sangamner,Sorgum(Jawar),2016,1686,1850,164,9.727164887307236
Malkapur,Sorgum(Jawar),2015,1138,1302,164,14.411247803163445
Yeotmal,Black Gram,2014,4620,4784,164,3.54978354978355
Latur,Maize,2016,1344,1508,164,12.202380952380953
Shrirampur-Belapur,SOYBEAN,2016,2489,2653,164,6.588991562876657
Akot,Sorgum(Jawar),2015,1067,1231,164,15.370196813495783
Pusad,Sesamum,2015,6676,6840,164,2.456560814859197
Paithan,Cotton,2014,3857,4021,164,4.252009333679025
Pusad,Wheat(Husked),2015,1497,1661,164,10.955243820975284
Malkapur,Bajri,2015,1268,1432,164,12.933753943217665
Pathari,Sorgum(Jawar),2016,1618,1782,164,10.135970333745364
Kalamb (Os),Green Gram,2016,4518,4682,164,3.6299247454625942
Jamkhed,Bajri,2015,1438,1602,164,11.404728789986091
Pune-Pimpri,Flower,2016,1156,1320,164,14.186851211072664
Akkolkot,Wheat(Unhusked),2016,2886,3050,164,5.682605682605683
Kej,Maize,2016,1557,1721,164,10.533076429030187
Pune,Bajri,2015,1860,2024,164,8.817204301075268
Kalamb (Os),Tamarind,2015,4508,4672,164,3.6379769299023956
Loha,Black Gram,2014,4861,5025,164,3.3737914009463075
Satara,CABBAGE,2016,391,555,164,41.94373401534527
Mahur,Cotton,2015,3800,3964,164,4.315789473684211
Khamgaon,Cotton,2015,4041,4204,163,4.033655035882207
Devala,Maize,2015,1152,1315,163,14.149305555555555
Vai,Cabbage,2015,852,1015,163,19.131455399061032
Rajura,Cotton,2016,4370,4533,163,3.7299771167048057
Sangamner,Soybean,2014,3083,3246,163,5.287058060330847
Nandgaon,Sorgum(Jawar),2015,1344,1507,163,12.12797619047619
Shrirampur,Sorgum(Jawar),2016,1525,1688,163,10.688524590163935
Vaduj,Bajri,2014,1400,1563,163,11.642857142857142
Mumbai,Sugar,2016,3306,3469,163,4.930429522081065
Udgir,Sorgum(Jawar),2014,990,1153,163,16.464646464646464
Manmad,WHEAT(HUSKED),2016,2024,2187,163,8.053359683794467
Parbhani,Pigeon Pea (Tur),2014,4556,4719,163,3.5776997366110623
Manchar,Cabbage,2015,707,870,163,23.055162659123056
Telhara,Black Gram,2014,4579,4742,163,3.5597291985149595
Mul,Paddy-Unhusked,2015,1877,2040,163,8.684070324986681
Umared,Sorgum(Jawar),2015,1575,1738,163,10.34920634920635
Ambejogai,Soybean,2015,3186,3349,163,5.116133082234777
Nandgaon,Bajri,2016,1241,1404,163,13.13456889605157
Sinner,Cowpea,2015,3651,3814,163,4.464530265680636
Anajngaon Surji,Banana,2016,2550,2713,163,6.392156862745098
Aurad Shahajani,Soybean,2016,3929,4092,163,4.14863833036396
Akola,Sorgum(Jawar),2016,1285,1448,163,12.684824902723735
Parola,Bajri,2016,1326,1489,163,12.292609351432882
Kalmeshwar,Coriander  ,2015,2456,2619,163,6.636807817589577
Kalmeshwar,Tomato,2014,614,777,163,26.547231270358306
Jalna-Badnapur,Bajri,2016,1224,1387,163,13.316993464052288
Patan,Cabbage,2014,582,745,163,28.006872852233677
Amarawati-Fruit And Vegetables,PUMPKIN,2016,754,917,163,21.618037135278513
Morshi,Soybean,2016,3325,3488,163,4.902255639097745
Kopargaon,Bajri,2015,1443,1606,163,11.295911295911296
Kurdwadi,MAIZE,2016,1137,1300,163,14.335971855760773
Palghar(Bevur),Potato,2015,1508,1671,163,10.809018567639257
Rahata,Mango(Raw),2015,875,1038,163,18.62857142857143
Sillod-Bharadi,Bajri,2016,1250,1413,163,13.04
Shahada,Maize,2016,1201,1364,163,13.57202331390508
Anajngaon Surji,Banana,2015,500,663,163,32.6
Vaduj,Ghevda Seed,2015,4500,4663,163,3.6222222222222222
Hingoli,Gram,2016,4228,4391,163,3.8552507095553454
Bhokar,Wheat(Husked),2015,1292,1455,163,12.61609907120743
Tuljapur,Pigeon Pea (Tur),2016,7930,8093,163,2.0554854981084487
Vai,Cabbage,2014,644,807,163,25.31055900621118
Gevrai,Gram,2016,4115,4278,163,3.9611178614823817
Ahmednagar,Gram,2015,5100,5263,163,3.196078431372549
Shevgaon-Bodhegaon,Wheat(Husked),2015,1615,1778,163,10.092879256965944
Gangakhed,Soybean,2016,3568,3731,163,4.568385650224215
Ralegaon,Soybean,2015,3079,3242,163,5.293926599545307
Naigaon,Sorgum(Jawar),2015,1100,1263,163,14.818181818181818
Ghansawangi,Soybean,2015,3456,3619,163,4.716435185185185
Tumsar,Paddy-Unhusked,2015,1678,1841,163,9.713945172824792
Kopargaon,Wheat(Husked),2015,1456,1619,163,11.195054945054945
Sillod-Bharadi,Bajri,2016,1375,1538,163,11.854545454545455
Hingoli,Soybean,2016,3529,3692,163,4.618872201756871
Vaduj,Sorgum(Jawar),2015,2100,2263,163,7.761904761904762
Amarawati-Fruit And Vegetables,Cucumber,2016,1089,1252,163,14.967860422405877
Shrirampur,Green Gram,2016,4529,4692,163,3.599028483108854
Chandvad,Cucumber,2016,2325,2488,163,7.010752688172043
Savner,Cotton,2015,3929,4092,163,4.14863833036396
Jafrabad,Sorgum(Jawar),2015,1025,1188,163,15.902439024390244
Kille Dharur,Sorgum(Jawar),2015,2413,2575,162,6.713634479900539
Pachora,SORGUM(JAWAR),2016,1318,1480,162,12.291350531107739
Shahapur,PADDY-UNHUSKED,2016,1536,1698,162,10.546875
Akluj,Banana,2016,138,300,162,117.3913043478261
Lasalgaon-Vinchur,Wheat(Husked),2015,1519,1681,162,10.664911125740618
Basmat,Soybean,2014,3003,3165,162,5.394605394605395
Nandura,Sorgum(Jawar),2016,1225,1387,162,13.224489795918368
Sailu,Sorgum(Jawar),2016,1770,1932,162,9.152542372881356
Latur-Murud,Sorgum(Jawar),2016,1478,1640,162,10.960757780784844
Telhara,Gram,2015,2817,2979,162,5.7507987220447285
Akot,Sorgum(Jawar),2015,1106,1268,162,14.64737793851718
Gangapur,Wheat(Husked),2014,1501,1663,162,10.792804796802132
Kada,Soybean,2015,2988,3150,162,5.421686746987952
Kolhapur-Malkapur,Tomato,2016,139,301,162,116.54676258992805
Akole,Maize,2016,1388,1550,162,11.671469740634006
Lasalgaon,Sorgum(Jawar),2015,1664,1826,162,9.735576923076923
Nandurbar,Bajri,2015,1064,1226,162,15.225563909774436
Raver,Maize,2015,1162,1324,162,13.941480206540447
Mandhal,Soybean,2016,3525,3687,162,4.595744680851064
Sangrampur-Varvatbakal,Soybean,2016,2813,2975,162,5.758976182012087
Amarawati,Gram,2015,4439,4601,162,3.6494706014868212
Amarawati,Spinach,2015,1288,1450,162,12.577639751552795
Anajngaon Surji,Banana,2016,438,600,162,36.986301369863014
Mandhal,Wheat(Husked),2016,1566,1728,162,10.344827586206897
Shegaon,Sunflower,2016,3067,3229,162,5.282034561460711
Nilanga,Sorgum(Jawar),2016,1253,1415,162,12.928970470869912
Dudhani,Wheat(Husked),2016,1884,2046,162,8.598726114649681
Hingoli,Black Gram,2014,4834,4996,162,3.3512618949110466
Nandurbar,Gram,2016,6291,6453,162,2.575107296137339
Manmad,Wheat(Husked),2016,1571,1733,162,10.311903246339911
Ashti (Jalna),Soybean,2015,3337,3499,162,4.854659874138448
Amarawati-Fruit And Vegetables,CABBAGE,2016,927,1089,162,17.475728155339805
Balapur,Soybean,2016,3788,3950,162,4.2766631467793035
Vai,Cabbage,2015,638,800,162,25.391849529780565
Murbad,Ladies Finger,2015,3823,3985,162,4.237509809050484
Jalgaon Jamod-Aasalgaon,Maize,2015,919,1081,162,17.6278563656148
Kalmeshwar,Tomato,2015,1182,1344,162,13.705583756345177
Mohol,Maize,2016,1799,1961,162,9.005002779321845
Jawala-Bajar,SOYBEAN,2016,2677,2839,162,6.051550242809115
Amarawati-Fruit And Vegetables,SPINACH,2016,694,856,162,23.34293948126801
Sindi (Selu),Cotton,2015,3741,3903,162,4.330392943063352
Ner Parasopant,Green Gram,2016,4857,5019,162,3.335392217418159
Lasalgaon-Niphad,Soybean,2016,3083,3245,162,5.254622121310412
Dhule,Sorgum(Jawar),2015,1390,1552,162,11.654676258992806
Bhusaval,Black Gram,2015,10088,10250,162,1.605868358445678
Malkapur,Wheat(Husked),2014,1330,1492,162,12.180451127819548
Nagpur,Cabbage,2016,321,483,162,50.467289719626166
Gevrai,BLACK GRAM,2016,5434,5596,162,2.981229297018771
Nashik,Mint,2016,180,342,162,90.0
Nashik,Mint,2016,296,458,162,54.729729729729726
Jalna,Mustard,2015,3538,3700,162,4.578858111927643
Rajura,Soybean,2015,3365,3527,162,4.814264487369985
Tumsar,Castor Seed,2015,3277,3439,162,4.943545926151968
Buldhana-Dhad,Soybean,2016,3418,3580,162,4.7396138092451725
Buldhana-Dhad,Soybean,2016,3038,3200,162,5.332455562870309
Amarawati,Ladies Finger,2016,1319,1481,162,12.282031842304777
Satana,Maize,2014,1019,1181,162,15.89793915603533
Balapur,Sorgum(Jawar),2015,1113,1275,162,14.555256064690028
Amarawati,Linseed,2016,5012,5174,162,3.232242617717478
Vai,Cabbage,2015,614,776,162,26.384364820846905
Aurangabad,Papai,2016,400,562,162,40.5
Umarga,Sunflower,2014,3060,3221,161,5.261437908496732
Mangalwedha,Wheat(Husked),2016,1885,2046,161,8.541114058355438
Umarga,Bajri,2016,1251,1412,161,12.869704236610712
Kalmeshwar,Coriander  ,2015,920,1081,161,17.5
Jalgaon,Banana,2016,247,408,161,65.18218623481782
Tumsar,Paddy-Unhusked,2016,1784,1945,161,9.024663677130045
Vaduj,Sorgum(Jawar),2014,2211,2372,161,7.281772953414745
Morshi,Wheat(Husked),2015,1467,1628,161,10.974778459441037
Nandura,Bajri,2015,990,1151,161,16.262626262626263
Jalgaon,Black Gram,2016,12631,12792,161,1.274641754413744
Katol,Ground Nut Pods (Dry),2016,4473,4634,161,3.599374021909233
Sinner,Maize,2015,1054,1215,161,15.275142314990513
Jalna,WHEAT(HUSKED),2016,2013,2174,161,7.9980129160457025
Rahata,Potato,2016,1531,1692,161,10.516002612671457
Sakri,Pigeon Pea (Tur),2015,5784,5945,161,2.7835408022130013
Palghar(Bevur),Potato,2015,1087,1248,161,14.811407543698252
Dhule,Bajri,2015,1239,1400,161,12.994350282485875
Gangakhed,Soybean,2014,2958,3119,161,5.442866801893171
Pune-Pimpri,Cabbage,2015,630,791,161,25.555555555555557
Mangalwedha,Bajri,2016,1386,1547,161,11.616161616161616
Mantha,Cotton,2015,4119,4280,161,3.9087157076960426
Jalna,Jaggery,2015,2177,2338,161,7.395498392282958
Chimur,Soybean,2016,3120,3281,161,5.160256410256411
Manora,Wheat(Husked),2015,1439,1600,161,11.188325225851285
Kalamb (Os),Soybean,2014,3192,3353,161,5.043859649122807
Lonar,Soybean,2015,3177,3338,161,5.0676739062008185
Ghansawangi,Soybean,2015,3500,3661,161,4.6
Solapur,Papai,2014,258,419,161,62.4031007751938
Barshi,Brinjal,2014,128,289,161,125.78125
Pusad,Sorgum(Jawar),2016,1299,1460,161,12.3941493456505
Jalna,JAGGERY,2016,2814,2975,161,5.721393034825871
Indapur,Rice(Paddy-Hus),2015,1280,1441,161,12.578125
Amarawati,Gram,2016,5209,5370,161,3.090804377039739
Hinganghat,Wheat(Husked),2016,1594,1755,161,10.100376411543287
Loha,Gram,2016,4127,4288,161,3.9011388417736854
Khamgaon,Safflower,2016,2260,2421,161,7.123893805309734
Tumsar,Other Cereals,2015,2428,2589,161,6.630971993410214
Armori-Desaiganj,Paddy-Unhusked,2016,1740,1901,161,9.25287356321839
Loha,Sorgum(Jawar),2015,1255,1416,161,12.828685258964143
Khamgaon,Sunflower,2015,2961,3122,161,5.4373522458628845
Sindi,Cotton,2015,4168,4329,161,3.862763915547025
Khamgaon,Sorgum(Jawar),2016,1399,1560,161,11.508220157255183
Anajngaon Surji,Soybean,2015,3185,3346,161,5.054945054945055
Udgir,Pigeon Pea (Tur),2016,9110,9271,161,1.7672886937431393
Achalpur,Wheat(Husked),2016,1765,1926,161,9.121813031161473
Mumbai,Squash Gourd,2015,462,623,161,34.84848484848485
Lasur Station,Maize,2015,1040,1200,160,15.384615384615385
Dhule,Green Gram,2016,6525,6685,160,2.4521072796934864
Shahada,Sorgum(Jawar),2016,1674,1834,160,9.55794504181601
Kada (Ashti),Gram,2015,4020,4180,160,3.9800995024875623
Buldhana,MAIZE,2016,1180,1340,160,13.559322033898304
Patur,Sorgum(Jawar),2014,1450,1610,160,11.03448275862069
Kalvan,Wheat(Husked),2015,1360,1520,160,11.764705882352942
Pathari,SORGUM(JAWAR),2016,1844,2004,160,8.676789587852495
Amalner,Green Gram,2016,5770,5930,160,2.7729636048526864
Raver,Sorgum(Jawar),2015,1277,1437,160,12.529365700861394
Jafrabad,Maize,2014,1215,1375,160,13.168724279835391
Shevgaon,Bajri,2015,1143,1303,160,13.99825021872266
Jamkhed,Bajri,2015,1457,1617,160,10.981468771448181
Digras,Cotton,2015,3780,3940,160,4.232804232804233
Murum,Pigeon Pea (Tur),2016,6515,6675,160,2.4558710667689945
Patan,Cabbage,2015,570,730,160,28.07017543859649
Patan,Flower,2015,650,810,160,24.615384615384617
Ausa,Safflower,2015,2551,2711,160,6.272050176401411
Parbhani,Wheat(Husked),2015,1423,1583,160,11.243851018973999
Sangrampur-Varvatbakal,Maize,2016,1120,1280,160,14.285714285714286
Vaijapur,SORGUM(JAWAR),2016,2004,2164,160,7.984031936127744
Varud-Rajura Bazar,Soybean,2014,3159,3319,160,5.064893953782843
Anajngaon Surji,Banana,2016,390,550,160,41.02564102564103
Akhadabalapur,Wheat(Husked),2015,1580,1740,160,10.126582278481013
Shrirampur,Soybean,2016,3468,3628,160,4.61361014994233
Akhadabalapur,Castor Seed,2016,2840,3000,160,5.633802816901408
Kalmeshwar,Flower,2015,653,813,160,24.502297090352222
Jintur,Wheat(Husked),2016,1881,2041,160,8.506113769271664
Pusad,Soybean,2015,3120,3280,160,5.128205128205129
Latur-Murud,Sorgum(Jawar),2016,1510,1670,160,10.596026490066226
Dudhani,Bajri,2015,1153,1313,160,13.876843018213357
Kinwat,Ground Nut Pods (Dry),2015,4940,5100,160,3.2388663967611335
Kolhapur-Malkapur,Capsicum,2016,163,323,160,98.15950920245399
Khamgaon,Maize,2016,1160,1320,160,13.793103448275861
Parbhani,Green Gram,2015,7464,7624,160,2.1436227224008575
Jafrabad,Sorgum(Jawar),2016,1070,1230,160,14.953271028037383
Korpana,Soybean,2016,2603,2763,160,6.146753745678064
Jintur-Bori,Soybean,2015,3079,3239,160,5.196492367651835
Jafrabad,Wheat(Husked),2016,1450,1610,160,11.03448275862069
Akhadabalapur,Cotton,2015,4060,4220,160,3.9408866995073892
Panvel,Tomato,2014,1260,1420,160,12.698412698412698
Parli-Vaijnath,Soybean,2015,3503,3663,160,4.567513559805881
Panvel,Flower,2014,1640,1800,160,9.75609756097561
Nagpur,Raddish,2015,444,604,160,36.03603603603604
Yeola,Bajri,2014,1265,1425,160,12.648221343873518
Partur,Bajri,2015,1090,1250,160,14.678899082568808
Palus,Cabbage,2016,660,820,160,24.242424242424242
Akot,Sunflower,2015,2895,3055,160,5.526770293609672
Nagpur,Tomato,2016,368,528,160,43.47826086956522
Murbad,Ghosali(Bhaji),2015,2080,2240,160,7.6923076923076925
Majalgaon,Wheat(Husked),2015,1427,1587,160,11.212333566923617
Ghatanji,Soybean,2015,3391,3551,160,4.718372161604247
Satana,Maize,2015,1340,1500,160,11.940298507462687
Murbad,Capsicum,2015,3760,3920,160,4.25531914893617
Kurdwadi-Modnimb,Pigeon Pea (Tur),2015,5851,6011,160,2.73457528627585
Akot,Maize,2015,1005,1165,160,15.92039800995025
Jintur,Pigeon Pea (Tur),2014,3841,4001,160,4.1655818797188235
Ramtek,Ladies Finger,2016,640,800,160,25.0
Akhadabalapur,Gram,2014,3120,3280,160,5.128205128205129
Pusad,Sorgum(Jawar),2015,1140,1300,160,14.035087719298245
Kalmeshwar,Orange,2015,350,510,160,45.714285714285715
Ralegaon,COTTON,2016,4809,4969,160,3.3270950301517987
Shegaon,Wheat(Husked),2015,1382,1542,160,11.577424023154848
Barshi,Maize,2016,1721,1881,160,9.296920395119116
Shirur,Bajri,2016,1416,1576,160,11.299435028248588
Gevrai,Cotton,2015,3600,3760,160,4.444444444444445
Sailu,Sorgum(Jawar),2015,1179,1339,160,13.570822731128075
Kolhapur,Chavli (Shenga ),2015,780,940,160,20.512820512820515
Korpana,Gram,2016,3820,3980,160,4.18848167539267
Phaltan,Jaggery,2015,2250,2410,160,7.111111111111111
Vai,Cabbage,2016,713,873,160,22.44039270687237
Lasalgaon-Vinchur,Maize,2015,1119,1279,160,14.298480786416443
Vaduj,GREEN GRAM,2016,4920,5080,160,3.252032520325203
Barshi,Mosambi,2016,210,370,160,76.19047619047619
Barshi,Mango,2016,335,495,160,47.76119402985075
Sindi,Wheat(Husked),2016,1511,1671,160,10.589013898080742
Khultabad,Maize,2016,1260,1420,160,12.698412698412698
Karad,Bottle Gourd,2015,660,820,160,24.242424242424242
Kalamb (Os),Tamarind,2016,1391,1551,160,11.502516175413371
Shahapur,Paddy-Unhusked,2015,1411,1571,160,11.339475549255846
Ner Parasopant,Wheat(Husked),2014,1380,1540,160,11.594202898550725
Devala,Sorgum(Jawar),2015,1872,2032,160,8.547008547008547
Indapur (Nimgaon Ketki),Wheat(Husked),2015,1331,1491,160,12.021036814425244
Amarawati,Cabbage,2016,1580,1740,160,10.126582278481013
Ner Parasopant,Green Gram,2016,3890,4050,160,4.113110539845758
Amarawati,Carrot,2016,720,880,160,22.22222222222222
Barshi,Cabbage,2016,173,333,160,92.48554913294798
Amarawati,Cucumber,2016,1148,1308,160,13.937282229965156
Umarga,Sorgum(Jawar),2016,1900,2060,160,8.421052631578947
Chandur Rly.,Green Gram,2015,8240,8400,160,1.941747572815534
Karad,Flower,2015,720,880,160,22.22222222222222
Mohol,Gram,2015,3867,4027,160,4.137574347039048
Chakur,Gram,2016,6148,6308,160,2.6024723487312946
Nashik,Mint,2015,173,333,160,92.48554913294798
Mauda,Soybean,2016,3351,3511,160,4.7746941211578635
Partur,Sorgum(Jawar),2015,1507,1666,159,10.550763105507631
Akot,Wheat(Husked),2016,1648,1807,159,9.648058252427184
Akot,Wheat(Husked),2016,1439,1598,159,11.049339819318972
Dondaicha-Sindkheda,BAJRI,2016,1084,1243,159,14.66789667896679
Shegaon,Sorgum(Jawar),2015,1115,1274,159,14.260089686098654
Khamgaon,Wheat(Husked),2015,1286,1445,159,12.363919129082426
Ahmedpur,Sunflower,2016,3407,3566,159,4.666862342236572
Kalyan,Cabbage,2016,623,782,159,25.52166934189406
Kalvan,Wheat(Husked),2014,1443,1602,159,11.018711018711018
Barshi-Vairag,Maize,2014,1087,1246,159,14.627414903403864
Barshi,Cluster Bean,2016,222,381,159,71.62162162162163
Purna,Soybean,2015,3111,3270,159,5.110896817743491
Ausa,Maize,2015,1040,1199,159,15.288461538461538
Armori-Desaiganj,Paddy-Unhusked,2015,1544,1703,159,10.297927461139896
Shevgaon-Bodhegaon,Bajri,2016,1390,1549,159,11.43884892086331
Shahada,Sorgum(Jawar),2016,1537,1696,159,10.344827586206897
Buldhana-Dhad,Maize,2016,1119,1278,159,14.20911528150134
Chalisgaon,Sorgum(Jawar),2016,1403,1562,159,11.332858161083394
Shirur,Gram,2015,3184,3343,159,4.993718592964824
Pune-Pimpri,Cabbage,2015,953,1112,159,16.684155299055615
Nagpur,Spinach,2015,500,659,159,31.8
Buldhana,Soybean,2016,3473,3632,159,4.578174488914483
Varud-Rajura Bazar,Soybean,2016,3267,3426,159,4.866850321395776
Akot,Maize,2015,931,1090,159,17.07841031149302
Jafrabad,Wheat(Husked),2015,1283,1442,159,12.392829306313327
Jalgaon,Gram,2015,3329,3488,159,4.776209071793331
Ahmedpur,Sorgum(Jawar),2015,1504,1663,159,10.571808510638299
Shrigonda,Bajri,2016,1400,1559,159,11.357142857142858
Parbhani,Sorgum(Jawar),2016,1619,1778,159,9.820877084620136
Kalvan,Maize,2015,1213,1372,159,13.107996702390766
Beed,Black Gram,2014,5090,5249,159,3.1237721021611002
Kalmeshwar,Chavli (Shenga ),2015,952,1111,159,16.701680672268907
Gevrai,Sorgum(Jawar),2015,1517,1676,159,10.48121292023731
Telhara,Green Gram,2014,6915,7074,159,2.299349240780911
Jafrabad,Cotton,2015,3695,3854,159,4.303112313937754
Dhule,Sorgum(Jawar),2015,1214,1373,159,13.097199341021417
Shirur,Bajri,2015,1240,1399,159,12.82258064516129
Sindkhed Raja,Soybean,2015,3505,3664,159,4.536376604850214
Kannad,Green Gram,2016,4633,4792,159,3.4319015756529248
Palghar(Bevur),Potato,2015,999,1158,159,15.915915915915916
Sangamner,Bajri,2016,1450,1609,159,10.96551724137931
Parbhani,Gram,2015,3544,3703,159,4.486455981941309
Kalmeshwar,Pumpkin,2015,885,1044,159,17.966101694915253
Chimur,COTTON,2016,4748,4907,159,3.3487784330244312
Akhadabalapur,Soybean,2015,3273,3432,159,4.857928505957837
Raver,Sorgum(Jawar),2016,1343,1502,159,11.839166046165301
Dudhani,Bajri,2016,1435,1594,159,11.0801393728223
Gevrai,Wheat(Husked),2014,1452,1610,158,10.881542699724518
Pune-Pimpri,Flower,2014,2074,2232,158,7.618129218900675
Kada,Bajri,2015,1200,1358,158,13.166666666666666
Sakri,Maize,2015,1382,1540,158,11.432706222865413
Dondaicha-Sindkheda,Sorgum(Jawar),2016,1783,1941,158,8.861469433538979
Gangapur,Bajri,2015,1355,1513,158,11.660516605166052
Navapur,Wheat(Husked),2016,1488,1646,158,10.618279569892474
Kalmeshwar,Spinach,2014,642,800,158,24.610591900311526
Nandurbar,Green Gram,2016,4627,4785,158,3.4147395720769396
Lasur Station,Maize,2015,1266,1424,158,12.480252764612954
Mantha,Wheat(Husked),2014,1417,1575,158,11.15031757233592
Katol,COTTON,2016,4797,4955,158,3.293725244944757
Shrirampur,Bajri,2016,1625,1783,158,9.723076923076922
Kalmeshwar,Brinjal,2015,746,904,158,21.179624664879356
Kalyan,CABBAGE,2016,517,675,158,30.56092843326886
Umarga,Sorgum(Jawar),2016,1490,1648,158,10.604026845637584
Kalamb (Os),Pigeon Pea (Tur),2014,3709,3867,158,4.259908331086546
Nandurbar,Pigeon Pea (Tur),2015,4953,5111,158,3.1899858671512216
Kalamb (Os),Bajri,2016,1345,1503,158,11.74721189591078
Indapur,Banana,2015,394,552,158,40.101522842639596
Sillod-Bharadi,Safflower,2014,2270,2428,158,6.960352422907489
Dondaicha,Bajri,2015,1131,1289,158,13.969938107869142
Kopargaon,Bajri,2016,1523,1681,158,10.374261326329613
Jalna,Soybean,2014,3041,3199,158,5.195659322591253
Newasa,Gram,2016,4171,4329,158,3.788060417166147
Pulgaon,Gram,2016,6637,6795,158,2.3805936417055897
Hinganghat,Wheat(Husked),2016,1423,1581,158,11.103302881236823
Chimur,Soybean,2015,3277,3435,158,4.821483063777846
Kannad,Bajri,2016,1651,1809,158,9.569957601453664
Nashik,Mint,2016,135,293,158,117.03703703703704
Bhiwapur,Paddy-Unhusked,2014,1850,2008,158,8.54054054054054
Dondaicha,Maize,2014,921,1079,158,17.15526601520087
Kalmeshwar,Raddish,2015,1201,1359,158,13.155703580349709
Yawal,Onion,2016,700,858,158,22.571428571428573
Dondaicha,Bajri,2016,1382,1540,158,11.432706222865413
Jalna,Wheat(Husked),2016,1878,2036,158,8.413205537806176
Shirur,Gram,2016,3350,3508,158,4.7164179104477615
Savner,Soybean,2015,3425,3583,158,4.613138686131387
Amalner,Maize,2014,996,1154,158,15.863453815261044
Wardha,Gram,2015,4279,4437,158,3.692451507361533
Umarga,Wheat(Husked),2015,2010,2168,158,7.8606965174129355
Shegaon,Black Gram,2016,7342,7500,158,2.152002179242713
Zarijamini,Gram,2015,3503,3661,158,4.510419640308307
Amalner,Bajri,2016,1492,1650,158,10.589812332439678
Lonar,Soybean,2015,3596,3754,158,4.39377085650723
Achalpur,Soybean,2014,3113,3271,158,5.075489881143591
Kalmeshwar,WHEAT(HUSKED),2016,1245,1403,158,12.690763052208835
Udgir,Green Gram,2016,4955,5113,158,3.1886982845610494
Gangapur,Bajri,2015,1185,1343,158,13.333333333333334
Aamgaon,Paddy-Unhusked,2014,1591,1749,158,9.93086109365179
Amarawati-Fruit And Vegetables,FLOWER,2016,871,1029,158,18.14006888633754
Kille Dharur,Sorgum(Jawar),2016,1673,1831,158,9.444112372982666
Kille Dharur,Green Gram,2015,7203,7361,158,2.193530473413855
Kurdwadi-Modnimb,Maize,2015,1078,1236,158,14.656771799628942
Kopargaon,Wheat(Husked),2015,1434,1592,158,11.01813110181311
Anajngaon Surji,Sorgum(Jawar),2015,1193,1350,157,13.160100586756077
Kalmeshwar,Tomato,2015,589,746,157,26.6553480475382
Shahada,Sorgum(Jawar),2014,1601,1758,157,9.80637101811368
Shahada,Sorgum(Jawar),2015,1490,1647,157,10.536912751677852
Paithan,Bajri,2014,1367,1524,157,11.485003657644477
Ausa,Soybean,2015,3760,3917,157,4.175531914893617
Ramtek,Garlic,2015,713,870,157,22.019635343618514
Mandhal,Gram,2016,5368,5525,157,2.9247391952309987
Kalmeshwar,Spinach,2015,369,526,157,42.547425474254744
Rahuri-Vambori,Ground Nut Pods (Dry),2015,3583,3740,157,4.381802958414736
Indapur,Jaggery,2016,2379,2536,157,6.599411517444304
Jintur,Green Gram,2015,7008,7165,157,2.240296803652968
Umarga,Sorgum(Jawar),2016,1245,1402,157,12.610441767068274
Mukhed,Pigeon Pea (Tur),2016,7800,7957,157,2.0128205128205128
Umarga,Sunflower,2015,3026,3183,157,5.188367481824191
Akhadabalapur,Sorgum(Jawar),2015,1357,1514,157,11.56963890935888
Kalvan,Bajri,2015,1284,1441,157,12.22741433021807
Patan,Flower,2016,529,686,157,29.678638941398866
Jalgaon,Banana,2015,163,320,157,96.31901840490798
Paithan,SOYBEAN,2016,2454,2611,157,6.397718011409943
Digras,COTTON,2016,4660,4817,157,3.369098712446352
Aurad Shahajani,Gram,2016,4241,4398,157,3.7019570855930204
Jalgaon Jamod-Aasalgaon,Maize,2015,1007,1164,157,15.590863952333665
Malkapur,Maize,2016,1244,1401,157,12.620578778135048
Jalgaon Jamod-Aasalgaon,Sorgum(Jawar),2015,1143,1300,157,13.73578302712161
Kalmeshwar,Spinach,2015,858,1015,157,18.2983682983683
Shirpur,Matki,2015,7122,7279,157,2.204436955911261
Morshi,Wheat(Husked),2015,1394,1551,157,11.262553802008608
Buldhana,Wheat(Husked),2015,1333,1490,157,11.77794448612153
Mantha,Soybean,2016,3457,3614,157,4.541509979751229
Barshi-Vairag,Soybean,2016,3531,3688,157,4.446332483715661
Tuljapur,Pigeon Pea (Tur),2015,5812,5969,157,2.7013076393668274
Kalyan,Onion,2016,621,778,157,25.281803542673106
Lasalgaon,Maize,2015,1151,1308,157,13.64031277150304
Ralegaon,Pigeon Pea (Tur),2015,4708,4865,157,3.334749362786746
Kada,Bajri,2015,1250,1407,157,12.56
Karad,Bottle Gourd,2015,606,763,157,25.90759075907591
Kinwat,Ground Nut Pods (Dry),2015,4543,4700,157,3.4558661677305746
Yawal,Sorgum(Jawar),2014,1329,1486,157,11.813393528969149
Korpana,Pigeon Pea (Tur),2015,4813,4970,157,3.2619987533762727
Savali,Paddy-Unhusked,2016,1764,1921,157,8.900226757369614
Nandura,Maize,2014,907,1064,157,17.30981256890849
Pusad,Bajri,2015,1381,1538,157,11.368573497465604
Dondaicha-Sindkheda,Gram,2016,4000,4157,157,3.925
Katol,Wheat(Husked),2016,1442,1599,157,10.8876560332871
Nagpur,Melon,2015,633,790,157,24.80252764612954
Bhokar,Gram,2015,3684,3841,157,4.261672095548317
Sangali,Wheat(Unhusked),2016,3253,3410,157,4.826314171533968
Panvel,Flower,2015,914,1071,157,17.177242888402628
Ambejogai,Soybean,2016,3614,3771,157,4.344216934144992
Vaijapur,Sorgum(Jawar),2016,1778,1935,157,8.830146231721034
Yeola,Bajri,2015,1407,1564,157,11.158493248045486
Barshi,Maize,2015,1227,1384,157,12.795436022819885
Ghansawangi,SOYBEAN,2016,2600,2757,157,6.038461538461538
Chopda,Sorgum(Jawar),2014,1360,1517,157,11.544117647058824
Vaduj,Soybean,2015,3000,3157,157,5.233333333333333
Jalkot,Sorgum(Jawar),2016,1356,1513,157,11.578171091445428
Jalgaon Jamod-Aasalgaon,Maize,2015,950,1106,156,16.42105263157895
Ghoti,Cabbage,2016,688,844,156,22.674418604651162
Sinner,Pigeon Pea (Tur),2015,3524,3680,156,4.426787741203178
Dhamangaon-Rly,Cotton,2016,4380,4536,156,3.5616438356164384
Kolhapur-Laxmipuri,Maize,2015,1477,1633,156,10.561949898442789
Ausa,Sunflower,2016,3408,3564,156,4.577464788732394
Karmala,Maize,2014,1081,1237,156,14.431082331174839
Chopda,Sorgum(Jawar),2015,1339,1495,156,11.650485436893204
Shegaon,Sorgum(Jawar),2015,1246,1402,156,12.520064205457464
Malegaon,Wheat(Husked),2016,1648,1804,156,9.466019417475728
Akhadabalapur,Soybean,2015,3144,3300,156,4.961832061068702
Jalgaon Jamod,Maize,2015,922,1078,156,16.919739696312366
Partur,Bajri,2015,1236,1392,156,12.62135922330097
Aurangabad,Potato,2015,565,721,156,27.61061946902655
Parola,SORGUM(JAWAR),2016,1075,1231,156,14.511627906976743
Parola,MAIZE,2016,996,1152,156,15.662650602409638
Udgir,Green Gram,2015,7595,7751,156,2.053982883475971
Yeola,Wheat(Husked),2014,1509,1665,156,10.337972166998012
Solapur,Green Gram,2016,4899,5055,156,3.1843233312921004
Nagpur,Banana,2016,594,750,156,26.262626262626263
Shirur,Sorgum(Jawar),2016,1637,1793,156,9.529627367135003
Sangrampur-Varvatbakal,Maize,2015,1004,1160,156,15.53784860557769
Hingoli,Soybean,2014,3013,3169,156,5.17756388981082
Vaijapur,Sorgum(Jawar),2016,1785,1941,156,8.739495798319327
Parli-Vaijnath,Soybean,2015,3183,3339,156,4.9010367577756835
Shrirampur,KARDAI,2016,2100,2256,156,7.428571428571429
Amarawati,Pumpkin,2016,750,906,156,20.8
Ahmednagar,Bajri,2016,1646,1802,156,9.477521263669502
Vaduj,Gram,2014,2522,2678,156,6.185567010309279
Umared,Coriander (Dry),2014,9225,9381,156,1.6910569105691058
Vai,Brinjal,2015,536,692,156,29.104477611940297
Rahuri-Vambori,Green Gram,2015,6569,6725,156,2.3747906835134724
Gevrai,Mustard,2015,3464,3620,156,4.503464203233256
Bori,GREEN GRAM,2016,3872,4028,156,4.028925619834711
Palghar(Bevur),Wheat(Husked),2016,2295,2451,156,6.7973856209150325
Jafrabad,Maize,2015,1050,1206,156,14.857142857142858
Dondaicha,Maize,2016,1347,1503,156,11.58129175946548
Kalamb (Os),Maize,2015,1354,1510,156,11.521418020679468
Kalmeshwar,Cucumber,2014,862,1018,156,18.097447795823665
Barshi,Bajri,2016,1232,1388,156,12.662337662337663
Devani,Soybean,2015,3610,3766,156,4.321329639889196
Vaduj,WHEAT(HUSKED),2016,1844,2000,156,8.459869848156183
Mehkar,Sorgum(Jawar),2015,1092,1248,156,14.285714285714286
Dondaicha,Maize,2016,1427,1583,156,10.932025227750525
Gangapur,Wheat(Husked),2014,1579,1735,156,9.879670677644079
Gangapur,Wheat(Husked),2014,1468,1624,156,10.626702997275205
Vaduj,Gram,2015,3822,3978,156,4.081632653061225
Mandhal,Gram,2015,3724,3880,156,4.189044038668099
Armori-Desaiganj,Paddy-Unhusked,2015,1512,1668,156,10.317460317460318
Morshi,Gram,2015,2994,3150,156,5.210420841683367
Akola,Wheat(Husked),2014,1449,1605,156,10.766045548654244
Panvel,Snake Gourd,2015,1411,1567,156,11.05598866052445
Kalmeshwar,Flower,2015,1013,1169,156,15.399802566633761
Umarga,Soybean,2016,3515,3671,156,4.438122332859175
Armori,Paddy-Unhusked,2015,1688,1844,156,9.24170616113744
Tumsar,Pigeon Pea (Tur),2015,6954,7110,156,2.243313201035375
Panvel,Brinjal,2015,700,856,156,22.285714285714285
Anajngaon Surji,Wheat(Husked),2014,1425,1581,156,10.947368421052632
Kalmeshwar,Chavli (Shenga ),2015,944,1100,156,16.52542372881356
Beed,Soybean,2014,3107,3263,156,5.02092050209205
Pachora,Pigeon Pea (Tur),2016,5415,5571,156,2.880886426592798
Morshi,Soybean,2016,3050,3206,156,5.114754098360656
Akluj,Gram,2014,2271,2427,156,6.869220607661823
Lasalgaon,Maize,2015,1155,1311,156,13.506493506493506
Nandura,Bajri,2016,1208,1364,156,12.913907284768213
Mehkar,Soybean,2016,3228,3383,155,4.801734820322181
Aurangabad,Papai,2015,305,460,155,50.81967213114754
Partur,Soybean,2014,3181,3336,155,4.872681546683433
Tumsar,Paddy-Unhusked,2016,1715,1870,155,9.037900874635568
Ahmedpur,Sorgum(Jawar),2015,1765,1920,155,8.78186968838527
Kalvan,Maize,2016,1349,1504,155,11.489992587101558
Chandur Rly.,Soybean,2015,3074,3229,155,5.042290175666883
Solapur,Grapes,2016,70,225,155,221.42857142857142
Sengaon,Gram,2015,4318,4473,155,3.589624826308476
Kalamb (Os),Tamarind,2016,6455,6610,155,2.4012393493415956
Udgir,Gram,2016,6448,6603,155,2.4038461538461537
Kolhapur,Raddish,2015,133,288,155,116.54135338345864
Lasalgaon-Niphad,Soybean,2015,3361,3516,155,4.6117227015769116
Gevrai,Soybean,2015,3106,3261,155,4.990341274951707
Gangapur,Bajri,2015,1568,1723,155,9.885204081632653
Jalna,Black Gram,2015,5294,5449,155,2.927842840952021
Kalmeshwar,Spinach,2014,1320,1475,155,11.742424242424242
Kalamb (Os),Bajri,2015,1372,1527,155,11.29737609329446
Panvel,Bottle Gourd,2015,567,722,155,27.336860670194003
Kalmeshwar,Tomato,2015,657,812,155,23.59208523592085
Umared,Coriander (Dry),2014,9573,9728,155,1.619137156586232
Barshi-Vairag,Gram,2016,4174,4329,155,3.7134643028270244
Nashik,Mint,2016,171,326,155,90.64327485380117
Ramtek,Tomato,2016,345,500,155,44.927536231884055
Tumsar,Sarsav,2014,2769,2924,155,5.597688696280246
Latur,Bajri,2015,1165,1320,155,13.304721030042918
Kopargaon,Sorgum(Jawar),2015,1390,1545,155,11.151079136690647
Patan,Brinjal,2015,539,694,155,28.7569573283859
Ausa,Soybean,2015,3174,3329,155,4.883427851291746
Shevgaon,Wheat(Husked),2014,1464,1619,155,10.587431693989071
Kannad,Maize,2015,1086,1241,155,14.27255985267035
Manwat,Cotton,2015,4283,4438,155,3.6189586738267567
Akot,Sunflower,2016,3053,3208,155,5.0769734687192924
Beed,Sorgum(Jawar),2015,1620,1775,155,9.567901234567902
Pandharpur,Sorgum(Jawar),2015,1658,1813,155,9.348612786489747
Aurad Shahajani,Soybean,2016,3409,3564,155,4.546787914344383
Vaduj,Sorgum(Jawar),2015,1889,2044,155,8.205399682371626
Rahuri-Vambori,Wheat(Husked),2016,1694,1849,155,9.149940968122786
Digras,Soybean,2016,3549,3704,155,4.367427444350521
Kalmeshwar,Tomato,2014,591,746,155,26.22673434856176
Pune-Pimpri,Cabbage,2015,759,914,155,20.421607378129117
Lasalgaon-Vinchur,Bajri,2015,1156,1311,155,13.408304498269896
Sindi,Gram,2015,3000,3155,155,5.166666666666667
Sillod,WHEAT(HUSKED),2016,1627,1782,155,9.526736324523663
Varud,Cotton,2015,4184,4339,155,3.704588910133843
Tumsar,Castor Seed,2016,2970,3125,155,5.218855218855219
Amarawati,Cucumber,2016,1689,1844,155,9.177027827116637
Gevrai,Soybean,2016,3271,3426,155,4.738612045246102
Murbad,Bitter Gourd,2015,5918,6073,155,2.6191280838120985
Ashti-Karanja,Wheat(Husked),2016,1500,1655,155,10.333333333333334
Bhandara,Gram,2016,4072,4227,155,3.8064833005893908
Kopargaon,Bajri,2016,1427,1582,155,10.861948142957253
Ashti-Karanja,Wheat(Husked),2015,1467,1622,155,10.565780504430812
Parbhani,Pigeon Pea (Tur),2014,4419,4574,155,3.507580900656257
Sindi,Cotton,2016,4540,4695,155,3.4140969162995596
Latur,Soybean,2015,3248,3403,155,4.772167487684729
Manmad,Bajri,2015,1284,1439,155,12.071651090342678
Devala,Wheat(Husked),2016,1582,1737,155,9.79772439949431
Varud,Cotton,2015,4311,4466,155,3.5954534910693576
Armori-Desaiganj,Paddy-Unhusked,2016,1695,1850,155,9.144542772861357
Chalisgaon,Bajri,2014,1224,1379,155,12.663398692810457
Parbhani,Gram,2016,3962,4117,155,3.9121655729429583
Shahada,Wheat(Husked),2016,1670,1825,155,9.281437125748504
Ausa,Maize,2015,1206,1360,154,12.769485903814262
Mandhal,Soybean,2015,3309,3463,154,4.653974010275007
Dudhani,Bajri,2015,1403,1557,154,10.97647897362794
Devala,Wheat(Husked),2015,1312,1466,154,11.737804878048781
Partur,Gram,2015,3970,4124,154,3.8790931989924435
Palghar(Bevur),Potato,2016,1098,1252,154,14.025500910746812
Washim,Wheat(Husked),2016,1831,1985,154,8.410704533042054
Latur-Murud,Sorgum(Jawar),2015,1229,1383,154,12.530512611879576
Washim,Sorgum(Jawar),2015,1087,1241,154,14.167433302667893
Umarkhed,Soybean,2015,3459,3613,154,4.452153801676785
Rahata,Ginger (Fresh),2015,4538,4692,154,3.393565447333627
Shevgaon,Bajri,2015,1415,1569,154,10.883392226148409
Barshi,Bitter Gourd,2015,100,254,154,154.0
Nandurbar,Soybean,2015,3475,3629,154,4.431654676258993
Shirur,Sorgum(Jawar),2016,1636,1790,154,9.41320293398533
Amalner,Gram,2014,2180,2334,154,7.064220183486238
Kalvan,Soybean,2015,3563,3717,154,4.322200392927308
Khamgaon,Sunflower,2016,3217,3371,154,4.787068697544296
Yeola,Wheat(Husked),2016,1708,1862,154,9.01639344262295
Narkhed,Cotton,2016,4300,4454,154,3.5813953488372094
Paithan,Sorgum(Jawar),2015,1931,2085,154,7.975142413257379
Gevrai,Soybean,2016,2948,3102,154,5.223880597014926
Umared,Cotton,2015,4155,4309,154,3.7063778580024067
Barshi,Bitter Gourd,2015,164,318,154,93.90243902439025
Murum,Soybean,2016,2921,3075,154,5.272167066073263
Barshi,Green Chilli,2015,200,354,154,77.0
Islampur,Brinjal,2016,160,314,154,96.25
Malkapur,Sorgum(Jawar),2015,1310,1464,154,11.755725190839694
Manmad,Wheat(Husked),2016,1553,1707,154,9.916291049581455
Dondaicha,Cotton,2015,3896,4050,154,3.952772073921971
Devala,Maize,2016,1355,1509,154,11.365313653136532
Purna,Soybean,2015,3146,3300,154,4.895104895104895
Barshi-Vairag,Wheat(Husked),2014,1948,2102,154,7.905544147843942
Gevrai,Bajri,2015,1162,1316,154,13.25301204819277
Aurad Shahajani,Gram,2016,4491,4645,154,3.429080382988199
Washim,Black Gram,2015,6532,6686,154,2.357624004898959
Sillod,Wheat(Husked),2015,1400,1554,154,11.0
Hingoli,Soybean,2016,3599,3753,154,4.278966379549875
Bhandara,Wheat(Husked),2016,1534,1688,154,10.039113428943937
Nandgaon Khandeshwar,Wheat(Husked),2016,1250,1404,154,12.32
Khamgaon,Sorgum(Jawar),2015,978,1132,154,15.74642126789366
Bori,Sorgum(Jawar),2016,1722,1876,154,8.94308943089431
Rahuri-Vambori,Wheat(Husked),2015,1506,1660,154,10.225763612217795
Ahmedpur,Wheat(Husked),2016,1378,1532,154,11.175616835994195
Hingoli,Soybean,2016,3385,3539,154,4.549483013293944
Amarawati-Fruit And Vegetables,Cucumber,2016,777,931,154,19.81981981981982
Kalmeshwar,Brinjal,2014,630,784,154,24.444444444444443
Amarawati,Beet Root,2016,1123,1277,154,13.713268032056991
Amarawati-Fruit And Vegetables,BRINJAL,2016,769,923,154,20.0260078023407
Kalyan,Onion,2016,721,874,153,21.220527045769764
Malkapur,Sorgum(Jawar),2015,1083,1236,153,14.12742382271468
Lasalgaon,Maize,2015,1422,1575,153,10.759493670886076
Dondaicha,Maize,2015,1195,1348,153,12.803347280334728
Jamkhed,Bajri,2015,1300,1453,153,11.76923076923077
Kopargaon,Soybean,2015,2983,3136,153,5.129064699966476
Kolhapur-Malkapur,Cabbage,2016,106,259,153,144.33962264150944
Loha,Wheat(Husked),2014,1407,1560,153,10.874200426439232
Ausa,Sorgum(Jawar),2016,1310,1463,153,11.679389312977099
Hingna,Pigeon Pea (Tur),2015,5376,5529,153,2.845982142857143
Telhara,Wheat(Husked),2016,1475,1628,153,10.372881355932204
Rahuri-Vambori,Bajri,2016,1373,1526,153,11.143481427530954
Kada,Bajri,2015,1382,1535,153,11.070911722141824
Zarijamini,Cotton,2015,3800,3953,153,4.026315789473684
Mehkar,Maize,2015,1296,1449,153,11.805555555555555
Kalmeshwar,Brinjal,2015,759,912,153,20.158102766798418
Lonar,Maize,2015,935,1088,153,16.363636363636363
Samudrapur,Gram,2016,4958,5111,153,3.0859217426381607
Lasur Station,Soybean,2016,3350,3503,153,4.567164179104478
Chopda,Bajri,2015,1091,1244,153,14.023831347387718
Vai,Tomato,2016,590,743,153,25.93220338983051
Chalisgaon,Sorgum(Jawar),2016,1388,1541,153,11.023054755043228
Sengaon,Gram,2015,4662,4815,153,3.281853281853282
Chikhali,Wheat(Husked),2015,1413,1566,153,10.828025477707007
Koregaon,Gram,2016,4037,4190,153,3.789943027000248
Gangapur,Wheat(Husked),2015,1570,1723,153,9.745222929936306
Kalmeshwar,Pumpkin,2015,722,875,153,21.191135734072024
Kalmeshwar,Flower,2015,439,592,153,34.851936218678816
Vaijapur,Gram,2015,4072,4225,153,3.757367387033399
Jamkhed,Bajri,2016,1425,1578,153,10.736842105263158
Beed,Soybean,2016,3517,3670,153,4.350298549900483
Lasur Station,Maize,2016,1541,1694,153,9.928617780661908
Shevgaon-Bodhegaon,Sorgum(Jawar),2016,1743,1896,153,8.777969018932874
Tumsar,Pigeon Pea (Tur),2015,5117,5270,153,2.990033222591362
Shahada,Pigeon Pea (Tur),2015,8475,8628,153,1.8053097345132743
Kalmeshwar,Spinach,2015,397,550,153,38.53904282115869
Dudhani,Maize,2014,917,1070,153,16.68484187568157
Satara,Cabbage,2016,485,638,153,31.54639175257732
Akluj,Coriander  ,2016,253,406,153,60.47430830039526
Shegaon,Wheat(Husked),2014,1329,1482,153,11.512415349887133
Sindi,Wheat(Husked),2016,1500,1653,153,10.2
Dudhani,Wheat(Husked),2014,1329,1482,153,11.512415349887133
Jawala-Bajar,Cotton,2016,4417,4570,153,3.4638895177722437
Devani,Soybean,2016,3926,4079,153,3.8970962812022414
Katol,Soybean,2016,2897,3050,153,5.281325509147394
Shahada,Soybean,2015,3189,3342,153,4.797742238946378
Barshi,Ladies Finger,2015,200,352,152,76.0
Armori-Desaiganj,Paddy-Unhusked,2015,1440,1592,152,10.555555555555555
Manchar,Bottle Gourd,2016,450,602,152,33.77777777777778
Loha,Pigeon Pea (Tur),2015,5225,5377,152,2.909090909090909
Pusad,Sorgum(Jawar),2016,1337,1489,152,11.36873597606582
Pachora,Wheat(Husked),2016,1591,1743,152,9.553739786297927
Pachora,Wheat(Husked),2016,1621,1773,152,9.376927822331893
Nashik,Mint,2016,199,351,152,76.38190954773869
Bhiwapur,Paddy-Unhusked,2015,1800,1952,152,8.444444444444445
Tumsar,Wheat(Husked),2015,1395,1547,152,10.89605734767025
Bhokar,Cotton,2015,3900,4052,152,3.8974358974358974
Kalmeshwar,Cucumber,2015,644,796,152,23.60248447204969
Chikhali,Maize,2015,1008,1160,152,15.079365079365079
Shevgaon-Bodhegaon,Sorgum(Jawar),2015,1558,1710,152,9.75609756097561
Mehkar,Maize,2015,1140,1292,152,13.333333333333334
Nandura,Sorgum(Jawar),2016,1230,1382,152,12.357723577235772
Bhandara,Other Cereals,2016,3960,4112,152,3.8383838383838382
Bhokar,Wheat(Husked),2016,1520,1672,152,10.0
Sillod,Wheat(Husked),2016,1590,1742,152,9.559748427672956
Pachora,Wheat(Husked),2015,1433,1585,152,10.60711793440335
Gangapur,Sorgum(Jawar),2016,1688,1840,152,9.004739336492891
Kalmeshwar,Coriander  ,2015,405,557,152,37.53086419753087
Daryapur,Sorgum(Jawar),2014,1225,1377,152,12.408163265306122
Lasalgaon,Maize,2015,1098,1250,152,13.843351548269581
Telhara,Soybean,2014,3062,3214,152,4.964075767472241
Chikhali,Soybean,2016,3301,3453,152,4.604665252953651
Sangamner,Gram,2016,3982,4134,152,3.8171772978402814
Chandur Rly.,Gram,2016,5378,5530,152,2.8263294905169207
Amalner,Wheat(Husked),2014,1391,1543,152,10.927390366642703
Malkapur,Maize,2014,911,1063,152,16.68496158068057
Dondaicha,Maize,2015,1055,1207,152,14.407582938388625
Hingoli,Black Gram,2015,5129,5281,152,2.963540651199064
Ashti (Jalna),Sorgum(Jawar),2015,1603,1755,152,9.482220835932626
Umared,Mustard,2016,2758,2910,152,5.511240029006527
Mandhal,Paddy-Unhusked,2016,1743,1895,152,8.720596672403902
Tasgaon,Maize,2016,1419,1571,152,10.711768851303734
Jalgaon,Banana,2015,276,428,152,55.072463768115945
Kalmeshwar,Methi (Bhaji),2015,313,465,152,48.56230031948882
Jamkhed,Wheat(Husked),2016,2248,2400,152,6.761565836298932
Ambejogai,Soybean,2016,3613,3765,152,4.2070301688347636
Dondaicha-Sindkheda,Wheat(Husked),2016,1497,1649,152,10.153640614562459
Lasur Station,Maize,2015,1339,1491,152,11.35175504107543
Nandura,Wheat(Husked),2015,1388,1540,152,10.951008645533141
Kurdwadi-Modnimb,Maize,2015,1177,1329,152,12.914188615123194
Dharangaon,Green Gram,2016,4205,4357,152,3.61474435196195
Pathardi,Bajri,2015,1261,1413,152,12.053925455987311
Pulgaon,Soybean,2015,3069,3220,151,4.920169436298469
Achalpur,Maize,2016,1394,1545,151,10.832137733142037
Rahuri-Vambori,Ground Nut Pods (Dry),2014,3325,3476,151,4.541353383458647
Dhule,Sorgum(Jawar),2015,1229,1380,151,12.286411716842961
Kada,Sunflower,2015,2900,3051,151,5.206896551724138
Kopargaon,Sorgum(Jawar),2015,1152,1303,151,13.10763888888889
Raver,Maize,2016,1232,1383,151,12.256493506493506
Gangapur,Maize,2014,846,997,151,17.84869976359338
Indapur-Bhigwan,Maize,2015,1231,1382,151,12.266450040617384
Indapur-Bhigwan,Soybean,2014,2850,3001,151,5.298245614035087
Chakur,Pigeon Pea (Tur),2015,8616,8767,151,1.7525533890436398
Karanja,Sunflower,2014,2699,2850,151,5.594664690626158
Shirur,BAJRI,2016,1260,1411,151,11.984126984126984
Umarga,Sorgum(Jawar),2015,1369,1520,151,11.029948867786706
Rajura,Pigeon Pea (Tur),2016,7853,8004,151,1.9228320387113205
Kalmeshwar,Brinjal,2014,625,776,151,24.16
Umared,Coriander (Dry),2015,8133,8284,151,1.856633468584778
Sailu,Pigeon Pea (Tur),2016,5115,5266,151,2.952101661779081
Umarga,Sunflower,2014,3043,3194,151,4.962208347025961
Kannad,Bajri,2015,1188,1339,151,12.710437710437711
Armori-Desaiganj,PADDY-UNHUSKED,2016,1540,1691,151,9.805194805194805
Telhara,Wheat(Husked),2015,1246,1397,151,12.118780096308186
Nampur,Wheat(Husked),2016,1452,1603,151,10.399449035812673
Nampur,Wheat(Husked),2016,1460,1611,151,10.342465753424657
Rahuri-Vambori,Soybean,2015,3296,3447,151,4.581310679611651
Kalmeshwar,Spinach,2016,240,391,151,62.916666666666664
Paithan,Soybean,2016,3920,4071,151,3.8520408163265305
Umarga,Sorgum(Jawar),2016,1554,1705,151,9.716859716859718
Indapur-Bhigwan,Maize,2016,1675,1826,151,9.014925373134329
Khamgaon,Sorgum(Jawar),2015,1256,1407,151,12.022292993630574
Yawal,Banana,2016,771,922,151,19.58495460440986
Dondaicha,Sorgum(Jawar),2015,1343,1494,151,11.243484735666419
Akluj,Gram,2016,4000,4151,151,3.775
Jalgaon,Banana,2014,225,376,151,67.11111111111111
Bhokar,Green Gram,2016,4310,4461,151,3.503480278422274
Bhokar,Wheat(Husked),2014,1363,1514,151,11.078503301540719
Pathari,Gram,2016,3900,4051,151,3.871794871794872
Akot,Wheat(Husked),2015,1399,1550,151,10.793423874195854
Umared,Other Pulses,2015,4200,4351,151,3.5952380952380953
Jalgaon,Sorgum(Jawar),2014,1368,1519,151,11.038011695906432
Kolhapur,Water Melon,2016,600,750,150,25.0
Vaijapur,Cotton,2014,3950,4100,150,3.7974683544303796
Kolhapur-Laxmipuri,Maize,2014,1350,1500,150,11.11111111111111
Kolhapur,Strawberi,2016,650,800,150,23.076923076923077
Buldhana,Maize,2015,900,1050,150,16.666666666666668
Vaijapur,Cotton,2014,3900,4050,150,3.8461538461538463
Kolhapur-Malkapur,Coriander  ,2016,250,400,150,60.0
Lasalgaon-Vinchur,Maize,2016,1446,1596,150,10.37344398340249
Daryapur,Green Gram,2016,6927,7077,150,2.1654395842356
Kolhapur-Laxmipuri,Paddy-Unhusked,2014,1600,1750,150,9.375
Purna,Sorgum(Jawar),2015,1076,1226,150,13.940520446096654
Koregaon,Green Gram,2015,7000,7150,150,2.142857142857143
Koregaon,Potato,2015,700,850,150,21.428571428571427
Kolhapur-Laxmipuri,Maize,2015,1450,1600,150,10.344827586206897
Kurdwadi,Black Gram,2016,5595,5745,150,2.680965147453083
Koregaon,Wheat(Husked),2015,1700,1850,150,8.823529411764707
Kolhapur-Laxmipuri,Paddy-Unhusked,2015,1542,1692,150,9.727626459143968
Chamorshi,Paddy-Unhusked,2014,1700,1850,150,8.823529411764707
Bori,Pigeon Pea (Tur),2016,4800,4950,150,3.125
Sangrampur,Banana,2015,400,550,150,37.5
Chalisgaon,Maize,2015,1044,1194,150,14.367816091954023
Kinwat,Sorgum(Jawar),2015,1300,1450,150,11.538461538461538
Chandur Bajar,Sorgum(Jawar),2015,1258,1408,150,11.92368839427663
Kinwat,Wheat(Husked),2015,1375,1525,150,10.909090909090908
Kinwat,Sorgum(Jawar),2015,1025,1175,150,14.634146341463415
Lakhandur,Oth.Split Pulses,2016,3813,3963,150,3.933910306845004
Kinwat,Soybean,2015,2950,3100,150,5.084745762711864
Chandvad,Ladies Finger,2015,3633,3783,150,4.1288191577208915
Chopda,Wheat(Husked),2016,1523,1673,150,9.848982271831911
Lasalgaon,Maize,2016,1517,1667,150,9.88793671720501
Darwha,Cotton,2015,3900,4050,150,3.8461538461538463
Latur-Murud,Gram,2015,3767,3917,150,3.9819485001327317
Pune-Pimpri,Wal Papdi,2016,2550,2700,150,5.882352941176471
Lasalgaon-Niphad,Gram,2016,6088,6238,150,2.463863337713535
Chalisgaon,Cluster Bean,2015,3250,3400,150,4.615384615384615
Chopda,Ground Nut Pods (Dry),2014,3101,3251,150,4.837149306675266
Purna,Cotton,2014,3900,4050,150,3.8461538461538463
Kinwat,Soybean,2016,3500,3650,150,4.285714285714286
Chandur Bajar,Sorgum(Jawar),2016,1350,1500,150,11.11111111111111
Chandur Bajar,Sorgum(Jawar),2016,1300,1450,150,11.538461538461538
Vaijapur,Cotton,2015,4100,4250,150,3.658536585365854
Buldhana,Sorgum(Jawar),2015,1167,1317,150,12.853470437017995
Kinwat,Cotton,2014,3778,3928,150,3.9703546850185285
Kolhapur,RADDISH,2016,300,450,150,50.0
Kille Dharur,Sorgum(Jawar),2016,1672,1822,150,8.971291866028707
Washi(Osmanabad),Soybean,2016,3400,3550,150,4.411764705882353
Nandgaon Khandeshwar,Wheat(Husked),2016,1527,1677,150,9.82318271119843
Sillod-Bharadi,Green Gram,2016,4375,4525,150,3.4285714285714284
Nandgaon Khandeshwar,Soybean,2014,3100,3250,150,4.838709677419355
Anajngaon Surji,Sorgum(Jawar),2015,1333,1483,150,11.252813203300825
Anajngaon Surji,Sunflower,2015,2925,3075,150,5.128205128205129
Kalmeshwar,Cucumber,2015,3750,3900,150,4.0
Akkalkuwa,Wheat(Husked),2016,1450,1600,150,10.344827586206897
Rahuri-Vambori,Pigeon Pea (Tur),2016,7465,7615,150,2.0093770931011385
Akkalkuwa,Wheat(Husked),2015,1300,1450,150,11.538461538461538
Kalmeshwar,Ladies Finger,2015,869,1019,150,17.26121979286536
Akhadabalapur,Gram,2015,3200,3350,150,4.6875
Jalgaon,Wal Papdi,2014,1600,1750,150,9.375
Akhadabalapur,Soybean,2016,3280,3430,150,4.573170731707317
Vaduj,Green Gram,2015,6500,6650,150,2.3076923076923075
Rahuri-Vambori,Gram,2016,4219,4369,150,3.5553448684522397
Shrirampur,Pigeon Pea (Tur),2015,3995,4145,150,3.7546933667083855
Kalmeshwar,Spinach,2015,890,1040,150,16.853932584269664
Parli-Vaijnath,Sorgum(Jawar),2015,1363,1513,150,11.005135730007337
Nandgaon Khandeshwar,Sorgum(Jawar),2016,1200,1350,150,12.5
Nandura,Bajri,2015,1040,1190,150,14.423076923076923
Sailu,Soybean,2016,3400,3550,150,4.411764705882353
Akkolkot,Bajri,2015,1450,1600,150,10.344827586206897
Jafrabad,Wheat(Husked),2016,1550,1700,150,9.67741935483871
Kalmeshwar,Chavli (Shenga ),2014,900,1050,150,16.666666666666668
Jafrabad,Wheat(Husked),2016,1300,1450,150,11.538461538461538
Sillod-Bharadi,Soybean,2015,3350,3500,150,4.477611940298507
Yawal,Cotton,2014,3769,3919,150,3.979835500132661
Telhara,Cotton,2015,4050,4200,150,3.7037037037037037
Sillod-Bharadi,Bajri,2016,1450,1600,150,10.344827586206897
Ambejogai,Pigeon Pea (Tur),2016,5183,5333,150,2.8940767895041484
Nandurbar,Chillies(Red),2015,3850,4000,150,3.896103896103896
Parbhani,GREEN GRAM,2016,4293,4443,150,3.4940600978336827
Anajngaon Surji,Banana,2014,980,1130,150,15.306122448979592
Anajngaon Surji,Banana,2014,950,1100,150,15.789473684210526
Telhara,Green Gram,2015,7000,7150,150,2.142857142857143
Nandura,Maize,2015,997,1147,150,15.045135406218655
Solapur,Spinach,2014,100,250,150,150.0
Nanded,Gram,2014,2350,2500,150,6.382978723404255
Nampur,Sunflower,2016,2600,2750,150,5.769230769230769
Washim,Sorgum(Jawar),2015,1337,1487,150,11.219147344801796
Kalyan,Cabbage,2014,750,900,150,20.0
Gondpimpri,Pigeon Pea (Tur),2015,4550,4700,150,3.2967032967032965
Akhadabalapur,Pigeon Pea (Tur),2014,4000,4150,150,3.75
Gondpimpri,Horse Gram,2015,1650,1800,150,9.090909090909092
Kalvan,Maize,2016,1363,1513,150,11.005135730007337
Akhadabalapur,Cotton,2014,4009,4159,150,3.7415814417560487
Ramtek,Maize(Corn.),2016,650,800,150,23.076923076923077
Shrirampur,Bajri,2016,2292,2442,150,6.544502617801047
Ghoti,Flower,2016,850,1000,150,17.647058823529413
Umarga,Safflower,2015,2423,2573,150,6.190672719768881
Kalyan,Potato,2014,1800,1950,150,8.333333333333334
Kalyan,Bajri,2015,1725,1875,150,8.695652173913043
Kalyan,Bajri,2015,1530,1680,150,9.803921568627452
Kalyan,Bajri,2015,1600,1750,150,9.375
Parola,Gram,2016,3375,3525,150,4.444444444444445
Murbad,Tomato,2015,2667,2817,150,5.62429696287964
Murbad,Tomato,2015,2400,2550,150,6.25
Sakri,Pigeon Pea (Tur),2016,5446,5596,150,2.754315093646713
Sillod-Bharadi,Wheat(Husked),2016,1600,1750,150,9.375
Umarkhed-Danki,Gram,2015,4850,5000,150,3.0927835051546393
Hadgaon,Wheat(Husked),2016,1650,1800,150,9.090909090909092
Aurangabad,Coriander  ,2015,150,300,150,100.0
Sillod-Bharadi,Mustard,2016,3550,3700,150,4.225352112676056
Sillod-Bharadi,Mustard,2016,3400,3550,150,4.411764705882353
Kalmeshwar,Soybean,2016,3302,3452,150,4.5427013930950935
Nagpur,Maize,2016,1350,1500,150,11.11111111111111
Akhadabalapur,Gram,2015,4100,4250,150,3.658536585365854
Aurangabad,Coriander  ,2016,350,500,150,42.857142857142854
Akhadabalapur,Gram,2015,3400,3550,150,4.411764705882353
Aurangabad,Papai,2016,406,556,150,36.94581280788177
Jalgaon,Maize(Corn.),2015,600,750,150,25.0
Jalgaon,Maize(Corn.),2015,800,950,150,18.75
Parli-Vaijnath,Wheat(Husked),2015,1449,1599,150,10.351966873706004
Aurangabad,Spinach,2016,250,400,150,60.0
Jalgaon,Melon,2015,750,900,150,20.0
Hanegaon,Soybean,2016,3500,3650,150,4.285714285714286
Jafrabad,Soybean,2016,3600,3750,150,4.166666666666667
Hingoli,Green Gram,2015,7314,7464,150,2.0508613617719442
Vaduj,Wheat(Husked),2015,2000,2150,150,7.5
Amarawati,Brinjal,2015,850,1000,150,17.647058823529413
Panvel,Brinjal,2015,825,975,150,18.181818181818183
Jafrabad,Maize,2016,1450,1600,150,10.344827586206897
Pachora,Wheat(Husked),2016,1530,1680,150,9.803921568627452
Ramtek,Pigeon Pea (Tur),2015,5350,5500,150,2.803738317757009
Islampur,Green Chilli,2016,608,758,150,24.67105263157895
Pachora,Sesamum,2016,5350,5500,150,2.803738317757009
Islampur,Capsicum,2016,390,540,150,38.46153846153846
Islampur,Flower,2015,200,350,150,75.0
Panvel,Flower,2015,675,825,150,22.22222222222222
Soygaon,Cotton,2015,3933,4083,150,3.8138825324180017
Amarawati,Carrot,2015,1350,1500,150,11.11111111111111
Soygaon,Maize,2015,1100,1250,150,13.636363636363637
Amarawati,Ladies Finger,2015,2163,2313,150,6.934812760055478
Soygaon,Cotton,2016,4400,4550,150,3.409090909090909
Raver-Sawada,Sorgum(Jawar),2016,1063,1213,150,14.111006585136407
Raver-Sawada,WHEAT(HUSKED),2016,1700,1850,150,8.823529411764707
Jafrabad,Castor Seed,2015,2875,3025,150,5.217391304347826
Kalamb (Os),Jaggery,2014,2400,2550,150,6.25
Washim,Black Gram,2016,7100,7250,150,2.112676056338028
Jafrabad,Maize,2015,1140,1290,150,13.157894736842104
Kada,Gram,2015,3283,3433,150,4.568991775814803
Solapur,SHEPU,2016,150,300,150,100.0
Jafrabad,Green Gram,2016,4925,5075,150,3.045685279187817
Panvel,Bitter Gourd,2014,1450,1600,150,10.344827586206897
Panvel,Cabbage,2014,783,933,150,19.157088122605366
Jafrabad,Wheat(Husked),2015,1350,1500,150,11.11111111111111
Akot,Maize,2015,1144,1294,150,13.111888111888112
Akot,Sesamum,2015,5350,5500,150,2.803738317757009
Akot,Sunflower,2015,2825,2975,150,5.3097345132743365
Akot,Wheat(Husked),2015,1400,1550,150,10.714285714285714
Jafrabad,Soybean,2015,3500,3650,150,4.285714285714286
Panvel,Flower,2014,1580,1730,150,9.49367088607595
Sonpeth,Bajri,2015,1475,1625,150,10.169491525423728
Panvel,Ghosali(Bhaji),2014,1617,1767,150,9.276437847866418
Kada,Soybean,2016,3500,3650,150,4.285714285714286
Amarawati,Linseed,2015,5054,5204,150,2.96794618124258
Indapur-Bhigwan,GROUND NUT PODS (DRY),2016,4400,4550,150,3.409090909090909
Ambejogai,Pigeon Pea (Tur),2014,4025,4175,150,3.7267080745341614
Amarawati-Fruit And Vegetables,Carrot,2016,850,1000,150,17.647058823529413
Jintur-Bori,Soybean,2016,3483,3633,150,4.306632213608958
Sillod,Bajri,2016,1481,1631,150,10.12829169480081
Sillod,Bajri,2016,1550,1700,150,9.67741935483871
Sailu,Green Gram,2015,7145,7295,150,2.099370188943317
Vaduj,Soybean,2014,3000,3150,150,5.0
Tasgaon,Ghevda Seed,2014,2450,2600,150,6.122448979591836
Amarawati-Fruit And Vegetables,Cabbage,2016,1483,1633,150,10.114632501685772
Kalamnuri,Gram,2015,3600,3750,150,4.166666666666667
Ramtek,Ladies Finger,2015,605,755,150,24.793388429752067
Jintur-Bori,Sorgum(Jawar),2016,1574,1724,150,9.529860228716645
Amarawati-Fruit And Vegetables,Pumpkin,2016,1450,1600,150,10.344827586206897
Parbhani,Cotton,2015,4275,4425,150,3.508771929824561
Parbhani,Sorgum(Jawar),2015,1583,1733,150,9.475679090334808
Nashik,Mint,2015,125,275,150,120.0
Ambejogai,Green Gram,2014,6421,6571,150,2.336084722005918
Jafrabad,Soybean,2016,3400,3550,150,4.411764705882353
Junnar (Narayangaon),Tomato,2015,200,350,150,75.0
Shrigonda,Pigeon Pea (Tur),2015,7425,7575,150,2.0202020202020203
Shrigonda,Bajri,2016,1650,1800,150,9.090909090909092
Taloda,Bajri,2016,1710,1860,150,8.771929824561404
Amarawati,Maize(Corn.),2015,300,450,150,50.0
Indapur-Bhigwan,GREEN GRAM,2016,4050,4200,150,3.7037037037037037
Amarawati,Maize(Corn.),2015,500,650,150,30.0
Amarawati,Math (Bhaji),2015,1550,1700,150,9.67741935483871
Panvel,Ghosali(Bhaji),2015,700,850,150,21.428571428571427
Indapur-Bhigwan,Green Peas (Dry),2015,1450,1600,150,10.344827586206897
Panvel,Ladies Finger,2015,1150,1300,150,13.043478260869565
Nira-Saswad,Soybean,2016,3150,3300,150,4.761904761904762
Indapur-Bhigwan,Ghevda Seed,2014,4350,4500,150,3.4482758620689653
Panvel,Snake Gourd,2015,1275,1425,150,11.764705882352942
Nira,Maize,2015,1250,1400,150,12.0
Indapur (Nimgaon Ketki),Bajri,2015,1413,1563,150,10.615711252653927
Panvel,Snake Gourd,2015,1150,1300,150,13.043478260869565
Sillod,Maize,2015,1186,1336,150,12.647554806070826
Amarawati,Green Chilli,2016,1100,1250,150,13.636363636363637
Washim,Green Gram,2016,6500,6650,150,2.3076923076923075
Balapur,Soybean,2015,3067,3217,150,4.890772742093251
Murbad,Bottle Gourd,2014,1157,1307,150,12.96456352636128
Jalgaon Jamod-Aasalgaon,Sorgum(Jawar),2016,1317,1467,150,11.389521640091116
Pune-Pimpri,Bitter Gourd,2015,2775,2925,150,5.405405405405405
Jalgaon Jamod-Aasalgaon,Wheat(Husked),2015,1213,1363,150,12.36603462489695
Sindi (Selu),SORGUM(JAWAR),2016,1050,1200,150,14.285714285714286
Beed,Soybean,2016,3264,3414,150,4.595588235294118
Manchar,Wal Bhaji,2016,1250,1400,150,12.0
Jalgaon Jamod-Aasalgaon,Wheat(Husked),2015,1231,1381,150,12.185215272136475
Bhandara,Soybean,2014,3500,3650,150,4.285714285714286
Pavani,Pigeon Pea (Tur),2016,6550,6700,150,2.2900763358778624
Ahmednagar,Bajri,2015,1438,1588,150,10.43115438108484
Jalgaon Jamod-Aasalgaon,Sorgum(Jawar),2016,1150,1300,150,13.043478260869565
Manchar,Bitter Gourd,2015,1855,2005,150,8.086253369272237
Manchar,Beet Root,2015,700,850,150,21.428571428571427
Jalgaon Jamod-Aasalgaon,Sorgum(Jawar),2016,1300,1450,150,11.538461538461538
Bhandara,Green Peas (Dry),2016,2100,2250,150,7.142857142857143
Rahata,Wheat(Husked),2015,1365,1515,150,10.989010989010989
Khamgaon,Maize,2016,1138,1288,150,13.181019332161688
Beed,Bajri,2015,1434,1584,150,10.460251046025105
Varud-Rajura Bazar,Gram,2016,5500,5650,150,2.727272727272727
Tumsar,Linseed,2015,4206,4356,150,3.566333808844508
Mangaon(Bhadav),Paddy-Unhusked,2015,1300,1450,150,11.538461538461538
Solapur,Green Peas (Dry),2016,2863,3013,150,5.239259517988124
Mangrulpeer,Sorgum(Jawar),2015,1011,1161,150,14.836795252225519
Barshi,Raddish,2016,200,350,150,75.0
Barshi,Safflower,2016,2600,2750,150,5.769230769230769
Barshi,Spinach,2016,150,300,150,100.0
Barshi,Spinach,2016,150,300,150,100.0
Barshi,Squash Gourd,2016,200,350,150,75.0
Barshi,Squash Gourd,2016,200,350,150,75.0
Varud-Rajura Bazar,Wheat(Husked),2016,1551,1701,150,9.671179883945841
Kej,Bajri,2014,1342,1492,150,11.177347242921014
Barshi Takli,Cotton,2016,4278,4428,150,3.506311360448808
Patur,Gram,2015,3050,3200,150,4.918032786885246
Mangalwedha,Black Gram,2016,6050,6200,150,2.479338842975207
Gadchiroli,Paddy-Unhusked,2014,1781,1931,150,8.422234699606962
Patur,Gram,2015,3050,3200,150,4.918032786885246
Umarkhed-Danki,Soybean,2015,3463,3613,150,4.331504475887958
Yeotmal,Cotton,2016,4586,4736,150,3.270824247710423
Malegaon (Washim),Soybean,2016,3600,3750,150,4.166666666666667
Jalgaon Jamod-Aasalgaon,Sorgum(Jawar),2016,1200,1350,150,12.5
Bhokardan,Pigeon Pea (Tur),2015,4850,5000,150,3.0927835051546393
Pune-Pimpri,Flower,2016,750,900,150,20.0
Achalpur,Wheat(Husked),2014,1467,1617,150,10.224948875255624
Jalna,Jaggery,2016,2476,2626,150,6.058158319870759
Pombhurni,Paddy-Unhusked,2016,1950,2100,150,7.6923076923076925
Pombhurni,Paddy-Unhusked,2016,1950,2100,150,7.6923076923076925
Khed-Chakan,Shepu,2016,400,550,150,37.5
Pombhurni,Paddy-Unhusked,2016,1950,2100,150,7.6923076923076925
Pombhurni,Paddy-Unhusked,2016,1950,2100,150,7.6923076923076925
Malegaon (Washim),Wheat(Husked),2015,1475,1625,150,10.169491525423728
Bhokardan-Pimpalgaon Renu,Pigeon Pea (Tur),2015,4850,5000,150,3.0927835051546393
Khultabad,Maize,2016,1350,1500,150,11.11111111111111
Bhusaval,Wheat(Husked),2015,1177,1327,150,12.74426508071368
Dharni,Cotton,2015,3850,4000,150,3.896103896103896
Sangli-Phale Bhajipalam,Bor,2016,150,300,150,100.0
Umared,Cotton,2015,3674,3824,150,4.0827436037016875
Jalna,Wheat(Husked),2015,1561,1711,150,9.609224855861628
Pune-Pimpri,Flower,2016,560,710,150,26.785714285714285
Jalkot,Soybean,2016,3750,3900,150,4.0
Rahata,Maize,2015,1202,1352,150,12.479201331114808
Achalpur,Gram,2015,2975,3125,150,5.042016806722689
Malegaon (Washim),Soybean,2015,3375,3525,150,4.444444444444445
Khamgaon,Wheat(Husked),2016,1656,1806,150,9.057971014492754
Pune-Pimpri,Small Gourd,2015,1750,1900,150,8.571428571428571
Jalna-Badnapur,Bajri,2015,1150,1300,150,13.043478260869565
Umarkhed-Danki,Ground Nut Pods (Dry),2016,4750,4900,150,3.1578947368421053
Solapur,Goosefoot,2015,250,400,150,60.0
Malegaon,Maize,2014,1124,1274,150,13.345195729537366
Jalna,Wheat(Husked),2016,1874,2024,150,8.0042689434365
Rahata,Potato,2015,850,1000,150,17.647058823529413
Mahagaon,Wheat(Husked),2015,1413,1563,150,10.615711252653927
Mahagaon,Cotton,2014,3850,4000,150,3.896103896103896
Bhokar,Sesamum,2015,6573,6723,150,2.2820629849383844
Lonar,WHEAT(HUSKED),2016,1650,1800,150,9.090909090909092
Bhokar,GRAM,2016,7675,7825,150,1.9543973941368078
Umarkhed-Danki,Soybean,2016,3567,3717,150,4.205214465937763
Kalyan,Banana,2016,700,850,150,21.428571428571427
Barshi,Green Chilli,2016,100,250,150,150.0
Gangapur,Pigeon Pea (Tur),2015,5083,5233,150,2.9510131811922093
Ahmedpur,Safflower,2014,2201,2351,150,6.815084052703317
Jalgaon Jamod,Maize,2015,1025,1175,150,14.634146341463415
Jalgaon Jamod,Sorgum(Jawar),2015,1075,1225,150,13.953488372093023
Jalgaon Jamod,Wheat(Husked),2015,1275,1425,150,11.764705882352942
Barshi,Shepu,2014,200,350,150,75.0
Kannad,Wheat(Husked),2015,1508,1658,150,9.946949602122016
Barshi,Bajri,2015,1426,1576,150,10.518934081346423
Jalgaon Jamod,MAIZE,2016,1050,1200,150,14.285714285714286
Sindi,Wheat(Husked),2015,1263,1413,150,11.876484560570072
Vaduj,Black Gram,2016,6400,6550,150,2.34375
Kannad,MAIZE,2016,905,1055,150,16.574585635359117
Shegaon,Thymol/Lovage,2015,10096,10246,150,1.4857369255150554
Barshi,Cluster Bean,2015,150,300,150,100.0
Barshi,Cluster Bean,2015,350,500,150,42.857142857142854
Barshi,Cluster Bean,2015,150,300,150,100.0
Barshi,Cluster Bean,2015,104,254,150,144.23076923076923
Ahmednagar,Soybean,2016,3363,3513,150,4.460303300624442
Jalgaon Jamod,Maize,2015,988,1138,150,15.182186234817813
Ghansawangi,Gram,2015,3150,3300,150,4.761904761904762
Barshi,Cluster Bean,2014,150,300,150,100.0
Ghansawangi,Neem-Seed,2015,463,613,150,32.39740820734341
Ramtek,Orange,2016,500,650,150,30.0
Baramati,Soybean,2015,3075,3225,150,4.878048780487805
Mumbai,Horse Gram,2015,3150,3300,150,4.761904761904762
Kalyan,Spinach,2016,400,550,150,37.5
Kannad,Bajri,2014,1245,1395,150,12.048192771084338
Ghatanji,Cotton,2015,3875,4025,150,3.870967741935484
Ghansawangi,Sorgum(Jawar),2016,1650,1800,150,9.090909090909092
Ghansawangi,Neem-Seed,2016,600,750,150,25.0
Ghansawangi,Wheat(Husked),2015,1600,1750,150,9.375
Morshi,Soybean,2016,2813,2963,150,5.332385353714895
Ghansawangi,Soybean,2015,3125,3275,150,4.8
Barshi,Bitter Gourd,2014,150,300,150,100.0
Jawala-Bajar,Gram,2016,3300,3450,150,4.545454545454546
Jalgaon Jamod,Maize,2015,1000,1150,150,15.0
Jalgaon Jamod,Maize,2015,940,1090,150,15.957446808510639
Barshi,Cluster Bean,2015,162,312,150,92.5925925925926
Barshi,Coriander  ,2015,50,200,150,300.0
Jamkhed,Maize,2016,1356,1506,150,11.061946902654867
Mantha,Sesamum,2015,5775,5925,150,2.5974025974025974
Jamkhed,Bajri,2016,1408,1558,150,10.653409090909092
Patan,Cabbage,2016,419,569,150,35.79952267303103
Barshi,Methi (Bhaji),2015,200,350,150,75.0
Manora,Sorgum(Jawar),2016,1600,1750,150,9.375
Manora,Gram,2015,4500,4650,150,3.3333333333333335
Manora,Gram,2015,3550,3700,150,4.225352112676056
Jalgaon Jamod-Aasalgaon,Maize,2015,938,1088,150,15.991471215351812
Vaduj,Soybean,2016,3525,3675,150,4.25531914893617
Patan,Tomato,2016,543,693,150,27.624309392265193
Sindi (Selu),Wheat(Husked),2015,1300,1450,150,11.538461538461538
Gangapur,Bajri,2016,1480,1630,150,10.135135135135135
Barshi,Ridge Gourd,2015,200,350,150,75.0
Jamkhed,Bajri,2015,1300,1450,150,11.538461538461538
Jamkhed,Bajri,2015,1300,1450,150,11.538461538461538
Barshi,Shevga,2015,200,350,150,75.0
Mantha,Pigeon Pea (Tur),2015,5500,5650,150,2.727272727272727
Akola,BAJRI,2016,1738,1888,150,8.63060989643268
Patan,Cabbage,2015,575,725,150,26.08695652173913
Karad,Cucumber,2015,600,750,150,25.0
Ahmednagar,Maize,2016,1675,1825,150,8.955223880597014
Barshi,Ladies Finger,2015,100,250,150,150.0
Gevrai,Castor Seed,2015,2700,2850,150,5.555555555555555
Mantha,Soybean,2016,3480,3630,150,4.310344827586207
Jalgaon Jamod-Aasalgaon,Sorgum(Jawar),2014,1013,1163,150,14.807502467917079
Mehkar,Green Gram,2016,4850,5000,150,3.0927835051546393
Barshi,Green Gram,2015,6622,6772,150,2.265176683781335
Vaduj,Ghevda Seed,2016,6690,6840,150,2.242152466367713
Karad,Ridge Gourd,2015,625,775,150,24.0
Mauda,Other Cereals,2016,3250,3400,150,4.615384615384615
Patan,Brinjal,2015,612,762,150,24.50980392156863
Gevrai,Maize,2015,1000,1150,150,15.0
Jalna,Wheat(Husked),2016,2003,2152,149,7.4388417373939095
Jintur-Bori,Sorgum(Jawar),2015,1184,1333,149,12.58445945945946
Pathari,Sorgum(Jawar),2015,1601,1750,149,9.306683322923172
Parbhani,Sorgum(Jawar),2016,1609,1758,149,9.260410192666253
Chopda,Bajri,2015,1371,1520,149,10.86797957695113
Parbhani,Gram,2014,2359,2508,149,6.3162356930902925
Kopargaon,Bajri,2016,1725,1874,149,8.63768115942029
Chopda,Bajri,2016,1634,1783,149,9.1187270501836
Loha,Sorgum(Jawar),2016,1339,1488,149,11.127707244212099
Chikhali,Sorgum(Jawar),2015,1107,1256,149,13.459801264679314
Karjat (Raigad),Paddy-Unhusked,2014,1310,1459,149,11.374045801526718
Kalmeshwar,Tomato,2015,574,723,149,25.958188153310104
Devala,Bajri,2015,1247,1396,149,11.948676824378508
Devala,Bajri,2015,1309,1458,149,11.382734912146677
Shevgaon-Bodhegaon,Bajri,2016,1576,1725,149,9.454314720812183
Kalvan,Maize,2016,1524,1673,149,9.776902887139107
Ausa,MAIZE,2016,1281,1430,149,11.631537861046057
Kannad,Bajri,2015,1226,1375,149,12.153344208809136
Barshi,Maize,2014,1052,1201,149,14.163498098859316
Kannad,Maize,2015,1102,1251,149,13.52087114337568
Shegaon,Sorgum(Jawar),2015,1574,1723,149,9.466327827191868
Mehkar,SORGUM(JAWAR),2016,1663,1812,149,8.959711365003006
Gevrai,Bajri,2015,1330,1479,149,11.203007518796992
Karanja,Ground Nut Pods (Dry),2015,5765,5914,149,2.5845620121422375
Karmala,Wheat(Husked),2016,1851,2000,149,8.049702863317126
Purna,Sorgum(Jawar),2016,1671,1820,149,8.916816277678038
Gangapur,Sorgum(Jawar),2015,1321,1470,149,11.279333838001515
Barshi-Vairag,Ground Nut Pods (Dry),2014,3171,3320,149,4.698833175654368
Barshi-Vairag,Maize,2016,1240,1389,149,12.016129032258064
Mandhal,Wheat(Husked),2016,1605,1754,149,9.28348909657321
Mandhal,Gram,2016,5101,5250,149,2.9209958831601646
Beed,Wheat(Husked),2016,1858,2007,149,8.019375672766415
Sindi (Selu),Wheat(Husked),2016,1604,1753,149,9.28927680798005
Loha,Sorgum(Jawar),2015,1251,1400,149,11.910471622701838
Digras,Cotton,2014,3889,4038,149,3.831319105168424
Dhule,Maize,2016,1268,1417,149,11.750788643533124
Bhokardan,Cotton,2014,3901,4050,149,3.8195334529607794
Dhule,Cowpea,2015,3742,3891,149,3.981827899518974
Dhamangaon-Rly,Wheat(Husked),2016,1422,1571,149,10.478199718706048
Kalmeshwar,Methi (Bhaji),2015,384,533,149,38.802083333333336
Chopda,Gram,2015,4575,4724,149,3.2568306010928962
Nandurbar,Safflower,2015,2351,2500,149,6.337728626116546
Lasalgaon-Vinchur,Bajri,2016,1451,1600,149,10.268780151619573
Taloda,Wheat(Husked),2014,1484,1633,149,10.040431266846362
Chandur Bajar,Wheat(Husked),2015,1454,1603,149,10.247592847317744
Nandurbar,Green Gram,2016,5668,5817,149,2.6287932251235
Kalamb (Os),PIGEON PEA (TUR),2016,4601,4750,149,3.238426429037166
Kalmeshwar,Brinjal,2015,720,869,149,20.694444444444443
Indapur-Bhigwan,Gram,2016,4927,5076,149,3.024152628374264
Ambad(Vadi Godri),Maize,2014,872,1021,149,17.087155963302752
Devala,Wheat(Husked),2016,1529,1677,148,9.679529103989536
Ahmednagar,Gram,2015,3074,3222,148,4.814573845152895
Navapur,Wheat(Husked),2016,1464,1612,148,10.109289617486338
Manchar,Kanda Pat,2015,457,605,148,32.38512035010941
Katol,Wheat(Husked),2015,1323,1471,148,11.186696900982616
Umared,Lang,2016,3415,3563,148,4.333821376281112
Pathardi,Bajri,2015,1252,1400,148,11.821086261980831
Kalamb (Os),Bajri,2016,1391,1539,148,10.639827462257369
Hingoli,Ground Nut Pods (Dry),2016,4615,4763,148,3.2069339111592634
Umarga,Sorgum(Jawar),2015,1438,1586,148,10.292072322670375
Bhandara,Soybean,2014,2927,3075,148,5.056371711650153
Khamgaon,Sorgum(Jawar),2015,1224,1372,148,12.091503267973856
Ner Parasopant,Green Gram,2015,7690,7838,148,1.9245773732119635
Kalmeshwar,Flower,2015,571,719,148,25.919439579684763
Jalgaon,Gram,2014,2926,3074,148,5.0580997949419
Sinner,Wheat(Husked),2014,1563,1711,148,9.46896992962252
Ramtek,Brinjal,2016,538,686,148,27.509293680297397
Bhokardan,Cotton,2015,3877,4025,148,3.817384575702863
Akot,Maize,2016,1324,1472,148,11.178247734138973
Lakhani,Paddy-Unhusked,2015,2289,2437,148,6.4657055482743555
Lonar,Sorgum(Jawar),2015,1115,1263,148,13.27354260089686
Shrirampur,Soybean,2014,3006,3154,148,4.9234863606121095
Sinner,Maize,2016,1305,1453,148,11.340996168582375
Chopda,Maize,2015,1141,1289,148,12.971078001752849
Majalgaon,Green Gram,2015,6019,6167,148,2.4588802126599103
Savner,Wheat(Husked),2016,1584,1732,148,9.343434343434344
Savner,Wheat(Husked),2016,1431,1579,148,10.3424178895877
Rahata,Sorgum(Jawar),2015,1105,1253,148,13.393665158371041
Buldhana,Soybean,2015,3025,3173,148,4.892561983471074
Bhandara,Rice(Paddy-Hus),2016,2598,2746,148,5.696689761354889
Barshi,Maize,2015,1418,1566,148,10.437235543018335
Washim,Turmeric,2016,7617,7765,148,1.9430221872128135
Barshi,Ladies Finger,2015,150,298,148,98.66666666666667
Pusad,Sorgum(Jawar),2015,1193,1341,148,12.405699916177703
Sailu,Wheat(Husked),2016,1679,1827,148,8.81477069684336
Washim,Sorgum(Jawar),2014,1133,1281,148,13.062665489849955
Parli-Vaijnath,Cotton,2015,3841,3989,148,3.8531632387399113
Nanded,Gram,2015,3640,3788,148,4.065934065934066
Aurangabad,Cabbage,2016,490,638,148,30.20408163265306
Nagpur,Spinach,2015,339,487,148,43.657817109144545
Nagpur,Raddish,2015,348,496,148,42.52873563218391
Chandur Bajar,Sorgum(Jawar),2014,1352,1500,148,10.946745562130177
Devala,Bajri,2015,1368,1516,148,10.818713450292398
Yawal,Maize,2016,1249,1397,148,11.849479583666934
Barshi,Green Chilli,2015,150,298,148,98.66666666666667
Mumbai,Potato,2015,1065,1213,148,13.896713615023474
Shegaon,Wheat(Husked),2016,1576,1724,148,9.390862944162437
Chalisgaon,Maize,2016,1442,1590,148,10.263522884882109
Devala,Wheat(Husked),2015,1506,1654,148,9.827357237715804
Umared,Coriander (Dry),2015,8915,9063,148,1.6601233875490746
Satana,Maize,2015,1177,1325,148,12.574341546304163
Barshi,Ladies Finger,2014,148,296,148,100.0
Tasgaon,Sorgum(Jawar),2016,1651,1799,148,8.964264082374319
Shrirampur-Belapur,Gram,2015,3322,3470,148,4.455147501505118
Gevrai,Soybean,2016,2817,2965,148,5.2538161164359245
Rahuri,Gram,2015,3257,3405,148,4.544058949953945
Chimur,Paddy-Unhusked,2016,1958,2106,148,7.558733401430031
Kada,Maize,2015,1067,1214,147,13.776944704779757
Dhamangaon-Rly,WHEAT(HUSKED),2016,1752,1899,147,8.39041095890411
Jalgaon,Banana,2015,314,461,147,46.81528662420382
Gangapur,Bajri,2016,1671,1818,147,8.797127468581687
Jamkhed,Bajri,2015,1486,1633,147,9.892328398384926
Indapur-Bhigwan,Maize,2015,1345,1492,147,10.929368029739777
Kopargaon,Maize,2014,977,1124,147,15.046059365404298
Digras,Soybean,2015,3492,3639,147,4.209621993127148
Indapur-Bhigwan,Soybean,2014,2938,3085,147,5.0034036759700475
Hadgaon,Cotton,2015,4097,4244,147,3.5879912130827436
Kinwat,Cotton,2015,3582,3729,147,4.1038525963149075
Rahuri-Vambori,Wheat(Husked),2016,1548,1695,147,9.496124031007753
Samudrapur,Cotton,2015,3947,4094,147,3.724347605776539
Kannad,Maize,2015,1104,1251,147,13.315217391304348
Rahuri,Wheat(Husked),2015,1417,1564,147,10.374029640084686
Jalna,Maize,2015,1351,1498,147,10.880829015544041
Pachora,Sorgum(Jawar),2016,1366,1513,147,10.76134699853587
Bhokardan,Cotton,2016,4157,4304,147,3.5362039932643734
Telhara,Wheat(Husked),2015,1433,1580,147,10.258199581297976
Paithan,Sorgum(Jawar),2016,1667,1814,147,8.818236352729453
Mumbai,Curry Leaves,2016,975,1122,147,15.076923076923077
Chalisgaon,Maize,2016,1267,1414,147,11.602209944751381
Bhusaval,Black Gram,2014,4464,4611,147,3.293010752688172
Ashti-Karanja,Wheat(Husked),2016,1452,1599,147,10.12396694214876
Manmad,Wheat(Husked),2014,1535,1682,147,9.576547231270359
Sindi (Selu),Cotton,2015,3941,4088,147,3.730017761989343
Lonand,Maize,2016,1500,1647,147,9.8
Chalisgaon,Bajri,2015,1300,1447,147,11.307692307692308
Ausa,Black Gram,2015,7954,8101,147,1.8481267286899674
Lonar,Sorgum(Jawar),2016,1453,1600,147,10.116999311768755
Pathardi,Bajri,2015,1260,1407,147,11.666666666666666
Udgir,Sorgum(Jawar),2016,1313,1460,147,11.195734958111196
Kurdwadi-Modnimb,Maize,2015,1134,1281,147,12.962962962962964
Patan,Cabbage,2015,667,814,147,22.038980509745127
Partur,Soybean,2016,3419,3566,147,4.299502778590231
Murum,Gram,2015,3347,3494,147,4.391992829399462
Barshi,Maize,2015,1314,1461,147,11.187214611872147
Lonar,Soybean,2015,3150,3297,147,4.666666666666667
Bhusaval,Wheat(Husked),2016,1433,1580,147,10.258199581297976
Phaltan,Maize,2016,1325,1472,147,11.09433962264151
Ahmedpur,Wheat(Husked),2016,1273,1420,147,11.547525530243519
Amarawati-Fruit And Vegetables,Cabbage,2016,953,1100,147,15.424973767051416
Pusad,Sorgum(Jawar),2016,1307,1454,147,11.247130833970926
Beed,Gram,2015,4054,4201,147,3.6260483473112974
Mandhal,SOYBEAN,2016,2618,2765,147,5.614973262032086
Lasalgaon,Rice(Paddy-Hus),2016,1655,1802,147,8.882175226586103
Washim,Sorgum(Jawar),2015,1156,1303,147,12.716262975778546
Tasgaon,Sorgum(Jawar),2016,1663,1810,147,8.83944678292243
Amarawati,Cucumber,2016,760,907,147,19.342105263157894
Amarawati,Linseed,2015,5168,5315,147,2.8444272445820435
Shirur,Bajri,2015,1351,1498,147,10.880829015544041
Akhadabalapur,Cotton,2015,4065,4212,147,3.6162361623616235
Achalpur,Gram,2016,5375,5522,147,2.7348837209302324
Nandurbar,Maize,2015,1424,1571,147,10.323033707865168
Mul,Paddy-Unhusked,2015,1662,1809,147,8.844765342960288
Lasalgaon-Vinchur,Sorgum(Jawar),2015,1485,1631,146,9.831649831649832
Akhadabalapur,Cotton,2015,3909,4055,146,3.7349705807111793
Digras,Soybean,2016,3746,3892,146,3.8974906567004806
Murbad,Tomato,2015,2187,2333,146,6.675811614083219
Barshi,Brinjal,2015,123,269,146,118.69918699186992
Mumbai,Curry Leaves,2015,1308,1454,146,11.162079510703364
Mul,Paddy-Unhusked,2015,1834,1980,146,7.960741548527808
Parbhani,Soybean,2015,3464,3610,146,4.214780600461894
Nandurbar,Maize,2015,1286,1432,146,11.35303265940902
Hinganghat,Wheat(Husked),2015,1430,1576,146,10.20979020979021
Rahuri-Vambori,Bajri,2015,1279,1425,146,11.415168100078185
Amarawati,Linseed,2015,5325,5471,146,2.7417840375586855
Hingoli,Soybean,2016,3736,3882,146,3.9079229122055676
Kinwat,Pigeon Pea (Tur),2016,7962,8108,146,1.8337101230846522
Sinner,Wheat(Husked),2015,1524,1670,146,9.58005249343832
Telhara,Pigeon Pea (Tur),2014,4392,4538,146,3.324225865209472
Kalmeshwar,Raddish,2014,629,775,146,23.211446740858506
Ambejogai,Soybean,2015,3468,3614,146,4.209919261822376
Kalmeshwar,Cucumber,2015,954,1100,146,15.30398322851153
Sangamner,Sorgum(Jawar),2016,1760,1906,146,8.295454545454545
Pachora,Sorgum(Jawar),2016,1531,1677,146,9.53625081645983
Paithan,SORGUM(JAWAR),2016,2153,2299,146,6.781235485369252
Shrirampur,Bajri,2015,1414,1560,146,10.325318246110326
Parola,Maize,2016,1243,1389,146,11.74577634754626
Chalisgaon,Sorgum(Jawar),2016,1332,1478,146,10.96096096096096
Shevgaon-Bodhegaon,Sorgum(Jawar),2016,1715,1861,146,8.513119533527696
Chopda,Sorgum(Jawar),2016,1572,1718,146,9.287531806615776
Indapur,Bajri,2015,1567,1713,146,9.317166560306317
Mangalwedha,Maize,2014,1039,1185,146,14.051973051010586
Jawala-Bajar,Wheat(Husked),2015,1520,1666,146,9.605263157894736
Jalgaon Jamod,Wheat(Husked),2015,1218,1364,146,11.986863711001641
Gangapur,Soybean,2014,3180,3326,146,4.591194968553459
Shahapur,Paddy-Unhusked,2015,1437,1583,146,10.160055671537926
Gangapur,Bajri,2016,1251,1397,146,11.670663469224621
Partur,Bajri,2014,1315,1461,146,11.102661596958175
Malkapur,Wheat(Husked),2014,1395,1541,146,10.46594982078853
Shegaon,Green Gram,2015,7226,7372,146,2.0204815942430114
Gangapur,Bajri,2015,1366,1512,146,10.68814055636896
Manwat,Gram,2015,4567,4713,146,3.1968469454784323
Rahata,Wheat(Husked),2015,1529,1675,146,9.548724656638326
Karanja,Sorgum(Jawar),2015,1348,1494,146,10.830860534124628
Pune-Pimpri,Flower,2015,747,893,146,19.54484605087015
Pombhurni,Paddy-Unhusked,2015,1871,2017,146,7.803313735970069
Khamgaon,WHEAT(HUSKED),2016,1856,2002,146,7.866379310344827
Bhandara,Rice(Paddy-Hus),2016,2680,2826,146,5.447761194029851
Chopda,Sesamum,2014,9221,9367,146,1.5833423706756318
Karanja,Sorgum(Jawar),2016,1526,1672,146,9.567496723460026
Devala,Bajri,2014,1257,1402,145,11.535401750198886
Chimur,Paddy-Unhusked,2016,2067,2212,145,7.014997581035317
Deulgaon Raja,Cotton,2014,3925,4070,145,3.694267515923567
Kalvan,Maize,2015,1240,1385,145,11.693548387096774
Hadgaon,Soybean,2015,3405,3550,145,4.258443465491924
Kada,Maize,2015,1195,1340,145,12.133891213389122
Shirpur,Maize,2015,1316,1461,145,11.01823708206687
Kalmeshwar,Spinach,2015,251,396,145,57.76892430278885
Ahmedpur,Wheat(Husked),2015,1425,1570,145,10.175438596491228
Shirpur,Maize,2015,1054,1199,145,13.757115749525617
Jamkhed,Bajri,2015,1300,1445,145,11.153846153846153
Kada,Wheat(Husked),2015,1623,1768,145,8.93407270486753
Sonpeth,Sorgum(Jawar),2014,1695,1840,145,8.55457227138643
Akot,Maize,2015,901,1046,145,16.09322974472808
Vai,TOMATO,2016,487,632,145,29.7741273100616
Gevrai,Matki,2015,7255,7400,145,1.9986216402481047
Kalmeshwar,Raddish,2015,316,461,145,45.88607594936709
Amalner,Wheat(Husked),2015,1368,1513,145,10.599415204678362
Mangaon(Bhadav),Paddy-Unhusked,2015,1300,1445,145,11.153846153846153
Kalamb (Os),Sunflower,2016,2688,2833,145,5.394345238095238
Jalna,Maize,2015,1124,1269,145,12.900355871886122
Khamgaon,Bajri,2015,1073,1218,145,13.513513513513514
Kej,Soybean,2016,3281,3426,145,4.419384334044499
Ner Parasopant,Soybean,2016,3161,3306,145,4.587155963302752
Buldhana,Wheat(Husked),2015,1250,1395,145,11.6
Nashik,Spinach,2016,196,341,145,73.9795918367347
Rajura,Soybean,2015,3417,3562,145,4.243488440152181
Amarawati,Coriander  ,2016,1200,1345,145,12.083333333333334
Taloda,Cotton,2015,3780,3925,145,3.835978835978836
Indapur (Nimgaon Ketki),Wheat(Husked),2016,1506,1651,145,9.628154050464808
Barshi-Vairag,Sunflower,2016,2570,2715,145,5.642023346303502
Raver-Sawada,SORGUM(JAWAR),2016,1058,1203,145,13.705103969754253
Raver,Sorgum(Jawar),2016,1304,1449,145,11.11963190184049
Kalmeshwar,Brinjal,2015,903,1048,145,16.057585825027687
Amarawati,Tomato,2014,1291,1436,145,11.23160340821069
Nandgaon,Gram,2016,4080,4225,145,3.553921568627451
Nandgaon,Wheat(Husked),2015,1574,1719,145,9.212198221092757
Telhara,Soybean,2015,3068,3213,145,4.726205997392438
Yeola,Sorgum(Jawar),2016,1624,1769,145,8.928571428571429
Kalmeshwar,Raddish,2015,440,585,145,32.95454545454545
Jafrabad,Maize,2016,1275,1420,145,11.372549019607844
Ausa,Safflower,2015,2535,2680,145,5.719921104536489
Mumbai-Onion And Potato Mkt,Onion,2016,588,733,145,24.65986394557823
Vai,Flower,2015,605,750,145,23.96694214876033
Pune-Pimpri,CHAVLI (SHENGA ),2016,1764,1909,145,8.219954648526077
Pune-Pimpri,Flower,2016,1211,1356,145,11.973575557390586
Digras,PIGEON PEA (TUR),2016,5699,5844,145,2.5443060185997544
Shegaon,WHEAT(HUSKED),2016,1573,1718,145,9.218054672600127
Barshi,Bitter Gourd,2015,185,330,145,78.37837837837837
Umared,Linseed,2015,4545,4690,145,3.1903190319031904
Malegaon,Maize,2016,1355,1500,145,10.70110701107011
Lonar,Sunflower,2016,3440,3585,145,4.215116279069767
Sangamner,Sorgum(Jawar),2015,1762,1907,145,8.229284903518728
Baramati,Maize,2015,1126,1271,145,12.877442273534635
Barshi,Cluster Bean,2015,97,242,145,149.48453608247422
Vaduj,Bajri,2016,1922,2067,145,7.544224765868886
Kopargaon,Maize,2016,1461,1606,145,9.924709103353868
Majalgaon,Sunflower,2015,3100,3245,145,4.67741935483871
Lasalgaon-Niphad,Wheat(Husked),2016,1699,1844,145,8.53443201883461
Khed (Shel Pimpalgaon),Farshi,2014,3010,3155,145,4.8172757475083055
Umarga,Safflower,2014,2369,2514,145,6.120726044744618
Maregaon,Cotton,2014,3804,3949,145,3.8117770767613037
Varud,Cotton,2014,3886,4031,145,3.7313432835820897
Shevgaon-Bodhegaon,Bajri,2015,1072,1217,145,13.526119402985074
Shrirampur-Belapur,Wheat(Husked),2016,1444,1589,145,10.041551246537397
Tumsar,Lentil,2015,4959,5104,145,2.9239766081871346
Latur,Black Gram,2015,5801,5945,144,2.482330632649543
Gadchiroli,Paddy-Unhusked,2015,1585,1729,144,9.085173501577287
Nanded,Gram,2016,4078,4222,144,3.531142717018146
Ner Parasopant,Pigeon Pea (Tur),2014,4725,4869,144,3.0476190476190474
Barshi,Turmeric,2016,7700,7844,144,1.87012987012987
Bhiwapur,Soybean,2015,3533,3677,144,4.075856212850269
Koregaon,Gram,2016,4103,4247,144,3.5096271021203997
Ramtek,Onion,2016,856,1000,144,16.822429906542055
Jintur,Cotton,2015,3756,3900,144,3.8338658146964857
Aarni,Wheat(Husked),2015,1366,1510,144,10.541727672035138
Parola,Wheat(Husked),2015,1364,1508,144,10.557184750733137
Pune-Manjri,Rajgira,2016,920,1064,144,15.652173913043478
Chopda,Wheat(Husked),2016,1636,1780,144,8.80195599022005
Hingoli,Soybean,2015,3591,3735,144,4.010025062656641
Sillod,Soybean,2016,3723,3867,144,3.8678485092667203
Shahada,Wheat(Husked),2016,1696,1840,144,8.49056603773585
Jalna,Wheat(Husked),2016,1922,2066,144,7.492195629552549
Pulgaon,Cotton,2014,3971,4115,144,3.6262906069000254
Kalamb (Os),Soybean,2015,3128,3272,144,4.603580562659847
Kalmeshwar,Pumpkin,2014,756,900,144,19.047619047619047
Armori,Paddy-Unhusked,2015,1502,1646,144,9.587217043941411
Mukhed,Black Gram,2016,6751,6895,144,2.1330173307658127
Jamkhed,Bajri,2015,1413,1557,144,10.19108280254777
Murum,Gram,2015,4643,4787,144,3.1014430325220763
Dhule,Sorgum(Jawar),2016,1382,1526,144,10.419681620839363
Kalvan,Wheat(Husked),2015,1470,1614,144,9.795918367346939
Panvel,Cucumber,2015,1189,1333,144,12.111017661900757
Washim-Ansing,Gram,2016,6289,6433,144,2.289712195897599
Jintur-Bori,Soybean,2015,3090,3234,144,4.660194174757281
Wardha,Wheat(Husked),2016,1476,1620,144,9.75609756097561
Akole,SOYBEAN,2016,2781,2925,144,5.17799352750809
Jintur-Bori,Sorgum(Jawar),2015,1123,1267,144,12.82279608192342
Khed-Chakan,Cabbage,2016,296,440,144,48.648648648648646
Gevrai,Soybean,2014,3098,3242,144,4.648160103292446
Jamkhed,Bajri,2015,1359,1503,144,10.596026490066226
Kolhapur-Malkapur,Tomato,2016,125,269,144,115.2
Gangapur,Bajri,2015,1168,1312,144,12.32876712328767
Sengaon,Soybean,2016,3523,3667,144,4.087425489639512
Shahapur,Paddy-Unhusked,2016,1475,1619,144,9.76271186440678
Umarga,Safflower,2015,2521,2665,144,5.712019040063467
Gevrai,Soybean,2015,3267,3410,143,4.377104377104377
Sillod,Wheat(Husked),2016,1750,1893,143,8.17142857142857
Sillod,Wheat(Husked),2016,1663,1806,143,8.598917618761275
Rahata,Ghevda,2016,6143,6286,143,2.3278528406316132
Lonar,Maize,2015,1152,1295,143,12.413194444444445
Mehkar,Wheat(Husked),2016,1611,1754,143,8.87647423960273
Vaijapur,Sorgum(Jawar),2016,1512,1655,143,9.457671957671957
Manmad,Maize,2016,1709,1852,143,8.36746635459333
Bhandara,Rice(Paddy-Hus),2016,3019,3162,143,4.736667770785028
Latur-Murud,SORGUM(JAWAR),2016,1791,1934,143,7.984366275823562
Mul,Paddy-Unhusked,2015,1762,1905,143,8.11577752553916
Pune-Moshi,Beet Root,2016,914,1057,143,15.645514223194748
Kalmeshwar,Raddish,2015,357,500,143,40.056022408963585
Navapur,Soybean,2016,2766,2909,143,5.169920462762112
Amarawati,Tomato,2016,486,629,143,29.4238683127572
Savner,Wheat(Husked),2015,1293,1436,143,11.059551430781129
Shevgaon,Bajri,2015,1219,1362,143,11.73092698933552
Murum,Black Gram,2016,7836,7979,143,1.8249106687085248
Mohol,Wheat(Husked),2014,1464,1607,143,9.76775956284153
Kalmeshwar,Brinjal,2015,515,658,143,27.766990291262136
Gangapur,Gram,2015,3635,3778,143,3.9339752407152684
Mumbai,Curry Leaves,2016,881,1024,143,16.23155505107832
Pune-Pimpri,Ghosali(Bhaji),2014,3071,3214,143,4.656463692608271
Dhule,Maize,2015,1109,1252,143,12.894499549143372
Ghatanji,Soybean,2016,3710,3853,143,3.8544474393530996
Varora,Cotton,2014,3817,3960,143,3.7463976945244957
Wardha,Soybean,2015,3218,3361,143,4.443753884400248
Rajura,Cotton,2015,4056,4199,143,3.5256410256410255
Hinganghat,Wheat(Husked),2016,1439,1582,143,9.937456567060458
Nagpur,Cabbage,2016,224,367,143,63.839285714285715
Manchar,Shepu,2015,664,807,143,21.53614457831325
Rahata,Carrot,2015,1571,1714,143,9.10248249522597
Kalyan,BOTTLE GOURD,2016,582,725,143,24.57044673539519
Kalmeshwar,Ladies Finger,2014,857,1000,143,16.686114352392064
Pune-Pimpri,Beet Root,2015,1343,1486,143,10.647803425167535
Kalyan,Wheat(Husked),2015,2071,2214,143,6.904876871076775
Gangapur,Green Gram,2016,4757,4900,143,3.0060962791675427
Jalgaon,Cluster Bean,2016,3186,3329,143,4.4883866917765225
Ramtek,CABBAGE,2016,400,543,143,35.75
Pusad,Black Gram,2014,5190,5333,143,2.7552986512524087
Pachora,Maize,2015,1394,1537,143,10.258249641319942
Amarawati,Gram,2016,5721,5864,143,2.4995630134591855
Kopargaon,Maize,2015,1042,1185,143,13.723608445297504
Achalpur,SORGUM(JAWAR),2016,1375,1518,143,10.4
Taloda,Maize,2015,1035,1178,143,13.816425120772946
Parbhani,Wheat(Husked),2015,1460,1603,143,9.794520547945206
Yeola,Wheat(Husked),2015,1567,1710,143,9.125717932354819
Kopargaon,GREEN GRAM,2016,4044,4187,143,3.536102868447082
Akhadabalapur,Soybean,2015,3286,3429,143,4.351795496043822
Kada,Maize,2015,1254,1397,143,11.403508771929825
Yeotmal,Cotton,2015,3805,3948,143,3.7582128777923787
Kolhapur-Laxmipuri,Maize,2014,1350,1493,143,10.592592592592593
Parli-Vaijnath,Gram,2016,5197,5340,143,2.751587454300558
Kurdwadi,Wheat(Husked),2015,1519,1662,143,9.414088215931534
Indapur-Bhigwan,Maize,2014,1263,1406,143,11.322248614410135
Jafrabad,Sorgum(Jawar),2015,1014,1157,143,14.102564102564102
Chopda,Bajri,2016,1649,1792,143,8.671922377198301
Palghar(Bevur),Potato,2016,1073,1216,143,13.327120223671947
Soygaon,Maize,2015,1007,1150,143,14.200595829195631
Chandur Rly.,Soybean,2016,2948,3091,143,4.850746268656716
Jafrabad,Maize,2016,1357,1500,143,10.537951363301401
Pune,Bajri,2016,2143,2286,143,6.672888474101726
Shrirampur,Bajri,2014,1295,1438,143,11.042471042471043
Patur,Sorgum(Jawar),2015,1550,1692,142,9.161290322580646
Sinner,Wheat(Husked),2016,1762,1904,142,8.059023836549375
Shevgaon-Bodhegaon,Pigeon Pea (Tur),2016,7347,7489,142,1.9327616714305158
Mehkar,Sorgum(Jawar),2016,1154,1296,142,12.305025996533795
Rajura,Cotton,2014,3871,4013,142,3.668302764143632
Dondaicha,Maize,2015,1164,1306,142,12.199312714776632
Jalgaon,Gram,2015,3917,4059,142,3.625223385243809
Loha,Sorgum(Jawar),2016,1351,1493,142,10.510732790525537
Kolhapur-Malkapur,Flower,2016,123,265,142,115.44715447154472
Mangalwedha,Bajri,2015,1468,1610,142,9.673024523160763
Malkapur,Sorgum(Jawar),2016,1487,1629,142,9.549428379287155
Akola,Wheat(Husked),2015,1419,1561,142,10.007047216349543
Kopargaon,Bajri,2015,1367,1509,142,10.387710314557426
Chalisgaon,Maize,2015,1313,1455,142,10.814927646610816
Rahata,Gram,2014,2475,2617,142,5.737373737373737
Shevgaon,Wheat(Husked),2014,1493,1635,142,9.511051574012056
Akkalkuwa,Maize,2015,1263,1405,142,11.243072050673002
Sonpeth,Bajri,2015,1544,1686,142,9.196891191709845
Barshi,Water Melon,2016,283,425,142,50.17667844522968
Aurangabad,Banana,2016,160,302,142,88.75
Aurad Shahajani,Gram,2015,4472,4614,142,3.1753130590339893
Jintur,Cotton,2015,3787,3929,142,3.749669923422234
Shevgaon-Bodhegaon,Bajri,2016,1598,1740,142,8.88610763454318
Shevgaon-Bodhegaon,BAJRI,2016,1102,1244,142,12.885662431941924
Sailu,Pigeon Pea (Tur),2014,4258,4400,142,3.3348990136214187
Jamkhed,Bajri,2015,1304,1446,142,10.889570552147239
Barshi,Ridge Gourd,2015,186,328,142,76.34408602150538
Yawal,Sorgum(Jawar),2016,1296,1438,142,10.95679012345679
Latur,Green Gram,2016,6538,6680,142,2.171918017742429
Jawala-Bajar,Soybean,2015,3327,3469,142,4.268109407874962
Shegaon,Black Gram,2014,4082,4224,142,3.478686918177364
Pusad,Sorgum(Jawar),2016,1305,1447,142,10.881226053639846
Sailu,Soybean,2015,3362,3504,142,4.223676383105294
Devani,Gram,2016,4320,4462,142,3.287037037037037
Chopda,Wheat(Husked),2015,1314,1456,142,10.80669710806697
Ramtek,Onion,2016,729,871,142,19.478737997256516
Buldhana,Soybean,2016,3515,3657,142,4.039829302987198
Kalyan,Cabbage,2016,529,671,142,26.843100189035916
Kalamnuri,Gram,2016,4067,4209,142,3.4915170887632163
Barshi,Tamarind,2015,2833,2975,142,5.012354394634663
Sinner,Wheat(Husked),2015,1549,1691,142,9.167204648160103
Rahata,Soybean,2014,3063,3205,142,4.635977799542932
Vai,Cabbage,2015,632,774,142,22.468354430379748
Mehkar,Green Gram,2016,4935,5077,142,2.877406281661601
Barshi,Maize,2015,1090,1232,142,13.027522935779816
Lonar,Soybean,2016,3683,3825,142,3.8555525386912843
Barshi,Capsicum,2016,175,317,142,81.14285714285714
Kej,Sorgum(Jawar),2016,1693,1835,142,8.387477849970466
Bhiwapur,Cotton,2015,3802,3944,142,3.734876380852183
Barshi,Ridge Gourd,2015,146,288,142,97.26027397260275
Bhokar,Soybean,2015,3678,3820,142,3.860793909733551
Sillod-Bharadi,Maize,2014,1150,1292,142,12.347826086956522
Jalgaon,Banana,2015,126,268,142,112.6984126984127
Jafrabad,Maize,2016,1312,1454,142,10.823170731707316
Tasgaon,Sorgum(Jawar),2016,1739,1881,142,8.16561242093157
Parbhani,Sorgum(Jawar),2016,1593,1734,141,8.851224105461393
Lasalgaon,Rice(Paddy-Hus),2016,1600,1741,141,8.8125
Shegaon,Sorgum(Jawar),2016,1210,1351,141,11.652892561983471
Telhara,Wheat(Husked),2016,1780,1921,141,7.921348314606742
Umarkhed-Danki,Soybean,2015,3164,3305,141,4.456384323640961
Parbhani,Green Gram,2016,4526,4667,141,3.1153336279275297
Gangapur,Gram,2016,5126,5267,141,2.7506827936012486
Malkapur,Sorgum(Jawar),2016,1412,1553,141,9.98583569405099
Tiroda,Paddy-Unhusked,2016,1715,1856,141,8.221574344023324
Gondiya,Paddy-Unhusked,2016,1469,1610,141,9.598366235534376
Sillod-Bharadi,Wheat(Husked),2016,1588,1729,141,8.879093198992443
Manmad,Maize,2015,1396,1537,141,10.100286532951289
Pathari,Soybean,2016,2950,3091,141,4.779661016949152
Gangapur,GRAM,2016,7952,8093,141,1.773138832997988
Morshi,Wheat(Husked),2014,1367,1508,141,10.314557425018288
Sonpeth,Gram,2016,4111,4252,141,3.4298224276331792
Nampur,Wheat(Husked),2016,1431,1572,141,9.853249475890985
Morshi,Soybean,2014,3081,3222,141,4.576436222005842
Kalamb (Os),Gram,2016,4169,4310,141,3.382106020628448
Manwat,COTTON,2016,4976,5117,141,2.8336012861736335
Karad,Brinjal,2015,517,658,141,27.272727272727273
Karad,Flower,2015,642,783,141,21.962616822429908
Indapur-Bhigwan,Maize,2015,1267,1408,141,11.128650355169691
Khamgaon,Sunflower,2015,2983,3124,141,4.726785115655381
Parola,Gram,2016,7803,7944,141,1.8069973087274125
Chikhali,Maize,2015,1124,1265,141,12.544483985765124
Kalamb (Os),Safflower,2016,2568,2709,141,5.490654205607477
Hingoli,Soybean,2015,3096,3237,141,4.554263565891473
Pune,Maize,2014,1426,1567,141,9.887798036465638
Pune-Moshi,Beet Root,2016,891,1032,141,15.824915824915825
Buldhana,Maize,2015,1150,1291,141,12.26086956521739
Tumsar,Linseed,2016,4797,4938,141,2.9393370856785492
Chopda,Ground Nut Pods (Dry),2015,5106,5247,141,2.7614571092831963
Amarawati,Gram,2016,4197,4338,141,3.359542530378842
Devala,Wheat(Husked),2016,1537,1678,141,9.173715029277814
Nandura,Onion,2016,463,604,141,30.453563714902806
Kurdwadi-Modnimb,Maize,2016,1421,1562,141,9.922589725545391
Shirur,Sorgum(Jawar),2016,1590,1731,141,8.867924528301886
Kannad,Bajri,2016,1608,1749,141,8.76865671641791
Sakri,Gram,2015,3608,3749,141,3.9079822616407984
Dound,Maize,2015,1424,1565,141,9.901685393258427
Ramtek,Tomato,2016,232,373,141,60.775862068965516
Kalmeshwar,Gram,2015,3175,3316,141,4.440944881889764
Loha,Sorgum(Jawar),2016,1463,1604,141,9.63773069036227
Barshi-Vairag,Wheat(Husked),2015,1967,2108,141,7.168276563294357
Indapur,Maize,2015,1413,1554,141,9.978768577494693
Amarawati,Soybean,2014,3100,3241,141,4.548387096774194
Jalgaon,Banana,2016,228,369,141,61.8421052631579
Barshi-Vairag,Wheat(Husked),2016,1884,2025,141,7.484076433121019
Khamgaon,Wheat(Husked),2015,1534,1675,141,9.191655801825293
Akhadabalapur,Gram,2016,3600,3740,140,3.888888888888889
Savner,Soybean,2015,3106,3246,140,4.507405022537025
Akhadabalapur,Soybean,2015,2880,3020,140,4.861111111111111
Chandur Bajar,Sorgum(Jawar),2015,1260,1400,140,11.11111111111111
Vai,Brinjal,2015,725,865,140,19.310344827586206
Wardha,Pigeon Pea (Tur),2014,4368,4508,140,3.2051282051282053
Digras,Sorgum(Jawar),2016,1550,1690,140,9.03225806451613
Kinwat,Cotton,2016,3989,4129,140,3.5096515417397844
Mantha,Cotton,2015,4026,4166,140,3.4773969200198707
Mantha,Sorgum(Jawar),2016,1688,1828,140,8.293838862559241
Parli-Vaijnath,Sorgum(Jawar),2015,1442,1582,140,9.70873786407767
Parli-Vaijnath,Gram,2015,3936,4076,140,3.5569105691056913
Barshi,Green Chilli,2015,185,325,140,75.67567567567568
Chandur Rly.,Pigeon Pea (Tur),2016,5615,5755,140,2.4933214603739984
Jintur,Black Gram,2015,5185,5325,140,2.700096432015429
Jalgaon,Wheat(Husked),2015,1271,1411,140,11.014948859166012
Vaduj,Bajri,2016,1700,1840,140,8.235294117647058
Dondaicha,Cowpea,2016,1200,1340,140,11.666666666666666
Lasalgaon,Ground Nut Pods (Dry),2015,3485,3625,140,4.017216642754663
Mukhed,Soybean,2015,3622,3762,140,3.8652678078409717
Ahmedpur,Sorgum(Jawar),2016,1576,1716,140,8.883248730964468
Dondaicha,Maize,2015,1033,1173,140,13.552758954501453
Ghatanji,Soybean,2015,3400,3540,140,4.117647058823529
Akhadabalapur,Sorgum(Jawar),2015,1340,1480,140,10.447761194029852
Khed (Shel Pimpalgaon),Cabbage,2014,520,660,140,26.923076923076923
Pune-Pimpri,Wal Papdi,2015,3040,3180,140,4.605263157894737
Yawal,Maize,2016,1310,1450,140,10.687022900763358
Jalgaon Jamod,Maize,2015,930,1070,140,15.053763440860216
Pune-Pimpri,Capsicum,2016,2635,2775,140,5.313092979127135
Gangapur,Bajri,2016,1755,1895,140,7.977207977207978
Latur,Maize,2016,1480,1620,140,9.45945945945946
Deulgaon Raja,Cotton,2014,3927,4067,140,3.5650623885918002
Chimur,Paddy-Unhusked,2016,1857,1997,140,7.539041464728056
Basmat,Soybean,2015,3167,3307,140,4.420587306599305
Baramati,Soybean,2014,3100,3240,140,4.516129032258065
Jafrabad,Maize,2015,920,1060,140,15.217391304347826
Bhandara,Gram,2016,7819,7959,140,1.7905102954341987
Jafrabad,Maize,2014,875,1015,140,16.0
Kolhapur-Laxmipuri,Split Lentil,2014,6327,6467,140,2.212739054844318
Jafrabad,Cotton,2014,3860,4000,140,3.626943005181347
Telhara,Soybean,2015,3105,3245,140,4.508856682769726
Shahapur,Paddy-Unhusked,2014,1450,1590,140,9.655172413793103
Achalpur,Soybean,2016,3685,3825,140,3.7991858887381276
Nandura,Bajri,2015,1147,1287,140,12.205754141238012
Islampur,Brinjal,2016,94,234,140,148.93617021276594
Islampur,Bitter Gourd,2016,400,540,140,35.0
Rahata,Ghevda,2015,2800,2940,140,5.0
Anajngaon Surji,Sunflower,2014,2821,2961,140,4.962779156327543
Amarawati,Math (Bhaji),2015,720,860,140,19.444444444444443
Barshi,Tamarind,2016,6485,6625,140,2.158828064764842
Pulgaon,COTTON,2016,4840,4980,140,2.8925619834710745
Kalamb (Os),Sunflower,2015,3011,3151,140,4.649618067087347
Dhamangaon-Rly,Cotton,2015,4290,4430,140,3.2634032634032635
Newasa,Wheat(Husked),2016,1640,1780,140,8.536585365853659
Ambejogai,Sorgum(Jawar),2015,2242,2382,140,6.244424620874219
Mandhal,Pigeon Pea (Tur),2016,6900,7040,140,2.028985507246377
Umarga,Sunflower,2015,3104,3244,140,4.510309278350515
Kinwat,Pigeon Pea (Tur),2016,8180,8320,140,1.7114914425427872
Udgir,Gram,2016,7140,7280,140,1.9607843137254901
Pune-Pimpri,Cabbage,2015,920,1060,140,15.217391304347826
Navapur,Paddy-Unhusked,2016,1151,1291,140,12.163336229365768
Latur,Maize,2016,1380,1520,140,10.144927536231885
Kinwat,Gram,2016,4185,4325,140,3.3452807646356035
Indapur,Maize,2014,1121,1261,140,12.488849241748438
Kada (Ashti),Bajri,2015,1138,1278,140,12.302284710017574
Washim,Sorgum(Jawar),2014,1134,1274,140,12.345679012345679
Nanded,Gram,2015,3957,4097,140,3.538033864038413
Ausa,Sorgum(Jawar),2016,1504,1644,140,9.308510638297872
Chopda,Sunflower,2015,2829,2969,140,4.948745139625309
Junnar-Otur,Cabbage,2016,134,274,140,104.4776119402985
Gondpimpri,Pigeon Pea (Tur),2014,4310,4450,140,3.2482598607888633
Junnar (Narayangaon),Tomato,2016,280,420,140,50.0
Parbhani,Sorgum(Jawar),2015,1560,1700,140,8.974358974358974
Murum,Black Gram,2015,5580,5720,140,2.5089605734767026
Ausa,Sunflower,2016,3341,3481,140,4.190362167015864
Panvel,Bottle Gourd,2015,740,880,140,18.91891891891892
Shevgaon,SORGUM(JAWAR),2016,2174,2314,140,6.439742410303588
Murtizapur,Wheat(Husked),2015,1425,1565,140,9.824561403508772
Wardha,Wheat(Husked),2016,1708,1848,140,8.19672131147541
Jafrabad,Wheat(Husked),2016,1410,1550,140,9.929078014184396
Balapur,Soybean,2015,3560,3700,140,3.932584269662921
Patan,Cabbage,2016,480,620,140,29.166666666666668
Kada,MAIZE,2016,1150,1290,140,12.173913043478262
Chimur,Paddy-Unhusked,2014,1976,2116,140,7.08502024291498
Dhule,Sorgum(Jawar),2015,1342,1482,140,10.432190760059612
Pusad,PIGEON PEA (TUR),2016,5580,5720,140,2.5089605734767026
Akot,Wheat(Husked),2016,1375,1515,140,10.181818181818182
Sinner,Green Gram,2015,6500,6640,140,2.1538461538461537
Tumsar,Paddy-Unhusked,2015,1450,1590,140,9.655172413793103
Jafrabad,Sorgum(Jawar),2015,990,1130,140,14.141414141414142
Gondpimpri,Soybean,2015,2870,3010,140,4.878048780487805
Rahata,Wheat(Husked),2015,1461,1601,140,9.582477754962355
Tiroda,Paddy-Unhusked,2016,1692,1832,140,8.274231678486998
Deulgaon Raja,Cotton,2014,3904,4044,140,3.5860655737704916
Patur,Wheat(Husked),2015,1710,1850,140,8.187134502923977
Panvel,Bottle Gourd,2014,910,1050,140,15.384615384615385
Aamgaon,Paddy-Unhusked,2014,1438,1577,139,9.666203059805285
Khamgaon,Sunflower,2016,3325,3464,139,4.180451127819549
Zarijamini,Cotton,2014,3889,4028,139,3.5741835947544356
Yeola,Maize,2015,1320,1459,139,10.530303030303031
Basmat,Pigeon Pea (Tur),2016,7259,7398,139,1.914864306378289
Kurdwadi-Modnimb,Maize,2015,1502,1641,139,9.254327563249001
Malkapur,Sorgum(Jawar),2015,1108,1247,139,12.545126353790614
Dound,Maize,2015,1524,1663,139,9.120734908136482
Varud-Rajura Bazar,Wheat(Husked),2015,1261,1400,139,11.022997620935765
Tumsar,Paddy-Unhusked,2016,1813,1952,139,7.666850523993381
Mantha,Cotton,2016,4437,4576,139,3.132747351814289
Jalgaon,Banana,2014,326,465,139,42.63803680981595
Shevgaon,Gram,2016,4976,5115,139,2.7934083601286175
Samudrapur,COTTON,2016,4811,4950,139,2.88921222199127
Tuljapur,Soybean,2014,2950,3089,139,4.711864406779661
Parshiwani,Cotton,2016,4289,4428,139,3.2408486826766145
Pandharpur,Sorgum(Jawar),2015,1825,1964,139,7.616438356164384
Pandharkawada,Cotton,2015,3771,3910,139,3.6860249270750463
Chamorshi,Paddy-Unhusked,2015,2031,2170,139,6.843919251600197
Telhara,Wheat(Husked),2016,1658,1797,139,8.383594692400482
Chalisgaon,Soybean,2015,3111,3250,139,4.468016714882674
Kalamb (Os),Sunflower,2014,2849,2988,139,4.878904878904879
Islampur,Flower,2016,185,324,139,75.13513513513513
Nandura,Wheat(Husked),2014,1392,1531,139,9.985632183908047
Nandura,Wheat(Husked),2014,1399,1538,139,9.93566833452466
Rahuri-Vambori,Soybean,2016,3158,3297,139,4.4015199493350226
Nandura,Bajri,2016,1469,1608,139,9.462219196732471
Brahmpuri,Paddy-Unhusked,2016,2215,2354,139,6.275395033860045
Dhadgaon,SORGUM(JAWAR),2016,1085,1224,139,12.811059907834101
Dhadgaon,Bhagar/Vari,2016,1600,1739,139,8.6875
Umarga,Wheat(Husked),2015,1458,1597,139,9.53360768175583
Lonar,SOYBEAN,2016,2775,2914,139,5.009009009009009
Devala,Black Gram,2014,5068,5207,139,2.7426992896606155
Kopargaon,Wheat(Husked),2015,1457,1596,139,9.540150995195608
Ramtek,Gram,2016,4013,4152,139,3.463742835783703
Kannad,Bajri,2016,1621,1760,139,8.574953732264035
Barshi,Brinjal,2015,94,233,139,147.87234042553192
Barshi,Bajri,2014,1611,1750,139,8.628181253879578
Savner,Wheat(Husked),2016,1425,1564,139,9.75438596491228
Shegaon,Sorgum(Jawar),2016,1411,1550,139,9.851169383416018
Parli-Vaijnath,Gram,2015,3297,3436,139,4.21595389748256
Barshi,Fodder,2015,520,659,139,26.73076923076923
Barshi,Maize,2015,1360,1498,138,10.147058823529411
Anajngaon Surji,Banana,2015,500,638,138,27.6
Mehkar,Maize,2015,1050,1188,138,13.142857142857142
Vai,Cabbage,2014,728,866,138,18.956043956043956
Amarawati,Maize,2015,1033,1171,138,13.359148112294289
Mehkar,Sorgum(Jawar),2016,1107,1245,138,12.466124661246612
Telhara,Cotton,2015,3856,3994,138,3.578838174273859
Achalpur,Soybean,2015,3100,3238,138,4.451612903225806
Dondaicha-Sindkheda,Wheat(Husked),2016,1636,1774,138,8.43520782396088
Pachora,Gram,2016,4042,4180,138,3.4141514101929737
Mumbai,Potato,2015,1082,1220,138,12.754158964879853
Jalna,Jaggery,2016,2427,2565,138,5.686032138442521
Mehkar,Maize,2015,972,1110,138,14.197530864197532
Partur,Cotton,2015,3812,3950,138,3.620146904512067
Shirur,Sorgum(Jawar),2014,1549,1687,138,8.908973531310522
Pune-Pimpri,Beet Root,2015,1175,1313,138,11.74468085106383
Telhara,Sorgum(Jawar),2014,1179,1317,138,11.704834605597965
Amarawati,Cotton,2016,5524,5662,138,2.498189717595945
Vaduj,Gram,2016,4200,4338,138,3.2857142857142856
Sinner,Wheat(Husked),2015,1576,1714,138,8.756345177664974
Amarawati,Linseed,2016,4605,4743,138,2.996742671009772
Barshi,Lemon,2015,123,261,138,112.1951219512195
Navapur,Ground Nut Pods (Dry),2016,5376,5514,138,2.5669642857142856
Indapur,Banana,2015,290,428,138,47.58620689655172
Indapur,Banana,2014,1117,1255,138,12.354521038495971
Tumsar,PADDY-UNHUSKED,2016,1715,1853,138,8.0466472303207
Aheri,Batbati,2016,4026,4164,138,3.427719821162444
Kalmeshwar,Raddish,2015,490,628,138,28.163265306122447
Kalmeshwar,Cucumber,2015,580,718,138,23.79310344827586
Jalgaon,Banana,2016,345,483,138,40.0
Jintur-Bori,Green Gram,2015,7675,7813,138,1.798045602605863
Murbad,Brinjal,2015,3225,3363,138,4.27906976744186
Shegaon,Pigeon Pea (Tur),2014,4401,4539,138,3.1356509884117245
Kalyan,Potato,2015,750,888,138,18.4
Shevgaon,Wheat(Husked),2015,1448,1586,138,9.530386740331492
Rahata,MAIZE,2016,977,1115,138,14.12487205731832
Kannad,Maize,2014,846,984,138,16.31205673758865
Gondiya,Paddy-Unhusked,2015,1428,1566,138,9.663865546218487
Shevgaon-Bodhegaon,Bajri,2015,1087,1225,138,12.695492180312787
Shevgaon-Bodhegaon,Sorgum(Jawar),2015,1752,1890,138,7.876712328767123
Murum,Sorgum(Jawar),2015,1832,1970,138,7.532751091703057
Kalvan,Bajri,2016,1488,1626,138,9.274193548387096
Panvel,Cabbage,2015,600,738,138,23.0
Shevgaon-Bodhegaon,Gram,2016,4063,4201,138,3.3965050455328574
Jintur,Cotton,2015,4015,4153,138,3.4371108343711083
Ausa,Soybean,2015,3470,3608,138,3.9769452449567724
Mangaon(Bhadav),Paddy-Unhusked,2015,1300,1438,138,10.615384615384615
Akhadabalapur,Cotton,2014,4000,4138,138,3.45
Telhara,Wheat(Husked),2016,1450,1588,138,9.517241379310345
Umarkhed-Danki,Soybean,2015,3462,3600,138,3.9861351819757367
Kada,Maize,2016,1288,1426,138,10.714285714285714
Pavani,Green Peas (Dry),2016,3100,3238,138,4.451612903225806
Ashti-Karanja,SOYBEAN,2016,2748,2886,138,5.021834061135372
Yeola,Maize,2015,1093,1231,138,12.62580054894785
Partur,COTTON,2016,4887,5025,138,2.823818293431553
Akhadabalapur,Soybean,2016,3525,3663,138,3.9148936170212765
Shevgaon-Bodhegaon,Bajri,2015,1064,1202,138,12.969924812030076
Latur,Bajri,2016,1523,1661,138,9.061063690085359
Pune-Pimpri,WAL PAPDI,2016,1456,1594,138,9.478021978021978
Vani,Cotton,2014,3913,4051,138,3.5267058522872476
Rahata,Soybean,2014,2875,3013,138,4.8
Tumsar,Wheat(Husked),2016,1621,1759,138,8.51326341764343
Satana,Wheat(Husked),2016,1790,1928,138,7.709497206703911
Vaijapur,Sorgum(Jawar),2015,1280,1418,138,10.78125
Savner,Wheat(Husked),2015,1273,1411,138,10.840534171249018
Chopda,Sorgum(Jawar),2015,1139,1277,138,12.115891132572433
Lonar,Soybean,2015,3553,3691,138,3.884041654939488
Bhandara,Wheat(Husked),2016,1543,1681,138,8.943616331821127
Vaijapur,Safflower,2016,2308,2445,137,5.935875216637782
Shrirampur,Soybean,2015,3398,3535,137,4.031783402001177
Vaijapur,Soybean,2016,3156,3293,137,4.340937896070976
Mumbai,Green Peas (Dry),2015,2706,2843,137,5.062823355506282
Kannad,Maize,2016,1195,1332,137,11.464435146443515
Savner,Cotton,2015,3783,3920,137,3.6214644462067143
Jalgaon Jamod-Aasalgaon,Sorgum(Jawar),2015,1113,1250,137,12.309074573225516
Kalamb (Os),Bajri,2016,1538,1675,137,8.907672301690507
Armori,Paddy-Unhusked,2016,1646,1783,137,8.323207776427704
Latur,Bajri,2015,1276,1413,137,10.736677115987462
Devala,Bajri,2015,1253,1390,137,10.933758978451715
Ahmednagar,Bajri,2016,1788,1925,137,7.662192393736018
Kalmeshwar,Flower,2014,385,522,137,35.58441558441559
Parli-Vaijnath,Gram,2015,4000,4137,137,3.425
Rahuri-Vambori,Sorgum(Jawar),2015,1198,1335,137,11.435726210350584
Lasalgaon-Vinchur,Maize,2016,1314,1451,137,10.426179604261796
Sakri,Wheat(Husked),2016,1469,1606,137,9.326072157930565
Devani,Gram,2016,5408,5545,137,2.533284023668639
Kej,Sorgum(Jawar),2015,2164,2301,137,6.33086876155268
Shegaon,Sorgum(Jawar),2016,1326,1463,137,10.331825037707391
Rahuri-Vambori,MAIZE,2016,1129,1266,137,12.134632418069089
Digras,Wheat(Husked),2016,1719,1856,137,7.969749854566609
Malkapur,Sorgum(Jawar),2016,1303,1440,137,10.514198004604758
Purna,Wheat(Husked),2014,1415,1552,137,9.681978798586572
Jalna-Badnapur,Cotton,2015,4016,4153,137,3.4113545816733066
Rahata,Wheat(Husked),2014,1420,1557,137,9.647887323943662
Khamgaon,Sorgum(Jawar),2016,1268,1405,137,10.804416403785488
Barshi,Paddy-Unhusked,2014,1270,1407,137,10.78740157480315
Telhara,Gram,2014,2567,2704,137,5.336969224776003
Ner Parasopant,Gram,2014,2427,2564,137,5.644829007004533
Jalgaon Jamod-Aasalgaon,Maize,2016,1088,1225,137,12.591911764705882
Tiroda,Paddy-Unhusked,2014,2035,2172,137,6.732186732186732
Manora,Ground Nut Pods (Dry),2016,6338,6475,137,2.1615651625118333
Morshi,Wheat(Husked),2016,1563,1700,137,8.765195137555983
Parli-Vaijnath,Gram,2014,2255,2392,137,6.075388026607539
Achalpur,Wheat(Husked),2015,1518,1655,137,9.025032938076416
Kinwat,Soybean,2015,3400,3537,137,4.029411764705882
Anajngaon Surji,Banana,2015,563,700,137,24.33392539964476
Ner Parasopant,Soybean,2016,3467,3604,137,3.951543120853764
Majalgaon,Soybean,2015,3162,3299,137,4.33270082226439
Vaduj,Cowpea,2014,3188,3325,137,4.297365119196988
Yawal,Banana,2016,468,605,137,29.273504273504273
Soygaon,Cotton,2016,4238,4375,137,3.232656913638509
Gevrai,Sesamum,2014,10913,11050,137,1.2553834875836158
Shahapur,Paddy-Unhusked,2015,1475,1612,137,9.288135593220339
Nashik,Spinach,2015,171,308,137,80.11695906432749
Latur-Murud,Safflower,2016,2601,2738,137,5.26720492118416
Mehkar,Maize,2016,1173,1310,137,11.679454390451832
Naigaon,Gram,2016,4219,4356,137,3.247214979853046
Dound,Maize,2016,1402,1539,137,9.771754636233952
Ausa,Sunflower,2016,3534,3671,137,3.876627051499717
Shrirampur,Bajri,2016,1511,1648,137,9.066843150231636
Paithan,Sorgum(Jawar),2016,1712,1849,137,8.00233644859813
Pachora,Sorgum(Jawar),2016,1535,1672,137,8.925081433224756
Ausa,SAFFLOWER,2016,2669,2806,137,5.133008617459723
Pune,Maize,2014,1540,1677,137,8.896103896103897
Vaduj,Green Gram,2016,4944,5081,137,2.7710355987055015
Lonar,Soybean,2015,3258,3395,137,4.2050337630448125
Bhokardan-Pimpalgaon Renu,Soybean,2015,3113,3250,137,4.400899453902987
Tiroda,Paddy-Unhusked,2016,1618,1755,137,8.4672435105068
Raver,Sorgum(Jawar),2015,1174,1311,137,11.669505962521296
Yawal,Sorgum(Jawar),2016,1279,1416,137,10.711493354182956
Tumsar,Sarsav,2014,2674,2811,137,5.12341062079282
Korpana,COTTON,2016,4727,4864,137,2.898244129469008
Parshiwani,Cotton,2016,4594,4731,137,2.982150631258163
Udgir,Sorgum(Jawar),2015,1370,1507,137,10.0
Vai,Cabbage,2016,567,703,136,23.98589065255732
Mukhed,SORGUM(JAWAR),2016,1125,1261,136,12.088888888888889
Nandura,Bajri,2015,999,1135,136,13.613613613613614
Jalgaon,Banana,2015,299,435,136,45.48494983277592
Baramati,Maize,2016,1359,1495,136,10.007358351729213
Sakri,Pigeon Pea (Tur),2016,5011,5147,136,2.7140291359010176
Raver,Maize,2014,932,1068,136,14.592274678111588
Umarga,Bajri,2014,1183,1319,136,11.496196111580726
Phaltan,Maize,2015,1284,1420,136,10.59190031152648
Bhiwapur,Soybean,2015,3164,3300,136,4.298356510745891
Shahada,Maize,2015,1211,1347,136,11.230388109000826
Umarga,Bajri,2014,1060,1196,136,12.830188679245284
Mehkar,Maize,2016,1206,1342,136,11.276948590381426
Loha,Turmeric,2016,7863,7999,136,1.7296197380134808
Varud,COTTON,2016,4821,4957,136,2.820991495540344
Rahata,Wheat(Husked),2015,1434,1570,136,9.483960948396096
Bhandara,Pigeon Pea (Tur),2016,6700,6836,136,2.029850746268657
Ner Parasopant,Green Gram,2015,9017,9153,136,1.5082621714539204
Ner Parasopant,Gram,2015,3914,4050,136,3.474706182933061
Jalgaon,Bitter Gourd,2014,2900,3036,136,4.689655172413793
Gangapur,Green Gram,2016,4753,4889,136,2.861350725857353
Bhandara,Wheat(Husked),2016,1434,1570,136,9.483960948396096
Jalna,Maize,2015,1138,1274,136,11.95079086115993
Dondaicha-Sindkheda,Wheat(Husked),2016,1648,1784,136,8.25242718446602
Nampur,Maize,2016,1325,1461,136,10.264150943396226
Bhokar,Wheat(Husked),2014,1311,1447,136,10.373760488176965
Partur,Gram,2016,4094,4230,136,3.321934538348803
Hinganghat,Cotton,2015,4002,4138,136,3.3983008495752123
Sangamner,Wheat(Husked),2016,1739,1875,136,7.8205865439907996
Chopda,Bajri,2015,1140,1276,136,11.929824561403509
Telhara,Cotton,2015,3807,3943,136,3.572366692934069
Lasalgaon-Vinchur,Wheat(Husked),2015,1505,1641,136,9.03654485049834
Bhokar,Cotton,2015,3713,3849,136,3.6628063560463238
Gevrai,Gram,2014,2197,2333,136,6.190259444697315
Kannad,Maize,2014,839,975,136,16.209773539928488
Nandura,Sorgum(Jawar),2015,1134,1270,136,11.99294532627866
Manmad,Maize,2015,1341,1477,136,10.141685309470544
Armori,Paddy-Unhusked,2015,1675,1811,136,8.119402985074627
Jamkhed,Wheat(Husked),2016,2132,2268,136,6.378986866791744
Shevgaon-Bodhegaon,Sorgum(Jawar),2015,1514,1650,136,8.982826948480845
Khultabad,Maize,2015,1236,1372,136,11.003236245954692
Malegaon,Maize,2015,1339,1475,136,10.156833457804332
Savner,Pigeon Pea (Tur),2015,5931,6067,136,2.2930365874220198
Devala,Bajri,2015,1411,1547,136,9.63855421686747
Telhara,Soybean,2015,3055,3191,136,4.451718494271685
Murbad,Brinjal,2015,2109,2245,136,6.4485538169748695
Nilanga,Safflower,2016,2583,2719,136,5.265195509097948
Barshi-Vairag,Soybean,2015,3534,3670,136,3.848330503678551
Osmanabad,Black Gram,2016,6173,6309,136,2.2031427182893246
Umarga,Sunflower,2015,3175,3311,136,4.283464566929134
Murbad,Ghevda,2015,3957,4093,136,3.436947182208744
Partur,Bajri,2014,1200,1336,136,11.333333333333334
Umarga,Wheat(Husked),2015,1336,1472,136,10.179640718562874
Barshi,Green Chilli,2015,138,274,136,98.55072463768116
Pune-Pimpri,Beet Root,2015,1900,2036,136,7.157894736842105
Sangli-Miraj,Wheat(Unhusked),2016,3403,3539,136,3.9964736996767556
Parbhani,Soybean,2014,3152,3288,136,4.314720812182741
Kalyan,Bottle Gourd,2015,629,764,135,21.462639109697932
Jalna,Wheat(Husked),2014,1564,1699,135,8.631713554987213
Morshi,Wheat(Husked),2016,1690,1825,135,7.988165680473373
Ausa,Soybean,2015,3191,3326,135,4.230648699467252
Kille Dharur,Sorgum(Jawar),2015,2363,2498,135,5.713076597545493
Rahata,Sorgum(Jawar),2015,1078,1213,135,12.523191094619666
Kalamb (Yawatmal),Cotton,2015,3965,4100,135,3.4047919293820934
Ramtek,Flower,2016,420,555,135,32.142857142857146
Ahmednagar,Wheat(Husked),2015,1537,1672,135,8.78334417696812
Chandrapur,Gram,2016,4112,4247,135,3.2830739299610894
Risod,Sesamum,2015,6010,6145,135,2.2462562396006653
Barshi,Paddy-Unhusked,2015,1344,1479,135,10.044642857142858
Akluj,Sorgum(Jawar),2015,1571,1706,135,8.593252705283259
Aurangabad,Cabbage,2014,303,438,135,44.554455445544555
Karanja,Green Gram,2016,6736,6871,135,2.0041567695961997
Dhule,Sorgum(Jawar),2016,1572,1707,135,8.587786259541986
Barshi,Jaggery,2015,2091,2226,135,6.456241032998565
Shrirampur-Belapur,Soybean,2015,3303,3438,135,4.087193460490464
Darwha,Cotton,2015,4084,4219,135,3.3055827619980414
Indapur-Bhigwan,Maize,2015,1448,1583,135,9.323204419889503
Himayatnagar,Wheat(Husked),2016,1370,1505,135,9.854014598540147
Lasalgaon-Vinchur,Bajri,2016,1868,2003,135,7.226980728051392
Telhara,Sorgum(Jawar),2016,1282,1417,135,10.530421216848675
Dondaicha-Sindkheda,MAIZE,2016,1084,1219,135,12.453874538745387
Aurangabad,CABBAGE,2016,344,479,135,39.24418604651163
Jintur-Bori,Pigeon Pea (Tur),2015,4906,5041,135,2.751732572360375
Yeola,Wheat(Husked),2015,1550,1685,135,8.709677419354838
Latur,Maize,2014,1100,1235,135,12.272727272727273
Bhokardan-Pimpalgaon Renu,Green Gram,2016,4650,4785,135,2.903225806451613
Kalamb (Os),Soybean,2015,3225,3360,135,4.186046511627907
Chandrapur,Soybean,2016,3450,3585,135,3.9130434782608696
Paithan,Sorgum(Jawar),2016,1711,1846,135,7.8901227352425485
Latur-Murud,Sorgum(Jawar),2015,1101,1236,135,12.26158038147139
Kalmeshwar,Raddish,2015,865,1000,135,15.606936416184972
Rahata,Wheat(Husked),2015,1484,1619,135,9.097035040431267
Amarawati,Cabbage,2016,553,688,135,24.412296564195298
Islampur,Capsicum,2016,253,388,135,53.359683794466406
Buldhana,Soybean,2014,3050,3185,135,4.426229508196721
Chandrapur,Horse Gram,2015,2200,2335,135,6.136363636363637
Mantha,Cotton,2016,4295,4430,135,3.1431897555296855
Nagpur,Math (Bhaji),2015,487,622,135,27.720739219712527
Kopargaon,Maize,2015,1216,1351,135,11.101973684210526
Nagpur,Potato,2015,815,950,135,16.56441717791411
Bhandara,Indian Bean,2016,3016,3151,135,4.476127320954907
Navapur,Indian Bean,2016,2479,2614,135,5.445744251714401
Pulgaon,Cotton,2016,4622,4757,135,2.9208135006490696
Amarawati-Fruit And Vegetables,Brinjal,2016,586,721,135,23.037542662116042
Barshi,Paddy-Unhusked,2016,1685,1820,135,8.011869436201781
Dondaicha,Bajri,2015,1047,1182,135,12.893982808022923
Jalna,Jaggery,2015,2075,2210,135,6.506024096385542
Tumsar,Sarsav,2015,3209,3344,135,4.206918043004051
Kannad,Bajri,2014,1250,1385,135,10.8
Shirur,Sorgum(Jawar),2015,1445,1580,135,9.342560553633218
Tumsar,Sarsav,2015,3400,3535,135,3.9705882352941178
Chimur,Gram,2016,5415,5550,135,2.4930747922437675
Jalgaon,Gram,2015,3890,4025,135,3.4704370179948585
Udgir,Black Gram,2016,7217,7351,134,1.856727171955106
Solapur,Papai,2014,258,392,134,51.93798449612403
Pathardi,Sorgum(Jawar),2015,1533,1667,134,8.741030658838879
Sailu,Sorgum(Jawar),2015,1531,1665,134,8.752449379490528
Vaduj,Bajri,2016,1744,1878,134,7.68348623853211
Khed (Shel Pimpalgaon),Bottle Gourd,2015,1646,1780,134,8.140947752126367
Mantha,Soybean,2014,2933,3067,134,4.568700988748722
Pathari,Sorgum(Jawar),2015,1706,1840,134,7.854630715123095
Bhokar,Soybean,2016,3367,3501,134,3.9798039798039797
Washim,Sorgum(Jawar),2016,1375,1509,134,9.745454545454546
Mantha,Wheat(Husked),2014,1448,1582,134,9.25414364640884
Nashik,Mint,2015,130,264,134,103.07692307692308
Chimur,PADDY-UNHUSKED,2016,2003,2137,134,6.689965052421368
Amarawati-Fruit And Vegetables,Brinjal,2016,1133,1267,134,11.827007943512799
Malegaon,Maize,2015,1075,1209,134,12.465116279069768
Morshi,Soybean,2015,3544,3678,134,3.781038374717833
Malegaon,Maize,2015,1344,1478,134,9.970238095238095
Shevgaon-Bodhegaon,Sorgum(Jawar),2015,1336,1470,134,10.029940119760479
Tasgaon,Gram,2016,4433,4567,134,3.0227836679449585
Chopda,Gram,2016,4232,4366,134,3.166351606805293
Vaduj,Sorgum(Jawar),2016,2144,2278,134,6.25
Vaduj,Sorgum(Jawar),2014,2244,2378,134,5.971479500891266
Patan,Cabbage,2015,483,617,134,27.74327122153209
Navapur,Sorgum(Jawar),2016,1250,1384,134,10.72
Barshi,Paddy-Unhusked,2014,1366,1500,134,9.809663250366032
Chikhali,MAIZE,2016,1111,1245,134,12.061206120612061
Ghansawangi,Cotton,2015,3833,3967,134,3.495956170101748
Palghar(Bevur),Wheat(Husked),2016,1994,2128,134,6.720160481444333
Osmanabad,Pigeon Pea (Tur),2015,5033,5167,134,2.662427975362607
Barshi,Paddy-Unhusked,2016,1691,1825,134,7.924305144884683
Pandharpur,Sorgum(Jawar),2015,1748,1882,134,7.665903890160183
Washi(Osmanabad),Soybean,2016,3433,3567,134,3.903291581706962
Bhokar,Sesamum,2016,6183,6317,134,2.1672327349183242
Umarkhed-Danki,Soybean,2016,3533,3667,134,3.7928106425134445
Rahata,Maize,2015,1283,1417,134,10.44427123928293
Gangapur,Bajri,2014,1285,1419,134,10.428015564202335
Kalyan,Cabbage,2016,533,667,134,25.140712945590995
Akhadabalapur,Pigeon Pea (Tur),2014,4083,4217,134,3.2819005633112908
Akot,Maize,2015,1102,1236,134,12.159709618874773
Kej,Sorgum(Jawar),2014,1677,1811,134,7.990459153249851
Mangalwedha,Gram,2016,4033,4167,134,3.3225886436895613
Yeola,Wheat(Husked),2014,1478,1612,134,9.066305818673884
Ahmedpur,Wheat(Husked),2015,1212,1346,134,11.056105610561056
Bhusaval,Wheat(Husked),2015,1215,1349,134,11.02880658436214
Vai,Cabbage,2014,733,867,134,18.281036834924965
Nilanga,Sorgum(Jawar),2014,1000,1134,134,13.4
Kolhapur-Laxmipuri,Maize,2016,1833,1967,134,7.310420076377524
Baramati,Maize,2015,1371,1505,134,9.773887673231219
Purna,Black Gram,2016,6773,6907,134,1.9784438210541857
Amalner,Sorgum(Jawar),2015,1200,1334,134,11.166666666666666
Kurdwadi-Modnimb,Wheat(Husked),2016,1857,1991,134,7.215939687668282
Barshi-Vairag,Wheat(Husked),2015,1883,2017,134,7.116303770578863
Osmanabad,Black Gram,2014,4933,5067,134,2.71639975674032
Vai,Tomato,2014,533,667,134,25.140712945590995
Islampur,Bitter Gourd,2016,200,334,134,67.0
Kalmeshwar,Cotton,2015,3754,3888,134,3.569525839104955
Malkapur,Maize,2016,1247,1381,134,10.7457898957498
Aamgaon,Paddy-Unhusked,2016,1536,1670,134,8.723958333333334
Paithan,Bajri,2014,1340,1474,134,10.0
Kalvan,Bajri,2015,1386,1520,134,9.668109668109668
Jalgaon Jamod,Soybean,2016,3133,3267,134,4.277050750079796
Ahmedpur,Tamarind,2015,2633,2767,134,5.089251804025826
Yeotmal,Cotton,2015,3808,3942,134,3.51890756302521
Ahmedpur,Soybean,2014,3214,3348,134,4.16925948973242
Dhamangaon-Rly,Wheat(Husked),2016,1653,1787,134,8.106473079249849
Ner Parasopant,Wheat(Husked),2015,1283,1417,134,10.44427123928293
Bhandara,Rice(Paddy-Hus),2016,2557,2691,134,5.240516229956981
Beed,Pigeon Pea (Tur),2016,6356,6490,134,2.1082441787287602
Savner,Sorgum(Jawar),2014,1158,1292,134,11.57167530224525
Akola,Maize,2016,1481,1615,134,9.047940580688724
Aurad Shahajani,Soybean,2016,3926,4060,134,3.413143148242486
Partur,Gram,2015,3656,3790,134,3.665207877461707
Barshi,Bitter Gourd,2016,158,292,134,84.81012658227849
Mudkhed,Pigeon Pea (Tur),2016,8033,8167,134,1.668119009087514
Dhule,Sorgum(Jawar),2016,1578,1712,134,8.491761723700888
Washi(Osmanabad),Sorgum(Jawar),2015,2083,2217,134,6.43302928468555
Indapur,Bajri,2015,1456,1590,134,9.203296703296703
Jalgaon Jamod,Wheat(Husked),2015,1258,1392,134,10.651828298887123
Kopargaon,Bajri,2015,1340,1473,133,9.925373134328359
Solapur,Gram,2015,3225,3358,133,4.124031007751938
Pusad,Sesamum,2014,9460,9593,133,1.4059196617336152
Umared,Sorgum(Jawar),2015,1417,1550,133,9.386026817219477
Bhusaval,Gram,2015,3181,3314,133,4.181075133605784
Nanded,Gram,2015,2667,2800,133,4.986876640419948
Parli-Vaijnath,Wheat(Husked),2015,1429,1562,133,9.307207837648706
Rahata,Lemon,2015,2089,2222,133,6.36668262326472
Ausa,SUNFLOWER,2016,2783,2916,133,4.77901545095221
Jintur,Sorgum(Jawar),2015,1222,1355,133,10.88379705400982
Parli-Vaijnath,Ground Nut Pods (Dry),2015,3917,4050,133,3.3954557058973704
Akhadabalapur,Soybean,2015,3211,3344,133,4.1420118343195265
Shevgaon,Soybean,2015,3184,3317,133,4.17713567839196
Murbad,Ghosali(Bhaji),2014,1400,1533,133,9.5
Jalgaon Jamod,Wheat(Husked),2016,1400,1533,133,9.5
Kille Dharur,Maize,2016,1467,1600,133,9.066121336059986
Vaduj,Gram,2015,4378,4511,133,3.0379168570123345
Morshi,Soybean,2014,3099,3232,133,4.291707002258793
Mahagaon,Sorgum(Jawar),2015,1500,1633,133,8.866666666666667
Dhamangaon-Rly,Wheat(Husked),2016,1503,1636,133,8.84896872920825
Nandurbar,Gram,2015,3741,3874,133,3.5551991446137396
Akhadabalapur,Soybean,2016,3600,3733,133,3.6944444444444446
Satana,Wheat(Husked),2014,1541,1674,133,8.63075924724205
Mudkhed,Sorgum(Jawar),2016,1316,1449,133,10.106382978723405
Jalgaon,Bajri,2015,1038,1171,133,12.8131021194605
Kolhapur-Malkapur,Ladies Finger,2016,367,500,133,36.23978201634878
Kolhapur-Malkapur,Ladies Finger,2016,267,400,133,49.81273408239701
Jalgaon Jamod,Sorgum(Jawar),2015,1150,1283,133,11.565217391304348
Kolhapur-Malkapur,Capsicum,2016,150,283,133,88.66666666666667
Ahmednagar,Bajri,2016,1522,1655,133,8.73850197109067
Nandgaon,Wheat(Husked),2014,1514,1647,133,8.784676354029061
Kalyan,Cabbage,2016,667,800,133,19.940029985007495
Partur,Soybean,2016,3587,3720,133,3.707833844438249
Ahmednagar,Wheat(Husked),2016,1709,1842,133,7.782328847279111
Shevgaon,Gram,2015,3509,3642,133,3.7902536335138217
Ambejogai,Green Gram,2015,8667,8800,133,1.5345563632167993
Jawala-Bajar,Gram,2015,3250,3383,133,4.092307692307692
Kalyan,Wheat(Husked),2015,1950,2083,133,6.82051282051282
Rahuri,Melon,2016,100,233,133,133.0
Shevgaon,Bajri,2015,1380,1513,133,9.63768115942029
Vaduj,Ghevda Seed,2016,1967,2100,133,6.761565836298932
Bhokar,Soybean,2016,3021,3154,133,4.40251572327044
Patur,BLACK GRAM,2016,5800,5933,133,2.293103448275862
Akole,Gram,2014,3000,3133,133,4.433333333333334
Amalner,Bajri,2016,1379,1512,133,9.644670050761421
Rahata,Sorgum(Jawar),2016,1405,1538,133,9.466192170818506
Hingoli,SOYBEAN,2016,2754,2887,133,4.829339143064633
Tasgaon,Gram,2015,3200,3333,133,4.15625
Ner Parasopant,Wheat(Husked),2016,1317,1450,133,10.098709187547456
Ausa,Sunflower,2015,3008,3141,133,4.42154255319149
Jalna,Jaggery,2016,3371,3504,133,3.9454167902699497
Kurdwadi,Maize,2015,1160,1293,133,11.46551724137931
Akot,Wheat(Husked),2016,1690,1823,133,7.8698224852071
Amarawati-Fruit And Vegetables,Brinjal,2016,900,1033,133,14.777777777777779
Malegaon,Sorgum(Jawar),2016,1747,1880,133,7.613050944476245
Umared,Sorgum(Jawar),2014,1200,1333,133,11.083333333333334
Mangrulpeer,Black Gram,2015,5400,5533,133,2.462962962962963
Shrigonda,Wheat(Husked),2016,1800,1933,133,7.388888888888889
Buldhana-Dhad,Maize,2016,1217,1350,133,10.928512736236648
Navapur,Wheat(Husked),2016,1485,1618,133,8.956228956228957
Beed,Wheat(Husked),2014,1725,1858,133,7.7101449275362315
Sailu,Soybean,2014,3145,3278,133,4.228934817170111
Vaijapur,Maize,2016,1536,1669,133,8.658854166666666
Soygaon,Cotton,2016,4367,4500,133,3.045569040531257
Sillod,Gram,2014,2367,2500,133,5.6189269117025775
Shrigonda,Gram,2015,3600,3733,133,3.6944444444444446
Katol,Cotton,2015,3757,3890,133,3.5400585573595955
Mangrulpeer,Sorgum(Jawar),2015,1337,1470,133,9.947643979057592
Amarawati,Papai,2015,1200,1333,133,11.083333333333334
Palghar(Bevur),Potato,2015,913,1046,133,14.56736035049288
Manchar,Brinjal,2015,567,700,133,23.45679012345679
Vaduj,Sorgum(Jawar),2016,2189,2322,133,6.075833714024669
Vaduj,Sorgum(Jawar),2016,2011,2144,133,6.61362506215813
Amarawati,Pumpkin,2016,667,800,133,19.940029985007495
Islampur,Flower,2016,217,350,133,61.29032258064516
Vaduj,Wheat(Husked),2016,1700,1833,133,7.823529411764706
Dound,MAIZE,2016,1225,1358,133,10.857142857142858
Barshi,Ridge Gourd,2015,187,320,133,71.12299465240642
Pune-Moshi,Beet Root,2016,1478,1611,133,8.998646820027064
Panvel,Tomato,2015,1056,1189,133,12.594696969696969
Jalgaon Jamod-Aasalgaon,Maize,2016,1067,1200,133,12.46485473289597
Vai,Tomato,2016,500,633,133,26.6
Karad,Capsicum,2015,667,800,133,19.940029985007495
Kolhapur-Laxmipuri,Bajri,2014,1620,1753,133,8.209876543209877
Amarawati-Fruit And Vegetables,Tomato,2016,467,600,133,28.4796573875803
Vaduj,Wheat(Husked),2016,1700,1833,133,7.823529411764706
Aurangabad,Cabbage,2016,363,496,133,36.63911845730028
Barshi-Vairag,Gram,2014,2517,2650,133,5.284068335319825
Dhule,Sorgum(Jawar),2015,1329,1462,133,10.00752445447705
Jalgaon,BANANA,2016,221,354,133,60.18099547511312
Dhule,Soybean,2015,2978,3111,133,4.466084620550705
Panvel,Flower,2015,967,1100,133,13.75387797311272
Koregaon,Gram,2016,4217,4350,133,3.153900877400996
Raver,Maize,2016,1180,1313,133,11.271186440677965
Kalamb (Os),Maize,2016,1477,1610,133,9.004739336492891
Kinwat,Soybean,2016,3400,3533,133,3.911764705882353
Sailu,Sorgum(Jawar),2016,1363,1495,132,9.684519442406456
Brahmpuri,Paddy-Unhusked,2016,1914,2046,132,6.896551724137931
Vai,Cabbage,2015,561,693,132,23.529411764705884
Chakur,SOYBEAN,2016,2721,2853,132,4.851157662624035
Pune-Pimpri,Onion,2016,589,721,132,22.410865874363328
Shegaon,Sorgum(Jawar),2016,1331,1463,132,9.917355371900827
Telhara,Wheat(Husked),2016,1691,1823,132,7.806031933767001
Lasalgaon-Vinchur,Wheat(Husked),2016,1740,1872,132,7.586206896551724
Malkapur,Wheat(Husked),2015,1501,1633,132,8.794137241838774
Amarawati,Brinjal,2016,492,624,132,26.829268292682926
Latur,Maize,2015,1231,1363,132,10.722989439480097
Lasalgaon-Vinchur,Bajri,2016,1837,1969,132,7.18562874251497
Rahata,Sorgum(Jawar),2016,1443,1575,132,9.147609147609147
Umared,Green Gram,2016,5638,5770,132,2.3412557644554806
Kalmeshwar,Flower,2016,239,371,132,55.23012552301255
Tumsar,Paddy-Unhusked,2016,1783,1915,132,7.403252944475603
Khamgaon,Maize,2015,997,1129,132,13.239719157472416
Kalvan,Bajri,2015,1341,1473,132,9.843400447427292
Shrirampur,Soybean,2015,3341,3473,132,3.950912900329243
Paithan,Sorgum(Jawar),2015,1662,1794,132,7.9422382671480145
Kalamb (Os),MAIZE,2016,1104,1236,132,11.956521739130435
Shahada,Gram,2015,4240,4372,132,3.1132075471698113
Chalisgaon,Sorgum(Jawar),2015,1222,1354,132,10.801963993453356
Chalisgaon,Banana,2016,208,340,132,63.46153846153846
Chimur,Soybean,2016,3303,3435,132,3.9963669391462306
Jalgaon,Banana,2016,202,334,132,65.34653465346534
Amarawati-Fruit And Vegetables,Spinach,2016,581,713,132,22.719449225473323
Sillod,Wheat(Husked),2016,1500,1632,132,8.8
Dhadgaon,Bhagar/Vari,2016,1515,1647,132,8.712871287128714
Bhandara,Wheat(Husked),2014,1293,1425,132,10.208816705336426
Ahmednagar,Bajri,2015,1406,1538,132,9.388335704125177
Amalner,Bajri,2016,1417,1549,132,9.31545518701482
Ashti-Karanja,Wheat(Husked),2015,1472,1604,132,8.967391304347826
Devala,Maize,2015,1364,1496,132,9.67741935483871
Gevrai,Bajri,2015,1247,1379,132,10.585404971932638
Yawal,Wheat(Husked),2016,1677,1809,132,7.8711985688729875
Ausa,Bajri,2016,1507,1639,132,8.75912408759124
Barshi,Squash Gourd,2016,184,316,132,71.73913043478261
Mantha,Black Gram,2014,4450,4582,132,2.966292134831461
Sindi (Selu),Cotton,2015,3784,3916,132,3.488372093023256
Gondpimpri,Soybean,2015,3345,3477,132,3.9461883408071747
Kada,Maize,2015,1294,1426,132,10.200927357032457
Partur,Soybean,2015,3411,3543,132,3.8698328935795954
Jafrabad,Wheat(Husked),2015,1194,1325,131,10.971524288107203
Lonar,Green Gram,2016,5202,5333,131,2.518262206843522
Rahuri-Vambori,Pigeon Pea (Tur),2014,4309,4440,131,3.040148526340218
Amarawati,Linseed,2015,5353,5484,131,2.447225854660938
Shevgaon-Bodhegaon,Wheat(Husked),2016,1806,1937,131,7.25359911406423
Telhara,Maize,2016,1325,1456,131,9.88679245283019
Parli-Vaijnath,Soybean,2015,3441,3572,131,3.807032839290904
Dondaicha-Sindkheda,Maize,2016,1255,1386,131,10.43824701195219
Yawal,Gram,2016,4100,4231,131,3.1951219512195124
Pulgaon,Soybean,2015,3470,3601,131,3.7752161383285303
Pune-Pimpri,Flower,2015,588,719,131,22.27891156462585
Ghoti,Ladies Finger,2014,1732,1863,131,7.563510392609699
Yawal,Banana,2016,803,934,131,16.31382316313823
Gangakhed,Soybean,2016,3598,3729,131,3.640911617565314
Devala,Wheat(Husked),2015,1358,1489,131,9.646539027982326
Bhandara,Coriander (Dry),2016,5820,5951,131,2.2508591065292096
Kalyan,Squash Gourd,2015,715,846,131,18.321678321678323
Khed (Shel Pimpalgaon),Green Chilli,2016,4193,4324,131,3.124254710231338
Akot,Wheat(Husked),2016,1560,1691,131,8.397435897435898
Lasalgaon,Sorgum(Jawar),2015,1487,1618,131,8.809683927370545
Savner,Soybean,2015,2942,3073,131,4.452753229095853
Akot,MAIZE,2016,1124,1255,131,11.654804270462634
Yawal,Banana,2016,449,580,131,29.175946547884188
Kurdwadi,Gram,2016,3909,4040,131,3.351240726528524
Barshi,Ladies Finger,2016,164,295,131,79.8780487804878
Malkapur,Sorgum(Jawar),2015,1266,1397,131,10.347551342812006
Kopargaon,Maize,2015,1308,1439,131,10.015290519877675
Brahmpuri,Paddy-Unhusked,2016,2155,2286,131,6.078886310904872
Rahuri-Vambori,Bajri,2015,1212,1343,131,10.808580858085808
Bhokar,Soybean,2014,3455,3586,131,3.7916063675832126
Tumsar,Paddy-Unhusked,2014,2071,2202,131,6.325446644133269
Akola,Sorgum(Jawar),2015,1189,1320,131,11.017661900756938
Tiroda,Paddy-Unhusked,2015,1506,1637,131,8.698539176626825
Wardha,Cotton,2015,4078,4209,131,3.2123589995095636
Malegaon,Gram,2014,3152,3283,131,4.156091370558376
Bhiwapur,Gram,2016,4970,5101,131,2.6358148893360163
Pathari,Sorgum(Jawar),2016,1594,1725,131,8.21831869510665
Jintur,Cotton,2015,3799,3930,131,3.4482758620689653
Yeola,BAJRI,2016,1325,1456,131,9.88679245283019
Akola,Wheat(Husked),2014,1436,1567,131,9.122562674094707
Chopda,Wheat(Husked),2015,1395,1526,131,9.390681003584229
Rahata,Papai,2016,344,475,131,38.08139534883721
Kinwat,Pigeon Pea (Tur),2016,8077,8208,131,1.621889315339854
Aheri,Pigeon Pea (Tur),2015,4855,4986,131,2.698249227600412
Akola,Sorgum(Jawar),2016,1336,1467,131,9.805389221556887
Jawala-Bajar,Pigeon Pea (Tur),2016,7492,7623,131,1.7485317672183662
Buldhana-Dhad,Soybean,2016,3514,3645,131,3.727945361411497
Nandura,Sorgum(Jawar),2016,1422,1553,131,9.212376933895921
Shirpur,Maize,2016,1488,1618,130,8.736559139784946
Parbhani,Sorgum(Jawar),2015,1474,1604,130,8.819538670284938
Washi(Osmanabad),Maize,2016,1320,1450,130,9.848484848484848
Barshi,Water Melon,2015,70,200,130,185.71428571428572
Raver,Sorgum(Jawar),2015,1209,1339,130,10.75268817204301
Amarawati,Brinjal,2015,590,720,130,22.033898305084747
Shegaon,Sorgum(Jawar),2015,1203,1333,130,10.806317539484622
Khalapur(Shil-Phata),Paddy-Unhusked,2016,1310,1440,130,9.923664122137405
Katol,Cotton,2014,3890,4020,130,3.341902313624679
Nandurbar,GRAM,2016,6175,6305,130,2.1052631578947367
Pusad,Sesamum,2016,6318,6448,130,2.05761316872428
Sillod,Maize,2015,1306,1436,130,9.95405819295559
Manchar,Squash Gourd,2015,550,680,130,23.636363636363637
Bhiwapur,Gram,2015,4060,4190,130,3.2019704433497536
Lasalgaon-Vinchur,Sorgum(Jawar),2016,1450,1580,130,8.96551724137931
Rahata,Shevga,2016,3070,3200,130,4.234527687296417
Chalisgaon,Bajri,2014,1208,1338,130,10.76158940397351
Barshi,Bor,2016,95,225,130,136.8421052631579
Jalgaon,Sorgum(Jawar),2014,1281,1411,130,10.14832162373146
Chopda,Wheat(Husked),2015,1472,1602,130,8.831521739130435
Samudrapur,Gram,2016,4040,4170,130,3.217821782178218
Shahapur,Paddy-Unhusked,2015,1464,1594,130,8.879781420765028
Shevgaon-Bodhegaon,Wheat(Husked),2015,1536,1666,130,8.463541666666666
Malegaon,Sorgum(Jawar),2015,1531,1661,130,8.491182233834095
Ausa,Safflower,2015,2560,2690,130,5.078125
Savali,Paddy-Unhusked,2016,1996,2126,130,6.513026052104208
Indapur,Maize,2015,1250,1380,130,10.4
Vaijapur,Bajri,2015,1375,1505,130,9.454545454545455
Nandurbar,Matki,2016,6313,6443,130,2.0592428322509106
Sinner,Soybean,2016,3597,3727,130,3.614122880177926
Jintur,Cotton,2014,3920,4050,130,3.316326530612245
Chimur,Paddy-Unhusked,2016,2266,2396,130,5.736981465136805
Udgir,Sorgum(Jawar),2014,950,1080,130,13.68421052631579
Ausa,Safflower,2016,2631,2761,130,4.941087039148613
Buldhana,Sorgum(Jawar),2015,1150,1280,130,11.304347826086957
Sengaon,Pigeon Pea (Tur),2015,8730,8860,130,1.4891179839633448
Barshi,Chikoo,2015,100,230,130,130.0
Telhara,Green Gram,2014,6603,6733,130,1.968802059669847
Ner Parasopant,Black Gram,2014,4200,4330,130,3.0952380952380953
Karjat (Raigad),Paddy-Unhusked,2016,1310,1440,130,9.923664122137405
Samudrapur,Cotton,2015,4109,4239,130,3.1637868094426866
Tiroda,Paddy-Unhusked,2014,1523,1653,130,8.535784635587657
Kalamb (Os),Soybean,2015,3380,3510,130,3.8461538461538463
Yeola,Wheat(Husked),2016,1711,1841,130,7.597895967270602
Ramtek,Cabbage,2015,450,580,130,28.88888888888889
Akola,Wheat(Husked),2015,1347,1477,130,9.651076466221232
Karjat (Raigad),Paddy-Unhusked,2016,1310,1440,130,9.923664122137405
Achalpur,Bajri,2015,1500,1630,130,8.666666666666666
Jalgaon,Banana,2016,208,338,130,62.5
Karjat (Raigad),Paddy-Unhusked,2016,1310,1440,130,9.923664122137405
Barshi-Vairag,Maize,2015,1466,1596,130,8.867667121418826
Karjat (Raigad),Paddy-Unhusked,2016,1310,1440,130,9.923664122137405
Karjat (Raigad),Paddy-Unhusked,2016,1310,1440,130,9.923664122137405
Washim,Black Gram,2015,5020,5150,130,2.589641434262948
Gangapur,Bajri,2016,1524,1654,130,8.530183727034121
Rajura,Gram,2015,3493,3623,130,3.721729172630976
Deulgaon Raja,Cotton,2015,4006,4136,130,3.2451323015476783
Tumsar,Wheat(Husked),2015,1437,1567,130,9.046624913013222
Amalner,Sorgum(Jawar),2016,1580,1710,130,8.227848101265822
Rahuri-Vambori,Bajri,2015,1369,1499,130,9.495982468955441
Indapur-Bhigwan,Soybean,2016,2833,2963,130,4.588775150017649
Mahagaon,Soybean,2016,2778,2908,130,4.679625629949604
Panvel,Cabbage,2014,590,720,130,22.033898305084747
Partur,Gram,2016,4441,4571,130,2.9272686331907227
Latur,Maize,2016,1508,1638,130,8.620689655172415
Dharangaon,Green Gram,2016,4910,5040,130,2.6476578411405294
Karjat (Raigad),Paddy-Unhusked,2014,1310,1440,130,9.923664122137405
Manora,Wheat(Husked),2015,1462,1592,130,8.891928864569083
Samudrapur,Pigeon Pea (Tur),2015,8121,8251,130,1.600788080285679
Shahada,Maize,2016,1222,1352,130,10.638297872340425
Karjat (Raigad),Paddy-Unhusked,2014,1310,1440,130,9.923664122137405
Nagpur,Coriander  ,2015,470,600,130,27.659574468085108
Karjat (Raigad),Paddy-Unhusked,2014,1310,1440,130,9.923664122137405
Amalner,Bajri,2015,1219,1349,130,10.66447908121411
Savali,Paddy-Unhusked,2015,2062,2191,129,6.256062075654704
Jalgaon,Maize,2016,1210,1339,129,10.661157024793388
Shevgaon-Bodhegaon,Sorgum(Jawar),2015,1311,1440,129,9.839816933638444
Jalgaon,Spinach,2016,1771,1900,129,7.284020327498588
Savali,Paddy-Unhusked,2016,2215,2344,129,5.823927765237021
Gondiya,Paddy-Unhusked,2015,1244,1373,129,10.369774919614148
Khed (Shel Pimpalgaon),Bottle Gourd,2014,417,546,129,30.93525179856115
Amarawati-Fruit And Vegetables,Papai,2016,514,643,129,25.09727626459144
Pavani,Paddy-Unhusked,2014,2157,2286,129,5.980528511821975
Gondiya,Paddy-Unhusked,2015,1420,1549,129,9.084507042253522
Malkapur,Bajri,2015,1121,1250,129,11.50758251561106
Shegaon,Wheat(Husked),2014,1351,1480,129,9.548482605477425
Yeola,WHEAT(HUSKED),2016,1844,1973,129,6.995661605206074
Gangapur,Sorgum(Jawar),2016,1685,1814,129,7.655786350148368
Ramtek,Cabbage,2015,447,576,129,28.859060402684563
Malkapur,Maize,2015,1072,1201,129,12.033582089552239
Karjat (Raigad),Paddy-Unhusked,2016,1310,1439,129,9.84732824427481
Sindi (Selu),Cotton,2015,4081,4210,129,3.1609899534427837
Deulgaon Raja,Cotton,2015,3765,3894,129,3.4262948207171315
Rahata,Wheat(Husked),2015,1453,1582,129,8.878183069511357
Indapur,BANANA,2016,501,630,129,25.748502994011975
Barshi Takli,Cotton,2015,4107,4236,129,3.1409788166544925
Chakur,Gram,2016,4008,4137,129,3.218562874251497
Gadchiroli,Paddy-Unhusked,2016,1898,2027,129,6.796628029504742
Jalna,Jaggery,2014,2578,2707,129,5.003878975950349
Khamgaon,Wheat(Husked),2015,1400,1529,129,9.214285714285714
Dudhani,Pigeon Pea (Tur),2015,9458,9587,129,1.3639247198139142
Jalna,Wheat(Husked),2015,1592,1721,129,8.103015075376884
Pachora,Bajri,2016,1394,1523,129,9.253945480631277
Dudhani,Maize,2014,942,1071,129,13.694267515923567
Amalner,Wheat(Husked),2016,1826,1955,129,7.064622124863089
Dondaicha-Sindkheda,Maize,2016,1034,1163,129,12.475822050290136
Pachora,Wheat(Husked),2016,1596,1725,129,8.082706766917294
Sangamner,Soybean,2014,3129,3258,129,4.1227229146692235
Devala,Horse Gram,2015,3638,3767,129,3.5459043430456294
Chopda,Ground Nut Pods (Dry),2015,3456,3585,129,3.732638888888889
Mantha,Sorgum(Jawar),2016,1557,1686,129,8.285163776493256
Aheri,SOYBEAN,2016,2318,2447,129,5.565142364106989
Devani,Soybean,2016,3869,3998,129,3.3341948823985526
Kannad,Maize,2016,1206,1335,129,10.696517412935323
Rahuri-Songaon,Bajri,2016,1296,1425,129,9.953703703703704
Murtizapur,Wheat(Husked),2015,1328,1457,129,9.713855421686747
Mumbai-Onion And Potato Mkt,Potato,2016,1150,1279,129,11.217391304347826
Lonar,Soybean,2016,3519,3648,129,3.6658141517476555
Armori-Desaiganj,Paddy-Unhusked,2015,1472,1601,129,8.763586956521738
Morshi,Soybean,2015,3100,3229,129,4.161290322580645
Pune-Manjri,Ghosali(Bhaji),2016,2757,2886,129,4.6789989118607185
Mehkar,Maize,2015,1245,1374,129,10.36144578313253
Pune-Manjri,RAJGIRA,2016,521,650,129,24.760076775431862
Sangali,Maize,2015,1453,1582,129,8.878183069511357
Ashti (Jalna),Sorgum(Jawar),2015,1351,1479,128,9.474463360473724
Shrirampur-Belapur,Wheat(Husked),2015,1368,1496,128,9.35672514619883
Armori-Desaiganj,Paddy-Unhusked,2016,1511,1639,128,8.471211118464593
Rahuri-Vambori,Ground Nut Pods (Dry),2016,4158,4286,128,3.0784030784030785
Bhusaval,Wheat(Husked),2014,1253,1381,128,10.215482841181165
Islampur,Ladies Finger,2016,217,345,128,58.986175115207374
Vaijapur,GREEN GRAM,2016,4680,4808,128,2.735042735042735
Pachora,WHEAT(HUSKED),2016,1617,1745,128,7.915893630179345
Chalisgaon,Castor Seed,2016,2550,2678,128,5.019607843137255
Akhadabalapur,Soybean,2014,3627,3755,128,3.529087400055142
Shirur,Sorgum(Jawar),2015,1439,1567,128,8.895066018068103
Udgir,Sorgum(Jawar),2015,1020,1148,128,12.549019607843137
Rahuri-Vambori,Wheat(Husked),2015,1585,1713,128,8.07570977917981
Purna,Soybean,2015,3508,3636,128,3.6488027366020526
Savali,PADDY-UNHUSKED,2016,1914,2042,128,6.687565308254963
Parbhani,Sorgum(Jawar),2016,1652,1780,128,7.74818401937046
Nagpur,MAIZE,2016,1160,1288,128,11.03448275862069
Jintur,Gram,2015,2968,3096,128,4.3126684636118595
Ambad(Vadi Godri),Pigeon Pea (Tur),2015,8572,8700,128,1.4932337844143724
Jintur,Cotton,2015,4178,4306,128,3.063666826232647
Hingoli,Green Gram,2016,5606,5734,128,2.2832679272208347
Nandurbar,Cluster Bean,2015,3643,3771,128,3.5135877024430413
Aurangabad,Papai,2016,486,614,128,26.337448559670783
Aurangabad,Cabbage,2016,346,474,128,36.994219653179194
Shirur,Green Gram,2014,4850,4978,128,2.6391752577319587
Kalmeshwar,Spinach,2014,372,500,128,34.40860215053763
Indapur,Banana,2015,526,654,128,24.334600760456272
Amarawati,Spinach,2016,400,528,128,32.0
Pune-Pimpri,Potato,2016,986,1114,128,12.981744421906694
Aurangabad,Potato,2015,665,793,128,19.24812030075188
Parbhani,Sorgum(Jawar),2016,1594,1722,128,8.030112923462987
Ramtek,Onion,2016,850,978,128,15.058823529411764
Raver,Wheat(Husked),2015,1301,1429,128,9.83858570330515
Pusad,Bajri,2016,1589,1717,128,8.055380742605411
Shevgaon-Bodhegaon,Bajri,2015,1355,1483,128,9.44649446494465
Bhokar,Soybean,2016,3442,3570,128,3.718768158047647
Pulgaon,Gram,2016,3988,4116,128,3.20962888665998
Lonar,Wheat(Husked),2015,1588,1716,128,8.060453400503778
Malkapur,Maize,2014,1009,1137,128,12.685827552031714
Parli-Vaijnath,Soybean,2016,3266,3394,128,3.919167176974893
Kalvan,Wheat(Husked),2015,1505,1633,128,8.50498338870432
Samudrapur,Cotton,2014,3887,4015,128,3.2930280421919216
Mandhal,Pigeon Pea (Tur),2015,6177,6305,128,2.0722033349522424
Karad,Cabbage,2015,486,614,128,26.337448559670783
Patan,Cabbage,2016,519,647,128,24.66281310211946
Kalvan,Bajri,2016,1405,1533,128,9.11032028469751
Umared,Linseed,2014,4469,4597,128,2.8641754307451333
Mehkar,Maize,2015,1171,1299,128,10.930828351836038
Tumsar,Other Cereals,2015,2203,2331,128,5.81025873808443
Bhandara,Wheat(Husked),2015,1406,1534,128,9.103840682788052
Umared,Lang,2015,1883,2011,128,6.797663303239512
Khamgaon,Bajri,2014,1266,1394,128,10.110584518167457
Jamner,Maize,2016,1350,1478,128,9.481481481481481
Mangalwedha,Bajri,2014,1343,1471,128,9.530900967982129
Majalgaon,Soybean,2015,3125,3253,128,4.096
Ahmedpur,Sorgum(Jawar),2016,1498,1626,128,8.544726301735647
Jawala-Bajar,Wheat(Husked),2016,1660,1788,128,7.710843373493976
Pavani,Gram,2016,4961,5089,128,2.580124974803467
Bhiwapur,Cotton,2016,4350,4478,128,2.942528735632184
Jalna,Soybean,2016,3020,3148,128,4.23841059602649
Phaltan,Maize,2016,1350,1478,128,9.481481481481481
Ausa,Safflower,2015,2432,2560,128,5.2631578947368425
Shevgaon,Wheat(Husked),2015,1537,1665,128,8.327911515940142
Partur,Soybean,2015,3201,3329,128,3.998750390502968
Partur,Sorgum(Jawar),2016,1688,1815,127,7.523696682464455
Savner,Gram,2015,2588,2715,127,4.90726429675425
Murtizapur,Wheat(Husked),2015,1334,1461,127,9.52023988005997
Telhara,WHEAT(HUSKED),2016,1691,1818,127,7.510348905972797
Hinganghat,Wheat(Husked),2016,1599,1726,127,7.9424640400250155
Purna,Soybean,2014,3090,3217,127,4.110032362459547
Raver,Sorgum(Jawar),2016,1233,1360,127,10.30008110300081
Nampur,Maize,2016,1349,1476,127,9.414381022979985
Umarga,Soybean,2015,3186,3313,127,3.9861895794099182
Mantha,COTTON,2016,4868,4995,127,2.608874281018899
Gangapur,Gram,2015,3178,3305,127,3.996224040276904
Mantha,Cotton,2016,4426,4553,127,2.869408043380027
Shrirampur,Bajri,2015,1355,1482,127,9.37269372693727
Sakri,Maize,2014,911,1038,127,13.94072447859495
Ahmedpur,Sorgum(Jawar),2015,1568,1695,127,8.099489795918368
Barshi,Squash Gourd,2016,193,320,127,65.80310880829016
Pune-Manjri,ONION,2016,604,731,127,21.026490066225165
Vasai,Paddy-Unhusked,2016,1468,1595,127,8.651226158038147
Partur,Soybean,2014,3126,3253,127,4.062699936020474
Dhamangaon-Rly,Wheat(Husked),2016,1634,1761,127,7.7723378212974294
Shirpur,Maize,2015,1088,1215,127,11.672794117647058
Rahuri-Vambori,Sorgum(Jawar),2015,1377,1504,127,9.222948438634713
Indapur-Bhigwan,Maize,2016,1729,1856,127,7.3452862926547136
Shirur,Sorgum(Jawar),2016,1454,1581,127,8.73452544704264
Nagpur,Melon,2015,588,715,127,21.598639455782312
Karjat (Raigad),Paddy-Unhusked,2015,1313,1440,127,9.672505712109672
Gadchiroli,Paddy-Unhusked,2016,1901,2028,127,6.680694371383482
Washim,Black Gram,2016,8183,8310,127,1.5519980447268729
Varud-Rajura Bazar,Castor Seed,2016,3144,3271,127,4.039440203562341
Bhandara,Rice(Paddy-Hus),2015,2475,2602,127,5.1313131313131315
Armori,Paddy-Unhusked,2016,1823,1950,127,6.966538672517828
Karanja,Sorgum(Jawar),2015,1231,1358,127,10.316815597075548
Yawal,Banana,2016,319,446,127,39.81191222570533
Pune,Bajri,2016,2155,2282,127,5.893271461716937
Ahmednagar,Wheat(Husked),2015,1537,1664,127,8.26284970722186
Umarga,Sunflower,2014,3048,3175,127,4.166666666666667
Tumsar,Paddy-Unhusked,2016,1801,1928,127,7.051637978900611
Udgir,Sorgum(Jawar),2015,955,1082,127,13.298429319371728
Ramtek,Onion,2016,873,1000,127,14.547537227949599
Amalner,Bajri,2015,1366,1492,126,9.224011713030746
Yeola,Pigeon Pea (Tur),2015,4885,5011,126,2.579324462640737
Bhiwapur,Wheat(Husked),2015,1255,1381,126,10.0398406374502
Pulgaon,Soybean,2015,3009,3135,126,4.187437686939182
Nandgaon,Maize,2015,1307,1433,126,9.640397857689365
Partur,Soybean,2016,3861,3987,126,3.2634032634032635
Shirpur,Maize,2016,1533,1659,126,8.219178082191782
Sailu,Gram,2016,5725,5851,126,2.2008733624454146
Chamorshi,Paddy-Unhusked,2015,1890,2016,126,6.666666666666667
Umarga,Sorgum(Jawar),2015,1440,1566,126,8.75
Vai,Cabbage,2015,533,659,126,23.639774859287055
Kopargaon,Bajri,2015,1621,1747,126,7.772979642196175
Jalgaon,Banana,2015,218,344,126,57.79816513761468
Baramati,Soybean,2015,3075,3201,126,4.097560975609756
Lonar,Sorgum(Jawar),2016,1228,1354,126,10.260586319218241
Amalner,Wheat(Husked),2014,1450,1576,126,8.689655172413794
Ahmednagar,Wheat(Husked),2015,1654,1780,126,7.617896009673519
Umarga,Sorgum(Jawar),2015,1893,2019,126,6.6561014263074485
Taloda,Cotton,2014,3790,3916,126,3.3245382585751977
Nandura,Bajri,2015,988,1114,126,12.753036437246964
Varud-Rajura Bazar,Soybean,2015,3166,3292,126,3.979785217940619
Chamorshi,Paddy-Unhusked,2015,1877,2003,126,6.712839637719766
Ghatanji,Cotton,2015,4242,4368,126,2.9702970297029703
Umarga,Soybean,2015,3126,3252,126,4.030710172744722
Kada,Maize,2014,1225,1351,126,10.285714285714286
Shirur,Sorgum(Jawar),2014,1589,1715,126,7.929515418502203
Pathari,Sorgum(Jawar),2016,1649,1775,126,7.640994542146756
Bhusaval,SORGUM(JAWAR),2016,1105,1231,126,11.402714932126697
Chalisgaon,Bajri,2015,1314,1440,126,9.58904109589041
Shevgaon-Bodhegaon,Sorgum(Jawar),2015,1435,1561,126,8.78048780487805
Pavani,Paddy-Unhusked,2014,2290,2416,126,5.502183406113537
Dhule,Maize,2015,1312,1438,126,9.603658536585366
Aamgaon,Paddy-Unhusked,2016,1626,1752,126,7.749077490774908
Chopda,Sesamum,2015,7722,7848,126,1.6317016317016317
Kalamb (Os),Soybean,2015,3191,3317,126,3.9486054528361016
Karjat (Raigad),Paddy-Unhusked,2015,1316,1442,126,9.574468085106384
Shevgaon-Bodhegaon,Gram,2016,4171,4297,126,3.020858307360345
Yeotmal,Cotton,2014,3911,4037,126,3.221682434160061
Amalner,Coriander (Dry),2016,8350,8476,126,1.5089820359281436
Khamgaon,Cotton,2015,3924,4050,126,3.2110091743119265
Beed,Soybean,2016,3900,4026,126,3.230769230769231
Sillod,Soybean,2015,3400,3526,126,3.7058823529411766
Latur,Maize,2016,1387,1513,126,9.084354722422495
Morshi,SORGUM(JAWAR),2016,1194,1320,126,10.552763819095478
Dondaicha-Sindkheda,Bajri,2015,1240,1366,126,10.161290322580646
Pachora,Maize,2016,1469,1595,126,8.577263444520081
Sailu,Soybean,2016,3557,3683,126,3.542310936182176
Islampur,Bitter Gourd,2016,135,261,126,93.33333333333333
Parli-Vaijnath,Sorgum(Jawar),2015,1514,1640,126,8.3223249669749
Rahata,Gram,2015,2331,2457,126,5.405405405405405
Udgir,Gram,2016,7542,7668,126,1.6706443914081146
Achalpur,Soybean,2015,3167,3293,126,3.9785285759393747
Pusad,Sorgum(Jawar),2015,1321,1447,126,9.538228614685844
Raver,MAIZE,2016,1059,1185,126,11.898016997167138
Wardha,Wheat(Husked),2016,1452,1578,126,8.677685950413224
Dudhani,Wheat(Husked),2014,1352,1478,126,9.319526627218934
Barshi-Vairag,Soybean,2014,3067,3193,126,4.108249103358331
Dudhani,Wheat(Husked),2014,1300,1426,126,9.692307692307692
Rahata,Sorgum(Jawar),2014,1360,1486,126,9.264705882352942
Mantha,Wheat(Husked),2016,2000,2126,126,6.3
Solapur,Jaggery,2016,3552,3678,126,3.5472972972972974
Morshi,Sorgum(Jawar),2015,1344,1469,125,9.300595238095237
Kej,Black Gram,2015,9200,9325,125,1.358695652173913
Gevrai,Green Gram,2016,6300,6425,125,1.9841269841269842
Rahata,GROUND NUT PODS (DRY),2016,3875,4000,125,3.225806451612903
Rahata,Ghevda,2016,3417,3542,125,3.6581796897863623
Devala,Wheat(Husked),2015,1457,1582,125,8.579272477693891
Newasa,Wheat(Husked),2016,1550,1675,125,8.064516129032258
Ambejogai,Sesamum,2015,7400,7525,125,1.6891891891891893
Barshi,Ladies Finger,2014,150,275,125,83.33333333333333
Yeola,Bajri,2015,1269,1394,125,9.850275807722616
Jamner,Cotton,2016,4583,4708,125,2.7274710888064586
Indapur (Nimgaon Ketki),Maize,2016,1600,1725,125,7.8125
Kurdwadi,Black Gram,2015,7116,7241,125,1.7566048341765037
Achalpur,Wheat(Husked),2014,1518,1643,125,8.234519104084322
Ambejogai,Safflower,2015,2363,2488,125,5.289885738468049
Patan,Cabbage,2015,588,713,125,21.258503401360546
Raver,Gram,2015,2505,2630,125,4.990019960079841
Kurdwadi-Modnimb,MAIZE,2016,1225,1350,125,10.204081632653061
Indapur,Ground Nut Pods (Dry),2016,4576,4701,125,2.7316433566433567
Pune-Pimpri,Brinjal,2014,2500,2625,125,5.0
Akot,Sesamum,2016,5000,5125,125,2.5
Buldhana,Sorgum(Jawar),2015,1175,1300,125,10.638297872340425
Sindi (Selu),Wheat(Husked),2016,1611,1736,125,7.759155803848541
Devala,Tamarind,2016,2188,2313,125,5.712979890310786
Navapur,Green Gram,2016,5500,5625,125,2.272727272727273
Jalgaon Jamod-Aasalgaon,Sorgum(Jawar),2015,1113,1238,125,11.230907457322552
Akole,Gram,2015,3175,3300,125,3.937007874015748
Amarawati-Fruit And Vegetables,Carrot,2016,642,767,125,19.470404984423677
Taloda,Bajri,2016,1679,1804,125,7.444907683144729
Sillod,Sorgum(Jawar),2015,1075,1200,125,11.627906976744185
Sangrampur-Varvatbakal,Maize,2016,1050,1175,125,11.904761904761905
Mantha,Bajri,2015,1450,1575,125,8.620689655172415
Kurdwadi,Maize,2015,1211,1336,125,10.32204789430223
Barshi,Mosambi,2015,225,350,125,55.55555555555556
Chamorshi,PADDY-UNHUSKED,2016,1932,2057,125,6.469979296066253
Karanja,Sorgum(Jawar),2016,1815,1940,125,6.887052341597796
Manora,Wheat(Husked),2015,1525,1650,125,8.19672131147541
Amarawati,Spinach,2016,638,763,125,19.592476489028215
Umarkhed-Danki,Wheat(Husked),2015,1400,1525,125,8.928571428571429
Aheri,Green Gram,2016,5525,5650,125,2.262443438914027
Yeotmal,Cotton,2015,3840,3965,125,3.2552083333333335
Jalna-Badnapur,Wheat(Husked),2014,1550,1675,125,8.064516129032258
Jalgaon Jamod-Aasalgaon,Sorgum(Jawar),2016,1100,1225,125,11.363636363636363
Koregaon,Gram,2016,8275,8400,125,1.5105740181268883
Vaduj,Sorgum(Jawar),2016,2013,2138,125,6.209637357178341
Shrigonda,Gram,2016,4250,4375,125,2.9411764705882355
Tasgaon,Maize,2016,1468,1593,125,8.514986376021799
Vaduj,Ghevda Seed,2016,3000,3125,125,4.166666666666667
Shrigonda,SOYBEAN,2016,2583,2708,125,4.83933410762679
Sillod,Sorgum(Jawar),2016,1350,1475,125,9.25925925925926
Karad,Cabbage,2015,438,563,125,28.538812785388128
Gevrai,Soybean,2015,3132,3257,125,3.9910600255427844
Paranda,Soybean,2015,3675,3800,125,3.401360544217687
Kalamnuri,Soybean,2016,3556,3681,125,3.515185601799775
Barshi,Spinach,2016,475,600,125,26.31578947368421
Buldhana,Sorgum(Jawar),2015,1075,1200,125,11.627906976744185
Buldhana,Sorgum(Jawar),2015,1150,1275,125,10.869565217391305
Mauda,WHEAT(HUSKED),2016,1500,1625,125,8.333333333333334
Patur,Sorgum(Jawar),2015,1350,1475,125,9.25925925925926
Shirur,Sorgum(Jawar),2015,1443,1568,125,8.662508662508662
Panvel,Tomato,2015,1325,1450,125,9.433962264150944
Pathari,Bajri,2016,1480,1605,125,8.445945945945946
Indapur,Maize,2015,1492,1617,125,8.378016085790884
Sailu,Soybean,2015,3150,3275,125,3.9682539682539684
Karad,Snake Gourd,2015,450,575,125,27.77777777777778
Karad,Tomato,2015,583,708,125,21.44082332761578
Panvel,Flower,2015,675,800,125,18.51851851851852
Vai,CABBAGE,2016,491,616,125,25.45824847250509
Ghansawangi,Cotton,2015,4138,4263,125,3.0207829869502176
Khamgaon,Wheat(Husked),2015,1420,1545,125,8.80281690140845
Nira-Saswad,Maize,2016,1467,1592,125,8.520790729379687
Tuljapur,Sorgum(Jawar),2016,1900,2025,125,6.578947368421052
Rahata,Lemon,2015,1875,2000,125,6.666666666666667
Bhokardan-Pimpalgaon Renu,Gram,2016,3950,4075,125,3.1645569620253164
Murtizapur,Wheat(Husked),2015,1434,1559,125,8.716875871687588
Kej,Wheat(Husked),2016,2363,2488,125,5.289885738468049
Bhokardan-Pimpalgaon Renu,Soybean,2016,3700,3825,125,3.3783783783783785
Sangamner,Maize,2016,1377,1502,125,9.07770515613653
Vaduj,Soybean,2015,3500,3625,125,3.5714285714285716
Balapur,SOYBEAN,2016,2613,2738,125,4.783773440489858
Rahata,Bitter Gourd,2015,2375,2500,125,5.2631578947368425
Shevgaon,Wheat(Husked),2015,1462,1587,125,8.549931600547195
Kalyan,Sorgum(Jawar),2015,1813,1938,125,6.894649751792609
Nandgaon,Bajri,2015,1344,1469,125,9.300595238095237
Kalyan,Sorgum(Jawar),2015,2375,2500,125,5.2631578947368425
Vaduj,Green Gram,2015,7733,7858,125,1.6164489848700374
Dhule,Pigeon Pea (Tur),2014,3986,4111,125,3.1359759157049676
Baramati,Maize,2014,1114,1239,125,11.220825852782765
Partur,Bajri,2015,1148,1273,125,10.888501742160278
Nanded,Ground Nut Pods (Dry),2016,4850,4975,125,2.577319587628866
Khed (Shel Pimpalgaon),BRINJAL,2016,813,938,125,15.375153751537516
Jawala-Bajar,Cotton,2015,3800,3925,125,3.289473684210526
Manchar,Shepu,2015,310,435,125,40.32258064516129
Savner,Soybean,2015,3089,3214,125,4.046617028164454
Ausa,Sunflower,2016,2875,3000,125,4.3478260869565215
Yawal,Sorgum(Jawar),2016,1343,1468,125,9.307520476545049
Aurangabad,Math (Bhaji),2015,300,425,125,41.666666666666664
Varud-Rajura Bazar,Mustard,2015,2875,3000,125,4.3478260869565215
Shevgaon-Bodhegaon,Wheat(Husked),2016,1783,1908,125,7.0106561974200785
Dondaicha-Sindkheda,Wheat(Husked),2016,1585,1710,125,7.886435331230284
Lonar,Sorgum(Jawar),2014,1125,1250,125,11.11111111111111
Kalvan,Bajri,2015,1246,1371,125,10.032102728731942
Varud-Rajura Bazar,Maize,2015,1267,1392,125,9.865824782951854
Ausa,Mustard,2015,3401,3526,125,3.6753895912966774
Washi(Osmanabad),Sorgum(Jawar),2016,2000,2125,125,6.25
Sillod-Bharadi,Wheat(Husked),2016,1642,1767,125,7.612667478684531
Sakri,Maize,2016,1306,1431,125,9.571209800918837
Tumsar,Other Cereals,2016,3845,3970,125,3.250975292587776
Nagpur,Melon,2015,492,617,125,25.40650406504065
Gondpimpri,Soybean,2016,3538,3663,125,3.5330695308083664
Mandhal,Paddy-Unhusked,2015,1917,2042,125,6.520605112154408
Ahmedpur,Maize,2016,1400,1525,125,8.928571428571429
Gondpimpri,Paddy-Unhusked,2015,2025,2150,125,6.172839506172839
Gondpimpri,Paddy-Unhusked,2015,2044,2169,125,6.1154598825831705
Parola,Sorgum(Jawar),2015,1206,1331,125,10.364842454394694
Rahata,Ghevda,2014,3125,3250,125,4.0
Ahmedpur,Black Gram,2016,5550,5675,125,2.2522522522522523
Shrirampur-Belapur,Maize,2015,1066,1191,125,11.726078799249532
Varud-Rajura Bazar,Mustard,2015,2975,3100,125,4.201680672268908
Shirpur,Cowpea,2016,5993,6118,125,2.0857667278491574
Kopargaon,Maize,2016,1330,1455,125,9.398496240601503
Khamgaon,Maize,2016,1521,1646,125,8.21827744904668
Ghansawangi,Soybean,2016,3200,3325,125,3.90625
Umared,Other Pulses,2015,6803,6928,125,1.8374246655887108
Nandurbar,Soybean,2014,3250,3375,125,3.8461538461538463
Kalyan,Wheat(Husked),2016,1975,2100,125,6.329113924050633
Manchar,Farshi,2015,1500,1625,125,8.333333333333334
Phaltan,POTATO,2016,1092,1217,125,11.446886446886447
Digras,Soybean,2016,3575,3700,125,3.4965034965034967
Jalgaon Jamod,Wheat(Husked),2015,1350,1475,125,9.25925925925926
Mudkhed,Sorgum(Jawar),2016,1268,1393,125,9.858044164037855
Kalmeshwar,Coriander  ,2015,1529,1654,125,8.175277959450622
Telhara,Gram,2015,4072,4197,125,3.069744597249509
Telhara,Green Gram,2015,7469,7594,125,1.6735841478109519
Jalgaon Jamod,Wheat(Husked),2015,1275,1400,125,9.803921568627452
Hinganghat,Wheat(Husked),2016,1623,1748,125,7.701786814540974
Rahata,Ghevda,2015,3938,4063,125,3.1742001015744035
Pune-Pimpri,Capsicum,2016,5000,5125,125,2.5
Rahata,Ghevda,2015,3738,3863,125,3.3440342429106473
Purna,Turmeric,2015,6800,6925,125,1.838235294117647
Dhamangaon-Rly,Wheat(Husked),2016,1489,1614,125,8.394895903290799
Morshi,Sorgum(Jawar),2016,1283,1408,125,9.742790335151987
Pune-Pimpri,Cabbage,2016,615,740,125,20.32520325203252
Chopda,Maize,2015,1036,1161,125,12.065637065637066
Amarawati,Spinach,2015,625,750,125,20.0
Nandgaon,Bajri,2016,1578,1703,125,7.921419518377693
Sillod-Bharadi,Bajri,2016,1482,1607,125,8.434547908232119
Washim,Green Gram,2015,6425,6550,125,1.9455252918287937
Morshi,Sorgum(Jawar),2016,1350,1475,125,9.25925925925926
Jalgaon,Sesamum,2014,10200,10325,125,1.2254901960784315
Akhadabalapur,Soybean,2016,3575,3700,125,3.4965034965034967
Barshi,Brinjal,2014,150,275,125,83.33333333333333
Pune-Manjri,KARDAI,2016,697,821,124,17.790530846484934
Kalvan,Maize,2016,1381,1505,124,8.97900072411296
Lasalgaon-Vinchur,Bajri,2016,1786,1910,124,6.942889137737962
Karanja,Sorgum(Jawar),2014,1471,1595,124,8.429639700883753
Barshi,Ridge Gourd,2015,200,324,124,62.0
Jamner-Neri,Cotton,2016,4576,4700,124,2.7097902097902096
Gondiya,Paddy-Unhusked,2016,1726,1850,124,7.184241019698725
Tumsar,Black Gram,2016,8480,8604,124,1.4622641509433962
Himayatnagar,Cotton,2016,4179,4303,124,2.9672170375687963
Sindi (Selu),COTTON,2016,4784,4908,124,2.591973244147157
Umared,Coriander (Dry),2014,10254,10378,124,1.209284181782719
Khamgaon,Wheat(Husked),2016,1712,1836,124,7.242990654205608
Dondaicha-Sindkheda,SORGUM(JAWAR),2016,1462,1586,124,8.481532147742818
Barshi,Bajri,2014,1416,1540,124,8.757062146892656
Kalamb (Os),Sunflower,2015,2933,3057,124,4.227753153767473
Bhandara,Pigeon Pea (Tur),2016,7731,7855,124,1.6039322209287286
Ausa,Maize,2016,1406,1530,124,8.819345661450924
Kalvan,Soybean,2015,3238,3362,124,3.8295243977764053
Jalgaon,Banana,2016,235,359,124,52.765957446808514
Jalgaon,Banana,2015,251,375,124,49.40239043824701
Gevrai,PIGEON PEA (TUR),2016,4789,4913,124,2.589267070369597
Jalna,Maize,2014,1125,1249,124,11.022222222222222
Mohol,Wheat(Husked),2014,1405,1529,124,8.825622775800712
Dharangaon,MAIZE,2016,1047,1171,124,11.843361986628462
Shrirampur-Belapur,Wheat(Husked),2015,1450,1574,124,8.551724137931034
Mehkar,Maize,2016,1200,1324,124,10.333333333333334
Jalna,Maize,2016,1362,1486,124,9.104258443465492
Umarga,Wheat(Husked),2014,1345,1469,124,9.219330855018587
Patan,Brinjal,2015,382,506,124,32.460732984293195
Barshi,Squash Gourd,2016,105,229,124,118.0952380952381
Shahada,Sorgum(Jawar),2015,1360,1484,124,9.117647058823529
Telhara,Soybean,2015,3094,3218,124,4.0077569489334195
Ghoti,CABBAGE,2016,829,953,124,14.957780458383594
Solapur,Pigeon Pea (Tur),2016,5754,5878,124,2.1550225929787974
Sonpeth,Soybean,2016,3162,3286,124,3.9215686274509802
Mumbai,Curry Leaves,2016,716,840,124,17.318435754189945
Murtizapur,Wheat(Husked),2015,1329,1453,124,9.330323551542513
Pandharpur,Banana,2016,265,389,124,46.79245283018868
Pune-Manjri,AMBAT CHUKA,2016,815,939,124,15.214723926380367
Mandhal,Cotton,2016,4367,4491,124,2.8394779024501946
Jalgaon,Sorgum(Jawar),2015,1189,1313,124,10.428931875525652
Lonar,Soybean,2015,3208,3332,124,3.865336658354115
Umarga,Pigeon Pea (Tur),2015,6540,6664,124,1.8960244648318043
Zarijamini,Cotton,2015,3913,4037,124,3.168924099156657
Amalner,Sorgum(Jawar),2015,1255,1379,124,9.880478087649402
Chakur,Soybean,2016,3626,3749,123,3.3921676778819636
Vai,Cabbage,2016,470,593,123,26.170212765957448
Indapur,Banana,2015,449,572,123,27.394209354120267
Jalna-Badnapur,Bajri,2015,1258,1381,123,9.777424483306836
Taloda,Bajri,2014,1175,1298,123,10.46808510638298
Varud-Rajura Bazar,Mustard,2015,2957,3080,123,4.159621237740954
Indapur-Bhigwan,Rice(Paddy-Hus),2016,1595,1718,123,7.7115987460815045
Sillod,Bajri,2015,1140,1263,123,10.789473684210526
Devala,Maize,2015,1241,1364,123,9.911361804995972
Jalkot,Soybean,2016,3592,3715,123,3.4242761692650334
Mandhal,Soybean,2016,2659,2782,123,4.625799172621286
Manmad,Bajri,2015,1415,1538,123,8.692579505300353
Barshi,Chikoo,2016,166,289,123,74.09638554216868
Jalna,Jaggery,2015,2433,2556,123,5.055487053020962
Kej,Sorgum(Jawar),2015,2327,2450,123,5.28577567683713
Amalner,Bajri,2016,1739,1862,123,7.073030477285797
Tiroda,Paddy-Unhusked,2016,1726,1849,123,7.12630359212051
Yawal,Sorgum(Jawar),2015,1207,1330,123,10.190555095277547
Telhara,SORGUM(JAWAR),2016,1219,1342,123,10.090237899917966
Nampur,Bajri,2016,1636,1759,123,7.518337408312958
Chamorshi,Paddy-Unhusked,2016,2223,2346,123,5.53306342780027
Telhara,Wheat(Husked),2016,1625,1748,123,7.569230769230769
Barshi,Green Chilli,2015,200,323,123,61.5
Narkhed,Cotton,2016,4308,4431,123,2.8551532033426184
Shegaon,Sorgum(Jawar),2016,1323,1446,123,9.297052154195011
Ghoti,Tomato,2014,1466,1589,123,8.390177353342429
Digras,Wheat(Husked),2016,1716,1839,123,7.1678321678321675
Ahmedpur,Wheat(Husked),2014,1318,1441,123,9.332321699544766
Shirur,Bajri,2015,1286,1409,123,9.564541213063764
Chopda,Bajri,2014,1230,1353,123,10.0
Udgir,Tamarind Seed,2015,1406,1529,123,8.748221906116642
Amarawati-Fruit And Vegetables,Cucumber,2016,559,682,123,22.003577817531305
Washim,Sorgum(Jawar),2015,1092,1215,123,11.263736263736265
Shevgaon-Bodhegaon,Wheat(Husked),2015,1606,1729,123,7.658779576587796
Himayatnagar,Gram,2016,4045,4168,123,3.0407911001236094
Kalvan,Maize,2015,1238,1361,123,9.935379644588044
Savner,Soybean,2015,3032,3155,123,4.056728232189974
Mumbai,CURRY LEAVES,2016,404,527,123,30.445544554455445
Savner,Maize,2016,1175,1298,123,10.46808510638298
Nandura,Wheat(Husked),2014,1404,1527,123,8.760683760683762
Jalgaon Jamod,Maize,2015,944,1067,123,13.029661016949152
Shegaon,Sorgum(Jawar),2016,1401,1524,123,8.779443254817988
Lasalgaon,Maize,2015,1342,1465,123,9.165424739195231
Bhiwapur,Paddy-Unhusked,2016,2050,2173,123,6.0
Kalmeshwar,Cotton,2014,3900,4023,123,3.1538461538461537
Kalmeshwar,Wheat(Husked),2016,1457,1580,123,8.44200411805079
Baramati,Maize,2016,1382,1505,123,8.90014471780029
Telhara,Soybean,2014,3084,3206,122,3.9559014267185475
Gangakhed,Wheat(Husked),2014,1503,1625,122,8.117099135063206
Newasa,Wheat(Husked),2016,1900,2022,122,6.421052631578948
Nanded,Gram,2014,2457,2579,122,4.965404965404965
Rahata,Gram,2015,3538,3660,122,3.4482758620689653
Jalna,Jaggery,2016,3294,3416,122,3.7037037037037037
Dondaicha-Sindkheda,Sorgum(Jawar),2016,1750,1872,122,6.9714285714285715
Barshi-Vairag,Soybean,2015,3726,3848,122,3.2742887815351582
Sinner,Sorgum(Jawar),2015,1303,1425,122,9.363008442056792
Chopda,Maize,2015,1052,1174,122,11.596958174904943
Nilanga,Sorgum(Jawar),2016,1230,1352,122,9.91869918699187
Tumsar,Rice(Paddy-Hus),2015,2820,2942,122,4.326241134751773
Vaduj,BAJRI,2016,1678,1800,122,7.270560190703218
Pandharpur,LADIES FINGER,2016,1500,1622,122,8.133333333333333
Palghar(Bevur),Potato,2015,1034,1156,122,11.798839458413926
Digras,Soybean,2016,3579,3701,122,3.408773400391171
Digras,Soybean,2016,3539,3661,122,3.4473014975981915
Nanded,Gram,2016,5386,5508,122,2.265131823245451
Shrirampur,Bajri,2015,1308,1430,122,9.327217125382264
Yeola,Wheat(Husked),2014,1515,1637,122,8.052805280528053
Baramati,Maize,2015,1210,1332,122,10.082644628099173
Vaijapur,Wheat(Husked),2016,1602,1724,122,7.615480649188514
Ausa,Safflower,2016,2671,2793,122,4.567577686259828
Vai,Tomato,2016,515,637,122,23.689320388349515
Armori,Paddy-Unhusked,2015,1505,1627,122,8.106312292358805
Bhiwapur,Paddy-Unhusked,2015,1910,2032,122,6.387434554973822
Kolhapur-Laxmipuri,Bajri,2015,1818,1940,122,6.710671067106711
Umarga,SORGUM(JAWAR),2016,1390,1512,122,8.776978417266188
Rahata,Bajri,2014,1282,1404,122,9.51638065522621
Rahata,Bajri,2014,1151,1273,122,10.599478714161599
Patur,Soybean,2015,3516,3638,122,3.4698521046643913
Chamorshi,Paddy-Unhusked,2015,1763,1885,122,6.920022688598979
Pavani,Paddy-Unhusked,2015,1750,1872,122,6.9714285714285715
Mandhal,Gram,2015,3984,4106,122,3.0622489959839356
Zarijamini,Cotton,2015,4060,4182,122,3.0049261083743843
Pandharpur,Sorgum(Jawar),2015,2213,2335,122,5.5128784455490285
Kalvan,Bajri,2015,1130,1252,122,10.79646017699115
Gangapur,Soybean,2015,3500,3622,122,3.4857142857142858
Chikhali,Maize,2014,991,1113,122,12.31079717457114
Vaduj,Gram,2016,4267,4389,122,2.8591516287790015
Jalgaon-Masawat,Black Gram,2016,6611,6733,122,1.845409166540614
Umared,Lang,2015,1786,1908,122,6.83090705487122
Ambad(Vadi Godri),Maize,2015,1041,1163,122,11.719500480307397
Shahada,Bajri,2014,1404,1526,122,8.68945868945869
Nampur,Bajri,2016,1479,1601,122,8.248816768086545
Pusad,Soybean,2015,3045,3167,122,4.006568144499179
Sangamner,Gram,2015,4345,4467,122,2.807825086306099
Murum,Sorgum(Jawar),2016,2101,2223,122,5.806758686339839
Sillod,Wheat(Husked),2016,1414,1536,122,8.628005657708629
Sinner,Pigeon Pea (Tur),2015,3532,3654,122,3.454133635334088
Jintur,Wheat(Husked),2014,1550,1672,122,7.870967741935484
Jalgaon,Banana,2016,218,339,121,55.5045871559633
Indapur-Bhigwan,RICE(PADDY-HUS),2016,1601,1722,121,7.557776389756402
Sonpeth,Sorgum(Jawar),2015,1706,1827,121,7.092614302461899
Armori,Paddy-Unhusked,2016,1725,1846,121,7.0144927536231885
Kalamb (Os),Green Gram,2015,5776,5897,121,2.094875346260388
Chopda,Wheat(Husked),2014,1480,1601,121,8.175675675675675
Kolhapur-Laxmipuri,Maize,2015,1611,1732,121,7.510862818125388
Nampur,Wheat(Husked),2016,1490,1611,121,8.120805369127517
Chalisgaon,Soybean,2015,3042,3163,121,3.977646285338593
Ashti (Jalna),Bajri,2015,1376,1497,121,8.793604651162791
Aurangabad,Potato,2015,648,769,121,18.67283950617284
Kille Dharur,Cotton,2015,4017,4138,121,3.012198157829226
Pune-Pimpri,Cucumber,2015,1536,1657,121,7.877604166666667
Aamgaon,Paddy-Unhusked,2016,1630,1751,121,7.423312883435583
Sonpeth,Wheat(Husked),2016,1743,1864,121,6.942053930005737
Tuljapur,Pigeon Pea (Tur),2016,8594,8715,121,1.407959041191529
Jalgaon,Sorgum(Jawar),2015,1416,1537,121,8.545197740112995
Devala,Sorgum(Jawar),2015,2131,2252,121,5.678085405912717
Shevgaon,BAJRI,2016,1151,1272,121,10.5125977410947
Amarawati,Pumpkin,2016,529,650,121,22.873345935727787
Mumbai,Curry Leaves,2015,1046,1167,121,11.567877629063098
Tumsar,Sarsav,2015,2600,2721,121,4.653846153846154
Barshi,Neem-Seed,2015,719,840,121,16.82892906815021
Zarijamini,Cotton,2014,3880,4001,121,3.118556701030928
Malegaon,Sorgum(Jawar),2016,1570,1691,121,7.707006369426751
Sillod,Maize,2016,1585,1706,121,7.634069400630914
Manwat,Cotton,2015,4194,4315,121,2.8850739151168336
Kada,Maize,2014,1041,1162,121,11.623439000960614
Akola,Sorgum(Jawar),2014,1074,1195,121,11.266294227188082
Loha,Gram,2015,3750,3871,121,3.2266666666666666
Solapur,Sorgum(Jawar),2015,1697,1818,121,7.1302298173246905
Parbhani,Soybean,2015,3148,3269,121,3.843710292249047
Jamner,Cotton,2015,4203,4324,121,2.8788960266476327
Jintur-Bori,Sorgum(Jawar),2015,1211,1332,121,9.991742361684558
Parbhani,Soybean,2016,3558,3679,121,3.400786958965711
Purna,Gram,2016,4155,4276,121,2.912154031287605
Tasgaon,Sorgum(Jawar),2016,1721,1842,121,7.030796048808832
Nandurbar,Green Gram,2015,6597,6718,121,1.8341670456268
Pune-Pimpri,Cabbage,2016,693,814,121,17.46031746031746
Yeola,Maize,2014,1065,1186,121,11.36150234741784
Dharangaon,SORGUM(JAWAR),2016,1121,1242,121,10.793933987511151
Mangalwedha,Bajri,2014,1413,1534,121,8.563340410474169
Anajngaon Surji,Wheat(Husked),2014,1393,1514,121,8.686288585786073
Chopda,Gram,2016,6010,6131,121,2.0133111480865225
Jamner-Neri,Cotton,2015,4195,4316,121,2.8843861740166865
Kannad,Gram,2015,2694,2815,121,4.491462509279881
Mukhed,Soybean,2015,3626,3747,121,3.337010479867623
Umarkhed-Danki,Wheat(Husked),2015,1380,1500,120,8.695652173913043
Kurdwadi,Maize,2015,1345,1465,120,8.921933085501859
Amalner,Ground Nut Pods (Dry),2016,4282,4402,120,2.802428771602055
Jalna,Green Gram,2016,5410,5530,120,2.2181146025878005
Panvel,Ghosali(Bhaji),2014,630,750,120,19.047619047619047
Umarkhed-Danki,Soybean,2015,3440,3560,120,3.488372093023256
Lasalgaon,Sorgum(Jawar),2014,1734,1854,120,6.920415224913495
Panvel,Snake Gourd,2014,1520,1640,120,7.894736842105263
Akola,Maize,2016,1456,1576,120,8.241758241758241
Umarkhed,Wheat(Husked),2015,1400,1520,120,8.571428571428571
Jalgaon Jamod-Aasalgaon,Sorgum(Jawar),2015,1140,1260,120,10.526315789473685
Chamorshi,Paddy-Unhusked,2015,1733,1853,120,6.924408540103866
Parbhani,Soybean,2016,3760,3880,120,3.1914893617021276
Jalgaon Jamod,Maize,2015,940,1060,120,12.76595744680851
Kurdwadi-Modnimb,Maize,2016,1389,1509,120,8.639308855291576
Amalner,Bajri,2014,1177,1297,120,10.195412064570943
Umarkhed,Wheat(Husked),2016,1500,1620,120,8.0
Akhadabalapur,Pigeon Pea (Tur),2014,4000,4120,120,3.0
Akhadabalapur,Gram,2015,3060,3180,120,3.9215686274509802
Jalgaon Jamod,Wheat(Husked),2015,1300,1420,120,9.23076923076923
Jafrabad,Sorgum(Jawar),2015,1010,1130,120,11.881188118811881
Phaltan,Maize,2015,1163,1283,120,10.318142734307825
Akhadabalapur,Gram,2014,3140,3260,120,3.821656050955414
Patan,CABBAGE,2016,485,605,120,24.742268041237114
Parbhani,Pigeon Pea (Tur),2014,4382,4502,120,2.7384755819260613
Shrirampur,Safflower,2016,2330,2450,120,5.150214592274678
Jalgaon-Masawat,Maize,2016,1120,1240,120,10.714285714285714
Akola,Maize,2015,1305,1425,120,9.195402298850574
Jalgaon,Green Gram,2015,6060,6180,120,1.9801980198019802
Chopda,Maize,2015,1020,1140,120,11.764705882352942
Umared,Cotton,2014,3874,3994,120,3.097573567372225
Mantha,Gram,2016,4070,4190,120,2.9484029484029484
Vaduj,COWPEA,2016,4500,4620,120,2.6666666666666665
Shevgaon,Gram,2016,4088,4208,120,2.935420743639922
Shegaon,Mustard,2016,3280,3400,120,3.658536585365854
Shirur,Pigeon Pea (Tur),2014,2880,3000,120,4.166666666666667
Dhamangaon-Rly,Gram,2016,4013,4133,120,2.99028158484924
Aurangabad,Spinach,2015,150,270,120,80.0
Gevrai,Soybean,2015,3658,3778,120,3.280481137233461
Kalamb (Os),Soybean,2015,3197,3317,120,3.753518923991242
Khed (Shel Pimpalgaon),Bottle Gourd,2016,520,640,120,23.076923076923077
Shevgaon,Bajri,2015,1246,1366,120,9.630818619582664
Vani,Gram,2016,4175,4295,120,2.874251497005988
Rahuri-Vambori,Wheat(Husked),2015,1527,1647,120,7.858546168958743
Ner Parasopant,Wheat(Husked),2015,1315,1435,120,9.125475285171103
Telhara,Cotton,2016,4300,4420,120,2.7906976744186047
Indapur,Maize,2014,1075,1195,120,11.162790697674419
Tasgaon,Gram,2015,3100,3220,120,3.870967741935484
Ner Parasopant,GREEN GRAM,2016,4500,4620,120,2.6666666666666665
Vaduj,Bajri,2016,1595,1715,120,7.523510971786834
Vaduj,Bajri,2016,1500,1620,120,8.0
Gangapur,Bajri,2015,1529,1649,120,7.848266841072596
Tumsar,Other Cereals,2015,2218,2338,120,5.410279531109107
Ner Parasopant,PIGEON PEA (TUR),2016,5610,5730,120,2.1390374331550803
Gangapur,Maize,2015,1056,1176,120,11.363636363636363
Rahata,Sorgum(Jawar),2016,1293,1413,120,9.280742459396752
Nandgaon,Soybean,2016,3525,3645,120,3.404255319148936
Shrigonda,Ground Nut Pods (Dry),2016,5160,5280,120,2.3255813953488373
Ghansawangi,Cotton,2015,4210,4330,120,2.8503562945368173
Telhara,Soybean,2015,3034,3154,120,3.955174686882004
Telhara,Soybean,2015,3181,3301,120,3.7723986167871737
Sinner,Pigeon Pea (Tur),2015,3838,3958,120,3.1266284523189163
Ausa,Maize,2015,1251,1371,120,9.59232613908873
Chalisgaon,Pigeon Pea (Tur),2015,4233,4353,120,2.8348688873139616
Bhiwapur,Pigeon Pea (Tur),2015,5600,5720,120,2.142857142857143
Chakur,Soybean,2016,2810,2930,120,4.270462633451957
Manora,Wheat(Husked),2015,1450,1570,120,8.275862068965518
Islampur,Ladies Finger,2016,236,356,120,50.847457627118644
Khamgaon,Sorgum(Jawar),2015,1126,1246,120,10.657193605683837
Ambejogai,Sorgum(Jawar),2015,2081,2201,120,5.766458433445459
Shahada,Maize,2015,1362,1482,120,8.810572687224669
Nandurbar,Black Gram,2016,9930,10050,120,1.2084592145015105
Hadgaon,Soybean,2014,2973,3093,120,4.036326942482341
Hadgaon,Wheat(Husked),2014,1680,1800,120,7.142857142857143
Shrirampur,Green Gram,2014,6619,6739,120,1.8129626831847712
Dhule,Sorgum(Jawar),2016,1396,1516,120,8.595988538681949
Khamgaon,Wheat(Husked),2016,1557,1677,120,7.707129094412331
Washi(Osmanabad),Soybean,2015,3452,3572,120,3.4762456546929315
Sinner,Green Gram,2016,6650,6770,120,1.8045112781954886
Navapur,Cotton,2015,3860,3980,120,3.1088082901554404
Manmad,Wheat(Husked),2016,1471,1591,120,8.157715839564922
Udgir,Black Gram,2015,8373,8493,120,1.4331780723754926
Brahmpuri,Paddy-Unhusked,2016,2163,2283,120,5.547850208044383
Sillod,Soybean,2016,3460,3580,120,3.468208092485549
Kalamnuri,Soybean,2016,3583,3703,120,3.3491487580240022
Barshi,Green Chilli,2015,217,337,120,55.29953917050691
Telhara,Soybean,2014,3102,3221,119,3.836234687298517
Rahata,Bajri,2015,1125,1244,119,10.577777777777778
Taloda,Sorgum(Jawar),2015,1548,1667,119,7.68733850129199
Manwat,Bajri,2016,1533,1652,119,7.762557077625571
Rajura,Gram,2016,4946,5065,119,2.4059846340477153
Newasa,Wheat(Husked),2015,1450,1569,119,8.206896551724139
Nandgaon,Ground Nut Pods (Dry),2016,5121,5240,119,2.3237648896699863
Barshi,Lemon,2015,229,348,119,51.96506550218341
Karad,Brinjal,2015,506,625,119,23.51778656126482
Rahuri,Gram,2015,3777,3896,119,3.150648662960021
Gangapur,Bajri,2016,1468,1587,119,8.106267029972752
Nandurbar,Cluster Bean,2015,3232,3351,119,3.6819306930693068
Chopda,BAJRI,2016,1312,1431,119,9.070121951219512
Malkapur,BAJRI,2016,1375,1494,119,8.654545454545454
Bhandara,Wheat(Husked),2016,1537,1656,119,7.742355237475602
Manmad,Bajri,2016,1556,1675,119,7.647814910025707
Chamorshi,Paddy-Unhusked,2016,1869,1988,119,6.367041198501872
Aheri,Pigeon Pea (Tur),2015,5650,5769,119,2.106194690265487
Malkapur,Sorgum(Jawar),2015,1155,1274,119,10.303030303030303
Malkapur,Sorgum(Jawar),2015,1259,1378,119,9.451945988880064
Gangapur,Pigeon Pea (Tur),2016,7893,8012,119,1.5076650196376535
Tumsar,Other Cereals,2014,1951,2070,119,6.09943618657099
Chikhali,Maize,2015,1048,1167,119,11.354961832061068
Indapur,Maize,2015,1376,1495,119,8.648255813953488
Lonar,Soybean,2016,3178,3297,119,3.7444933920704844
Raver,Maize,2015,1015,1134,119,11.724137931034482
Lonar,Soybean,2016,3351,3470,119,3.5511787526111607
Balapur,Soybean,2016,3456,3575,119,3.443287037037037
Gadchiroli,Paddy-Unhusked,2016,1781,1900,119,6.681639528354856
Mangalwedha,Wheat(Husked),2015,2089,2208,119,5.6965055050263285
Lonar,Wheat(Husked),2015,1438,1557,119,8.27538247566064
Sakri,Bajri,2016,1613,1732,119,7.377557346559207
Shevgaon-Bodhegaon,Bajri,2015,1108,1227,119,10.740072202166065
Parshiwani,Cotton,2014,3831,3950,119,3.1062385800052206
Raver,Wheat(Husked),2015,1346,1465,119,8.841010401188708
Parola,Wheat(Husked),2016,1488,1607,119,7.997311827956989
Pachora,Wheat(Husked),2015,1469,1588,119,8.10074880871341
Khamgaon,Bajri,2014,1017,1136,119,11.701081612586037
Tumsar,Linseed,2016,6014,6133,119,1.9787163285666778
Amalner,Bajri,2016,1500,1619,119,7.933333333333334
Khamgaon,Maize,2014,893,1012,119,13.325867861142218
Jalgaon,Green Gram,2016,4517,4636,119,2.634491919415541
Shevgaon-Bodhegaon,Sorgum(Jawar),2015,1382,1501,119,8.610709117221418
Rahuri-Vambori,Soybean,2014,3148,3267,119,3.7801778907242696
Barshi-Vairag,Pigeon Pea (Tur),2015,4960,5079,119,2.399193548387097
Gangapur,Maize,2015,1068,1187,119,11.142322097378278
Gangapur,Maize,2015,1609,1728,119,7.395898073337476
Armori-Desaiganj,Paddy-Unhusked,2016,1630,1749,119,7.300613496932515
Armori-Desaiganj,Paddy-Unhusked,2016,1548,1667,119,7.68733850129199
Aurad Shahajani,Soybean,2016,3643,3762,119,3.266538567115015
Partur,Gram,2016,4021,4140,119,2.9594628201939814
Kolhapur-Laxmipuri,Maize,2016,1548,1667,119,7.68733850129199
Indapur (Nimgaon Ketki),Gram,2016,3441,3560,119,3.4582970066841034
Phaltan,Maize,2014,1273,1392,119,9.347996857816183
Morshi,Wheat(Husked),2015,1506,1625,119,7.901726427622842
Sangli-Miraj,Wheat(Unhusked),2016,3160,3279,119,3.7658227848101267
Barshi,Cluster Bean,2014,142,261,119,83.80281690140845
Jamner-Neri,Maize,2016,1343,1462,119,8.860759493670885
Akot,Wheat(Husked),2015,1369,1488,119,8.692476260043827
Morshi,Wheat(Husked),2016,1625,1744,119,7.323076923076923
Sakri,Maize,2015,1200,1318,118,9.833333333333334
Morshi,Sorgum(Jawar),2016,1341,1459,118,8.799403430275914
Chikhali,Maize,2015,1165,1283,118,10.128755364806867
Sillod,Wheat(Husked),2016,1632,1750,118,7.230392156862745
Gondiya,Paddy-Unhusked,2016,1535,1653,118,7.687296416938111
Nandura,Bajri,2015,1147,1265,118,10.28770706190061
Shirpur,Soybean,2015,3143,3261,118,3.7543748011454023
Jawala-Bajar,Wheat(Husked),2015,1475,1593,118,8.0
Gondiya,Paddy-Unhusked,2015,1472,1590,118,8.016304347826088
Dondaicha,Bajri,2015,1212,1330,118,9.735973597359736
Kalvan,Maize,2015,1157,1275,118,10.198789974070873
Telhara,Sorgum(Jawar),2014,944,1062,118,12.5
Shegaon,Sorgum(Jawar),2015,1127,1245,118,10.470275066548359
Chopda,Sorgum(Jawar),2016,1512,1630,118,7.804232804232805
Shirpur,Maize,2015,1146,1264,118,10.296684118673648
Nandgaon,Maize,2014,1212,1330,118,9.735973597359736
Bhokardan,Soybean,2015,3377,3495,118,3.4942256440627775
Dhamangaon-Rly,Wheat(Husked),2015,1453,1571,118,8.121128699242945
Gevrai,Bajri,2015,1230,1348,118,9.59349593495935
Indapur (Nimgaon Ketki),Bajri,2016,1771,1889,118,6.662902315076228
Kada,Maize,2015,1368,1486,118,8.625730994152047
Phaltan,Potato,2016,1406,1524,118,8.392603129445234
Purna,Gram,2016,5132,5250,118,2.2992985190958692
Kinwat,Cotton,2016,4317,4435,118,2.7333796618021773
Indapur-Bhigwan,Maize,2016,1463,1581,118,8.065618591934381
Raver,Sorgum(Jawar),2015,1233,1351,118,9.570154095701541
Gangapur,Bajri,2016,1636,1754,118,7.212713936430318
Latur-Murud,Sorgum(Jawar),2016,1472,1590,118,8.016304347826088
Islampur,Capsicum,2016,168,286,118,70.23809523809524
Devala,Wheat(Husked),2016,1662,1780,118,7.099879663056559
Chamorshi,Paddy-Unhusked,2014,1811,1929,118,6.515737161789067
Jalna,Jaggery,2016,3032,3150,118,3.891820580474934
Umarkhed,Soybean,2015,3482,3600,118,3.388856978747846
Akola,Maize,2016,1639,1757,118,7.199511897498475
Chamorshi,Paddy-Unhusked,2016,2264,2382,118,5.212014134275618
Taloda,Maize,2015,1078,1196,118,10.946196660482375
Bhokar,Sorgum(Jawar),2016,1466,1584,118,8.049113233287859
Nashik,Mint,2015,152,270,118,77.63157894736842
Amarawati,Linseed,2015,5038,5156,118,2.3421992854307265
Shirur,Green Gram,2015,6806,6924,118,1.7337643255950632
Akot,Cotton,2016,4591,4709,118,2.570246133739926
Amarawati,Carrot,2016,576,694,118,20.48611111111111
Mudkhed,Sorgum(Jawar),2016,1390,1507,117,8.417266187050359
Kannad,Bajri,2014,1250,1367,117,9.36
Barshi,Chikoo,2016,115,232,117,101.73913043478261
Lohara,Sunflower,2016,3400,3517,117,3.4411764705882355
Varud-Rajura Bazar,Castor Seed,2016,3070,3187,117,3.811074918566775
Barshi,Shepu,2016,83,200,117,140.96385542168676
Khamgaon,Ground Nut Pods (Dry),2016,4033,4150,117,2.9010662038184973
Partur,Soybean,2015,3294,3411,117,3.551912568306011
Sonpeth,Safflower,2014,2500,2617,117,4.68
Devala,Maize,2015,1071,1188,117,10.92436974789916
Ghansawangi,Wheat(Husked),2015,1550,1667,117,7.548387096774194
Pune-Manjri,Kardai,2016,835,952,117,14.011976047904191
Kalyan,Sorgum(Jawar),2016,1700,1817,117,6.882352941176471
Nagpur,Maize,2015,1283,1400,117,9.11925175370226
Rahata,GHEVDA,2016,1883,2000,117,6.213489113117366
Lasur Station,Soybean,2016,3800,3917,117,3.0789473684210527
Indapur-Bhigwan,Maize,2015,1410,1527,117,8.297872340425531
Amarawati,Pumpkin,2015,1433,1550,117,8.164689462665736
Murtizapur,Wheat(Husked),2014,1391,1508,117,8.411214953271028
Sangamner,Maize,2016,1540,1657,117,7.597402597402597
Jalgaon,Wheat(Husked),2015,1317,1434,117,8.883826879271071
Chalisgaon,Maize,2016,1348,1465,117,8.679525222551929
Lonar,Sorgum(Jawar),2014,1070,1187,117,10.934579439252337
Kalyan,Sorgum(Jawar),2015,1650,1767,117,7.090909090909091
Telhara,Cotton,2016,4550,4667,117,2.5714285714285716
Amarawati,Soybean,2015,3779,3896,117,3.096057157978301
Rahata,Ginger (Fresh),2016,2758,2875,117,4.2422044960116025
Phaltan,Jaggery,2015,2222,2339,117,5.265526552655266
Jalkot,Green Gram,2016,4929,5046,117,2.373706634205721
Nilanga,Wheat(Husked),2015,1443,1560,117,8.108108108108109
Bhokardan,Soybean,2016,3058,3175,117,3.8260300850228908
Telhara,Sorgum(Jawar),2016,1411,1528,117,8.291991495393338
Sangli-Phale Bhajipalam,Water Melon,2016,84,201,117,139.28571428571428
Beed,Bajri,2015,1356,1473,117,8.628318584070797
Jalna,Wheat(Husked),2016,1860,1977,117,6.290322580645161
Jintur,Ground Nut Pods (Dry),2014,3568,3685,117,3.2791479820627805
Lasalgaon-Vinchur,Bajri,2015,1359,1476,117,8.609271523178808
Barshi,Grapes,2015,111,228,117,105.4054054054054
Solapur,MATKI,2016,5583,5700,117,2.0956475013433637
Kada,Bajri,2015,1442,1559,117,8.11373092926491
Panvel,Cabbage,2014,500,617,117,23.4
Sillod-Bharadi,BAJRI,2016,1283,1400,117,9.11925175370226
Jalgaon Jamod-Aasalgaon,Maize,2016,1100,1217,117,10.636363636363637
Jalgaon Jamod-Aasalgaon,Maize,2016,1100,1217,117,10.636363636363637
Dhamangaon-Rly,Wheat(Husked),2014,1417,1534,117,8.256880733944953
Gangapur,SORGUM(JAWAR),2016,2162,2279,117,5.411655874190564
Shirur,Sorgum(Jawar),2015,1388,1505,117,8.429394812680115
Nandurbar,Soybean,2015,3398,3515,117,3.4432018834608593
Amalner,Pigeon Pea (Tur),2016,7050,7167,117,1.6595744680851063
Tumsar,Paddy-Unhusked,2016,1521,1638,117,7.6923076923076925
Vaduj,Maize,2016,1722,1839,117,6.794425087108014
Jintur-Bori,Soybean,2015,3012,3129,117,3.8844621513944224
Washim-Ansing,Wheat(Husked),2016,1483,1600,117,7.889413351314902
Sillod,Sorgum(Jawar),2016,1423,1540,117,8.222066057624737
Mantha,Gram,2016,4031,4148,117,2.9025055817415035
Hingoli,Sorgum(Jawar),2015,1486,1603,117,7.873485868102288
Barshi,Ladies Finger,2015,169,286,117,69.23076923076923
Kalamb (Os),Bajri,2016,1656,1773,117,7.065217391304348
Shirur,Ground Nut Pods (Dry),2014,2900,3017,117,4.0344827586206895
Chakur,Soybean,2016,3196,3313,117,3.6608260325406756
Yeola,Bajri,2015,1359,1476,117,8.609271523178808
Morshi,Sorgum(Jawar),2015,1344,1461,117,8.705357142857142
Armori-Desaiganj,Paddy-Unhusked,2015,1445,1562,117,8.09688581314879
Devala,Tag,2016,4375,4492,117,2.6742857142857144
Tuljapur,Maize,2015,1332,1449,117,8.783783783783784
Shegaon,Sorgum(Jawar),2016,1299,1416,117,9.006928406466512
Yeotmal,Wheat(Husked),2015,1442,1559,117,8.11373092926491
Barshi,Chikoo,2015,183,300,117,63.9344262295082
Pandharpur,Bajri,2016,1473,1590,117,7.942973523421589
Jalgaon Jamod-Aasalgaon,Sorgum(Jawar),2016,1183,1300,117,9.89010989010989
Koregaon,Ghevda Seed,2015,3783,3900,117,3.0927835051546393
Achalpur,Wheat(Husked),2016,1744,1861,117,6.708715596330276
Akola,Maize,2016,1304,1421,117,8.97239263803681
Umarga,Gram,2016,5333,5450,117,2.1938871179448713
Barshi,Water Melon,2015,50,167,117,234.0
Karad,Brinjal,2015,550,667,117,21.272727272727273
Parola,Wheat(Husked),2016,1317,1434,117,8.883826879271071
Rahata,Bajri,2016,1599,1715,116,7.254534083802376
Mandhal,Cotton,2016,4389,4505,116,2.6429710640236954
Khamgaon,Safflower,2015,2067,2183,116,5.611998064828254
Umared,Cotton,2016,4400,4516,116,2.6363636363636362
Bhandara,Wheat(Husked),2014,1359,1475,116,8.535688005886682
Patur,Soybean,2015,3600,3716,116,3.2222222222222223
Umared,Cotton,2014,3800,3916,116,3.0526315789473686
Shahapur,Paddy-Unhusked,2014,1400,1516,116,8.285714285714286
Mantha,Wheat(Husked),2014,1456,1572,116,7.967032967032967
Bhandara,Wheat(Husked),2016,1637,1753,116,7.08613317043372
Pavani,Paddy-Unhusked,2015,1913,2029,116,6.0637741766858335
Karad,Cabbage,2015,342,458,116,33.91812865497076
Malegaon,Maize,2015,1177,1293,116,9.855564995751912
Pusad,Green Gram,2016,4664,4780,116,2.4871355060034306
Mohol,Maize,2016,1421,1537,116,8.16326530612245
Barshi,Bajri,2016,1451,1567,116,7.994486560992419
Kurdwadi,Maize,2015,1185,1301,116,9.789029535864978
Katol,Cotton,2015,4201,4317,116,2.7612473220661746
Jamner,Cotton,2016,4382,4498,116,2.6471930625285256
Kannad,Maize,2015,1091,1207,116,10.632447296058661
Jalgaon Jamod-Aasalgaon,Sorgum(Jawar),2016,1117,1233,116,10.384959713518352
Shevgaon,Soybean,2014,2884,3000,116,4.0221914008321775
Dondaicha,Maize,2016,1465,1581,116,7.918088737201365
Mangalwedha,Wheat(Husked),2016,1907,2023,116,6.082852648138437
Achalpur,Maize,2015,1348,1464,116,8.6053412462908
Mumbai,Curry Leaves,2016,492,608,116,23.577235772357724
Mangalwedha,Wheat(Husked),2015,1922,2038,116,6.035379812695109
Lonar,Soybean,2014,3171,3287,116,3.6581520025228635
Telhara,Cotton,2015,4017,4133,116,2.8877271595718197
Sinner,Sorgum(Jawar),2014,1672,1788,116,6.937799043062201
Purna,Sorgum(Jawar),2015,1137,1253,116,10.202286719437115
Sangrampur,Maize,2015,917,1033,116,12.649945474372956
Osmanabad,Soybean,2016,3600,3716,116,3.2222222222222223
Lonar,Sorgum(Jawar),2014,1137,1253,116,10.202286719437115
Tasgaon,Gram,2015,3188,3304,116,3.638644918444166
Udgir,Gram,2016,4508,4624,116,2.5732031943212066
Jalgaon,BAJRI,2016,1378,1494,116,8.417997097242381
Taloda,Maize,2014,970,1086,116,11.958762886597938
Chalisgaon,Maize,2016,1307,1423,116,8.875286916602908
Kopargaon,Maize,2015,1324,1440,116,8.761329305135952
Panvel,Cucumber,2014,1117,1233,116,10.384959713518352
Sillod-Bharadi,Sorgum(Jawar),2016,1367,1483,116,8.485735186539868
Himayatnagar,Soybean,2016,3311,3427,116,3.5034732709151313
Dharni,Chino,2016,3617,3733,116,3.2070776886922863
Lasalgaon-Vinchur,Bajri,2015,1213,1329,116,9.563066776586975
Parli-Vaijnath,Sorgum(Jawar),2015,1667,1783,116,6.9586082783443315
Umarga,Safflower,2015,2658,2774,116,4.36418359668924
Umarkhed,Soybean,2015,3460,3576,116,3.352601156069364
Umared,Cotton,2015,3773,3889,116,3.074476543864299
Kalamb (Os),Tamarind,2015,4071,4187,116,2.8494227462539916
Loha,Sorgum(Jawar),2016,1386,1502,116,8.369408369408369
Washim,Mustard,2015,2917,3033,116,3.976688378471032
Buldhana,Maize,2015,1248,1364,116,9.294871794871796
Narkhed,Cotton,2016,4497,4613,116,2.579497442739604
Kalamb (Os),Sunflower,2014,2603,2719,116,4.456396465616597
Nandura,Bajri,2016,1487,1603,116,7.800941492938803
Dondaicha-Sindkheda,Sorgum(Jawar),2016,1459,1575,116,7.9506511309115835
Dhule,Maize,2016,1325,1441,116,8.754716981132075
Hinganghat,Wheat(Husked),2016,1615,1731,116,7.182662538699691
Hingoli,Soybean,2015,3668,3784,116,3.162486368593239
Islampur,Green Chilli,2016,138,254,116,84.05797101449275
Malegaon,Maize,2015,1226,1341,115,9.380097879282218
Loha,Sorgum(Jawar),2015,1318,1433,115,8.725341426403642
Mauda,Wheat(Husked),2016,1600,1715,115,7.1875
Morshi,Sorgum(Jawar),2016,1394,1509,115,8.249641319942612
Shirpur,Soybean,2015,3045,3160,115,3.7766830870279144
Rahuri-Vambori,Wheat(Husked),2016,1799,1914,115,6.392440244580323
Akot,Sorgum(Jawar),2015,1042,1157,115,11.036468330134356
Telhara,Wheat(Husked),2015,1358,1473,115,8.468335787923417
Akot,Sorgum(Jawar),2015,1279,1394,115,8.991399530883502
Gangapur,Maize,2015,1245,1360,115,9.236947791164658
Barshi,Chikoo,2015,100,215,115,115.0
Khamgaon,Sorgum(Jawar),2016,1464,1579,115,7.855191256830601
Pune,Maize,2015,1416,1531,115,8.121468926553673
Indapur,Maize,2015,1340,1455,115,8.582089552238806
Deulgaon Raja,Cotton,2015,4160,4275,115,2.764423076923077
Solapur,Green Peas (Dry),2015,3950,4065,115,2.911392405063291
Parbhani,Sorgum(Jawar),2016,1647,1762,115,6.982392228293867
Parbhani,Soybean,2016,3434,3549,115,3.3488642981945254
Malkapur,Bajri,2014,1108,1223,115,10.379061371841155
Indapur,Gram,2016,3365,3480,115,3.4175334323922733
Ner Parasopant,Gram,2014,2454,2569,115,4.686226568867156
Malkapur,Sorgum(Jawar),2014,1177,1292,115,9.770603228547154
Latur-Murud,Soybean,2016,3295,3410,115,3.490136570561457
Barshi,Mosambi,2016,250,365,115,46.0
Tasgaon,Tamarind,2016,6345,6460,115,1.8124507486209613
Khamgaon,Bajri,2016,1420,1535,115,8.098591549295774
Shevgaon-Bodhegaon,Bajri,2015,1335,1450,115,8.614232209737828
Sillod,Wheat(Husked),2014,1402,1517,115,8.202567760342369
Parola,Wheat(Husked),2016,1400,1515,115,8.214285714285714
Gondpimpri,Soybean,2016,3508,3623,115,3.2782212086659066
Umarga,Maize,2015,1114,1229,115,10.323159784560143
Aamgaon,Paddy-Unhusked,2016,1598,1713,115,7.196495619524406
Khamgaon,Sorgum(Jawar),2014,1117,1232,115,10.295434198746642
Pune,Jaggery,2014,2403,2518,115,4.78568456096546
Mandhal,Paddy-Unhusked,2015,1968,2083,115,5.84349593495935
Kalvan,Paddy-Unhusked,2016,1400,1515,115,8.214285714285714
Dound,Maize,2016,1374,1489,115,8.369723435225618
Jalgaon,MAIZE,2016,1100,1215,115,10.454545454545455
Shevgaon-Bodhegaon,Gram,2015,4048,4163,115,2.840909090909091
Jalgaon,Green Gram,2016,4747,4862,115,2.422582683800295
Kalvan,Wheat(Husked),2015,1529,1644,115,7.521255722694572
Shevgaon-Bodhegaon,Pigeon Pea (Tur),2015,4934,5049,115,2.3307661126874746
Paithan,Bajri,2015,1406,1521,115,8.17923186344239
Tumsar,Paddy-Unhusked,2015,1597,1712,115,7.201001878522229
Indapur-Bhigwan,Maize,2016,1417,1532,115,8.115737473535638
Kada (Ashti),Bajri,2014,1250,1365,115,9.2
Barshi-Vairag,Gram,2015,4199,4314,115,2.7387473207906643
Jalna,Maize,2016,1523,1638,115,7.550886408404465
Jalgaon,Sorgum(Jawar),2015,1346,1461,115,8.543833580980683
Gangakhed,Sorgum(Jawar),2014,1450,1565,115,7.931034482758621
Ghatanji,Soybean,2015,3125,3240,115,3.68
Bhokar,Gram,2015,3940,4055,115,2.918781725888325
Umared,Coriander (Dry),2015,8358,8473,115,1.3759272553242403
Jawala-Bajar,Cotton,2015,4098,4213,115,2.8062469497315763
Taloda,Cotton,2015,3825,3940,115,3.0065359477124183
Chandur Rly.,Green Gram,2015,9091,9206,115,1.2649873501264988
Vai,Cabbage,2016,662,776,114,17.220543806646525
Sailu,COTTON,2016,5041,5155,114,2.2614560603054947
Achalpur,Sorgum(Jawar),2015,1284,1398,114,8.878504672897197
Tumsar,Other Pulses,2016,4516,4630,114,2.524357838795394
Barshi,Ladies Finger,2015,136,250,114,83.82352941176471
Palghar(Bevur),Wheat(Husked),2015,1981,2095,114,5.754669358909641
Udgir,Gram,2016,5632,5746,114,2.024147727272727
Indapur-Bhigwan,Maize,2015,1251,1365,114,9.112709832134293
Sinner,Tamarind,2015,1173,1287,114,9.718670076726342
Jalna-Badnapur,Cotton,2016,4227,4341,114,2.69694819020582
Manmad,Wheat(Husked),2015,1599,1713,114,7.129455909943715
Panvel,Cabbage,2014,586,700,114,19.453924914675767
Jalna-Badnapur,Cotton,2016,4211,4325,114,2.707195440512942
Khamgaon,Bajri,2016,1123,1237,114,10.151380231522706
Amarawati,Gram,2015,4331,4445,114,2.6321865619949203
Manmad,Wheat(Husked),2016,1718,1832,114,6.635622817229336
Khamgaon,Maize,2016,1262,1376,114,9.033280507131538
Manmad,Tomato,2016,237,351,114,48.10126582278481
Chopda,Bajri,2014,1199,1313,114,9.50792326939116
Lasur Station,Soybean,2016,3825,3939,114,2.980392156862745
Indapur-Bhigwan,Soybean,2015,3120,3234,114,3.6538461538461537
Kolhapur-Malkapur,Cabbage,2016,100,214,114,114.0
Loha,Soybean,2015,3961,4075,114,2.8780610956829085
Lonar,Wheat(Husked),2015,1549,1663,114,7.359586830213041
Lasalgaon,Maize,2014,1247,1361,114,9.141940657578187
Ahmedpur,Sorgum(Jawar),2016,1471,1585,114,7.749830047586676
Chopda,Sorgum(Jawar),2016,1493,1607,114,7.635632953784327
Barshi,Brinjal,2015,88,202,114,129.54545454545453
Murbad,Paddy-Unhusked,2014,1811,1925,114,6.2948647156267254
Tiroda,Paddy-Unhusked,2014,1846,1960,114,6.175514626218852
Vaduj,Wheat(Husked),2015,1533,1647,114,7.436399217221135
Majalgaon,Green Gram,2015,6625,6739,114,1.7207547169811321
Partur,Sorgum(Jawar),2016,1613,1727,114,7.067575945443274
Shrirampur-Belapur,Gram,2016,3943,4057,114,2.8911995942176008
Sakri,Wheat(Husked),2014,1268,1382,114,8.990536277602523
Shegaon,Mustard,2016,3322,3436,114,3.4316676700782662
Digras,Wheat(Husked),2016,1670,1784,114,6.826347305389222
Mukhed,Green Gram,2015,7105,7219,114,1.6045038705137227
Kannad,Bajri,2014,1250,1364,114,9.12
Jalgaon,Banana,2015,178,292,114,64.04494382022472
Jintur,Wheat(Husked),2015,1531,1645,114,7.4461136512083606
Kalmeshwar,Soybean,2015,3212,3326,114,3.5491905354919053
Jalgaon Jamod,Wheat(Husked),2015,1229,1343,114,9.275834011391375
Kolhapur-Malkapur,TOMATO,2016,144,258,114,79.16666666666667
Khed (Shel Pimpalgaon),Methi (Bhaji),2014,601,715,114,18.96838602329451
Nanded,Gram,2016,4161,4275,114,2.73972602739726
Rahuri-Vambori,Bajri,2015,1393,1507,114,8.183776022972003
Anajngaon Surji,Green Gram,2014,7375,7489,114,1.5457627118644068
Pune-Manjri,Rajgira,2016,797,911,114,14.303638644918443
Chikhali,Sorgum(Jawar),2014,1061,1175,114,10.744580584354383
Chikhali,Sorgum(Jawar),2015,1111,1225,114,10.261026102610261
Yeola,Wheat(Husked),2015,1525,1639,114,7.475409836065574
Gondiya,Paddy-Unhusked,2016,1614,1728,114,7.063197026022305
Jalgaon,Green Gram,2016,5486,5600,114,2.078016769959898
Morshi,Wheat(Husked),2016,1600,1713,113,7.0625
Bhokardan-Pimpalgaon Renu,Wheat(Husked),2016,1525,1638,113,7.409836065573771
Kannad,Maize,2014,800,913,113,14.125
Umarkhed-Danki,SOYBEAN,2016,2659,2772,113,4.2497179390748405
Palghar(Bevur),Onion,2016,537,650,113,21.042830540037244
Tumsar,Paddy-Unhusked,2016,1699,1812,113,6.650971159505591
Indapur,Banana,2016,1025,1138,113,11.024390243902438
Washim-Ansing,Wheat(Husked),2016,1567,1680,113,7.211231652839821
Tumsar,Paddy-Unhusked,2016,1530,1643,113,7.38562091503268
Parola,Sorgum(Jawar),2016,1427,1540,113,7.918710581639804
Shahada,Bajri,2016,1397,1510,113,8.088761632068719
Kalamb (Os),Bajri,2015,1356,1469,113,8.333333333333334
Basmat,Gram,2015,3331,3444,113,3.3923746622635846
Vaduj,Wheat(Husked),2016,1700,1813,113,6.647058823529412
Aamgaon,Paddy-Unhusked,2016,1527,1640,113,7.400130975769483
Gondpimpri,Paddy-Unhusked,2015,1900,2013,113,5.947368421052632
Shevgaon-Bodhegaon,Bajri,2015,1129,1242,113,10.008857395925597
Gondpimpri,Soybean,2016,3382,3495,113,3.341218214074512
Osmanabad,Soybean,2016,3775,3888,113,2.993377483443709
Jalna,Wheat(Husked),2015,1678,1791,113,6.734207389749702
Jafrabad,Maize,2015,900,1013,113,12.555555555555555
Akot,Cotton,2016,5027,5140,113,2.2478615476427293
Jawala-Bajar,Wheat(Husked),2016,1700,1813,113,6.647058823529412
Jintur-Bori,Sorgum(Jawar),2015,1126,1239,113,10.035523978685612
Sillod,Maize,2014,900,1013,113,12.555555555555555
Umared,Cotton,2015,3871,3984,113,2.919142340480496
Mauda,Wheat(Husked),2016,1650,1763,113,6.848484848484849
Gevrai,Bajri,2015,1292,1405,113,8.746130030959753
Gangapur,Gram,2016,4227,4340,113,2.6732907499408562
Nandgaon Khandeshwar,Wheat(Husked),2016,1483,1596,113,7.619689817936615
Rajura,Soybean,2016,3503,3616,113,3.225806451612903
Shirur,Bajri,2016,1391,1504,113,8.123652048885694
Dhadgaon,Sorgum(Jawar),2016,1433,1546,113,7.885554780181438
Shirur,Wheat(Husked),2015,1389,1502,113,8.135349172066235
Parbhani,Sorgum(Jawar),2015,1600,1713,113,7.0625
Arvi,Cotton,2015,3953,4066,113,2.858588413862889
Anajngaon Surji,Banana,2015,525,638,113,21.523809523809526
Mehkar,Maize,2016,1159,1272,113,9.749784296807594
Hingoli,Cotton,2016,4443,4556,113,2.5433265811388703
Khed (Shel Pimpalgaon),Ladies Finger,2014,2531,2644,113,4.464638482813117
Vaduj,Bajri,2016,1525,1638,113,7.409836065573771
Shegaon,Wheat(Husked),2014,1334,1447,113,8.470764617691154
Akhadabalapur,Soybean,2016,3600,3713,113,3.138888888888889
Washim,Gram,2016,7160,7273,113,1.5782122905027933
Devala,Wheat(Husked),2014,1473,1586,113,7.671418873048201
Kannad,Wheat(Husked),2015,1404,1517,113,8.048433048433049
Akot,Maize,2015,1265,1378,113,8.932806324110672
Umarkhed,SOYBEAN,2016,2663,2776,113,4.24333458505445
Vai,Tomato,2016,450,563,113,25.11111111111111
Devani,Gram,2016,4259,4372,113,2.6532049776942945
Achalpur,Wheat(Husked),2016,1742,1855,113,6.486796785304248
Morshi,Sorgum(Jawar),2015,1350,1463,113,8.37037037037037
Washim,Black Gram,2015,5625,5738,113,2.008888888888889
Kalamb (Os),Green Gram,2016,6319,6432,113,1.7882576357018516
Jalgaon,Banana,2015,245,358,113,46.12244897959184
Bhiwapur,Paddy-Unhusked,2015,1750,1863,113,6.457142857142857
Washim,Pigeon Pea (Tur),2016,6632,6744,112,1.6887816646562124
Vaijapur,Pigeon Pea (Tur),2016,7193,7305,112,1.5570693730015293
Akluj,Bajri,2014,1526,1638,112,7.339449541284404
Shevgaon-Bodhegaon,Pigeon Pea (Tur),2015,5044,5156,112,2.2204599524187154
Islampur,Flower,2016,97,209,112,115.4639175257732
Yawal,Onion,2016,443,555,112,25.28216704288939
Jalgaon Jamod,Maize,2014,934,1046,112,11.991434689507495
Amalner,Maize,2016,1331,1443,112,8.414725770097672
Bhiwapur,Green Chilli,2015,1734,1846,112,6.459054209919262
Amarawati,Cotton,2016,4713,4825,112,2.376405686399321
Amarawati,Cotton,2015,4333,4445,112,2.5848142164781907
Dudhani,Sorgum(Jawar),2015,1980,2092,112,5.656565656565657
Akot,Maize,2016,1000,1112,112,11.2
Ghansawangi,Bajri,2015,1613,1725,112,6.9435833849969
Vaduj,Sorgum(Jawar),2014,2013,2125,112,5.563835072031793
Indapur,Maize,2016,1572,1684,112,7.124681933842239
Indapur (Nimgaon Ketki),Wheat(Husked),2015,1397,1509,112,8.017179670722978
Vaduj,Sorgum(Jawar),2014,2163,2275,112,5.17799352750809
Vaduj,Bajri,2015,1413,1525,112,7.926397735314933
Gangakhed,Sorgum(Jawar),2016,1713,1825,112,6.538237011091652
Shevgaon,Bajri,2015,1188,1300,112,9.427609427609427
Vaijapur,Sorgum(Jawar),2016,1624,1736,112,6.896551724137931
Shirpur,Bajri,2015,1117,1229,112,10.026857654431513
Chopda,Sorgum(Jawar),2016,1484,1596,112,7.547169811320755
Balapur,Soybean,2015,3088,3200,112,3.626943005181347
Jalgaon,Wheat(Husked),2015,1528,1640,112,7.329842931937173
Shevgaon-Bodhegaon,Sorgum(Jawar),2016,1526,1638,112,7.339449541284404
Devala,Maize,2015,1252,1364,112,8.945686900958467
Shahada,Cotton,2015,3913,4025,112,2.862254025044723
Sillod-Bharadi,Maize,2016,1563,1675,112,7.165706973768394
Kundalwadi,Soybean,2015,3535,3647,112,3.1683168316831685
Partur,Bajri,2016,1330,1442,112,8.421052631578947
Rajura,Gram,2016,5487,5599,112,2.041188263167487
Katol,Wheat(Husked),2016,1513,1625,112,7.402511566424322
Telhara,Sorgum(Jawar),2016,1275,1387,112,8.784313725490197
Rahata,Wheat(Husked),2014,1499,1611,112,7.471647765176784
Partur,Bajri,2016,1590,1702,112,7.044025157232705
Pachora,Sorgum(Jawar),2016,1621,1733,112,6.909315237507712
Partur,Black Gram,2014,4400,4512,112,2.5454545454545454
Tuljapur,Gram,2016,4281,4393,112,2.6162111656155105
Navapur,Paddy-Unhusked,2015,1524,1636,112,7.349081364829396
Jalna,Wheat(Husked),2015,1648,1760,112,6.796116504854369
Tumsar,Paddy-Unhusked,2014,2028,2140,112,5.522682445759369
Tumsar,Paddy-Unhusked,2015,1679,1791,112,6.670637284097677
Parli-Vaijnath,Bajri,2015,1245,1357,112,8.995983935742972
Nandurbar,Pigeon Pea (Tur),2015,8223,8335,112,1.3620333211723215
Lakhandur,Black Gram,2016,10729,10841,112,1.043899711063473
Tiroda,Paddy-Unhusked,2016,1710,1822,112,6.549707602339181
Parbhani,Sorgum(Jawar),2015,1563,1675,112,7.165706973768394
Morshi,Sorgum(Jawar),2016,1306,1418,112,8.575803981623277
Manmad,Maize,2015,1143,1255,112,9.798775153105861
Jawala-Bajar,Wheat(Husked),2015,1613,1725,112,6.9435833849969
Mumbai,Curry Leaves,2015,1232,1344,112,9.090909090909092
Lonar,Wheat(Husked),2015,1395,1507,112,8.028673835125447
Pune,Maize,2016,1788,1900,112,6.263982102908278
Nandgaon,Wheat(Husked),2016,1869,1981,112,5.992509363295881
Pune-Pimpri,Chavli (Shenga ),2016,2663,2775,112,4.205782951558393
Tasgaon,Gram,2016,4113,4225,112,2.723073182591782
Nandurbar,Maize,2016,1458,1570,112,7.681755829903978
Barshi,Paddy-Unhusked,2015,1433,1544,111,7.745987438939288
Gondiya,PADDY-UNHUSKED,2016,1404,1515,111,7.905982905982906
Chopda,Maize,2015,1271,1382,111,8.733280881195908
Chopda,Wheat(Husked),2016,1696,1807,111,6.544811320754717
Vaduj,Soybean,2015,3489,3600,111,3.181427343078246
Rahata,Ghevda,2015,3111,3222,111,3.5679845708775315
Vaduj,Wheat(Husked),2015,1589,1700,111,6.985525487728131
Sangli-Miraj,Wheat(Unhusked),2016,3581,3692,111,3.0996928232337337
Kalamb (Os),Maize,2015,1663,1774,111,6.674684305472039
Dhule,Soybean,2014,3170,3281,111,3.501577287066246
Vaijapur,Maize,2015,1335,1446,111,8.314606741573034
Tumsar,Gram,2015,3100,3211,111,3.5806451612903225
Ghatanji,Cotton,2014,3927,4038,111,2.826585179526356
Rahata,Walvad,2016,1611,1722,111,6.890130353817504
Barshi,Chikoo,2015,124,235,111,89.51612903225806
Barshi,Bor,2014,81,192,111,137.03703703703704
Jalna-Badnapur,Sorgum(Jawar),2016,1636,1747,111,6.784841075794621
Shrigonda-Ghogargaon,COTTON,2016,4917,5028,111,2.2574740695546063
Kannad,Maize,2016,1293,1404,111,8.584686774941995
Paithan,Sorgum(Jawar),2016,1655,1766,111,6.706948640483383
Amalner,Maize,2016,1428,1539,111,7.773109243697479
Rahata,Ghevda,2015,3389,3500,111,3.2753024491000295
Kannad,Sorgum(Jawar),2016,1536,1647,111,7.2265625
Rahuri-Vambori,Ground Nut Pods (Dry),2014,3649,3760,111,3.0419292956974515
Morshi,Sorgum(Jawar),2014,1364,1475,111,8.137829912023461
Kolhapur,Raddish,2015,90,201,111,123.33333333333333
Vaduj,Sorgum(Jawar),2016,2200,2311,111,5.045454545454546
Sangli-Phale Bhajipalam,Water Melon,2016,83,194,111,133.73493975903614
Devala,Sorgum(Jawar),2015,1754,1865,111,6.328392246294185
Kada,Tamarind Seed,2015,1410,1521,111,7.872340425531915
Rahata,Sorgum(Jawar),2016,1477,1588,111,7.515233581584292
Jamner-Neri,Cotton,2016,4378,4489,111,2.535404294198264
Chakur,Soybean,2016,3653,3764,111,3.0385984122638927
Kalamb (Os),Green Gram,2015,6789,6900,111,1.6349977905435262
Shrirampur,Bajri,2016,1546,1657,111,7.179818887451487
Rahuri-Vambori,Ground Nut Pods (Dry),2014,3921,4032,111,2.8309104820198927
Manchar,Cabbage,2015,342,453,111,32.45614035087719
Malkapur,Sorgum(Jawar),2016,1471,1582,111,7.545887151597553
Loha,Pigeon Pea (Tur),2014,4650,4761,111,2.3870967741935485
Bhokar,Cotton,2014,3855,3966,111,2.8793774319066148
Latur,Bajri,2015,1228,1339,111,9.039087947882736
Yeola,Bajri,2015,1255,1366,111,8.844621513944222
Malkapur,Maize,2016,1539,1650,111,7.212475633528265
Kalamnuri,Gram,2016,4164,4275,111,2.6657060518731988
Nampur,Wheat(Husked),2016,1575,1686,111,7.0476190476190474
Kalamb (Os),Sesamum,2016,6278,6389,111,1.768079006052883
Pathardi,Sorgum(Jawar),2016,1625,1736,111,6.8307692307692305
Aheri,Gram,2015,3002,3113,111,3.6975349766822116
Ahmedpur,Soybean,2016,3901,4012,111,2.8454242501922584
Vaduj,Gram,2015,4467,4578,111,2.4848891873740766
Vaduj,Bajri,2014,1400,1511,111,7.928571428571429
Jintur,Cotton,2016,4761,4872,111,2.3314429741650913
Lasalgaon-Vinchur,Maize,2016,1345,1456,111,8.25278810408922
Pulgaon,Cotton,2015,3989,4100,111,2.782652293807972
Kalvan,Wheat(Husked),2015,1555,1666,111,7.138263665594855
Khamgaon,Bajri,2015,1355,1466,111,8.191881918819188
Vaijapur,Ground Nut Pods (Dry),2016,5808,5919,111,1.9111570247933884
Shrirampur,Mustard,2015,3197,3308,111,3.4720050046918987
Gondpimpri,Paddy-Unhusked,2015,2161,2272,111,5.1365108745950945
Shrirampur-Belapur,BAJRI,2016,1078,1189,111,10.296846011131725
Shirur,Bajri,2016,1342,1453,111,8.27123695976155
Tumsar,Green Gram,2016,5207,5318,111,2.1317457269060878
Pulgaon,Cotton,2014,3875,3986,111,2.8645161290322583
Rahuri-Vambori,Wheat(Husked),2016,1729,1840,111,6.4198958935801045
Lasur Station,Maize,2015,1137,1248,111,9.762532981530343
Pathari,Bajri,2015,1300,1411,111,8.538461538461538
Bhokardan-Pimpalgaon Renu,Soybean,2016,3490,3600,110,3.151862464183381
Khed (Shel Pimpalgaon),Green Chilli,2015,2614,2724,110,4.208110175975516
Sindevahi,Paddy-Unhusked,2016,2187,2297,110,5.029721079103795
Dhule,Maize,2015,1105,1215,110,9.95475113122172
Telhara,Wheat(Husked),2016,1656,1766,110,6.642512077294686
Tuljapur,Sunflower,2015,3940,4050,110,2.7918781725888326
Ausa,Bajri,2016,1841,1951,110,5.975013579576317
Umared,Mustard,2015,2660,2770,110,4.135338345864661
Washi(Osmanabad),Sunflower,2015,2890,3000,110,3.8062283737024223
Sangamner,Sorgum(Jawar),2015,1690,1800,110,6.508875739644971
Sangli-Miraj,Wheat(Unhusked),2016,3373,3483,110,3.261191817373258
Sindkhed Raja,Maize,2015,1310,1420,110,8.396946564885496
Sangrampur-Varvatbakal,MAIZE,2016,990,1100,110,11.11111111111111
Balapur,Soybean,2016,3440,3550,110,3.197674418604651
Kalamb (Os),Bajri,2015,1448,1558,110,7.596685082872928
Bhokardan,Pigeon Pea (Tur),2015,4840,4950,110,2.272727272727273
Vani,Soybean,2016,2775,2885,110,3.963963963963964
Bhokardan,Cotton,2015,4180,4290,110,2.6315789473684212
Savali,Paddy-Unhusked,2016,1869,1979,110,5.8855002675227395
Vani,Pigeon Pea (Tur),2014,4651,4761,110,2.3650827778972263
Vaijapur,Sorgum(Jawar),2016,1849,1959,110,5.949161709031909
Bhokar,Soybean,2015,3206,3316,110,3.4310667498440424
Chakur,SUNFLOWER,2016,2942,3052,110,3.7389530931339223
Bhiwapur,Paddy-Unhusked,2015,1988,2098,110,5.533199195171026
Udgir,Pigeon Pea (Tur),2016,8999,9109,110,1.222358039782198
Manchar,Carrot,2015,1600,1710,110,6.875
Tumsar,Lentil,2016,5062,5172,110,2.173054128802845
Mandhal,Gram,2016,4178,4288,110,2.6328386787936813
Vasai,Paddy-Unhusked,2015,1481,1591,110,7.427413909520594
Chandrapur,Gram,2015,4175,4285,110,2.6347305389221556
Barshi,Water Melon,2015,50,160,110,220.0
Barshi,Squash Gourd,2015,119,229,110,92.43697478991596
Kopargaon,Maize,2016,1578,1688,110,6.97084917617237
Barshi,Capsicum,2015,115,225,110,95.65217391304348
Mohol,Maize,2016,1687,1797,110,6.520450503852993
Shegaon,Wheat(Husked),2015,1391,1501,110,7.907979870596693
Darwha,Soybean,2015,3650,3760,110,3.0136986301369864
Shegaon,Black Gram,2016,8095,8205,110,1.358863495985176
Mohol,Wheat(Husked),2016,1650,1760,110,6.666666666666667
Devala,Bajri,2015,1385,1495,110,7.9422382671480145
Kej,Sorgum(Jawar),2015,2290,2400,110,4.8034934497816595
Ashti-Karanja,Wheat(Husked),2016,1500,1610,110,7.333333333333333
Bhusaval,Gram,2014,2265,2375,110,4.856512141280353
Partur,Bajri,2015,1865,1975,110,5.898123324396783
Vaduj,Cowpea,2016,4490,4600,110,2.4498886414253898
Amarawati,Maize,2014,1210,1320,110,9.090909090909092
Taloda,Cotton,2015,3851,3961,110,2.856400934822124
Sonpeth,Bajri,2016,1405,1515,110,7.829181494661921
Amarawati,Maize,2016,1563,1673,110,7.037747920665387
Sangali,Maize,2016,1750,1860,110,6.285714285714286
Navapur,Wheat(Husked),2016,1406,1516,110,7.823613086770981
Gangapur,Sorgum(Jawar),2016,1719,1829,110,6.399069226294357
Taloda,Bajri,2015,1310,1420,110,8.396946564885496
Umarga,Maize,2015,1380,1490,110,7.971014492753623
Parli-Vaijnath,Bajri,2016,1359,1469,110,8.094186902133922
Parola,Maize,2015,1269,1379,110,8.668242710795901
Rahata,Gram,2016,4568,4678,110,2.408056042031524
Ahmedpur,Sunflower,2015,3048,3158,110,3.608923884514436
Akhadabalapur,Soybean,2015,3170,3280,110,3.470031545741325
Osmanabad,Wheat(Husked),2015,2790,2900,110,3.942652329749104
Tasgaon,Soybean,2016,2790,2900,110,3.942652329749104
Rajura,Soybean,2016,3448,3558,110,3.1902552204176335
Aheri,Green Gram,2015,6040,6150,110,1.8211920529801324
Shrirampur,Maize,2016,1305,1415,110,8.42911877394636
Ghoti,Cabbage,2014,859,968,109,12.689173457508732
Patur,SORGUM(JAWAR),2016,1358,1467,109,8.026509572901325
Manwat,Sorgum(Jawar),2016,1766,1875,109,6.172140430351076
Kopargaon,Maize,2016,1324,1433,109,8.23262839879154
Bhokar,Wheat(Husked),2014,1375,1484,109,7.927272727272728
Chopda,Wheat(Husked),2016,1663,1772,109,6.554419723391462
Sonpeth,Wheat(Husked),2015,1844,1953,109,5.911062906724512
Savner,Maize,2015,1270,1379,109,8.582677165354331
Savali,Paddy-Unhusked,2016,1934,2043,109,5.63598759048604
Darwha,Cotton,2014,3941,4050,109,2.765795483379853
Kannad,Maize,2015,1234,1343,109,8.833063209076174
Chikhali,Soybean,2016,3155,3264,109,3.4548335974643423
Kopargaon,Maize,2015,1112,1221,109,9.802158273381295
Shrirampur,Bajri,2015,1397,1506,109,7.802433786685755
Morshi,Soybean,2015,3134,3243,109,3.4779834077855774
Shegaon,Sorgum(Jawar),2016,1269,1378,109,8.58944050433412
Rahata,Bajri,2015,1211,1320,109,9.000825763831545
Amarawati,Gram,2015,4897,5006,109,2.225852562793547
Devala,Bajri,2015,1307,1416,109,8.339709257842387
Lohara,Sorgum(Jawar),2016,1825,1934,109,5.972602739726027
Gondiya,Paddy-Unhusked,2015,1413,1522,109,7.714083510261855
Kalamb (Os),Sunflower,2015,3227,3336,109,3.377750232414007
Kada,Maize,2015,1201,1310,109,9.075770191507077
Varud-Rajura Bazar,SORGUM(JAWAR),2016,1341,1450,109,8.128262490678598
Shahada,Bajri,2015,1403,1512,109,7.769066286528867
Kalamb (Os),Soybean,2015,3777,3886,109,2.8858882711146414
Ralegaon,Cotton,2014,3931,4040,109,2.772831340625795
Ralegaon,Cotton,2015,4000,4109,109,2.725
Ahmedpur,Sunflower,2016,3360,3469,109,3.244047619047619
Lasur Station,Soybean,2015,3644,3753,109,2.991218441273326
Malegaon,Soybean,2015,3589,3698,109,3.037057676232934
Kalvan,Bajri,2015,1109,1218,109,9.828674481514879
Chamorshi,Paddy-Unhusked,2015,1780,1889,109,6.123595505617978
Shahapur,Paddy-Unhusked,2014,1428,1537,109,7.633053221288516
Rahuri-Vambori,Maize,2014,1094,1203,109,9.963436928702011
Jalgaon,Banana,2015,227,336,109,48.01762114537445
Sinner,Tamarind,2015,1255,1364,109,8.685258964143426
Gondiya,Paddy-Unhusked,2016,1644,1753,109,6.630170316301703
Tumsar,Other Cereals,2015,1884,1993,109,5.785562632696391
Bhiwapur,SOYBEAN,2016,2682,2791,109,4.064131245339299
Indapur-Bhigwan,Maize,2015,1421,1530,109,7.670654468684026
Vaijapur,Green Gram,2016,5034,5143,109,2.1652761223678985
Purna,Wheat(Husked),2016,1634,1743,109,6.670746634026928
Mangrulpeer,Wheat(Husked),2016,1630,1739,109,6.6871165644171775
Shrirampur-Belapur,Wheat(Husked),2016,1468,1577,109,7.425068119891008
Palghar(Bevur),Onion,2015,1550,1659,109,7.032258064516129
Kinwat,SOYBEAN,2016,2782,2891,109,3.9180445722501798
Shevgaon-Bodhegaon,SORGUM(JAWAR),2016,2278,2387,109,4.784899034240562
Armori,Paddy-Unhusked,2016,1709,1818,109,6.377998829724985
Shirur,MAIZE,2016,1198,1307,109,9.098497495826377
Khamgaon,Maize,2015,983,1092,109,11.088504577822992
Gangapur,Bajri,2015,1274,1383,109,8.555729984301413
Sillod-Bharadi,Maize,2016,1597,1706,109,6.825297432686287
Murud,Paddy-Unhusked,2016,1454,1563,109,7.49656121045392
Sindevahi,Paddy-Unhusked,2015,1635,1744,109,6.666666666666667
Sillod,Maize,2016,1583,1692,109,6.885660138976626
Nandura,Bajri,2016,1600,1709,109,6.8125
Ashti (Jalna),Wheat(Husked),2016,1625,1734,109,6.707692307692308
Dharni,Cotton,2016,4386,4495,109,2.4851801185590516
Newasa,Gram,2016,5333,5442,109,2.0438777423588976
Jawala-Bajar,Wheat(Husked),2015,1658,1767,109,6.574185765983112
Murbad,Paddy-Unhusked,2015,1800,1909,109,6.055555555555555
Armori-Desaiganj,Paddy-Unhusked,2015,1443,1552,109,7.553707553707554
Taloda,Bajri,2015,1476,1585,109,7.384823848238482
Khamgaon,Sunflower,2016,3244,3353,109,3.3600493218249077
Umared,Linseed,2016,7241,7350,109,1.5053169451733186
Karanja,Sorgum(Jawar),2016,1583,1692,109,6.885660138976626
Dhamangaon-Rly,Wheat(Husked),2016,1528,1637,109,7.133507853403142
Sinner,Sorgum(Jawar),2016,1460,1569,109,7.465753424657534
Telhara,Sorgum(Jawar),2016,1260,1369,109,8.65079365079365
Mumbai,Curry Leaves,2015,1058,1167,109,10.302457466918714
Nandurbar,Rice(Paddy-Hus),2016,3294,3402,108,3.278688524590164
Chamorshi,Paddy-Unhusked,2016,1924,2032,108,5.613305613305613
Dound,Maize,2015,1393,1501,108,7.753050969131371
Pune-Pimpri,Cabbage,2014,732,840,108,14.754098360655737
Khed (Shel Pimpalgaon),Bottle Gourd,2015,517,625,108,20.889748549323016
Lasur Station,Maize,2016,1310,1418,108,8.244274809160306
Rahata,Wheat(Husked),2015,1415,1523,108,7.6325088339222615
Chalisgaon,Maize,2015,1108,1216,108,9.747292418772563
Shirur,Sorgum(Jawar),2015,1579,1687,108,6.839772007599747
Basmat,Green Gram,2015,7400,7508,108,1.4594594594594594
Chalisgaon,Maize,2016,1300,1408,108,8.307692307692308
Nashik,Mint,2015,125,233,108,86.4
Basmat,Soybean,2015,3613,3721,108,2.9892056462773318
Dound,Maize,2015,1377,1485,108,7.8431372549019605
Kej,Bajri,2015,1449,1557,108,7.453416149068323
Armori,Paddy-Unhusked,2015,1576,1684,108,6.852791878172589
Gadchiroli,Paddy-Unhusked,2015,1675,1783,108,6.447761194029851
Zarijamini,Cotton,2016,4405,4513,108,2.4517593643586832
Kalamb (Os),Bajri,2016,1358,1466,108,7.952871870397644
Nandurbar,Gram,2015,3622,3730,108,2.9817780231916067
Nandurbar,Gram,2015,4175,4283,108,2.586826347305389
Sailu,Cotton,2014,4020,4128,108,2.6865671641791047
Bhusaval,Sorgum(Jawar),2015,1153,1261,108,9.366869037294016
Pune-Pimpri,Flower,2016,988,1096,108,10.931174089068826
Kalamb (Os),SUNFLOWER,2016,2703,2811,108,3.995560488346282
Kalamb (Os),Safflower,2016,2536,2644,108,4.2586750788643535
Yeola,Maize,2016,1779,1887,108,6.070826306913997
Bori,Green Gram,2016,4826,4934,108,2.2378781599668462
Lonar,Wheat(Husked),2016,1664,1772,108,6.490384615384615
Brahmpuri,PADDY-UNHUSKED,2016,1701,1809,108,6.349206349206349
Loha,Wheat(Husked),2014,1391,1499,108,7.764198418404026
Nandura,Green Gram,2015,7575,7683,108,1.4257425742574257
Sengaon,Ground Nut Pods (Dry),2015,5200,5308,108,2.076923076923077
Dudhani,Bajri,2015,1263,1371,108,8.551068883610451
Nandurbar,Green Gram,2016,5327,5435,108,2.027407546461423
Yeola,Maize,2015,1345,1453,108,8.029739776951672
Shirpur,Maize,2016,1550,1658,108,6.967741935483871
Barshi-Vairag,Maize,2015,1181,1289,108,9.144792548687553
Barshi,PADDY-UNHUSKED,2016,1646,1754,108,6.561360874848116
Shirur,Gram,2016,5900,6008,108,1.8305084745762712
Mantha,Black Gram,2014,4348,4456,108,2.483900643974241
Ghatanji,Soybean,2015,3100,3208,108,3.4838709677419355
Rahuri-Vambori,Wheat(Husked),2014,1473,1581,108,7.3319755600814664
Alibag,Paddy-Unhusked,2016,1454,1562,108,7.4277854195323245
Sillod,Bajri,2016,1296,1404,108,8.333333333333334
Amalner,Maize,2015,1354,1462,108,7.976366322008863
Jawala-Bajar,Soybean,2016,3697,3805,108,2.9212875304300785
Newasa,Wheat(Husked),2016,1567,1675,108,6.892150606253988
Pachora,Sorgum(Jawar),2016,1550,1658,108,6.967741935483871
Kolhapur-Malkapur,CABBAGE,2016,100,208,108,108.0
Soygaon,Cotton,2015,4240,4348,108,2.547169811320755
Vaduj,Maize,2016,1438,1546,108,7.510431154381084
Dhamangaon-Rly,COTTON,2016,4864,4972,108,2.2203947368421053
Soygaon,Cotton,2015,3917,4025,108,2.7572121521572632
Kinwat,Soybean,2015,3388,3496,108,3.187721369539551
Barshi,Brinjal,2014,150,258,108,72.0
Gevrai,Maize,2015,1295,1403,108,8.339768339768339
Taloda,Bajri,2014,1340,1448,108,8.059701492537313
Sangamner,Sorgum(Jawar),2016,1845,1953,108,5.853658536585366
Rahata,SOYBEAN,2016,2667,2775,108,4.049493813273341
Purna,Soybean,2016,2743,2851,108,3.937294932555596
Tiroda,Paddy-Unhusked,2016,1666,1774,108,6.482593037214886
Pandharpur,Sorgum(Jawar),2016,1879,1987,108,5.747738158594998
Parbhani,Soybean,2015,3096,3204,108,3.488372093023256
Jamner-Neri,Cotton,2015,3750,3858,108,2.88
Shrirampur-Belapur,Wheat(Husked),2016,1490,1598,108,7.248322147651007
Khed (Shel Pimpalgaon),Brinjal,2016,1365,1473,108,7.912087912087912
Barshi,BAJRI,2016,1181,1289,108,9.144792548687553
Rahuri-Vambori,Wheat(Husked),2014,1545,1653,108,6.990291262135922
Baramati,Maize,2016,1355,1463,108,7.970479704797048
Tumsar,Lentil,2015,3620,3728,108,2.983425414364641
Chimur,Paddy-Unhusked,2014,1947,2055,108,5.546995377503852
Kinwat,Cotton,2014,3882,3989,107,2.7563111798042246
Dhadgaon,Bhagar/Vari,2016,1512,1619,107,7.076719576719577
Khed (Shel Pimpalgaon),Flower,2015,892,999,107,11.995515695067265
Solapur,Papai,2015,329,436,107,32.52279635258358
Umarga,Safflower,2016,2423,2530,107,4.4160132067684685
Dudhani,Sorgum(Jawar),2016,1958,2065,107,5.464759959141982
Chikhali,Sorgum(Jawar),2015,1103,1210,107,9.700815956482321
Chimur,Paddy-Unhusked,2015,1966,2073,107,5.442522889114954
Kannad,Sorgum(Jawar),2015,1316,1423,107,8.130699088145896
Chopda,Ground Nut Pods (Dry),2015,4833,4940,107,2.2139457893647836
Dudhani,Bajri,2016,1598,1705,107,6.6958698372966206
Karanja,Sorgum(Jawar),2014,1512,1619,107,7.076719576719577
Umari,Sorgum(Jawar),2016,1337,1444,107,8.00299177262528
Sailu,Cotton,2015,3868,3975,107,2.766287487073423
Chikhali,Wheat(Husked),2015,1418,1525,107,7.545839210155148
Latur-Murud,Maize,2016,1272,1379,107,8.41194968553459
Sailu,Cotton,2015,3836,3943,107,2.789363920750782
Udgir,Safflower,2016,4315,4422,107,2.4797219003476245
Satana,Maize,2015,1432,1539,107,7.472067039106145
Chopda,Sorgum(Jawar),2015,1199,1306,107,8.924103419516264
Samudrapur,Gram,2016,4076,4183,107,2.6251226692836114
Kalamb (Os),Safflower,2015,2586,2693,107,4.137664346481052
Gadchiroli,Paddy-Unhusked,2015,1607,1714,107,6.658369632856254
Lonar,Sorgum(Jawar),2015,1052,1159,107,10.171102661596958
Bhokardan,Wheat(Husked),2016,1531,1638,107,6.988896146309601
Shrirampur,Bajri,2016,1709,1816,107,6.2609713282621415
Parli-Vaijnath,Bajri,2016,1376,1483,107,7.776162790697675
Bhiwapur,Soybean,2015,3533,3640,107,3.028587602604019
Shirur,Pigeon Pea (Tur),2016,6333,6440,107,1.6895626085583453
Shirur,SORGUM(JAWAR),2016,1753,1860,107,6.103822019395322
Amarawati,Pumpkin,2016,1433,1540,107,7.46685275645499
Akhadabalapur,Cotton,2015,4000,4107,107,2.675
Sindevahi,Paddy-Unhusked,2016,2248,2355,107,4.759786476868327
Yawal,Sorgum(Jawar),2015,1208,1315,107,8.857615894039736
Mumbai,Curry Leaves,2016,912,1019,107,11.732456140350877
Tumsar,Castor Seed,2015,3337,3444,107,3.2064728798321847
Nagpur,Melon,2015,437,544,107,24.48512585812357
Murtizapur,Wheat(Husked),2015,1401,1508,107,7.637401855817274
Barshi,Chikoo,2016,121,228,107,88.4297520661157
Wardha,Wheat(Husked),2016,1666,1773,107,6.422569027611044
Nandura,Bajri,2016,1309,1416,107,8.174178762414057
Barshi,Ridge Gourd,2015,109,216,107,98.1651376146789
Manmad,Sorgum(Jawar),2016,1784,1891,107,5.997757847533633
Morshi,Wheat(Husked),2015,1536,1643,107,6.966145833333333
Akot,Sorgum(Jawar),2015,1083,1190,107,9.879963065558634
Telhara,Sorgum(Jawar),2016,1336,1443,107,8.008982035928144
Navapur,Onion,2015,1300,1407,107,8.23076923076923
Nandurbar,Maize,2016,1457,1564,107,7.3438572409059715
Morshi,Wheat(Husked),2016,1585,1692,107,6.750788643533123
Partur,Sorgum(Jawar),2016,1756,1863,107,6.093394077448747
Solapur,BAJRI,2016,1496,1603,107,7.152406417112299
Jalna,Jaggery,2015,2350,2457,107,4.553191489361702
Murum,Sorgum(Jawar),2016,1922,2029,107,5.567117585848075
Yeola,Bajri,2015,1270,1377,107,8.4251968503937
Bhokardan,Soybean,2016,3729,3836,107,2.8694019844462324
Pusad,Bajri,2016,1484,1590,106,7.142857142857143
Gadchiroli,Paddy-Unhusked,2016,1866,1972,106,5.680600214362272
Kannad,Sorgum(Jawar),2016,1789,1895,106,5.925097820011179
Lakhandur,Paddy-Unhusked,2014,1675,1781,106,6.3283582089552235
Shevgaon,Bajri,2015,1219,1325,106,8.695652173913043
Sinner,Maize,2014,1107,1213,106,9.57542908762421
Kalyan,Wheat(Husked),2016,2118,2224,106,5.004721435316336
Rahuri,Wheat(Husked),2015,1404,1510,106,7.54985754985755
Kalamb (Os),Bajri,2015,1300,1406,106,8.153846153846153
Morshi,Wheat(Husked),2015,1494,1600,106,7.095046854082999
Amarawati,Cucumber,2016,483,589,106,21.946169772256727
Rahata,Wheat(Husked),2014,1489,1595,106,7.118871725990598
Morshi,Wheat(Husked),2016,1600,1706,106,6.625
Devala,Wheat(Husked),2015,1334,1440,106,7.946026986506746
Chopda,Sunflower,2016,2700,2806,106,3.925925925925926
Tasgaon,Maize,2016,1430,1536,106,7.4125874125874125
Navapur,Cabbage,2015,744,850,106,14.24731182795699
Tumsar,Paddy-Unhusked,2014,1862,1968,106,5.692803437164339
Shegaon,Wheat(Husked),2015,1360,1466,106,7.794117647058823
Akot,Sorgum(Jawar),2015,1184,1290,106,8.952702702702704
Darwha,Cotton,2016,4506,4612,106,2.3524189968930314
Sillod,Maize,2016,1472,1578,106,7.201086956521739
Dhadgaon,MAIZE,2016,1081,1187,106,9.805735430157261
Karanja,Sorgum(Jawar),2015,1283,1389,106,8.261886204208885
Pandharpur,Gram,2015,3310,3416,106,3.202416918429003
Ghoti,Paddy-Unhusked,2015,2036,2142,106,5.206286836935167
Purna,Ground Nut Pods (Dry),2014,3845,3951,106,2.756827048114434
Manmad,Brinjal,2016,148,254,106,71.62162162162163
Kada,Maize,2015,1491,1597,106,7.109322602280349
Varud,SORGUM(JAWAR),2016,1253,1359,106,8.459696727853153
Chalisgaon,Maize,2014,1189,1295,106,8.915054667788057
Islampur,Bitter Gourd,2016,86,192,106,123.25581395348837
Vaduj,Gram,2015,4200,4306,106,2.5238095238095237
Ahmedpur,Sorgum(Jawar),2016,1553,1659,106,6.825499034127495
Partur,Neem-Seed,2015,448,554,106,23.660714285714285
Tumsar,Linseed,2016,5907,6013,106,1.7944811240900627
Buldhana,Maize,2015,1367,1473,106,7.754206291148501
Ralegaon,Cotton,2014,3744,3850,106,2.8311965811965814
Rahata,BAJRI,2016,1199,1305,106,8.84070058381985
Pune-Pimpri,ONION,2016,671,777,106,15.797317436661698
Khed (Shel Pimpalgaon),Bottle Gourd,2014,306,412,106,34.64052287581699
Yeola,Wheat(Husked),2016,1557,1663,106,6.8079640333975595
Khed (Shel Pimpalgaon),Cluster Bean,2015,1454,1560,106,7.290233837689134
Vaduj,Maize,2015,1450,1556,106,7.310344827586207
Kinwat,Gram,2016,4050,4156,106,2.617283950617284
Akhadabalapur,Soybean,2016,3588,3694,106,2.9542920847268674
Parbhani,Wheat(Husked),2015,1466,1572,106,7.230559345156889
Ramtek,Gram,2016,5454,5560,106,1.9435276861019435
Akole,Gram,2014,3194,3300,106,3.3187226048841576
Mangrulpeer,Sorgum(Jawar),2016,1198,1304,106,8.848080133555927
Barshi,Ladies Finger,2016,155,261,106,68.38709677419355
Shahapur,Paddy-Unhusked,2015,1459,1565,106,7.26525017135024
Shahada,Maize,2016,1333,1439,106,7.95198799699925
Parbhani,Cotton,2015,3884,3990,106,2.729145211122554
Shahapur,Paddy-Unhusked,2014,1415,1521,106,7.491166077738516
Parbhani,Soybean,2016,3518,3624,106,3.013075611142695
Nandura,Wheat(Husked),2014,1400,1505,105,7.5
Fulambri,Maize,2015,1205,1310,105,8.71369294605809
Ambejogai,Sorgum(Jawar),2015,2043,2148,105,5.139500734214391
Telhara,Cotton,2015,4028,4133,105,2.606752730883813
Nandgaon Khandeshwar,WHEAT(HUSKED),2016,1500,1605,105,7.0
Armori-Desaiganj,Paddy-Unhusked,2016,1559,1664,105,6.735086593970494
Kej,Gram,2015,3800,3905,105,2.763157894736842
Gadchiroli,Paddy-Unhusked,2014,1584,1689,105,6.628787878787879
Khed (Shel Pimpalgaon),Cucumber,2014,667,772,105,15.742128935532234
Nagpur,Melon,2015,458,563,105,22.925764192139738
Gadchiroli,Paddy-Unhusked,2016,1887,1992,105,5.5643879173290935
Washim,Paddy-Unhusked,2015,1350,1455,105,7.777777777777778
Nandgaon,Sorgum(Jawar),2016,1735,1840,105,6.051873198847262
Akot,Wheat(Husked),2016,1705,1810,105,6.158357771260997
Raver,Sorgum(Jawar),2016,1491,1596,105,7.042253521126761
Sakri,Wheat(Husked),2016,1455,1560,105,7.216494845360825
Phaltan,Maize,2015,1253,1358,105,8.379888268156424
Yeotmal,Cotton,2014,3750,3855,105,2.8
Pavani,Paddy-Unhusked,2015,1754,1859,105,5.986316989737742
Patur,Sorgum(Jawar),2015,1387,1492,105,7.570295602018746
Ahmednagar,Bajri,2015,1466,1571,105,7.162346521145976
Patan,Tomato,2015,506,611,105,20.75098814229249
Patan,Bitter Gourd,2015,985,1090,105,10.65989847715736
Partur,Sorgum(Jawar),2016,1611,1716,105,6.517690875232774
Parli-Vaijnath,Sorgum(Jawar),2015,1470,1575,105,7.142857142857143
Umarga,Safflower,2015,2400,2505,105,4.375
Sakri,Soybean,2016,2652,2757,105,3.9592760180995477
Gondpimpri,Paddy-Unhusked,2014,1786,1891,105,5.879059350503919
Gangakhed,Wheat(Husked),2016,1508,1613,105,6.962864721485412
Pandharpur,Gram,2015,3695,3800,105,2.841677943166441
Akot,Cotton,2016,4533,4638,105,2.316346790205162
Palghar(Bevur),Wheat(Husked),2016,2145,2250,105,4.895104895104895
Kannad,Bajri,2015,1068,1173,105,9.831460674157304
Jalna-Badnapur,Sorgum(Jawar),2016,1548,1653,105,6.782945736434108
Kannad,Maize,2016,1306,1411,105,8.039816232771823
Rahata,Soybean,2016,2619,2724,105,4.009163802978236
Sillod,Wheat(Husked),2015,1429,1534,105,7.3477956613016095
Karanja,Sorgum(Jawar),2014,1340,1445,105,7.835820895522388
Gangapur,BAJRI,2016,1398,1503,105,7.510729613733906
Katol,Pigeon Pea (Tur),2014,4382,4487,105,2.3961661341853033
Digras,Soybean,2016,3714,3819,105,2.827140549273021
Ausa,Maize,2015,1169,1274,105,8.982035928143713
Bhokardan-Pimpalgaon Renu,Wheat(Husked),2016,1530,1635,105,6.862745098039215
Dharni,Wheat(Husked),2016,1560,1665,105,6.730769230769231
Lasur Station,Maize,2016,1332,1437,105,7.882882882882883
Beed,Soybean,2015,3438,3543,105,3.054101221640489
Basmat,Wheat(Husked),2015,1388,1493,105,7.564841498559078
Jintur,Pigeon Pea (Tur),2016,6100,6205,105,1.721311475409836
Barshi,Cucumber,2016,100,205,105,105.0
Tumsar,Black Gram,2014,3900,4005,105,2.6923076923076925
Lasalgaon,Pigeon Pea (Tur),2015,7981,8086,105,1.315624608445057
Kolhapur,Raddish,2016,375,480,105,28.0
Chimur,Paddy-Unhusked,2016,1834,1939,105,5.7251908396946565
Chopda,Bajri,2014,1192,1297,105,8.808724832214764
Barshi,Bitter Gourd,2015,145,250,105,72.41379310344827
Jintur,Turmeric,2014,4245,4350,105,2.4734982332155475
Raver,Pigeon Pea (Tur),2015,4191,4296,105,2.5053686471009304
Barshi,Cluster Bean,2015,100,205,105,105.0
Mohol,Maize,2015,1494,1599,105,7.028112449799197
Sangrampur-Varvatbakal,Maize,2016,1600,1705,105,6.5625
Digras,BLACK GRAM,2016,5806,5911,105,1.8084739924216329
Lasur Station,Maize,2016,1285,1390,105,8.171206225680933
Mantha,Safflower,2014,2200,2305,105,4.7727272727272725
Sangli-Miraj,Wheat(Unhusked),2016,3995,4100,105,2.6282853566958697
Udgir,Wheat(Husked),2015,1391,1496,105,7.5485262401150255
Loha,Sorgum(Jawar),2016,1342,1447,105,7.824143070044709
Sindevahi,Paddy-Unhusked,2016,1829,1934,105,5.740841990158557
Lonar,Sorgum(Jawar),2016,1645,1750,105,6.382978723404255
Dhule,Cowpea,2016,4001,4106,105,2.6243439140214946
Udgir,Wheat(Husked),2015,1240,1345,105,8.46774193548387
Sindkhed Raja,SOYBEAN,2016,2705,2810,105,3.8817005545286505
Bhiwapur,Soybean,2015,3400,3505,105,3.088235294117647
Bhusaval,Wheat(Husked),2016,1636,1741,105,6.418092909535452
Chakur,Pigeon Pea (Tur),2016,6168,6273,105,1.7023346303501945
Bhusaval,Sorgum(Jawar),2015,1225,1330,105,8.571428571428571
Dhule,Soybean,2016,2990,3095,105,3.511705685618729
Malkapur,Maize,2016,1521,1626,105,6.903353057199211
Manora,Wheat(Husked),2015,1446,1550,104,7.19225449515906
Manora,Wheat(Husked),2015,1450,1554,104,7.172413793103448
Sailu,Cotton,2014,3940,4044,104,2.6395939086294415
Jalna-Badnapur,Sorgum(Jawar),2016,1604,1708,104,6.483790523690773
Jintur-Bori,Sorgum(Jawar),2015,1132,1236,104,9.187279151943462
Mantha,Cotton,2014,3867,3971,104,2.6894233255753814
Sinner,Maize,2015,1163,1267,104,8.942390369733449
Wardha,Cotton,2014,3925,4029,104,2.6496815286624202
Manmad,Brinjal,2016,194,298,104,53.608247422680414
Majalgaon,Soybean,2014,3223,3327,104,3.2268073223704623
Raver,Maize,2015,1088,1192,104,9.558823529411764
Satana,Maize,2016,1555,1659,104,6.688102893890675
Parbhani,Soybean,2014,3193,3297,104,3.2571249608518635
Mangrulpeer,Sorgum(Jawar),2015,1171,1275,104,8.88129803586678
Akluj,Gram,2015,3756,3860,104,2.768903088391906
Gevrai,Mustard,2015,3353,3457,104,3.1016999701759618
Malkapur,Maize,2015,1012,1116,104,10.276679841897232
Basmat,SOYBEAN,2016,2754,2858,104,3.776325344952796
Solapur,Papai,2016,273,377,104,38.095238095238095
Gondpimpri,Soybean,2015,3293,3397,104,3.1582143941694505
Shahada,Sorgum(Jawar),2016,1766,1870,104,5.889014722536806
Paithan,Gram,2015,4238,4342,104,2.4539877300613497
Dondaicha,Bajri,2015,1200,1304,104,8.666666666666666
Shevgaon-Bodhegaon,Bajri,2015,1307,1411,104,7.957153787299158
Mumbai,Curry Leaves,2015,1184,1288,104,8.783783783783784
Jalgaon,Banana,2016,141,245,104,73.75886524822695
Mumbai,Curry Leaves,2015,1026,1130,104,10.1364522417154
Raver,Sorgum(Jawar),2016,1350,1454,104,7.703703703703703
Jawala-Bajar,Wheat(Husked),2015,1559,1663,104,6.670942912123156
Kolhapur,Banana,2016,894,998,104,11.6331096196868
Murbad,Paddy-Unhusked,2015,1833,1937,104,5.673758865248227
Kolhapur-Laxmipuri,Bajri,2015,1679,1783,104,6.194163192376415
Ashti (Jalna),Sorgum(Jawar),2016,1436,1540,104,7.242339832869081
Khamgaon,Sorgum(Jawar),2016,1488,1592,104,6.989247311827957
Nampur,Maize,2016,1283,1387,104,8.106001558846454
Shegaon,Sorgum(Jawar),2016,1245,1349,104,8.353413654618475
Ambejogai,Sorgum(Jawar),2015,2476,2580,104,4.20032310177706
Gangapur,Gram,2016,4073,4177,104,2.553400441934692
Khed (Shel Pimpalgaon),Coriander  ,2016,151,255,104,68.87417218543047
Shirur,Wheat(Husked),2014,1402,1506,104,7.417974322396576
Kalamb (Os),Bajri,2014,1161,1265,104,8.957795004306632
Barshi,Chikoo,2015,120,224,104,86.66666666666667
Amarawati,Maize,2016,1352,1456,104,7.6923076923076925
Dound,Maize,2016,1688,1792,104,6.161137440758294
Umari,Sorgum(Jawar),2016,1255,1359,104,8.286852589641434
Barshi,Ladies Finger,2015,104,208,104,100.0
Jamner,Cotton,2015,3750,3854,104,2.7733333333333334
Mumbai,Curry Leaves,2016,932,1036,104,11.158798283261802
Mumbai,Curry Leaves,2016,496,600,104,20.967741935483872
Sindevahi,PADDY-UNHUSKED,2016,2096,2199,103,4.91412213740458
Ambejogai,Sorgum(Jawar),2016,1932,2035,103,5.3312629399585925
Sinner,Pigeon Pea (Tur),2014,3057,3160,103,3.3693163231926726
Gevrai,Maize,2015,1296,1399,103,7.947530864197531
Lonar,Soybean,2016,3669,3772,103,2.807304442627419
Arvi,Cotton,2014,3897,4000,103,2.6430587631511417
Mahagaon,Sorgum(Jawar),2016,1597,1700,103,6.4495929868503445
Savner,Wheat(Husked),2015,1223,1326,103,8.421913327882256
Loha,Wheat(Husked),2015,1503,1606,103,6.852960745176314
Bhusaval,Wheat(Husked),2015,1317,1420,103,7.820804859529233
Dhule,Sorgum(Jawar),2016,1667,1770,103,6.1787642471505695
Khed (Shel Pimpalgaon),Flower,2014,400,503,103,25.75
Tuljapur,Maize,2014,981,1084,103,10.499490316004078
Phaltan,Maize,2014,1160,1263,103,8.879310344827585
Bhokardan,Sorgum(Jawar),2016,1250,1353,103,8.24
Sakri,Wheat(Husked),2015,1253,1356,103,8.220271348762969
Chamorshi,Paddy-Unhusked,2016,2295,2398,103,4.4880174291939
Kalvan,Soybean,2015,3259,3362,103,3.160478674440012
Barshi,Cluster Bean,2014,122,225,103,84.42622950819673
Amarawati,Maize,2015,1278,1381,103,8.059467918622849
Amarawati,Maize,2015,1250,1353,103,8.24
Amarawati,Linseed,2015,5000,5103,103,2.06
Chopda,Wheat(Husked),2015,1506,1609,103,6.839309428950863
Paithan,Sorgum(Jawar),2016,1565,1668,103,6.5814696485623
Sindi,COTTON,2016,4828,4931,103,2.1333885666942836
Sillod,Maize,2016,1541,1644,103,6.683971447112265
Kurdwadi-Modnimb,Maize,2015,1540,1643,103,6.688311688311688
Akot,Wheat(Husked),2015,1407,1510,103,7.3205401563610515
Akot,Wheat(Husked),2015,1413,1516,103,7.289455060155697
Devala,Sorgum(Jawar),2015,1869,1972,103,5.510968432316747
Sindi,Cotton,2014,3967,4070,103,2.5964204688681622
Gondiya,Paddy-Unhusked,2015,1347,1450,103,7.646622123236822
Devala,Cowpea,2016,3600,3703,103,2.861111111111111
Dhamangaon-Rly,Wheat(Husked),2015,1538,1641,103,6.697009102730819
Mangaon(Bhadav),Paddy-Unhusked,2015,1381,1484,103,7.4583635047067345
Kalvan,Wheat(Husked),2015,1508,1611,103,6.8302387267904505
Shrirampur,Maize,2015,996,1099,103,10.34136546184739
Umarga,Niger-Seed,2014,3934,4037,103,2.6182003050330453
Sangali,Maize,2016,1573,1676,103,6.547997457088366
Mandhal,Wheat(Husked),2016,1588,1691,103,6.486146095717884
Gondpimpri,Paddy-Unhusked,2015,1856,1959,103,5.549568965517241
Indapur,Maize,2016,1574,1677,103,6.543837357052096
Jalna,Maize,2015,1263,1366,103,8.155186064924782
Jintur,Soybean,2015,3125,3228,103,3.296
Islampur,Green Chilli,2016,98,201,103,105.10204081632654
Ramtek,Paddy-Unhusked,2015,1604,1707,103,6.4214463840399
Jintur,Gram,2015,3966,4069,103,2.5970751386787696
Jawala-Bajar,Soybean,2015,3627,3730,103,2.8398125172318722
Jintur-Bori,Green Gram,2015,7267,7370,103,1.4173661758634926
Kolhapur-Laxmipuri,Maize,2016,1615,1717,102,6.315789473684211
Barshi,Bitter Gourd,2015,150,252,102,68.0
Gondpimpri,Paddy-Unhusked,2015,1782,1884,102,5.723905723905724
Fulambri,Maize,2015,1083,1185,102,9.418282548476455
Tiroda,Paddy-Unhusked,2015,1406,1508,102,7.2546230440967285
Amarawati,Maize,2016,1464,1566,102,6.967213114754099
Amarawati,Maize,2016,1313,1415,102,7.768469154607769
Shevgaon,Pigeon Pea (Tur),2015,5348,5450,102,1.9072550486163051
Tiroda,Paddy-Unhusked,2014,1491,1593,102,6.841046277665996
Sindevahi,Paddy-Unhusked,2015,1539,1641,102,6.627680311890838
Kalvan,Tamarind,2016,2389,2491,102,4.269568857262453
Aheri,Batbati,2015,3516,3618,102,2.901023890784983
Washim-Ansing,Sorgum(Jawar),2016,1260,1362,102,8.095238095238095
Wardha,Gram,2016,3351,3453,102,3.043867502238138
Kalmeshwar,Cotton,2014,3873,3975,102,2.6336173508907823
Dudhani,Gram,2015,4591,4693,102,2.2217381834023087
Chopda,Wheat(Husked),2016,1706,1808,102,5.978898007033997
Gondiya,Paddy-Unhusked,2015,1294,1396,102,7.882534775888717
Tasgaon,Gram,2014,2988,3090,102,3.4136546184738954
Kalvan,Wheat(Husked),2016,1705,1807,102,5.9824046920821115
Majalgaon,Cotton,2015,4058,4160,102,2.5135534746180386
Yeola,Sorgum(Jawar),2016,1630,1732,102,6.257668711656442
Karanja,Sorgum(Jawar),2016,1393,1495,102,7.322325915290739
Jalna-Badnapur,Maize,2015,1228,1330,102,8.306188925081432
Jalna,Jaggery,2015,2286,2388,102,4.4619422572178475
Hinganghat,Cotton,2015,4119,4221,102,2.47632920611799
Parola,Sorgum(Jawar),2016,1405,1507,102,7.259786476868327
Kurdwadi,Wheat(Husked),2014,1348,1450,102,7.566765578635015
Vaijapur,SOYBEAN,2016,2647,2749,102,3.853418964865886
Jintur-Bori,Soybean,2016,3049,3151,102,3.345359134142342
Mangalwedha,MAIZE,2016,1170,1272,102,8.717948717948717
Indapur (Nimgaon Ketki),Maize,2015,1497,1599,102,6.813627254509018
Tumsar,Paddy-Unhusked,2015,1714,1816,102,5.950991831971995
Dhule,Maize,2016,1670,1772,102,6.107784431137724
Shahada,Sorgum(Jawar),2015,1526,1628,102,6.684141546526868
Sailu,Gram,2015,4689,4791,102,2.1753039027511196
Dhule,Sorgum(Jawar),2015,1278,1380,102,7.981220657276995
Barshi,Maize,2016,1705,1807,102,5.9824046920821115
Sangamner,Sorgum(Jawar),2016,1634,1736,102,6.24235006119951
Tumsar,Castor Seed,2014,2798,2900,102,3.645461043602573
Palghar(Bevur),Wheat(Husked),2016,2036,2138,102,5.009823182711198
Kolhapur,BANANA,2016,605,707,102,16.859504132231404
Armori,Paddy-Unhusked,2014,1474,1576,102,6.919945725915875
Paithan,Sorgum(Jawar),2015,1558,1660,102,6.546854942233633
Savner,Pigeon Pea (Tur),2014,4567,4669,102,2.2334136194438363
Sangamner,Soybean,2015,3399,3501,102,3.000882612533098
Parola,Sorgum(Jawar),2016,1282,1384,102,7.956318252730109
Khultabad,Cotton,2015,3823,3925,102,2.6680617316243787
Jalna,Maize,2015,1155,1257,102,8.831168831168831
Kille Dharur,Cotton,2015,3789,3891,102,2.6920031670625493
Alibag,Paddy-Unhusked,2016,1440,1542,102,7.083333333333333
Wardha,Pigeon Pea (Tur),2014,4048,4150,102,2.5197628458498023
Murtizapur,Safflower,2015,2500,2601,101,4.04
Devala,Wheat(Husked),2016,1670,1771,101,6.047904191616767
Ausa,Jaggery,2016,2500,2601,101,4.04
Shevgaon-Bodhegaon,Bajri,2014,1180,1281,101,8.559322033898304
Sindevahi,Paddy-Unhusked,2015,1998,2099,101,5.055055055055055
Shirur,Wheat(Husked),2015,1390,1491,101,7.266187050359712
Shevgaon-Bodhegaon,Sorgum(Jawar),2015,1425,1526,101,7.087719298245614
Murum,Sorgum(Jawar),2016,2090,2191,101,4.832535885167464
Shirur,Sorgum(Jawar),2015,1367,1468,101,7.388441843452816
Bhokardan,Wheat(Husked),2015,1550,1651,101,6.516129032258065
Kej,Sesamum,2015,7300,7401,101,1.3835616438356164
Jintur-Bori,Wheat(Husked),2015,1398,1499,101,7.224606580829756
Taloda,Cotton,2015,3684,3785,101,2.741585233441911
Tumsar,Wheat(Husked),2015,1389,1490,101,7.271418286537077
Mandhal,Wheat(Husked),2016,1514,1615,101,6.67107001321004
Islampur,Capsicum,2016,94,195,101,107.44680851063829
Mangrulpeer,Sorgum(Jawar),2015,1253,1354,101,8.060654429369514
Sonpeth,Safflower,2016,2611,2712,101,3.8682497127537343
Kalamb (Os),Black Gram,2015,5038,5139,101,2.0047637951568085
Shahada,Sorgum(Jawar),2014,1762,1863,101,5.732122587968218
Palghar(Bevur),Onion,2015,4825,4926,101,2.093264248704663
Maregaon,Cotton,2015,4185,4286,101,2.4133811230585422
Baramati,Maize,2015,1292,1393,101,7.817337461300309
Rahuri-Vambori,Bajri,2015,1373,1474,101,7.356154406409322
Rahuri-Vambori,Soybean,2014,3039,3140,101,3.3234616650213886
Khamgaon,Neem-Seed,2015,708,809,101,14.265536723163843
Barshi,Chikoo,2015,101,202,101,100.0
Tumsar,Paddy-Unhusked,2014,1613,1714,101,6.261624302541848
Nagpur,Banana,2016,449,550,101,22.494432071269486
Rajura,Soybean,2016,3456,3557,101,2.9224537037037037
Dudhani,Bajri,2016,1318,1419,101,7.663125948406677
Barshi,Maize,2014,1047,1148,101,9.64660936007641
Digras,Wheat(Husked),2015,1543,1644,101,6.5456902138690864
Aurangabad,Cotton,2014,3942,4043,101,2.562151192288179
Rahata,Wheat(Husked),2016,1479,1580,101,6.8289384719405
Chakur,Soybean,2015,3650,3751,101,2.767123287671233
Naigaon,SORGUM(JAWAR),2016,1150,1251,101,8.782608695652174
Vaijapur,Maize,2015,1111,1212,101,9.090909090909092
Phaltan,Maize,2016,1463,1564,101,6.903622693096377
Rahata,Maize,2014,955,1056,101,10.575916230366492
Kalamb (Os),Maize,2014,1053,1154,101,9.591642924976258
Umared,Lang,2014,1932,2033,101,5.227743271221532
Purna,Sorgum(Jawar),2014,1115,1216,101,9.058295964125561
Chamorshi,Paddy-Unhusked,2015,1733,1834,101,5.8280438545874205
Kopargaon,Maize,2015,1156,1257,101,8.737024221453288
Telhara,Wheat(Husked),2015,1382,1483,101,7.308248914616498
Morshi,Soybean,2015,3111,3211,100,3.2144005143040824
Vaduj,SOYBEAN,2016,2811,2911,100,3.5574528637495555
Barshi,Chikoo,2015,200,300,100,50.0
Barshi,Cluster Bean,2015,400,500,100,25.0
Barshi,Cluster Bean,2015,250,350,100,40.0
Morshi,Wheat(Husked),2015,1506,1606,100,6.6401062416998675
Barshi,Grapes,2015,200,300,100,50.0
Washim,Safflower,2014,2100,2200,100,4.761904761904762
Aurad Shahajani,Soybean,2016,3650,3750,100,2.73972602739726
Sangamner,Gram,2015,3500,3600,100,2.857142857142857
Mauda,Coriander (Dry),2016,7401,7501,100,1.3511687609782461
Telhara,Cotton,2016,4400,4500,100,2.272727272727273
Manwat,Ground Nut Pods (Dry),2016,5334,5434,100,1.8747656542932134
Aurangabad,Math (Bhaji),2014,300,400,100,33.333333333333336
Barshi,Green Chilli,2015,150,250,100,66.66666666666667
Mantha,Safflower,2016,2250,2350,100,4.444444444444445
Nanded,Pigeon Pea (Tur),2015,7867,7967,100,1.271132579128003
Mantha,Bajri,2016,1300,1400,100,7.6923076923076925
Mantha,Wheat(Husked),2015,1450,1550,100,6.896551724137931
Barshi,Ladies Finger,2015,150,250,100,66.66666666666667
Barshi,Ladies Finger,2015,104,204,100,96.15384615384616
Vaduj,Maize,2016,1742,1842,100,5.7405281285878305
Vaduj,Maize,2016,1444,1544,100,6.925207756232687
Mantha,Bajri,2015,1519,1619,100,6.583278472679394
Jalgaon Jamod,Cotton,2014,3950,4050,100,2.5316455696202533
Barshi,Chikoo,2015,90,190,100,111.11111111111111
Morshi,Soybean,2015,3288,3388,100,3.0413625304136254
Rahata,Bottle Gourd,2016,500,600,100,20.0
Morshi,Soybean,2015,3213,3313,100,3.1123560535325243
Morshi,Sorgum(Jawar),2014,1400,1500,100,7.142857142857143
Morshi,Sorgum(Jawar),2014,1400,1500,100,7.142857142857143
Aurangabad,Math (Bhaji),2014,300,400,100,33.333333333333336
Barshi,Bitter Gourd,2015,187,287,100,53.475935828877006
Barshi,Bitter Gourd,2015,248,348,100,40.32258064516129
Barshi,Bitter Gourd,2015,150,250,100,66.66666666666667
Shegaon,Green Gram,2016,6614,6714,100,1.5119443604475356
Barshi,Brinjal,2015,128,228,100,78.125
Aurangabad,Maize(Corn.),2014,400,500,100,25.0
Mohol,Maize,2016,1444,1544,100,6.925207756232687
Rahata,Small Gourd,2016,1660,1760,100,6.024096385542169
Barshi,Capsicum,2015,150,250,100,66.66666666666667
Barshi,Lemon,2014,147,247,100,68.02721088435374
Barshi,Capsicum,2015,150,250,100,66.66666666666667
Sangamner,Wheat(Husked),2014,1450,1550,100,6.896551724137931
Barshi,Capsicum,2015,150,250,100,66.66666666666667
Barshi,Capsicum,2015,105,205,100,95.23809523809524
Mantha,Black Gram,2014,4535,4635,100,2.205071664829107
Washim,Safflower,2014,2900,3000,100,3.4482758620689653
Mohol,Wheat(Husked),2015,1684,1784,100,5.938242280285036
Umarkhed-Danki,Sorgum(Jawar),2015,1400,1500,100,7.142857142857143
Nagpur,Banana,2016,450,550,100,22.22222222222222
Vaduj,Maize,2016,1700,1800,100,5.882352941176471
Manora,Wheat(Husked),2016,1450,1550,100,6.896551724137931
Sangamner,Soybean,2015,3830,3930,100,2.6109660574412534
Jalgaon,Fenugreek,2015,4150,4250,100,2.4096385542168677
Barshi,Flower,2016,100,200,100,100.0
Sillod-Bharadi,Maize,2016,1618,1718,100,6.180469715698393
Jawala-Bajar,Gram,2016,4250,4350,100,2.3529411764705883
Karad,Math (Bhaji),2015,200,300,100,50.0
Khed (Shel Pimpalgaon),Chavli (Shenga ),2015,1503,1603,100,6.65335994677312
Mangrulpeer,Black Gram,2015,5440,5540,100,1.838235294117647
Karad,Flower,2015,613,713,100,16.31321370309951
Jalgaon Jamod,Maize,2014,950,1050,100,10.526315789473685
Tumsar,Other Pulses,2015,2900,3000,100,3.4482758620689653
Barshi,Other Cereals,2016,4575,4675,100,2.185792349726776
Barshi,Shepu,2016,50,150,100,200.0
Washim,Bajri,2015,1450,1550,100,6.896551724137931
Karad,Coriander  ,2015,151,251,100,66.2251655629139
Khed (Shel Pimpalgaon),Ladies Finger,2015,1309,1409,100,7.639419404125286
Arvi,Cotton,2014,3740,3840,100,2.6737967914438503
Karad,Carrot,2015,500,600,100,20.0
Pune-Moshi,Wal Papdi,2016,1800,1900,100,5.555555555555555
Jalgaon,Black Gram,2015,6567,6667,100,1.5227653418608194
Jalgaon Jamod,Sorgum(Jawar),2014,1000,1100,100,10.0
Rahata,Melon,2015,300,400,100,33.333333333333336
Pune-Pimpri,Chavli (Shenga ),2014,2000,2100,100,5.0
Varud-Rajura Bazar,Wheat(Husked),2016,1684,1784,100,5.938242280285036
Islampur,Cucumber,2016,75,175,100,133.33333333333334
Jalgaon Jamod,Soybean,2014,3100,3200,100,3.225806451612903
Ashti-Karanja,Wheat(Husked),2015,1400,1500,100,7.142857142857143
Jawala-Bajar,Gram,2016,5300,5400,100,1.8867924528301887
Vaduj,Maize,2016,1450,1550,100,6.896551724137931
Barshi,Capsicum,2016,133,233,100,75.18796992481202
Vaduj,Sorgum(Jawar),2016,2206,2306,100,4.533091568449683
Sindi (Selu),Cotton,2014,3900,4000,100,2.5641025641025643
Manora,Wheat(Husked),2015,1487,1587,100,6.724949562878279
Manora,Wheat(Husked),2015,1550,1650,100,6.451612903225806
Karad,Tomato,2015,538,638,100,18.587360594795538
Manora,Gram,2014,2250,2350,100,4.444444444444445
Atpadi,Maize,2016,1400,1500,100,7.142857142857143
Rahata,Sorgum(Jawar),2015,1158,1258,100,8.635578583765112
Atpadi,Maize,2016,1400,1500,100,7.142857142857143
Wardha,Cotton,2014,3966,4066,100,2.5214321734745337
Khed,Raddish,2014,201,301,100,49.75124378109453
Atpadi,Maize,2016,1350,1450,100,7.407407407407407
Barshi,Paddy-Unhusked,2015,1394,1494,100,7.173601147776184
Barshi,Spinach,2015,100,200,100,100.0
Atpadi,Maize,2015,1400,1500,100,7.142857142857143
Manmad,Wheat(Husked),2015,1552,1652,100,6.443298969072165
Jalgaon,Guava,2015,1800,1900,100,5.555555555555555
Barshi,Water Melon,2015,100,200,100,100.0
Solapur,Goosefoot,2015,300,400,100,33.333333333333336
Barshi,Bitter Gourd,2016,217,317,100,46.08294930875576
Umared,Sorgum(Jawar),2015,1600,1700,100,6.25
Khed (Shel Pimpalgaon),Coriander  ,2014,1501,1601,100,6.662225183211192
Atpadi,Maize,2015,1475,1575,100,6.779661016949152
Barshi,Brinjal,2016,100,200,100,100.0
Sangamner,Sorgum(Jawar),2015,1592,1692,100,6.28140703517588
Aurangabad,Melon,2014,350,450,100,28.571428571428573
Barshi,Bitter Gourd,2014,150,250,100,66.66666666666667
Umarkhed-Danki,Sorgum(Jawar),2015,1400,1500,100,7.142857142857143
Nagpur,Banana,2016,450,550,100,22.22222222222222
Nagpur,Banana,2016,450,550,100,22.22222222222222
Nagpur,Banana,2014,450,550,100,22.22222222222222
Shirala,SOYBEAN,2016,2800,2900,100,3.5714285714285716
Nagpur,Banana,2016,450,550,100,22.22222222222222
Nagpur,Maize,2016,1300,1400,100,7.6923076923076925
Ausa,Safflower,2015,2407,2507,100,4.154549231408392
Shirala,MAIZE,2016,1400,1500,100,7.142857142857143
Rahata,Green Gram,2016,4700,4800,100,2.127659574468085
Shirala,Soybean,2014,3400,3500,100,2.9411764705882355
Shirala,Paddy-Unhusked,2014,1400,1500,100,7.142857142857143
Shirala,Paddy-Unhusked,2014,1360,1460,100,7.352941176470588
Tiwasa,Cotton,2015,4000,4100,100,2.5
Naigaon,Cotton,2014,3850,3950,100,2.5974025974025974
Shevgaon-Bodhegaon,Pigeon Pea (Tur),2016,8300,8400,100,1.2048192771084338
Shevgaon-Bodhegaon,Pigeon Pea (Tur),2016,7450,7550,100,1.342281879194631
Ausa,Sunflower,2015,3201,3301,100,3.1240237425804436
Sillod-Bharadi,Wheat(Husked),2016,1759,1859,100,5.6850483229107445
Shirpur,Bajri,2015,1195,1295,100,8.368200836820083
Aurangabad,CORIANDER ,2016,150,250,100,66.66666666666667
Raver,Sorgum(Jawar),2016,1277,1377,100,7.830853563038371
Sindevahi,Paddy-Unhusked,2014,2578,2678,100,3.878975950349108
Sillod-Bharadi,Sorgum(Jawar),2016,1367,1467,100,7.315288953913679
Shevgaon-Bodhegaon,Maize,2015,1050,1150,100,9.523809523809524
Vaduj,Wheat(Husked),2016,1633,1733,100,6.12369871402327
Sillod-Bharadi,SORGUM(JAWAR),2016,1250,1350,100,8.0
Nagpur,Banana,2014,450,550,100,22.22222222222222
Nagpur,Banana,2014,450,550,100,22.22222222222222
Sindevahi,Paddy-Unhusked,2015,1748,1848,100,5.720823798627002
Nagpur,Banana,2015,450,550,100,22.22222222222222
Nagpur,Banana,2016,450,550,100,22.22222222222222
Aurangabad,Maize(Corn.),2016,500,600,100,20.0
Nagpur,BANANA,2016,450,550,100,22.22222222222222
Nagpur,Nolkol,2015,500,600,100,20.0
Katol,Cotton,2014,3848,3948,100,2.598752598752599
Aurangabad,Coriander  ,2016,200,300,100,50.0
Aurangabad,Spinach,2016,300,400,100,33.333333333333336
Washim,Maize,2014,1000,1100,100,10.0
Ausa,Paddy-Unhusked,2014,1001,1101,100,9.99000999000999
Nagpur,Lemon,2015,150,250,100,66.66666666666667
Nagpur,Banana,2015,450,550,100,22.22222222222222
Nagpur,Banana,2015,450,550,100,22.22222222222222
Nagpur,Banana,2015,450,550,100,22.22222222222222
Ausa,Green Gram,2015,7950,8050,100,1.2578616352201257
Nagpur,Banana,2015,450,550,100,22.22222222222222
Nagpur,Banana,2015,450,550,100,22.22222222222222
Nagpur,Banana,2016,450,550,100,22.22222222222222
Nagpur,Banana,2015,450,550,100,22.22222222222222
Nagpur,Banana,2015,450,550,100,22.22222222222222
Katol,Wheat(Husked),2015,1292,1392,100,7.739938080495356
Nagpur,Banana,2015,450,550,100,22.22222222222222
Nagpur,Banana,2015,450,550,100,22.22222222222222
Nagpur,Banana,2016,450,550,100,22.22222222222222
Nagpur,Banana,2015,450,550,100,22.22222222222222
Sillod-Bharadi,Soybean,2016,3325,3425,100,3.007518796992481
Naigaon,Sorgum(Jawar),2015,1000,1100,100,10.0
Sindevahi,Paddy-Unhusked,2015,1635,1735,100,6.116207951070336
Nagpur,Banana,2016,450,550,100,22.22222222222222
Murbad,Bottle Gourd,2015,1500,1600,100,6.666666666666667
Mumbai,Horse Gram,2016,3300,3400,100,3.0303030303030303
Mumbai,Curry Leaves,2016,962,1062,100,10.395010395010395
Mumbai,Curry Leaves,2016,968,1068,100,10.330578512396695
Rahata,Papai,2016,400,500,100,25.0
Jalgaon,Black Gram,2016,11771,11871,100,0.8495454931611588
Aurangabad,Melon,2015,900,1000,100,11.11111111111111
Aurangabad,Melon,2015,600,700,100,16.666666666666668
Islampur,Tomato,2015,60,160,100,166.66666666666666
Mumbai,Horse Gram,2015,3400,3500,100,2.9411764705882355
Mumbai,Horse Gram,2015,3200,3300,100,3.125
Mumbai,Horse Gram,2015,3225,3325,100,3.10077519379845
Aurangabad,Math (Bhaji),2015,300,400,100,33.333333333333336
Kej,Rala,2016,1236,1336,100,8.090614886731391
Umarkhed-Danki,Sorgum(Jawar),2015,1357,1457,100,7.369196757553427
Aurangabad,Maize,2015,1100,1200,100,9.090909090909092
Mukhed,Sorgum(Jawar),2015,1556,1656,100,6.426735218508997
Mudkhed,Pigeon Pea (Tur),2016,8300,8400,100,1.2048192771084338
Morshi,Wheat(Husked),2016,1656,1756,100,6.038647342995169
Washim,Paddy-Unhusked,2014,1100,1200,100,9.090909090909092
Aurangabad,Spinach,2014,200,300,100,50.0
Umarkhed-Danki,Sorgum(Jawar),2015,1400,1500,100,7.142857142857143
Aurangabad,Spinach,2014,100,200,100,100.0
Morshi,WHEAT(HUSKED),2016,1667,1767,100,5.9988002399520095
Vaduj,Sorgum(Jawar),2016,2200,2300,100,4.545454545454546
Aurangabad,Melon,2014,400,500,100,25.0
Murbad,Bitter Gourd,2015,4350,4450,100,2.2988505747126435
Murbad,Bottle Gourd,2015,1300,1400,100,7.6923076923076925
Naigaon,Sorgum(Jawar),2015,1000,1100,100,10.0
Murbad,Bottle Gourd,2015,1800,1900,100,5.555555555555555
Murud,Paddy-Unhusked,2016,1450,1550,100,6.896551724137931
Balapur,Bajri,2015,1100,1200,100,9.090909090909092
Jalgaon,Jaggery,2016,3441,3541,100,2.906131938390003
Sindevahi,Paddy-Unhusked,2016,1775,1875,100,5.633802816901408
Sindevahi,Paddy-Unhusked,2016,1804,1904,100,5.5432372505543235
Karjat (Raigad),Paddy-Unhusked,2015,1340,1440,100,7.462686567164179
Murtizapur,Wheat(Husked),2014,1361,1461,100,7.347538574577516
Murbad,Tomato,2015,2250,2350,100,4.444444444444445
Murbad,Paddy-Unhusked,2015,1844,1944,100,5.422993492407809
Murbad,Paddy-Unhusked,2015,1850,1950,100,5.405405405405405
Jintur-Bori,Green Gram,2014,6862,6962,100,1.457301078402798
Balapur,PIGEON PEA (TUR),2016,5900,6000,100,1.694915254237288
Murbad,Paddy-Unhusked,2015,1717,1817,100,5.824111822947001
Fulambri,Cotton,2016,4400,4500,100,2.272727272727273
Murbad,Paddy-Unhusked,2015,1850,1950,100,5.405405405405405
Fulambri,Wheat(Husked),2015,1400,1500,100,7.142857142857143
Karjat (Raigad),Paddy-Unhusked,2015,1340,1440,100,7.462686567164179
Murbad,Paddy-Unhusked,2015,1826,1926,100,5.47645125958379
Murbad,Paddy-Unhusked,2015,1850,1950,100,5.405405405405405
Jalgaon,Coriander (Dry),2016,8250,8350,100,1.2121212121212122
Vaduj,Wheat(Husked),2016,1683,1783,100,5.941770647653001
Murbad,Brinjal,2015,950,1050,100,10.526315789473685
Karjat (Raigad),Paddy-Unhusked,2015,1340,1440,100,7.462686567164179
Karjat (Raigad),Paddy-Unhusked,2015,1340,1440,100,7.462686567164179
Murbad,Bottle Gourd,2015,1867,1967,100,5.356186395286556
Manchar,Bottle Gourd,2015,500,600,100,20.0
Bhandara,Soybean,2015,3159,3259,100,3.1655587211142766
Basmat,Ground Nut Pods (Dry),2015,3400,3500,100,2.9411764705882355
Lohara,Bajri,2016,1270,1370,100,7.874015748031496
Vai,Other Vegetables,2016,1200,1300,100,8.333333333333334
Kolhapur-Laxmipuri,Maize,2015,1400,1500,100,7.142857142857143
Bodwad-Varangaon,Wheat(Husked),2016,1450,1550,100,6.896551724137931
Kolhapur-Laxmipuri,Maize,2014,1500,1600,100,6.666666666666667
Junnar-Otur,Farshi,2016,400,500,100,25.0
Lohara,Sunflower,2015,3288,3388,100,3.0413625304136254
Ramtek,Potato,2015,900,1000,100,11.11111111111111
Bhokardan-Pimpalgaon Renu,Soybean,2016,3700,3800,100,2.7027027027027026
Ramtek,Potato,2015,900,1000,100,11.11111111111111
Bhusaval,Gram,2015,3075,3175,100,3.252032520325203
Bhusaval,Bajri,2015,1150,1250,100,8.695652173913043
Bhokardan-Pimpalgaon Renu,Wheat(Husked),2016,1500,1600,100,6.666666666666667
Bhokardan-Pimpalgaon Renu,Wheat(Husked),2016,1525,1625,100,6.557377049180328
Bhokardan-Pimpalgaon Renu,Wheat(Husked),2016,1500,1600,100,6.666666666666667
Loha,Green Gram,2016,6450,6550,100,1.550387596899225
Kolhapur-Laxmipuri,Maize,2015,1500,1600,100,6.666666666666667
Kolhapur-Laxmipuri,Paddy-Unhusked,2015,1525,1625,100,6.557377049180328
Ramtek,Pumpkin,2015,400,500,100,25.0
Kolhapur-Laxmipuri,Paddy-Unhusked,2015,1600,1700,100,6.25
Kolhapur-Laxmipuri,MAIZE,2016,1900,2000,100,5.2631578947368425
Kolhapur-Laxmipuri,Maize,2016,1633,1733,100,6.12369871402327
Kolhapur-Laxmipuri,Maize,2016,1800,1900,100,5.555555555555555
Brahmpuri,Paddy-Unhusked,2015,1800,1900,100,5.555555555555555
Brahmpuri,Paddy-Unhusked,2015,1717,1817,100,5.824111822947001
Brahmpuri,Paddy-Unhusked,2015,1943,2043,100,5.14668039114771
Brahmpuri,Paddy-Unhusked,2015,2044,2144,100,4.892367906066537
Loha,Turmeric,2015,7800,7900,100,1.2820512820512822
Loha,Sunflower,2015,2900,3000,100,3.4482758620689653
Pune-Pimpri,Potato,2016,1133,1233,100,8.8261253309797
Rahata,Bajri,2015,1168,1268,100,8.561643835616438
Pune-Pimpri,Potato,2016,1000,1100,100,10.0
Bhokardan-Pimpalgaon Renu,Soybean,2016,3550,3650,100,2.816901408450704
Bhokardan-Pimpalgaon Renu,Soybean,2016,3513,3613,100,2.846569883290635
Ramtek,Cabbage,2016,379,479,100,26.385224274406333
Kinwat,Ground Nut Pods (Dry),2016,4700,4800,100,2.127659574468085
Devala,Sorgum(Jawar),2016,1867,1967,100,5.356186395286556
Bhokardan,Wheat(Husked),2016,1494,1594,100,6.693440428380187
Bhokardan,Soybean,2016,3575,3675,100,2.797202797202797
Bhokardan,Soybean,2016,3788,3888,100,2.6399155227032733
Kinwat,Soybean,2016,2625,2725,100,3.8095238095238093
Umarkhed,Pigeon Pea (Tur),2016,8550,8650,100,1.1695906432748537
Umarkhed,Sorgum(Jawar),2016,1400,1500,100,7.142857142857143
Bhokardan-Pimpalgaon Renu,Soybean,2016,3833,3933,100,2.6089225150013045
Kinwat,Cotton,2016,3900,4000,100,2.5641025641025643
Kinwat,Cotton,2016,3900,4000,100,2.5641025641025643
Bhokardan,Green Gram,2016,4400,4500,100,2.272727272727273
Bhokardan,Gram,2016,4000,4100,100,2.5
Kinwat,Wheat(Husked),2015,1200,1300,100,8.333333333333334
Kinwat,Soybean,2015,3000,3100,100,3.3333333333333335
Bhokardan-Pimpalgaon Renu,Sorgum(Jawar),2015,1250,1350,100,8.0
Bhokardan-Pimpalgaon Renu,Soybean,2015,3250,3350,100,3.076923076923077
Vai,Coriander  ,2016,500,600,100,20.0
Bhokardan-Pimpalgaon Renu,Soybean,2015,3375,3475,100,2.962962962962963
Bhokardan-Pimpalgaon Renu,Soybean,2015,3550,3650,100,2.816901408450704
Bhokardan-Pimpalgaon Renu,Soybean,2015,3210,3310,100,3.115264797507788
Bhokardan-Pimpalgaon Renu,Castor Seed,2016,2750,2850,100,3.6363636363636362
Bhokardan-Pimpalgaon Renu,Castor Seed,2016,3900,4000,100,2.5641025641025643
Bhokardan-Pimpalgaon Renu,Castor Seed,2016,2500,2600,100,4.0
Bhokardan-Pimpalgaon Renu,Castor Seed,2016,2867,2967,100,3.487966515521451
Bhokardan-Pimpalgaon Renu,GREEN GRAM,2016,4450,4550,100,2.247191011235955
Bhokardan-Pimpalgaon Renu,Gram,2016,4050,4150,100,2.4691358024691357
Bhokardan-Pimpalgaon Renu,Gram,2016,4060,4160,100,2.4630541871921183
Bhokardan-Pimpalgaon Renu,Pigeon Pea (Tur),2016,6000,6100,100,1.6666666666666667
Bhokardan-Pimpalgaon Renu,Sorgum(Jawar),2016,1250,1350,100,8.0
Bhokardan-Pimpalgaon Renu,Sorgum(Jawar),2016,1250,1350,100,8.0
Jafrabad,Sorgum(Jawar),2016,1100,1200,100,9.090909090909092
Ramtek,Cabbage,2016,410,510,100,24.390243902439025
Deglur,Green Gram,2016,4100,4200,100,2.4390243902439024
Umarkhed,Wheat(Husked),2016,1500,1600,100,6.666666666666667
Chikhali,Maize,2014,1000,1100,100,10.0
Umarkhed,Sorgum(Jawar),2015,1400,1500,100,7.142857142857143
Chimur,Cotton,2014,3940,4040,100,2.5380710659898478
Umarkhed,Sorgum(Jawar),2015,1200,1300,100,8.333333333333334
Kada,Soybean,2016,3400,3500,100,2.9411764705882355
Chikhali,Mustard,2015,3000,3100,100,3.3333333333333335
Chikhali,Mustard,2015,3300,3400,100,3.0303030303030303
Koregaon,Sorgum(Jawar),2015,1600,1700,100,6.25
Solapur,Papai,2015,1267,1367,100,7.892659826361484
Koregaon,Potato,2015,900,1000,100,11.11111111111111
Kada (Ashti),Gram,2016,4075,4175,100,2.4539877300613497
Lasalgaon,Horse Gram,2016,3100,3200,100,3.225806451612903
Chandur Rly.,Green Gram,2016,6600,6700,100,1.5151515151515151
Chandur Rly.,Wheat(Husked),2014,1400,1500,100,7.142857142857143
Koregaon,Wheat(Husked),2014,1667,1767,100,5.9988002399520095
Umarkhed,Sorgum(Jawar),2015,1400,1500,100,7.142857142857143
Umarkhed,Sorgum(Jawar),2015,1400,1500,100,7.142857142857143
Lakhandur,Pigeon Pea (Tur),2015,6100,6200,100,1.639344262295082
Lakhandur,Linseed,2015,4130,4230,100,2.4213075060532687
Chimur,Cotton,2015,4000,4100,100,2.5
Korpana,Soybean,2014,3025,3125,100,3.3057851239669422
Kada (Ashti),Wheat(Husked),2015,1206,1306,100,8.291873963515755
Chimur,Gram,2015,3100,3200,100,3.225806451612903
Lakhandur,Green Peas (Dry),2015,2200,2300,100,4.545454545454546
Chimur,Paddy-Unhusked,2015,2000,2100,100,5.0
Lakhandur,Black Gram,2015,7030,7130,100,1.422475106685633
Umarkhed,Sorgum(Jawar),2015,1400,1500,100,7.142857142857143
Kada (Ashti),Black Gram,2015,7300,7400,100,1.36986301369863
Kada (Ashti),Gram,2015,3600,3700,100,2.7777777777777777
Sinner,Matki,2014,6701,6801,100,1.4923145799134458
Sinner,Matki,2014,6270,6370,100,1.594896331738437
Kurdwadi,Bajri,2015,1451,1551,100,6.891798759476223
Vaijapur,Cowpea,2016,4483,4583,100,2.230649118893598
Kada,Maize,2016,1426,1526,100,7.012622720897616
Kolhapur-Laxmipuri,PADDY-UNHUSKED,2016,1725,1825,100,5.797101449275362
Latur,Bajri,2016,1450,1550,100,6.896551724137931
Umarkhed,Wheat(Husked),2015,1500,1600,100,6.666666666666667
Daryapur,Sorgum(Jawar),2014,1200,1300,100,8.333333333333334
Umarkhed,Wheat(Husked),2015,1500,1600,100,6.666666666666667
Purna,Cotton,2015,3861,3961,100,2.59000259000259
Kada,Green Gram,2015,6533,6633,100,1.530690341343946
Kolhapur-Malkapur,Cluster Bean,2016,270,370,100,37.03703703703704
Jafrabad,Castor Seed,2015,2950,3050,100,3.389830508474576
Chandrapur,Green Gram,2014,5700,5800,100,1.7543859649122806
Latur-Murud,Maize,2015,1342,1442,100,7.451564828614009
Loha,Black Gram,2014,4651,4751,100,2.150075252633842
Kolhapur-Laxmipuri,Paddy-Unhusked,2016,1900,2000,100,5.2631578947368425
Pune-Pimpri,Shevga,2016,2067,2167,100,4.837929366231253
Loha,Soybean,2014,3250,3350,100,3.076923076923077
Kolhapur-Laxmipuri,Paddy-Unhusked,2016,1700,1800,100,5.882352941176471
Solapur,Rajgira,2015,200,300,100,50.0
Umarkhed,Wheat(Husked),2015,1400,1500,100,7.142857142857143
Umarkhed,Wheat(Husked),2015,1500,1600,100,6.666666666666667
Jafrabad,Wheat(Husked),2015,1450,1550,100,6.896551724137931
Lasur Station,Castor Seed,2016,2900,3000,100,3.4482758620689653
Rahata,Lemon,2014,4000,4100,100,2.5
Udgir,Safflower,2016,2500,2600,100,4.0
Chalisgaon,Maize,2015,1093,1193,100,9.149130832570906
Lasur Station,Soybean,2015,3200,3300,100,3.125
Kada,Soybean,2015,3276,3376,100,3.0525030525030523
Umarkhed,Gram,2015,4500,4600,100,2.2222222222222223
Chalisgaon,Banana,2016,150,250,100,66.66666666666667
Umarkhed,Gram,2015,4025,4125,100,2.484472049689441
Umared,Sorgum(Jawar),2014,1675,1775,100,5.970149253731344
Lasur Station,Maize,2015,1155,1255,100,8.658008658008658
Kada (Ashti),Soybean,2016,3400,3500,100,2.9411764705882355
Sangrampur,Wheat(Husked),2016,1300,1400,100,7.6923076923076925
Kinwat,Soybean,2015,3100,3200,100,3.225806451612903
Bhokardan,Soybean,2015,3120,3220,100,3.2051282051282053
Devri,Paddy-Unhusked,2016,1350,1450,100,7.407407407407407
Dharni,Wheat(Husked),2016,1459,1559,100,6.854009595613434
Dharni,Soybean,2016,3700,3800,100,2.7027027027027026
Dharni,Soybean,2016,7700,7800,100,1.2987012987012987
Dharni,WHEAT(HUSKED),2016,1600,1700,100,6.25
Dharni,Wheat(Husked),2016,1410,1510,100,7.092198581560283
Dharni,Wheat(Husked),2016,1388,1488,100,7.204610951008646
Dharni,Wheat(Husked),2016,1440,1540,100,6.944444444444445
Dharni,Wheat(Husked),2016,1400,1500,100,7.142857142857143
Pune-Pimpri,Squash Gourd,2015,1100,1200,100,9.090909090909092
Dharni,Wheat(Husked),2016,1404,1504,100,7.122507122507122
Sengaon,Black Gram,2016,9470,9570,100,1.0559662090813093
Dhule,Cotton,2014,4100,4200,100,2.4390243902439024
Bhiwapur,Paddy-Unhusked,2015,2025,2125,100,4.938271604938271
Dhule,Pigeon Pea (Tur),2014,3457,3557,100,2.8926815157651142
Pune-Pimpri,Squash Gourd,2015,1200,1300,100,8.333333333333334
Dharni,Soybean,2016,3900,4000,100,2.5641025641025643
Dharni,Soybean,2016,3267,3367,100,3.0609121518212428
Dharni,Soybean,2016,3350,3450,100,2.985074626865672
Dharni,Soybean,2016,2800,2900,100,3.5714285714285716
Vadgaon Peth,Maize(Corn.),2015,400,500,100,25.0
Dharni,Sorgum(Jawar),2016,1564,1664,100,6.3938618925831205
Dharni,Sorgum(Jawar),2016,1375,1475,100,7.2727272727272725
Dharni,Sorgum(Jawar),2016,1275,1375,100,7.8431372549019605
Dharni,Sorgum(Jawar),2016,1400,1500,100,7.142857142857143
Dharni,Sorgum(Jawar),2016,1244,1344,100,8.038585209003216
Dharni,Sorgum(Jawar),2016,1323,1423,100,7.558578987150415
Dharni,Sorgum(Jawar),2016,1367,1467,100,7.315288953913679
Dharni,SOYBEAN,2016,2555,2655,100,3.9138943248532287
Dharni,SORGUM(JAWAR),2016,1360,1460,100,7.352941176470588
Dharni,Pigeon Pea (Tur),2016,7733,7833,100,1.29315918789603
Dharni,Pigeon Pea (Tur),2016,7500,7600,100,1.3333333333333333
Dharni,Pigeon Pea (Tur),2016,8057,8157,100,1.2411567580985479
Ramtek,Pigeon Pea (Tur),2015,7250,7350,100,1.3793103448275863
Sengaon,Gram,2016,7350,7450,100,1.3605442176870748
Bhokardan,Soybean,2015,3243,3343,100,3.0835646006783843
Dhule,Pigeon Pea (Tur),2016,7000,7100,100,1.4285714285714286
Kalamb (Os),Castor Seed,2015,3100,3200,100,3.225806451612903
Manchar,Ladies Finger,2016,2186,2286,100,4.574565416285453
Mandhal,Gram,2015,3218,3318,100,3.107520198881293
Solapur,Gram,2015,4570,4670,100,2.1881838074398248
Varud-Rajura Bazar,Maize,2015,975,1075,100,10.256410256410257
Beed,Soybean,2015,3799,3899,100,2.632271650434325
Dhule,Potato,2016,900,1000,100,11.11111111111111
Bhiwapur,Green Gram,2015,6100,6200,100,1.639344262295082
Khed (Shel Pimpalgaon),Cabbage,2016,350,450,100,28.571428571428573
Pune-Pimpri,Beet Root,2015,1122,1222,100,8.9126559714795
Basmat,Soybean,2016,2800,2900,100,3.5714285714285716
Basmat,COTTON,2016,4750,4850,100,2.1052631578947367
Pune-Pimpri,Squash Gourd,2014,1100,1200,100,9.090909090909092
Umarkhed,Wheat(Husked),2016,1500,1600,100,6.666666666666667
Manchar,Capsicum,2016,1800,1900,100,5.555555555555555
Manchar,Walvad,2015,2575,2675,100,3.883495145631068
Karad,Cabbage,2015,350,450,100,28.571428571428573
Manchar,Maize(Corn.),2015,700,800,100,14.285714285714286
Sangamner,Soybean,2016,3400,3500,100,2.9411764705882355
Shahada,Sorgum(Jawar),2014,1515,1615,100,6.600660066006601
Khed-Chakan,Spinach,2016,400,500,100,25.0
Dhule,Maize(Corn.),2015,4600,4700,100,2.1739130434782608
Dhule,Maize,2015,1108,1208,100,9.025270758122744
Khed-Chakan,Spinach,2016,300,400,100,33.333333333333336
Umarkhed,Wheat(Husked),2016,1500,1600,100,6.666666666666667
Vai,Spinach,2015,700,800,100,14.285714285714286
Sindkhed Raja,Gram,2016,6700,6800,100,1.492537313432836
Umarkhed,Wheat(Husked),2016,1500,1600,100,6.666666666666667
Pune-Pimpri,Pavtta,2015,3233,3333,100,3.093102381688834
Pune-Pimpri,Pavtta,2015,1600,1700,100,6.25
Pune-Pimpri,Potato,2015,871,971,100,11.481056257175661
Dharni,Pigeon Pea (Tur),2016,7500,7600,100,1.3333333333333333
Dharni,Pigeon Pea (Tur),2016,7600,7700,100,1.3157894736842106
Dharni,Maize,2016,1392,1492,100,7.183908045977011
Umarkhed,Wheat(Husked),2016,1500,1600,100,6.666666666666667
Islampur,Tomato,2016,100,200,100,100.0
Dhamangaon-Rly,Green Gram,2016,5000,5100,100,2.0
Kille Dharur,Green Gram,2016,4900,5000,100,2.0408163265306123
Umarkhed,Wheat(Husked),2016,1500,1600,100,6.666666666666667
Umarkhed,Wheat(Husked),2016,1500,1600,100,6.666666666666667
Umarkhed,Wheat(Husked),2016,1500,1600,100,6.666666666666667
Rahata,Ghevda,2015,2700,2800,100,3.7037037037037037
Dharni,Maize,2016,1270,1370,100,7.874015748031496
Bhokar,Cotton,2015,4000,4100,100,2.5
Pune-Pimpri,CARROT,2016,900,1000,100,11.11111111111111
Mahagaon,Cotton,2014,3817,3917,100,2.6198585276395074
Mahagaon,Cotton,2015,3900,4000,100,2.5641025641025643
Mahagaon,Cotton,2015,3900,4000,100,2.5641025641025643
Bhokar,Turmeric,2014,5465,5565,100,1.829826166514181
Umarkhed,WHEAT(HUSKED),2016,1500,1600,100,6.666666666666667
Bhokar,Sunflower,2015,2971,3071,100,3.365870077415012
Bhokar,Black Gram,2016,8450,8550,100,1.183431952662722
Bhokar,Maize,2016,1260,1360,100,7.936507936507937
Bhokar,Sorgum(Jawar),2016,1500,1600,100,6.666666666666667
Bhokar,Sorgum(Jawar),2016,1500,1600,100,6.666666666666667
Savner,Cotton,2015,4000,4100,100,2.5
Pune-Pimpri,Ginger (Fresh),2016,3400,3500,100,2.9411764705882355
Dhadgaon,Maize,2016,1200,1300,100,8.333333333333334
Savali,Paddy-Unhusked,2015,2050,2150,100,4.878048780487805
Savali,Paddy-Unhusked,2014,2500,2600,100,4.0
Bhokardan,Cotton,2015,3900,4000,100,2.5641025641025643
Bhokardan,Gram,2015,3750,3850,100,2.6666666666666665
Kinwat,Ground Nut Pods (Dry),2014,3400,3500,100,2.9411764705882355
Kinwat,Cotton,2015,3988,4088,100,2.507522567703109
Bhokardan,Gram,2015,3606,3706,100,2.7731558513588466
Bhokardan,Pigeon Pea (Tur),2015,4300,4400,100,2.3255813953488373
Udgir,Safflower,2015,2500,2600,100,4.0
Bhokar,Green Gram,2014,6150,6250,100,1.6260162601626016
Pune-Pimpri,Beet Root,2016,1311,1411,100,7.627765064836003
Dharni,Chino,2016,3200,3300,100,3.125
Dharni,Maize,2016,1230,1330,100,8.130081300813009
Dharni,Maize,2016,1325,1425,100,7.547169811320755
Dharni,Maize,2016,1392,1492,100,7.183908045977011
Dharni,Maize,2016,1275,1375,100,7.8431372549019605
Dharni,Maize,2016,1256,1356,100,7.961783439490445
Dharni,MAIZE,2016,1250,1350,100,8.0
Dharni,Green Gram,2016,6070,6170,100,1.6474464579901154
Dharni,Green Gram,2016,5233,5333,100,1.910949742021785
Dharni,Green Gram,2016,5200,5300,100,1.9230769230769231
Dharni,Cotton,2016,4500,4600,100,2.2222222222222223
Dharni,Chino,2016,4613,4713,100,2.167786689789725
Dharni,Chino,2016,3571,3671,100,2.800336040324839
Dharni,Chino,2016,5269,5369,100,1.8978933383943823
Dharni,Chino,2016,7133,7233,100,1.4019346698443853
Dharni,Chino,2016,4007,4107,100,2.495632642874969
Bhiwapur,Mustard,2016,2500,2600,100,4.0
Bhiwapur,Wheat(Husked),2015,1300,1400,100,7.6923076923076925
Kille Dharur,Gram,2015,4285,4385,100,2.3337222870478413
Dharni,Wheat(Husked),2015,1300,1400,100,7.6923076923076925
Dharni,Wheat(Husked),2015,1300,1400,100,7.6923076923076925
Dharni,Soybean,2015,3100,3200,100,3.225806451612903
Dharni,Soybean,2015,3100,3200,100,3.225806451612903
Dharni,Sorgum(Jawar),2015,1100,1200,100,9.090909090909092
Dharni,Maize,2015,1100,1200,100,9.090909090909092
Dharni,Maize,2015,1100,1200,100,9.090909090909092
Dharni,Cotton,2015,3850,3950,100,2.5974025974025974
Sengaon,Ground Nut Pods (Dry),2015,5300,5400,100,1.8867924528301887
Jintur-Bori,Gram,2015,2478,2578,100,4.035512510088782
Bhiwapur,Green Gram,2016,4900,5000,100,2.0408163265306123
Pune-Pimpri,Beet Root,2016,1555,1655,100,6.430868167202572
Sangali,Maize,2015,1572,1672,100,6.361323155216285
Islampur,Soybean,2014,3175,3275,100,3.1496062992125986
Amarawati,Maize,2015,1250,1350,100,8.0
Tasgaon,Black Gram,2014,4350,4450,100,2.2988505747126435
Jalgaon Jamod,Wheat(Husked),2015,1250,1350,100,8.0
Akkalkuwa,Sorgum(Jawar),2016,1300,1400,100,7.6923076923076925
Rahuri-Songaon,Potato,2016,1100,1200,100,9.090909090909092
Kalyan,Banana,2014,900,1000,100,11.11111111111111
Navapur,Onion,2016,275,375,100,36.36363636363637
Akkalkuwa,Gram,2016,4100,4200,100,2.4390243902439024
Sinner,Maize,2015,1300,1400,100,7.6923076923076925
Hadgaon,Sorgum(Jawar),2014,1667,1767,100,5.9988002399520095
Jalgaon Jamod,Wheat(Husked),2015,1250,1350,100,8.0
Pune,Mango(Raw),2015,300,400,100,33.333333333333336
Kalyan,Banana,2014,900,1000,100,11.11111111111111
Ghoti,WAL PAPDI,2016,800,900,100,12.5
Kalyan,Bottle Gourd,2014,700,800,100,14.285714285714286
Kalyan,Cabbage,2014,500,600,100,20.0
Sailu,Wheat(Husked),2015,1400,1500,100,7.142857142857143
Tasgaon,Wheat(Husked),2014,1800,1900,100,5.555555555555555
Kalyan,Elephant Root,2014,1500,1600,100,6.666666666666667
Vaduj,Sorgum(Jawar),2015,2000,2100,100,5.0
Ghoti,Cucumber,2016,800,900,100,12.5
Akkalkuwa,Wheat(Husked),2016,1450,1550,100,6.896551724137931
Ralegaon,Cotton,2015,4000,4100,100,2.5
Vaduj,Cowpea,2015,4300,4400,100,2.3255813953488373
Ralegaon,Cotton,2015,3950,4050,100,2.5316455696202533
Washim-Ansing,Sorgum(Jawar),2016,1233,1333,100,8.110300081103
Jalgaon Jamod-Aasalgaon,Maize,2015,970,1070,100,10.309278350515465
Sillod,Bajri,2016,1250,1350,100,8.0
Sillod,Bajri,2016,1250,1350,100,8.0
Ner Parasopant,Wheat(Husked),2014,1475,1575,100,6.779661016949152
Ner Parasopant,Wheat(Husked),2014,1400,1500,100,7.142857142857143
Navapur,Wheat(Husked),2016,1508,1608,100,6.63129973474801
Parbhani,Gram,2016,7400,7500,100,1.3513513513513513
Sillod,Castor Seed,2016,2600,2700,100,3.8461538461538463
Pune,Nolkol,2016,500,600,100,20.0
Taloda,Wheat(Husked),2016,1783,1883,100,5.608524957936063
Sailu,Gram,2016,6900,7000,100,1.4492753623188406
Yawal,Bajri,2015,1100,1200,100,9.090909090909092
Vaduj,Ghevda Seed,2015,4300,4400,100,2.3255813953488373
Ralegaon,Cotton,2014,3950,4050,100,2.5316455696202533
Kalamnuri,Wheat(Husked),2016,1700,1800,100,5.882352941176471
Pune,Nolkol,2015,500,600,100,20.0
Akkolkot,Maize,2015,1500,1600,100,6.666666666666667
Shirur,Indian Bean,2016,4017,4117,100,2.4894199651481204
Vaduj,Sorgum(Jawar),2015,2013,2113,100,4.967709885742672
Vaduj,Cowpea,2015,4400,4500,100,2.272727272727273
Umarkhed-Danki,Sorgum(Jawar),2016,1400,1500,100,7.142857142857143
Kalyan,Cabbage,2015,400,500,100,25.0
Akhadabalapur,Sorgum(Jawar),2014,1500,1600,100,6.666666666666667
Jamner-Neri,Cotton,2015,3750,3850,100,2.6666666666666665
Tasgaon,Sorgum(Jawar),2015,1400,1500,100,7.142857142857143
Shrirampur-Belapur,Sorgum(Jawar),2015,1000,1100,100,10.0
Akhadabalapur,Ground Nut Pods (Dry),2014,4300,4400,100,2.3255813953488373
Akhadabalapur,Gram,2014,3000,3100,100,3.3333333333333335
Kalyan,Carrot,2015,1400,1500,100,7.142857142857143
Akhadabalapur,Gram,2014,3000,3100,100,3.3333333333333335
Kalyan,Cucumber,2015,400,500,100,25.0
Kalyan,Lemon,2015,700,800,100,14.285714285714286
Vaduj,Bajri,2015,1400,1500,100,7.142857142857143
Amarawati-Fruit And Vegetables,Pumpkin,2016,500,600,100,20.0
Gondpimpri,Soybean,2016,3425,3525,100,2.9197080291970803
Vaduj,Bajri,2015,1400,1500,100,7.142857142857143
Vaduj,Bajri,2015,1400,1500,100,7.142857142857143
Umarkhed-Danki,Wheat(Husked),2016,1500,1600,100,6.666666666666667
Parli-Vaijnath,Gram,2016,6500,6600,100,1.5384615384615385
Kalyan,Papai,2015,700,800,100,14.285714285714286
Ahmedpur,Soybean,2016,3171,3271,100,3.15357931251971
Akhadabalapur,Castor Seed,2015,3100,3200,100,3.225806451612903
Vaduj,Cowpea,2015,4400,4500,100,2.272727272727273
Amarawati-Fruit And Vegetables,Green-Peas,2016,2000,2100,100,5.0
Umarkhed-Danki,WHEAT(HUSKED),2016,1500,1600,100,6.666666666666667
Kalyan,Squash Gourd,2014,700,800,100,14.285714285714286
Kalyan,Squash Gourd,2014,900,1000,100,11.11111111111111
Rahuri-Songaon,Bajri,2016,1300,1400,100,7.6923076923076925
Akhadabalapur,Castor Seed,2016,2900,3000,100,3.4482758620689653
Akhadabalapur,Castor Seed,2016,2900,3000,100,3.4482758620689653
Akhadabalapur,Soybean,2015,3400,3500,100,2.9411764705882355
Parli-Vaijnath,Gram,2015,5100,5200,100,1.9607843137254901
Solapur,Papai,2016,150,250,100,66.66666666666667
Akhadabalapur,Sorgum(Jawar),2015,1480,1580,100,6.756756756756757
Amarawati,Maize,2015,1250,1350,100,8.0
Vaduj,Sorgum(Jawar),2015,2000,2100,100,5.0
Kalyan,Bajri,2015,1700,1800,100,5.882352941176471
Navapur,Cotton,2016,4200,4300,100,2.380952380952381
Ghoti,Bitter Gourd,2016,1800,1900,100,5.555555555555555
Kalyan,Banana,2015,900,1000,100,11.11111111111111
Sillod,Bajri,2015,1200,1300,100,8.333333333333334
Shirur,Cowpea,2016,4580,4680,100,2.183406113537118
Kalyan,Bottle Gourd,2015,500,600,100,20.0
Kalyan,Brinjal,2015,1400,1500,100,7.142857142857143
Rajura,Gram,2015,3085,3185,100,3.2414910858995136
Sillod,Bajri,2016,1434,1534,100,6.97350069735007
Kalyan,Rice(Paddy-Hus),2015,2300,2400,100,4.3478260869565215
Sonpeth,Gram,2016,7251,7351,100,1.3791201213625708
Jalgaon Jamod-Aasalgaon,Maize,2015,950,1050,100,10.526315789473685
Gondpimpri,Soybean,2015,3257,3357,100,3.070310101320233
Jamner,Cotton,2015,3750,3850,100,2.6666666666666665
Nilanga,Sorgum(Jawar),2015,1300,1400,100,7.6923076923076925
Jalna-Badnapur,Sorgum(Jawar),2016,1625,1725,100,6.153846153846154
Soygaon,Cotton,2015,4000,4100,100,2.5
Palam,Pigeon Pea (Tur),2016,8900,9000,100,1.1235955056179776
Sillod,Bajri,2014,1320,1420,100,7.575757575757576
Taloda,Cotton,2015,3746,3846,100,2.6695141484249865
Amalner,Bajri,2015,1175,1275,100,8.51063829787234
Indapur-Bhigwan,Ghevda Seed,2015,3700,3800,100,2.7027027027027026
Amarawati,Maize,2015,1150,1250,100,8.695652173913043
Amarawati,Cotton,2016,4400,4500,100,2.272727272727273
Gondpimpri,Paddy-Unhusked,2015,1775,1875,100,5.633802816901408
Sinner,Matki,2015,6228,6328,100,1.6056518946692357
Amarawati,Flower,2015,1500,1600,100,6.666666666666667
Gondpimpri,Paddy-Unhusked,2015,1692,1792,100,5.91016548463357
Sillod,Maize,2015,1005,1105,100,9.950248756218905
Umarga,Sunflower,2016,3100,3200,100,3.225806451612903
Sakri,Soybean,2015,3441,3541,100,2.906131938390003
Gondpimpri,PADDY-UNHUSKED,2016,2351,2451,100,4.253509145044662
Sillod,Mustard,2015,3300,3400,100,3.0303030303030303
Nilanga,Sorgum(Jawar),2016,1400,1500,100,7.142857142857143
Osmanabad,Sweet Potato,2016,2600,2700,100,3.8461538461538463
Amarawati,Maize(Corn.),2015,350,450,100,28.571428571428573
Jalgaon Jamod-Aasalgaon,Maize,2015,950,1050,100,10.526315789473685
Karad,Cabbage,2015,300,400,100,33.333333333333336
Amarawati,Beet Root,2015,2400,2500,100,4.166666666666667
Jamkhed,Cotton,2015,3800,3900,100,2.6315789473684212
Jamkhed,Wheat(Husked),2016,1800,1900,100,5.555555555555555
Osmanabad,Pigeon Pea (Tur),2015,4000,4100,100,2.5
Osmanabad,Carrot,2015,1300,1400,100,7.6923076923076925
Hadgaon,Wheat(Husked),2014,1633,1733,100,6.12369871402327
Nira-Saswad,Soybean,2016,2900,3000,100,3.4482758620689653
Amalner,Sorgum(Jawar),2016,1718,1818,100,5.820721769499418
Amarawati,Soybean,2015,3196,3296,100,3.1289111389236544
Amarawati,Spinach,2015,465,565,100,21.50537634408602
Amalner,Pigeon Pea (Tur),2016,7300,7400,100,1.36986301369863
Amarawati,Spinach,2015,470,570,100,21.27659574468085
Jamkhed,Cotton,2014,3950,4050,100,2.5316455696202533
Nira,Maize,2015,1500,1600,100,6.666666666666667
Nira,Maize,2015,1300,1400,100,7.6923076923076925
Alibag,Paddy-Unhusked,2016,1450,1550,100,6.896551724137931
Umarkhed-Danki,Wheat(Husked),2015,1500,1600,100,6.666666666666667
Akluj,Gram,2015,3400,3500,100,2.9411764705882355
Ner Parasopant,Wheat(Husked),2016,1408,1508,100,7.1022727272727275
Sillod,Soybean,2015,3348,3448,100,2.986857825567503
Jalgaon Jamod-Aasalgaon,Maize,2014,955,1055,100,10.471204188481675
Sillod,BAJRI,2016,1314,1414,100,7.610350076103501
Ner Parasopant,BLACK GRAM,2016,5563,5663,100,1.7975912277548085
Paranda,Maize,2016,1300,1400,100,7.6923076923076925
Rahuri-Vambori,Pigeon Pea (Tur),2016,6167,6267,100,1.6215339711366954
Parbhani,Green Gram,2015,6000,6100,100,1.6666666666666667
Jalgaon Jamod-Aasalgaon,Sorgum(Jawar),2016,1100,1200,100,9.090909090909092
Shrirampur-Belapur,WHEAT(HUSKED),2016,1500,1600,100,6.666666666666667
Sailu,Soybean,2016,3201,3301,100,3.1240237425804436
Ner Parasopant,Gram,2015,3988,4088,100,2.507522567703109
Shrirampur-Belapur,Maize,2016,1181,1281,100,8.467400508044031
Washim-Ansing,Gram,2016,6089,6189,100,1.6423057973394646
Ner Parasopant,Gram,2015,2463,2563,100,4.0600893219650835
Rajura,Gram,2015,3199,3299,100,3.1259768677711786
Vaduj,Gram,2015,3950,4050,100,2.5316455696202533
Akluj,Gram,2015,2300,2400,100,4.3478260869565215
Pune,Maize,2016,1650,1750,100,6.0606060606060606
Amarawati,Spinach,2016,367,467,100,27.247956403269754
Panvel,Snake Gourd,2015,1375,1475,100,7.2727272727272725
Amarawati,Melon,2016,300,400,100,33.333333333333336
Jalna-Badnapur,Sorgum(Jawar),2015,1400,1500,100,7.142857142857143
Kalvan,Green Gram,2016,4900,5000,100,2.0408163265306123
Ramtek,Jambhul,2015,400,500,100,25.0
Jalna-Badnapur,Sorgum(Jawar),2015,1154,1254,100,8.665511265164644
Palus,Cabbage,2016,700,800,100,14.285714285714286
Palus,Onion,2016,600,700,100,16.666666666666668
Solapur,Wheat(Unhusked),2016,3500,3600,100,2.857142857142857
Umarkhed-Danki,Wheat(Husked),2015,1400,1500,100,7.142857142857143
Pandharpur,Sorgum(Jawar),2014,2250,2350,100,4.444444444444445
Umarkhed-Danki,Wheat(Husked),2015,1500,1600,100,6.666666666666667
Umarkhed-Danki,Wheat(Husked),2015,1500,1600,100,6.666666666666667
Akot,Cotton,2015,3950,4050,100,2.5316455696202533
Akole,Gram,2015,3200,3300,100,3.125
Akole,Gram,2014,3200,3300,100,3.125
Akola,Maize,2016,1450,1550,100,6.896551724137931
Panvel,Bitter Gourd,2015,3500,3600,100,2.857142857142857
Taloda,Bajri,2016,1500,1600,100,6.666666666666667
Vaduj,Maize,2015,1200,1300,100,8.333333333333334
Panvel,Cucumber,2015,1200,1300,100,8.333333333333334
Sillod,Sorgum(Jawar),2015,950,1050,100,10.526315789473685
Gondpimpri,Pigeon Pea (Tur),2014,4350,4450,100,2.2988505747126435
Umarkhed-Danki,Wheat(Husked),2016,1500,1600,100,6.666666666666667
Shrirampur,Soybean,2015,3000,3100,100,3.3333333333333335
Jamkhed,Maize,2016,1400,1500,100,7.142857142857143
Pathardi,Cotton,2015,3760,3860,100,2.6595744680851063
Ghansawangi,Sorgum(Jawar),2015,1633,1733,100,6.12369871402327
Ghansawangi,Sorgum(Jawar),2015,1700,1800,100,5.882352941176471
Roha,Paddy-Unhusked,2014,1300,1400,100,7.6923076923076925
Kannad,Gram,2015,3450,3550,100,2.898550724637681
Roha,Paddy-Unhusked,2014,1300,1400,100,7.6923076923076925
Amarawati,Maize,2015,1150,1250,100,8.695652173913043
Kannad,Green Gram,2015,6603,6703,100,1.5144631228229593
Tasgaon,Green Gram,2016,5300,5400,100,1.8867924528301887
Jalgaon Jamod,Soybean,2015,3200,3300,100,3.125
Roha,Paddy-Unhusked,2014,1300,1400,100,7.6923076923076925
Roha,Paddy-Unhusked,2014,1300,1400,100,7.6923076923076925
Amarawati,Linseed,2015,5006,5106,100,1.9976028765481422
Ghansawangi,Bajri,2015,1300,1400,100,7.6923076923076925
Ghansawangi,Bajri,2015,1567,1667,100,6.381620931716656
Ghansawangi,Sorgum(Jawar),2015,1500,1600,100,6.666666666666667
Patan,Pavtta,2016,400,500,100,25.0
Achalpur,Lentil,2016,5100,5200,100,1.9607843137254901
Shirur,Indian Bean,2015,3142,3242,100,3.1826861871419476
Sillod,Sorgum(Jawar),2016,1200,1300,100,8.333333333333334
Sillod,Sorgum(Jawar),2016,1150,1250,100,8.695652173913043
Jalgaon Jamod,Ground Nut Pods (Dry),2015,4400,4500,100,2.272727272727273
Pavani,Wheat(Husked),2016,1500,1600,100,6.666666666666667
Shirur,Jaggery,2015,2300,2400,100,4.3478260869565215
Vaduj,Cowpea,2016,4500,4600,100,2.2222222222222223
Umarkhed-Danki,Wheat(Husked),2016,1500,1600,100,6.666666666666667
Anajngaon Surji,Banana,2015,513,613,100,19.49317738791423
Achalpur,Mustard,2015,3133,3233,100,3.191828917969997
Tasgaon,Green Gram,2016,5150,5250,100,1.941747572815534
Achalpur,Rajgira,2015,4500,4600,100,2.2222222222222223
Vaduj,Gram,2014,2600,2700,100,3.8461538461538463
Shrirampur-Belapur,Gram,2015,3361,3461,100,2.9753049687592976
Amarawati,Maize,2015,1250,1350,100,8.0
Kalamb (Os),Maize,2016,1343,1443,100,7.4460163812360385
Vaduj,Bajri,2014,1400,1500,100,7.142857142857143
Jalgaon Jamod,Gram,2015,3050,3150,100,3.278688524590164
Aheri,Green Gram,2015,6167,6267,100,1.6215339711366954
Jawala-Bajar,Sorgum(Jawar),2015,1700,1800,100,5.882352941176471
Kannad,Sorgum(Jawar),2016,1533,1633,100,6.523157208088715
Pavani,Green Gram,2016,5500,5600,100,1.8181818181818181
Kannad,Gram,2016,6400,6500,100,1.5625
Washim,Paddy-Unhusked,2015,1400,1500,100,7.142857142857143
Sillod-Bharadi,Maize,2015,950,1050,100,10.526315789473685
Aheri,Batbati,2016,4400,4500,100,2.272727272727273
Jalgaon Jamod,Sorgum(Jawar),2015,1150,1250,100,8.695652173913043
Sillod-Bharadi,Sorgum(Jawar),2015,950,1050,100,10.526315789473685
Washim,Paddy-Unhusked,2015,1300,1400,100,7.6923076923076925
Jalgaon Jamod,Maize,2015,950,1050,100,10.526315789473685
Telhara,Sorgum(Jawar),2014,1198,1298,100,8.347245409015025
Sillod-Bharadi,Soybean,2015,3300,3400,100,3.0303030303030303
Sillod-Bharadi,Sunflower,2015,3300,3400,100,3.0303030303030303
Telhara,Cotton,2015,3900,4000,100,2.5641025641025643
Pavani,Wheat(Husked),2014,1400,1500,100,7.142857142857143
Achalpur,Maize,2016,1436,1536,100,6.963788300835654
Jalgaon Jamod,Sorgum(Jawar),2015,1100,1200,100,9.090909090909092
Achalpur,Maize,2016,1369,1469,100,7.304601899196494
Nandura,MAIZE,2016,1110,1210,100,9.00900900900901
Solapur,Green Peas (Dry),2016,3125,3225,100,3.2
Nandura,Sesamum,2016,5076,5176,100,1.9700551615445232
Kalyan,Sorgum(Jawar),2015,2500,2600,100,4.0
Vaduj,Bajri,2016,1688,1788,100,5.924170616113744
Pavani,Wheat(Husked),2014,1400,1500,100,7.142857142857143
Jalna,Mustard,2015,3405,3505,100,2.9368575624082234
Washim,Safflower,2015,2500,2600,100,4.0
Amarawati,Linseed,2015,5000,5100,100,2.0
Sillod-Bharadi,Bajri,2016,1250,1350,100,8.0
Tasgaon,Sorgum(Jawar),2016,1750,1850,100,5.714285714285714
Telhara,Green Gram,2015,8000,8100,100,1.25
Nandurbar,Cluster Bean,2015,4501,4601,100,2.221728504776716
Sillod,Sorgum(Jawar),2016,1250,1350,100,8.0
Achalpur,Maize,2015,1400,1500,100,7.142857142857143
Umarga,Bajri,2015,1000,1100,100,10.0
Soygaon,Cotton,2016,4700,4800,100,2.127659574468085
Vaduj,Wheat(Husked),2015,1500,1600,100,6.666666666666667
Vaduj,Wheat(Husked),2015,1711,1811,100,5.844535359438924
Vaduj,Gram,2014,2575,2675,100,3.883495145631068
Indapur,Sunflower,2014,3000,3100,100,3.3333333333333335
Amarawati-Fruit And Vegetables,Spinach,2016,350,450,100,28.571428571428573
Pulgaon,Gram,2016,5509,5609,100,1.8152114721365038
Tasgaon,Soybean,2015,3300,3400,100,3.0303030303030303
Solapur,Hemp,2014,300,400,100,33.333333333333336
Sailu,Gram,2015,2800,2900,100,3.5714285714285716
Kalyan,Banana,2016,700,800,100,14.285714285714286
Ahmedpur,Wheat(Husked),2015,1275,1375,100,7.8431372549019605
Ahmedpur,Bajri,2016,1278,1378,100,7.82472613458529
Zarijamini,Pigeon Pea (Tur),2016,7300,7400,100,1.36986301369863
Rahata,Wheat(Husked),2016,1587,1687,100,6.30119722747322
Kalyan,Banana,2016,700,800,100,14.285714285714286
Shrirampur-Belapur,Maize,2015,1200,1300,100,8.333333333333334
Tasgaon,Soybean,2015,3400,3500,100,2.9411764705882355
Karad,Cabbage,2015,420,520,100,23.80952380952381
Kalamb (Yawatmal),Soybean,2016,2775,2875,100,3.6036036036036037
Parola,Maize,2016,1550,1650,100,6.451612903225806
Kalyan,Bajri,2016,1900,2000,100,5.2631578947368425
Kalyan,Sorgum(Jawar),2015,1600,1700,100,6.25
Kalyan,Sorgum(Jawar),2015,1650,1750,100,6.0606060606060606
Ghoti,Cabbage,2014,1570,1670,100,6.369426751592357
Jalgaon Jamod,Wheat(Husked),2014,1336,1436,100,7.485029940119761
Jamkhed,Cotton,2015,3800,3900,100,2.6315789473684212
Parli-Vaijnath,Pigeon Pea (Tur),2016,8400,8500,100,1.1904761904761905
Amarawati,Maize,2015,1150,1250,100,8.695652173913043
Vaduj,Bajri,2015,1400,1500,100,7.142857142857143
Jalgaon Jamod,Wheat(Husked),2014,1317,1417,100,7.593014426727411
Solapur,Kanda Pat,2016,575,675,100,17.391304347826086
Pimpalgaon Basawant,Tomato,2016,240,340,100,41.666666666666664
Umarkhed-Danki,Wheat(Husked),2016,1500,1600,100,6.666666666666667
Navapur,Paddy-Unhusked,2014,1200,1300,100,8.333333333333334
Achalpur,Castor Seed,2015,2700,2800,100,3.7037037037037037
Ghatanji,Gram,2015,3700,3800,100,2.7027027027027026
Navapur,Maize,2014,1000,1100,100,10.0
Umarkhed-Danki,Wheat(Husked),2016,1525,1625,100,6.557377049180328
Jalkot,Soybean,2016,3500,3600,100,2.857142857142857
Ghatanji,Cotton,2015,3900,4000,100,2.5641025641025643
Navapur,Coriander  ,2015,900,1000,100,11.11111111111111
Nashik,Mint,2015,100,200,100,100.0
Jalgaon Jamod,Cotton,2015,3950,4050,100,2.5316455696202533
Achalpur,Lentil,2015,5100,5200,100,1.9607843137254901
Solapur,Green Gram,2014,6334,6434,100,1.5787811809283234
Anajngaon Surji,Banana,2016,340,440,100,29.41176470588235
Nandgaon,Ground Nut Pods (Dry),2016,5901,6001,100,1.6946280291476021
Navapur,Sorgum(Jawar),2014,1400,1500,100,7.142857142857143
Sillod-Bharadi,Wheat(Husked),2015,1350,1450,100,7.407407407407407
Achalpur,Sesamum,2014,9850,9950,100,1.015228426395939
Hadgaon,Gram,2014,2433,2533,100,4.110152075626798
Amarawati-Fruit And Vegetables,Spinach,2016,300,400,100,33.333333333333336
Achalpur,Green Gram,2014,6500,6600,100,1.5384615384615385
Jalgaon Jamod-Aasalgaon,Maize,2015,950,1050,100,10.526315789473685
Navapur,Onion,2015,1838,1938,100,5.44069640914037
Tasgaon,Wheat(Husked),2015,2300,2400,100,4.3478260869565215
Sillod,SORGUM(JAWAR),2016,1350,1450,100,7.407407407407407
Umarkhed-Danki,Wheat(Husked),2016,1500,1600,100,6.666666666666667
Kurdwadi-Modnimb,Maize,2015,1421,1520,99,6.9669247009148485
Dhule,Horse Gram,2014,4226,4325,99,2.342640795078088
Jamkhed,Cotton,2015,3838,3937,99,2.579468473163106
Manwat,Gram,2016,5701,5800,99,1.7365374495702508
Kalamb (Os),Bajri,2016,1393,1492,99,7.106963388370423
Telhara,Wheat(Husked),2015,1452,1551,99,6.818181818181818
Nandura,Cotton,2014,3951,4050,99,2.5056947608200457
Jintur,Wheat(Husked),2016,1866,1965,99,5.305466237942122
Telhara,Wheat(Husked),2015,1419,1518,99,6.976744186046512
Pachora,Sorgum(Jawar),2016,1318,1417,99,7.511380880121396
Lasur Station,Maize,2015,1137,1236,99,8.70712401055409
Kurdwadi-Modnimb,Maize,2015,1491,1590,99,6.639839034205232
Chamorshi,Paddy-Unhusked,2016,2375,2474,99,4.168421052631579
Kalvan,Soybean,2014,3184,3283,99,3.10929648241206
Armori,Paddy-Unhusked,2014,1675,1774,99,5.91044776119403
Jalgaon,Sorgum(Jawar),2015,1330,1429,99,7.443609022556391
Sangli-Miraj,Wheat(Unhusked),2016,3560,3659,99,2.7808988764044944
Nandura,Bajri,2015,989,1088,99,10.010111223458038
Kalvan,Bajri,2015,1156,1255,99,8.56401384083045
Bhandara,Wheat(Husked),2015,1430,1529,99,6.923076923076923
Ahmedpur,Sorgum(Jawar),2016,1514,1613,99,6.538969616908851
Yeotmal,Green Gram,2015,6101,6200,99,1.622684805769546
Shirur,Gram,2015,2955,3054,99,3.350253807106599
Loha,Sorgum(Jawar),2015,1222,1321,99,8.101472995090017
Parbhani,Soybean,2016,3601,3700,99,2.7492363232435433
Indapur-Bhigwan,Ghevda Seed,2016,3101,3200,99,3.1925185424056757
Lonar,Sorgum(Jawar),2016,1155,1254,99,8.571428571428571
Yeola,Bajri,2015,1261,1360,99,7.8509119746233145
Islampur,Tomato,2016,113,212,99,87.61061946902655
Jintur,Cotton,2014,3939,4038,99,2.5133282559025134
Katol,Cotton,2015,3979,4078,99,2.488062327217894
Ausa,Safflower,2014,2287,2386,99,4.328815041539134
Tumsar,Other Cereals,2015,1722,1821,99,5.7491289198606275
Lonar,Sorgum(Jawar),2015,1139,1238,99,8.691834942932397
Mangalwedha,Maize,2015,1139,1238,99,8.691834942932397
Udgir,Sorgum(Jawar),2015,1342,1441,99,7.377049180327869
Solapur,Jaggery,2016,3401,3500,99,2.9109085563069685
Parshiwani,Cotton,2015,4219,4318,99,2.3465276131784782
Murtizapur,Wheat(Husked),2014,1405,1504,99,7.0462633451957295
Ausa,Paddy-Unhusked,2016,1101,1200,99,8.991825613079019
Ahmedpur,Soybean,2016,3711,3810,99,2.667744543249798
Ramtek,Mango,2015,403,502,99,24.56575682382134
Malegaon,Soybean,2014,3226,3325,99,3.0688158710477373
Gangapur,MAIZE,2016,1033,1132,99,9.583736689254598
Parbhani,Soybean,2015,3274,3373,99,3.0238240684178375
Tiroda,Paddy-Unhusked,2015,1541,1640,99,6.424399740428293
Barshi,Ladies Finger,2016,120,219,99,82.5
Shahapur,Paddy-Unhusked,2015,1473,1572,99,6.720977596741344
Latur,Maize,2015,1300,1399,99,7.615384615384615
Chamorshi,Paddy-Unhusked,2015,1829,1927,98,5.358119190814652
Lasur Station,Maize,2015,1120,1218,98,8.75
Akhadabalapur,Cotton,2015,4044,4142,98,2.4233432245301683
Varud-Rajura Bazar,Soybean,2015,3233,3331,98,3.0312403340550573
Sonpeth,Gram,2016,4204,4302,98,2.331113225499524
Pune-Pimpri,Onion,2016,552,650,98,17.753623188405797
Pune-Pimpri,Onion,2016,673,771,98,14.561664190193165
Indapur,Rice(Paddy-Hus),2016,1410,1508,98,6.950354609929078
Wardha,Pigeon Pea (Tur),2014,4492,4590,98,2.1816562778272486
Koregaon,Gram,2016,5540,5638,98,1.7689530685920578
Nagpur,Banana,2014,450,548,98,21.77777777777778
Umarga,Wheat(Husked),2015,1300,1398,98,7.538461538461538
Sindevahi,Paddy-Unhusked,2016,1745,1843,98,5.616045845272207
Barshi,Chikoo,2015,80,178,98,122.5
Dound,Maize,2016,1457,1555,98,6.726149622512011
Khed (Shel Pimpalgaon),Flower,2016,1402,1500,98,6.990014265335235
Ahmedpur,Bajri,2016,1269,1367,98,7.722616233254531
Ahmedpur,Sunflower,2016,3710,3808,98,2.641509433962264
Gadchiroli,Paddy-Unhusked,2015,1579,1677,98,6.206459784673844
Bhokardan,Soybean,2016,3432,3530,98,2.8554778554778553
Parola,Maize,2016,1318,1416,98,7.435508345978755
Islampur,Cabbage,2016,125,223,98,78.4
Dhule,Soybean,2015,3142,3240,98,3.1190324633991087
Sindevahi,Paddy-Unhusked,2015,1800,1898,98,5.444444444444445
Kurdwadi,Maize,2015,1147,1245,98,8.54402789886661
Murum,Bajri,2015,1467,1565,98,6.680299931833674
Kej,Maize,2016,1488,1586,98,6.586021505376344
Barshi,Brinjal,2015,79,177,98,124.0506329113924
Pandharpur,Sorgum(Jawar),2016,1787,1885,98,5.484051482932289
Patan,Ladies Finger,2015,378,476,98,25.925925925925927
Mangalwedha,Maize,2015,1145,1243,98,8.558951965065502
Morshi,Soybean,2015,3162,3260,98,3.0993042378241618
Dhule,Soybean,2016,3160,3258,98,3.1012658227848102
Bhokar,Black Gram,2014,4513,4611,98,2.1715045424329715
Tasgaon,Maize,2016,1459,1557,98,6.716929403701165
Kolhapur-Malkapur,BRINJAL,2016,131,229,98,74.80916030534351
Barshi,Kharbuj,2015,120,218,98,81.66666666666667
Akot,Sorgum(Jawar),2015,1040,1138,98,9.423076923076923
Khed (Shel Pimpalgaon),Cluster Bean,2015,2716,2814,98,3.6082474226804124
Washim,Sorgum(Jawar),2015,1231,1329,98,7.961007311129164
Digras,Cotton,2015,3897,3995,98,2.514754939697203
Dudhani,Bajri,2015,1500,1598,98,6.533333333333333
Bori Arab,Ground Nut Pods (Dry),2016,4855,4953,98,2.018537590113285
Chalisgaon,Sorgum(Jawar),2016,1305,1403,98,7.509578544061303
Achalpur,Soybean,2015,3217,3315,98,3.0463164438918247
Ahmednagar,Wheat(Husked),2016,1747,1845,98,5.609616485403549
Barshi,Brinjal,2015,145,243,98,67.58620689655173
Palghar(Bevur),Onion,2016,978,1076,98,10.020449897750511
Kolhapur-Malkapur,LADIES FINGER,2016,130,228,98,75.38461538461539
Kalamb (Os),Bajri,2016,1524,1622,98,6.430446194225722
Parbhani,Soybean,2015,3390,3488,98,2.8908554572271385
Mudkhed,Wheat(Husked),2015,1407,1505,98,6.965174129353234
Barshi,Ladies Finger,2015,50,148,98,196.0
Lonar,Sorgum(Jawar),2015,1255,1353,98,7.808764940239044
Karjat (Raigad),Paddy-Unhusked,2015,1340,1438,98,7.313432835820896
Malegaon,Soybean,2015,3478,3576,98,2.8177113283496262
Mandhal,Paddy-Unhusked,2016,1770,1867,97,5.480225988700565
Jalgaon,Banana,2015,177,274,97,54.80225988700565
Osmanabad,Gram,2016,4172,4269,97,2.3250239693192714
Mangalwedha,Maize,2015,1193,1290,97,8.130762782900252
Hadgaon,Soybean,2014,3205,3302,97,3.0265210608424336
Mandhal,Gram,2016,3558,3655,97,2.726250702641934
Pachora,Bajri,2015,1344,1441,97,7.217261904761905
Zarijamini,Gram,2015,3074,3171,97,3.155497722836695
Bhusaval,Wheat(Husked),2015,1282,1379,97,7.566302652106084
Vaijapur,Wheat(Husked),2016,1656,1753,97,5.857487922705314
Devala,Bajri,2015,1252,1349,97,7.747603833865814
Pathari,Bajri,2015,1372,1469,97,7.069970845481049
Latur,Bajri,2016,1665,1762,97,5.8258258258258255
Umarga,Sorgum(Jawar),2016,1674,1771,97,5.7945041816009555
Satana,Maize,2016,1407,1504,97,6.894100923951671
Bhusaval,Sorgum(Jawar),2015,1098,1195,97,8.83424408014572
Chandvad,Maize,2015,1352,1449,97,7.174556213017752
Aarni,Wheat(Husked),2015,1410,1507,97,6.879432624113475
Pulgaon,Gram,2016,5046,5143,97,1.9223147047166071
Pune,Jaggery,2014,3136,3233,97,3.0931122448979593
Chimur,Paddy-Unhusked,2016,2315,2412,97,4.190064794816415
Chopda,Wheat(Husked),2014,1426,1523,97,6.802244039270687
Junnar (Narayangaon),Tomato,2016,96,193,97,101.04166666666667
Bhokardan,Wheat(Husked),2016,1543,1640,97,6.2864549578742706
Paithan,Bajri,2015,1291,1388,97,7.513555383423703
Indapur-Bhigwan,Maize,2014,1250,1347,97,7.76
Dhule,Maize,2015,1265,1362,97,7.66798418972332
Malkapur,Sorgum(Jawar),2016,1278,1375,97,7.589984350547731
Malkapur,Wheat(Husked),2014,1402,1499,97,6.9186875891583455
Bhiwapur,Cotton,2015,3814,3911,97,2.54326166754064
Sangli-Miraj,Wheat(Unhusked),2016,3390,3487,97,2.8613569321533925
Akola,Maize,2015,1395,1492,97,6.953405017921147
Sinner,Soybean,2015,3878,3975,97,2.5012893243940177
Akhadabalapur,Cotton,2015,3925,4022,97,2.4713375796178343
Rahuri-Vambori,Soybean,2016,3245,3342,97,2.989214175654854
Rajura,Gram,2016,4032,4129,97,2.4057539682539684
Kalamb (Os),Soybean,2015,3214,3311,97,3.0180460485376477
Lonar,Wheat(Husked),2016,1531,1628,97,6.3357282821685175
Savner,Maize,2015,1271,1368,97,7.631785995279308
Akhadabalapur,Soybean,2016,2779,2876,97,3.4904641957538685
Devani,Soybean,2016,3666,3763,97,2.645935624659029
Chopda,Bajri,2015,1278,1375,97,7.589984350547731
Karjat (Raigad),Paddy-Unhusked,2015,1340,1437,97,7.2388059701492535
Gondpimpri,Soybean,2016,3588,3685,97,2.7034559643255296
Shirur,Wheat(Husked),2015,1369,1466,97,7.085463842220599
Nandgaon,Soybean,2014,3303,3400,97,2.936724190130185
Nira-Saswad,Maize,2015,1495,1592,97,6.488294314381271
Karjat (Raigad),Paddy-Unhusked,2015,1343,1440,97,7.2226358897989575
Gevrai,MAIZE,2016,1139,1236,97,8.516242317822652
Barshi,Ladies Finger,2015,61,158,97,159.01639344262296
Ambejogai,Sorgum(Jawar),2015,2029,2126,97,4.780680137999014
Nanded,Sorgum(Jawar),2014,1265,1362,97,7.66798418972332
Aurad Shahajani,Soybean,2016,3754,3851,97,2.583910495471497
Jawala-Bajar,Soybean,2015,3537,3634,97,2.7424370935821316
Rahuri-Vambori,Bajri,2015,1479,1576,97,6.558485463150777
Barshi,Grapes,2015,100,197,97,97.0
Telhara,Sorgum(Jawar),2016,1258,1355,97,7.710651828298887
Dondaicha,Sorgum(Jawar),2016,1592,1689,97,6.092964824120603
Tiroda,PADDY-UNHUSKED,2016,1530,1627,97,6.339869281045751
Mohol,Maize,2015,1537,1634,97,6.31099544567339
Aurangabad,Cotton,2014,3920,4017,97,2.4744897959183674
Shirur,Wheat(Husked),2015,1449,1546,97,6.694271911663216
Mohol,Maize,2016,1374,1471,97,7.059679767103348
Tumsar,Paddy-Unhusked,2015,1481,1578,97,6.549628629304524
Katol,Wheat(Husked),2016,1448,1545,97,6.698895027624309
Jawala-Bajar,Gram,2016,4148,4244,96,2.314368370298939
Telhara,Sorgum(Jawar),2015,1454,1550,96,6.6024759284731775
Barshi,Flower,2015,100,196,96,96.0
Sindevahi,Paddy-Unhusked,2016,1900,1996,96,5.052631578947368
Bhokardan,Maize,2016,1353,1449,96,7.095343680709535
Kopargaon,Maize,2016,1324,1420,96,7.2507552870090635
Shirpur,Black Gram,2015,5524,5620,96,1.7378711078928313
Chimur,Paddy-Unhusked,2015,1806,1902,96,5.3156146179401995
Ghatanji,Cotton,2015,3946,4042,96,2.432843385707045
Dondaicha,Matki,2014,6728,6824,96,1.426872770511296
Pune-Manjri,Cabbage,2016,768,864,96,12.5
Tiroda,Paddy-Unhusked,2015,1501,1597,96,6.395736175882745
Telhara,Sorgum(Jawar),2016,1242,1338,96,7.729468599033816
Sindevahi,Paddy-Unhusked,2016,1723,1819,96,5.571677307022635
Savner,Sorgum(Jawar),2016,1175,1271,96,8.170212765957446
Kolhapur,Banana,2016,1190,1286,96,8.067226890756302
Shrirampur,Maize,2016,1249,1345,96,7.6861489191353085
Achalpur,Sorgum(Jawar),2014,1414,1510,96,6.789250353606789
Paithan,Sorgum(Jawar),2015,1528,1624,96,6.282722513089006
Tumsar,Black Gram,2016,7707,7803,96,1.2456208641494746
Chopda,Bajri,2015,1412,1508,96,6.798866855524079
Chopda,Sorgum(Jawar),2015,1181,1277,96,8.128704487722269
Sonpeth,COTTON,2016,4677,4773,96,2.0525978191148173
Chopda,Wheat(Husked),2014,1460,1556,96,6.575342465753424
Kalamb (Os),Sunflower,2016,3138,3234,96,3.0592734225621414
Lonar,Sorgum(Jawar),2015,1195,1291,96,8.03347280334728
Devala,Tamarind,2016,1155,1251,96,8.311688311688311
Digras,Wheat(Husked),2015,1551,1647,96,6.189555125725338
Rahuri,Wheat(Husked),2015,1402,1498,96,6.847360912981455
Amarawati,Maize,2015,1158,1254,96,8.290155440414507
Washim,Sesamum,2016,4500,4596,96,2.1333333333333333
Ambad(Vadi Godri),Maize,2016,1300,1396,96,7.384615384615385
Dharni,Sorgum(Jawar),2016,1459,1555,96,6.579849211788897
Chamorshi,Paddy-Unhusked,2015,1797,1893,96,5.342237061769616
Umari,Soybean,2016,3853,3949,96,2.4915650142745913
Brahmpuri,Paddy-Unhusked,2015,2000,2096,96,4.8
Kalmeshwar,Cotton,2015,3825,3921,96,2.5098039215686274
Vaijapur,Wheat(Husked),2014,1383,1479,96,6.941431670281996
Chimur,Paddy-Unhusked,2016,2280,2376,96,4.2105263157894735
Satana,Wheat(Husked),2014,1535,1631,96,6.254071661237785
Tuljapur,Sorgum(Jawar),2015,1192,1288,96,8.053691275167786
Katol,Pigeon Pea (Tur),2014,4225,4321,96,2.272189349112426
Loha,Wheat(Husked),2015,1446,1542,96,6.639004149377594
Aamgaon,Paddy-Unhusked,2015,1459,1555,96,6.579849211788897
Gadchiroli,Paddy-Unhusked,2015,1559,1655,96,6.157793457344452
Chimur,Paddy-Unhusked,2016,2281,2377,96,4.208680403331872
Rahuri-Vambori,Maize,2014,1010,1106,96,9.504950495049505
Indapur,Maize,2015,1411,1506,95,6.732813607370659
Savner,Wheat(Husked),2015,1223,1318,95,7.76778413736713
Roha,Paddy-Unhusked,2015,1305,1400,95,7.2796934865900385
Ambejogai,Wheat(Husked),2015,2113,2208,95,4.4959772834831995
Shirala,Maize,2014,1310,1405,95,7.251908396946565
Kalmeshwar,Wheat(Husked),2016,1563,1658,95,6.078055022392834
Dhamangaon-Rly,Wheat(Husked),2016,1527,1622,95,6.221349050425672
Mangalwedha,Maize,2015,1234,1329,95,7.698541329011345
Achalpur,Wheat(Husked),2015,1492,1587,95,6.367292225201072
Chakur,Gram,2016,5548,5643,95,1.7123287671232876
Vaijapur,Sorgum(Jawar),2015,1535,1630,95,6.188925081433225
Yeola,Sorgum(Jawar),2016,1628,1723,95,5.835380835380835
Yawal,Banana,2015,248,343,95,38.306451612903224
Parbhani,Sorgum(Jawar),2016,1660,1755,95,5.72289156626506
Raver,Pigeon Pea (Tur),2014,3808,3903,95,2.494747899159664
Mohol,Maize,2016,1766,1861,95,5.379388448471121
Mohol,Maize,2014,1361,1456,95,6.980161645848641
Washim-Ansing,Green Gram,2016,4101,4196,95,2.316508168739332
Gondiya,Paddy-Unhusked,2016,1510,1605,95,6.291390728476821
Gondiya,Paddy-Unhusked,2016,1467,1562,95,6.4758009543285615
Barshi,Brinjal,2015,146,241,95,65.06849315068493
Morshi,Sorgum(Jawar),2014,1361,1456,95,6.980161645848641
Morshi,Wheat(Husked),2014,1433,1528,95,6.6294487090020935
Umarga,Sunflower,2016,3560,3655,95,2.668539325842697
Gevrai,Bajri,2015,1141,1236,95,8.326029798422436
Akot,Sorgum(Jawar),2016,1421,1516,95,6.685432793807178
Shirur,Bajri,2014,1351,1446,95,7.031828275351591
Barshi,Cluster Bean,2015,144,239,95,65.97222222222223
Kada,Soybean,2015,3161,3256,95,3.0053780449224927
Lasalgaon-Vinchur,Bajri,2015,1575,1670,95,6.031746031746032
Akkolkot,Sorgum(Jawar),2016,2105,2200,95,4.513064133016627
Raver,Sorgum(Jawar),2016,1510,1605,95,6.291390728476821
Rahata,Soybean,2015,3074,3169,95,3.0904359141184123
Kalvan,WHEAT(HUSKED),2016,1724,1819,95,5.510440835266821
Amarawati,Maize,2015,1206,1301,95,7.877280265339967
Tumsar,RICE(PADDY-HUS),2016,2614,2709,95,3.6342769701606734
Beed,Maize,2016,1466,1561,95,6.4802182810368345
Shahada,Maize,2015,1133,1228,95,8.384819064430715
Dhule,Soybean,2015,3114,3209,95,3.050738599871548
Chopda,Wheat(Husked),2014,1429,1524,95,6.648005598320504
Pusad,Batbati,2016,5589,5684,95,1.699767400250492
Rahata,Wheat(Husked),2016,1600,1695,95,5.9375
Sangamner,Sorgum(Jawar),2015,1550,1645,95,6.129032258064516
Beed,Gram,2015,3342,3437,95,2.8426092160383005
Indapur-Bhigwan,Sunflower,2016,3256,3351,95,2.9176904176904177
Jalna-Badnapur,Wheat(Husked),2016,1750,1845,95,5.428571428571429
Dhule,Sorgum(Jawar),2016,1574,1669,95,6.035578144853876
Tiroda,Paddy-Unhusked,2015,1496,1591,95,6.350267379679145
Devala,Pigeon Pea (Tur),2016,7168,7263,95,1.3253348214285714
Tiroda,Paddy-Unhusked,2015,1496,1591,95,6.350267379679145
Kej,Maize,2015,1393,1488,95,6.819813352476669
Kundalwadi,Gram,2016,4160,4255,95,2.2836538461538463
Brahmpuri,Paddy-Unhusked,2014,2660,2755,95,3.5714285714285716
Umarga,Bajri,2015,1200,1295,95,7.916666666666667
Kalvan,Soybean,2015,3250,3345,95,2.923076923076923
Morshi,Wheat(Husked),2016,1631,1726,95,5.824647455548743
Parli-Vaijnath,Bajri,2015,1398,1493,95,6.795422031473533
Raver,Maize,2015,1032,1127,95,9.205426356589147
Kalamb (Os),Maize,2015,1371,1466,95,6.9292487235594455
Ambejogai,Black Gram,2015,5306,5401,95,1.790425932906144
Savali,Paddy-Unhusked,2016,1906,2001,95,4.984260230849948
Kalamb (Os),Tamarind,2015,3871,3966,95,2.4541462154482048
Shrirampur-Belapur,Gram,2016,3864,3959,95,2.458592132505176
Parli-Vaijnath,Sorgum(Jawar),2014,1190,1285,95,7.983193277310924
Gondpimpri,Soybean,2016,3263,3358,95,2.911431198283788
Jalgaon,Bajri,2014,1354,1449,95,7.016248153618907
Tiroda,Paddy-Unhusked,2016,1645,1739,94,5.714285714285714
Navapur,SOYBEAN,2016,2700,2794,94,3.4814814814814814
Kopargaon,Bajri,2015,1270,1364,94,7.4015748031496065
Devala,Maize,2014,1190,1284,94,7.899159663865547
Brahmpuri,Paddy-Unhusked,2015,1845,1939,94,5.094850948509485
Sindevahi,Paddy-Unhusked,2016,2204,2298,94,4.26497277676951
Yeotmal,Cotton,2015,3932,4026,94,2.390640895218718
Ausa,Sunflower,2015,3023,3117,94,3.109493880251406
Katol,Cotton,2015,4183,4277,94,2.247191011235955
Umarga,Soybean,2015,3101,3195,94,3.0312802321831667
Daryapur,Soybean,2016,2959,3053,94,3.176748901655965
Raver,Wheat(Husked),2015,1350,1444,94,6.962962962962963
Gangapur,Maize,2015,1108,1202,94,8.483754512635379
Dhamangaon-Rly,Cotton,2016,4563,4657,94,2.0600482138943677
Lasur Station,Maize,2015,1184,1278,94,7.9391891891891895
Parli-Vaijnath,Sunflower,2014,2775,2869,94,3.3873873873873874
Pune,Maize,2015,1586,1680,94,5.926860025220681
Morshi,Sorgum(Jawar),2015,1344,1438,94,6.994047619047619
Sillod,Maize,2016,1369,1463,94,6.866325785244705
Barshi,Ladies Finger,2014,100,194,94,94.0
Morshi,Wheat(Husked),2015,1431,1525,94,6.568832983927323
Sindevahi,Paddy-Unhusked,2016,1691,1785,94,5.558840922531047
Umared,Linseed,2015,4462,4556,94,2.10667861945316
Washim-Ansing,Wheat(Husked),2016,1591,1685,94,5.90823381521056
Bhusaval,Bajri,2015,1206,1300,94,7.794361525704809
Sindi,Cotton,2015,3904,3998,94,2.4077868852459017
Parbhani,Soybean,2015,3485,3579,94,2.697274031563845
Kopargaon,Maize,2015,1096,1190,94,8.576642335766424
Jalgaon,Maize,2014,1027,1121,94,9.152872444011685
Jawala-Bajar,Soybean,2016,3544,3638,94,2.6523702031602707
Navapur,Cabbage,2016,511,605,94,18.395303326810176
Bhokardan,Gram,2016,3975,4069,94,2.3647798742138364
Washim,Soybean,2016,3548,3642,94,2.6493799323562572
Darwha,Cotton,2014,3925,4019,94,2.394904458598726
Parli-Vaijnath,Gram,2015,4344,4438,94,2.1639042357274403
Jalna,Wheat(Husked),2016,1745,1839,94,5.386819484240688
Chopda,Pigeon Pea (Tur),2016,6660,6754,94,1.4114114114114114
Jalgaon,Spinach,2014,1944,2038,94,4.8353909465020575
Chandrapur,Soybean,2016,3540,3634,94,2.6553672316384183
Lasalgaon-Niphad,Maize,2016,979,1073,94,9.601634320735444
Jawala-Bajar,Soybean,2015,3151,3245,94,2.9831799428752777
Vaduj,Maize,2016,1406,1500,94,6.685633001422475
Rahuri,Wheat(Husked),2014,1443,1537,94,6.514206514206514
Malkapur,Sorgum(Jawar),2015,1193,1287,94,7.87929589270746
Khultabad,Maize,2015,1208,1302,94,7.781456953642384
Khultabad,Maize,2014,850,944,94,11.058823529411764
Arjuni Morgaon,Paddy-Unhusked,2014,1911,2005,94,4.918890633176347
Paithan,Gram,2016,5825,5919,94,1.613733905579399
Amalner,Maize,2016,1448,1542,94,6.49171270718232
Barshi,Tamarind Seed,2015,1693,1787,94,5.552274069698759
Armori,PADDY-UNHUSKED,2016,1613,1707,94,5.827650340979541
Telhara,Wheat(Husked),2015,1390,1484,94,6.762589928057554
Nanded,Green Gram,2016,4656,4750,94,2.0189003436426116
Sillod,Bajri,2015,1256,1350,94,7.484076433121019
Barshi-Vairag,Wheat(Husked),2016,2199,2293,94,4.274670304683947
Mangalwedha,Bajri,2015,1313,1407,94,7.159177456207159
Gondpimpri,Soybean,2016,3269,3363,94,2.8754970939125113
Rahuri-Vambori,Gram,2015,4131,4225,94,2.2754780924715567
Tumsar,Paddy-Unhusked,2015,1650,1744,94,5.696969696969697
Tumsar,Paddy-Unhusked,2015,1597,1691,94,5.886036318096431
Barshi-Vairag,Maize,2014,1101,1195,94,8.537693006357857
Kalmeshwar,Gram,2016,3942,4036,94,2.384576357179097
Manchar,Kanda Pat,2014,433,527,94,21.709006928406467
Pandharpur,Sorgum(Jawar),2016,1905,1999,94,4.934383202099737
Ner Parasopant,Pigeon Pea (Tur),2015,8709,8803,94,1.0793432081754506
Amarawati,Maize,2016,1396,1490,94,6.73352435530086
Nanded,Soybean,2014,3263,3356,93,2.850137909898866
Parola,Sorgum(Jawar),2016,1255,1348,93,7.410358565737051
Wardha,Wheat(Husked),2015,1432,1525,93,6.494413407821229
Bhokar,Soybean,2015,3256,3349,93,2.8562653562653564
Pavani,Paddy-Unhusked,2015,1767,1860,93,5.2631578947368425
Rahata,Maize,2014,1076,1169,93,8.643122676579926
Manmad,Maize,2015,1398,1491,93,6.652360515021459
Bhandara,Wheat(Husked),2016,1644,1737,93,5.656934306569343
Umari,Soybean,2016,3684,3777,93,2.52442996742671
Ghoti,TOMATO,2016,892,985,93,10.426008968609866
Nandurbar,Pigeon Pea (Tur),2015,5249,5342,93,1.7717660506763193
Bhiwapur,Cotton,2014,3863,3956,93,2.4074553455863317
Nampur,Bajri,2016,1409,1502,93,6.60042583392477
Shirur,Cowpea,2015,4864,4957,93,1.9120065789473684
Savner,Sorgum(Jawar),2015,1096,1189,93,8.485401459854014
Yeola,Wheat(Husked),2015,1540,1633,93,6.038961038961039
Umared,COTTON,2016,4823,4916,93,1.9282604188264565
Jalna,Jaggery,2015,2390,2483,93,3.8912133891213387
Bhokardan,Soybean,2015,3200,3293,93,2.90625
Sailu,Soybean,2015,3184,3277,93,2.920854271356784
Amalner,Sorgum(Jawar),2016,1395,1488,93,6.666666666666667
Vaduj,Bajri,2014,1388,1481,93,6.70028818443804
Nandurbar,Maize,2016,1476,1569,93,6.300813008130081
Chalisgaon,Banana,2016,187,280,93,49.73262032085562
Jalgaon,Banana,2016,182,275,93,51.0989010989011
Shevgaon-Bodhegaon,Sorgum(Jawar),2015,1382,1475,93,6.729377713458756
Umarga,Sorgum(Jawar),2015,1383,1476,93,6.724511930585683
Babhulgaon,Cotton,2015,4198,4291,93,2.215340638399238
Kolhapur,Raddish,2015,417,510,93,22.302158273381295
Nagpur,Lemon,2016,113,206,93,82.30088495575221
Bhusaval,Wheat(Husked),2014,1281,1374,93,7.259953161592506
Ghoti,CUCUMBER,2016,913,1006,93,10.18619934282585
Lonar,Wheat(Husked),2015,1490,1583,93,6.241610738255034
Jalgaon,Wheat(Husked),2016,1576,1669,93,5.901015228426396
Sakri,Bajri,2015,1376,1469,93,6.758720930232558
Umarga,Wheat(Husked),2015,1884,1977,93,4.936305732484076
Ghatanji,Soybean,2015,3146,3239,93,2.9561347743165927
Pune,JAGGERY,2016,3042,3135,93,3.057199211045365
Yeola,Bajri,2016,1384,1477,93,6.719653179190751
Rahuri-Vambori,Bajri,2016,1829,1922,93,5.084745762711864
Tiroda,Paddy-Unhusked,2016,1562,1655,93,5.953905249679898
Shevgaon-Bodhegaon,Bajri,2015,1275,1368,93,7.294117647058823
Amarawati,Maize,2016,1365,1458,93,6.813186813186813
Bhiwapur,Paddy-Unhusked,2016,1850,1943,93,5.027027027027027
Lonar,Maize,2015,1284,1377,93,7.242990654205608
Ahmednagar,Bajri,2015,1311,1404,93,7.093821510297483
Raver,Sorgum(Jawar),2016,1273,1366,93,7.305577376276513
Aarni,Sorgum(Jawar),2015,1245,1338,93,7.469879518072289
Pavani,Paddy-Unhusked,2014,1851,1944,93,5.024311183144246
Pune,Jaggery,2015,2414,2507,93,3.852526926263463
Tasgaon,MAIZE,2016,1367,1460,93,6.803218727139722
Dondaicha-Sindkheda,Bajri,2016,1327,1420,93,7.008289374529013
Akluj,Wheat(Husked),2015,1486,1579,93,6.2584118438761775
Tuljapur,Sorgum(Jawar),2014,1143,1236,93,8.136482939632545
Jalna,Jaggery,2015,2406,2499,93,3.865336658354115
Indapur-Bhigwan,Maize,2016,1492,1585,93,6.233243967828418
Khalapur(Shil-Phata),Paddy-Unhusked,2016,1410,1503,93,6.595744680851064
Jintur,Gram,2016,6045,6138,93,1.5384615384615385
Parbhani,Gram,2015,3207,3299,92,2.868724664795759
Indapur (Nimgaon Ketki),Wheat(Husked),2015,1375,1467,92,6.6909090909090905
Dondaicha-Sindkheda,Bajri,2016,1270,1362,92,7.244094488188976
Barshi,Grapes,2016,150,242,92,61.333333333333336
Shahada,Bajri,2016,1136,1228,92,8.098591549295774
Shevgaon-Bodhegaon,Bajri,2014,1188,1280,92,7.744107744107744
Bhokardan,Soybean,2015,3583,3675,92,2.567680714485068
Pathardi,Cotton,2015,3750,3842,92,2.453333333333333
Barshi,Ghevda,2016,150,242,92,61.333333333333336
Bhokardan,Bajri,2016,1279,1371,92,7.193119624706802
Khed (Shel Pimpalgaon),Bottle Gourd,2015,785,877,92,11.719745222929935
Bhokardan,Wheat(Husked),2016,1529,1621,92,6.017004578155658
Beed,Pigeon Pea (Tur),2015,5550,5642,92,1.6576576576576576
Bhokardan,Wheat(Husked),2016,1500,1592,92,6.133333333333334
Sangali,Maize,2014,1350,1442,92,6.814814814814815
Barshi,Capsicum,2016,136,228,92,67.6470588235294
Mandhal,Soybean,2016,3364,3456,92,2.7348394768133173
Islampur,Cucumber,2016,88,180,92,104.54545454545455
Devala,Bajri,2015,1250,1342,92,7.36
Nandgaon,Wheat(Husked),2014,1489,1581,92,6.178643384822029
Sangli-Miraj,Wheat(Unhusked),2016,3983,4075,92,2.309816721064524
Shirur,Sorgum(Jawar),2016,1613,1705,92,5.703657780533168
Savner,Wheat(Husked),2015,1283,1375,92,7.1706936866718625
Barshi,Flower,2015,93,185,92,98.9247311827957
Indapur,Soybean,2015,3317,3409,92,2.7735905939101597
Bhusaval,Gram,2015,3800,3892,92,2.4210526315789473
Rahata,Wheat(Husked),2015,1406,1498,92,6.543385490753912
Majalgaon,Gram,2015,4667,4759,92,1.9712877651596314
Savner,Sorgum(Jawar),2015,1212,1304,92,7.590759075907591
Kille Dharur,Cotton,2015,4332,4424,92,2.123730378578024
Barshi-Vairag,Wheat(Husked),2015,2059,2151,92,4.468188440990772
Parbhani,Soybean,2015,3143,3235,92,2.927139675469297
Shrirampur,Maize,2016,1283,1375,92,7.1706936866718625
Washim-Ansing,Sorgum(Jawar),2016,1233,1325,92,7.461476074614761
Dharni,Wheat(Husked),2016,1546,1638,92,5.950840879689522
Pune-Pimpri,Potato,2015,1075,1167,92,8.55813953488372
Bhiwapur,Cotton,2015,4033,4125,92,2.281180262831639
Rahata,Bajri,2015,1234,1326,92,7.455429497568882
Amarawati,Gram,2015,4719,4811,92,1.9495655859292222
Chopda,Soybean,2016,2893,2985,92,3.180089872105081
Khed (Shel Pimpalgaon),Cluster Bean,2015,2927,3019,92,3.143149982917663
Bhokar,Wheat(Husked),2015,1398,1490,92,6.580829756795422
Sailu,Green Gram,2015,6709,6801,92,1.3712922939335221
Mangalwedha,Bajri,2014,1263,1355,92,7.28424386381631
Achalpur,Sorgum(Jawar),2016,1536,1628,92,5.989583333333333
Basmat,Soybean,2014,3253,3345,92,2.828158622809714
Bhokardan-Pimpalgaon Renu,Wheat(Husked),2015,1560,1651,91,5.833333333333333
Jawala-Bajar,Gram,2016,4130,4221,91,2.2033898305084745
Shegaon,Wheat(Husked),2015,1459,1550,91,6.237148732008225
Pune-Pimpri,Cabbage,2014,695,786,91,13.093525179856115
Rahata,Ghevda,2016,2409,2500,91,3.7775010377750102
Parola,Wheat(Husked),2016,1353,1444,91,6.725794530672579
Gangapur,Maize,2014,907,998,91,10.033076074972437
Mandhal,Soybean,2016,3301,3392,91,2.7567403817025142
Gadchiroli,PADDY-UNHUSKED,2016,1707,1798,91,5.330990041007616
Devala,Wheat(Husked),2015,1536,1627,91,5.924479166666667
Devala,Wheat(Husked),2015,1567,1658,91,5.807275047862157
Amarawati,Gram,2015,4614,4705,91,1.9722583441699177
Pune-Pimpri,Beet Root,2015,1467,1558,91,6.203135650988412
Umared,Cotton,2016,4531,4622,91,2.008386669609358
Manmad,Maize,2014,1249,1340,91,7.285828662930344
Malegaon,Sorgum(Jawar),2015,1540,1631,91,5.909090909090909
Lakhandur,Black Gram,2016,8974,9065,91,1.0140405616224648
Jalgaon Jamod-Aasalgaon,Sorgum(Jawar),2014,1092,1183,91,8.333333333333334
Mohol,Maize,2015,1449,1540,91,6.280193236714976
Lonar,Green Gram,2016,4927,5018,91,1.8469656992084433
Lasur Station,Mustard,2015,3611,3702,91,2.5200775408474105
Shegaon,Green Gram,2016,6388,6479,91,1.4245460237946148
Barshi,Lemon,2015,119,210,91,76.47058823529412
Shirpur,Maize,2015,1146,1237,91,7.940663176265271
Kalamb (Os),Bajri,2016,1328,1419,91,6.852409638554217
Alibag,Paddy-Unhusked,2016,1543,1634,91,5.897602073882048
Umared,Other Pulses,2014,3921,4012,91,2.320836521295588
Raver-Sawada,Maize,2016,1302,1393,91,6.989247311827957
Lasalgaon-Vinchur,Maize,2015,1424,1515,91,6.390449438202247
Bhiwapur,Paddy-Unhusked,2016,1867,1958,91,4.874129619710766
Bhiwapur,Paddy-Unhusked,2016,1840,1931,91,4.945652173913044
Purna,Soybean,2015,3118,3209,91,2.918537524053881
Shirur,Bajri,2014,1386,1477,91,6.565656565656566
Dound,Maize,2016,1665,1756,91,5.465465465465465
Mehkar,Maize,2014,929,1020,91,9.795479009687837
Savner,Cotton,2015,4156,4247,91,2.1896053897978827
Pune-Pimpri,Walvad,2016,1982,2073,91,4.591321897073663
Indapur,Jaggery,2015,2194,2285,91,4.1476754785779395
Kej,Maize,2016,1470,1561,91,6.190476190476191
Shevgaon,Gram,2016,4192,4283,91,2.170801526717557
Ramtek,Paddy-Unhusked,2015,1885,1976,91,4.827586206896552
Murbad,Paddy-Unhusked,2015,1841,1932,91,4.942965779467681
Shirur,Black Gram,2016,5573,5664,91,1.6328727794724565
Devani,Soybean,2016,3665,3756,91,2.4829467939972716
Amarawati,Soybean,2015,3653,3744,91,2.491103202846975
Tuljapur,Sorgum(Jawar),2016,1705,1796,91,5.3372434017595305
Partur,Sorgum(Jawar),2014,1056,1147,91,8.617424242424242
Pune-Pimpri,Ghevda,2015,3227,3318,91,2.819956616052061
Chamorshi,Paddy-Unhusked,2015,1790,1880,90,5.027932960893855
Umarga,Sorgum(Jawar),2016,1757,1847,90,5.122367672168469
Udgir,Wheat(Husked),2015,1368,1458,90,6.578947368421052
Ambad(Vadi Godri),Cotton,2014,3940,4030,90,2.284263959390863
Vaijapur,Cotton,2015,3822,3912,90,2.3547880690737832
Chamorshi,Paddy-Unhusked,2016,1993,2083,90,4.515805318615153
Nanded,Gram,2016,4205,4295,90,2.140309155766944
Achalpur,Maize,2016,1561,1651,90,5.7655349135169764
Satana,Maize,2015,1321,1411,90,6.813020439061317
Kalamb (Os),Matki,2015,7900,7990,90,1.139240506329114
Rahata,Wheat(Husked),2016,1441,1531,90,6.2456627342123525
Latur,Maize,2016,1710,1800,90,5.2631578947368425
Chopda,Ground Nut Pods (Dry),2015,4520,4610,90,1.991150442477876
Kannad,Maize,2015,1050,1140,90,8.571428571428571
Rahata,Sorgum(Jawar),2016,1464,1554,90,6.147540983606557
Armori,Paddy-Unhusked,2016,1516,1606,90,5.936675461741425
Chimur,Soybean,2014,3010,3100,90,2.990033222591362
Pavani,Paddy-Unhusked,2014,1731,1821,90,5.1993067590987865
Koregaon,Ghevda Seed,2016,3323,3413,90,2.708396027685826
Aamgaon,Paddy-Unhusked,2016,1401,1491,90,6.423982869379015
Chopda,Bajri,2015,1053,1143,90,8.547008547008547
Indapur,Banana,2016,302,392,90,29.801324503311257
Indapur,Jaggery,2015,2271,2361,90,3.963011889035667
Indapur,Maize,2016,1474,1564,90,6.1058344640434195
Pune,Jaggery,2014,2975,3065,90,3.0252100840336134
Chopda,Soybean,2015,3150,3240,90,2.857142857142857
Ambejogai,Bajri,2014,1506,1596,90,5.9760956175298805
Rahata,WHEAT(HUSKED),2016,1833,1923,90,4.909983633387888
Manchar,Cabbage,2015,657,747,90,13.698630136986301
Barshi,Lemon,2015,200,290,90,45.0
Mandhal,Soybean,2016,3585,3675,90,2.510460251046025
Jalgaon,Wheat(Husked),2015,1560,1650,90,5.769230769230769
Fulambri,Maize,2015,1005,1095,90,8.955223880597014
Mandhal,Gram,2016,4092,4182,90,2.19941348973607
Devri,Paddy-Unhusked,2016,1360,1450,90,6.617647058823529
Bhokardan,Sorgum(Jawar),2015,1250,1340,90,7.2
Manmad,Maize,2014,1105,1195,90,8.144796380090497
Pune,Maize,2016,1655,1745,90,5.438066465256798
Lonar,Maize,2014,1060,1150,90,8.49056603773585
Jalgaon,Banana,2016,191,281,90,47.12041884816754
Udgir,Wheat(Husked),2014,1250,1340,90,7.2
Mukhed,Green Gram,2016,4728,4818,90,1.9035532994923858
Bhandara,Wheat(Husked),2016,1613,1703,90,5.579665220086794
Sakri,Wheat(Husked),2015,1398,1488,90,6.437768240343348
Kej,Sorgum(Jawar),2016,1725,1815,90,5.217391304347826
Sindi,Cotton,2015,4021,4111,90,2.2382491917433476
Morshi,Wheat(Husked),2016,1674,1764,90,5.376344086021505
Manchar,Cabbage,2015,467,557,90,19.271948608137045
Kille Dharur,Maize,2016,1457,1547,90,6.177076183939602
Taloda,Wheat(Husked),2016,1630,1720,90,5.521472392638037
Jintur,Soybean,2015,3226,3316,90,2.789832610043397
Solapur,Grapes,2015,55,145,90,163.63636363636363
Savner,Wheat(Husked),2015,1439,1529,90,6.254343293954135
Bhandara,Gram,2016,3970,4060,90,2.2670025188916876
Tumsar,Linseed,2015,4212,4302,90,2.1367521367521367
Khamgaon,Maize,2015,1021,1111,90,8.81488736532811
Barshi,Kharbuj,2015,60,150,90,150.0
Sindevahi,Paddy-Unhusked,2015,1739,1829,90,5.175388154111558
Barshi,Maize,2016,1444,1534,90,6.232686980609419
Ausa,Soybean,2015,3176,3266,90,2.8337531486146097
Himayatnagar,Wheat(Husked),2016,1410,1500,90,6.382978723404255
Amarawati,Maize,2016,1414,1504,90,6.364922206506365
Rahata,Ghevda,2016,3455,3545,90,2.6049204052098407
Bhokardan-Pimpalgaon Renu,Bajri,2016,1285,1375,90,7.003891050583658
Mehkar,Sorgum(Jawar),2016,1622,1712,90,5.548705302096177
Kalvan,Soybean,2015,3531,3621,90,2.548853016142736
Ahmedpur,Bajri,2016,1250,1340,90,7.2
Rahata,Ginger (Fresh),2015,4955,5045,90,1.8163471241170535
Pandharpur,Gram,2015,3900,3990,90,2.3076923076923075
Basmat,Soybean,2016,3604,3694,90,2.497225305216426
Kille Dharur,Cotton,2015,3775,3865,90,2.384105960264901
Mangaon(Bhadav),Paddy-Unhusked,2016,1410,1500,90,6.382978723404255
Mangaon(Bhadav),Paddy-Unhusked,2016,1410,1500,90,6.382978723404255
Shirur,Soybean,2015,3104,3194,90,2.899484536082474
Dhule,Soybean,2014,3041,3130,89,2.926668858927984
Parbhani,Soybean,2016,3507,3596,89,2.5377815796977474
Amalner,Bajri,2015,1093,1182,89,8.142726440988106
Savner,Wheat(Husked),2015,1399,1488,89,6.36168691922802
Aheri,Pigeon Pea (Tur),2015,5038,5127,89,1.7665740373163954
Kalmeshwar,Soybean,2016,2795,2884,89,3.184257602862254
Lasalgaon-Vinchur,Maize,2016,1370,1459,89,6.4963503649635035
Chopda,Wheat(Husked),2015,1442,1531,89,6.171983356449376
Dhule,Bajri,2015,1235,1324,89,7.206477732793522
Umari,Sorgum(Jawar),2016,1316,1405,89,6.762917933130699
Bhiwapur,Cotton,2015,3860,3949,89,2.305699481865285
Jalgaon,Sorgum(Jawar),2014,1312,1401,89,6.783536585365853
Barshi,Tomato,2014,54,143,89,164.8148148148148
Barshi,Bitter Gourd,2015,126,215,89,70.63492063492063
Barshi,Bor,2015,96,185,89,92.70833333333333
Lasur Station,Maize,2015,1278,1367,89,6.964006259780907
Wardha,Sorgum(Jawar),2015,1342,1431,89,6.631892697466468
Paithan,Sorgum(Jawar),2016,1631,1720,89,5.456774984671981
Vaduj,Wheat(Husked),2015,1722,1811,89,5.168408826945412
Pune-Pimpri,Pavtta,2015,2900,2989,89,3.0689655172413794
Aurad Shahajani,Sorgum(Jawar),2015,1497,1586,89,5.945223780895123
Aheri,Cotton,2015,3900,3989,89,2.282051282051282
Jawala-Bajar,Soybean,2015,3590,3679,89,2.479108635097493
Rahata,Sorgum(Jawar),2015,1135,1224,89,7.841409691629956
Pune-Pimpri,Onion,2016,597,686,89,14.90787269681742
Dhamangaon-Rly,Wheat(Husked),2016,1653,1742,89,5.384150030248034
Indapur (Nimgaon Ketki),Maize,2015,1453,1542,89,6.125258086717137
Navapur,Cabbage,2016,967,1056,89,9.20372285418821
Indapur,Jaggery,2016,2587,2676,89,3.440278314650174
Bhokardan,Soybean,2016,3800,3889,89,2.3421052631578947
Murud,Paddy-Unhusked,2016,1582,1671,89,5.625790139064476
Beed,Gram,2014,2235,2324,89,3.982102908277405
Bhokardan-Pimpalgaon Renu,Bajri,2015,1289,1378,89,6.904577191621412
Shirur,Wheat(Husked),2015,1383,1472,89,6.4352856109906
Jalna,Wheat(Husked),2015,1687,1776,89,5.275637225844695
Bhokardan,Soybean,2015,3417,3506,89,2.60462393912789
Kurdwadi,Gram,2016,4528,4617,89,1.965547703180212
Nanded,Green Gram,2016,4573,4662,89,1.9462059916903565
Ahmedpur,Rice(Paddy-Hus),2016,1411,1500,89,6.307583274273565
Jalgaon,Sorgum(Jawar),2016,1821,1910,89,4.887424492037342
Loha,Gram,2016,6341,6430,89,1.4035641066077906
Partur,Soybean,2015,3107,3196,89,2.8644995172191825
Partur,Soybean,2015,3251,3340,89,2.737619194094125
Vaduj,Sorgum(Jawar),2015,2000,2089,89,4.45
Ramtek,Chavli (Shenga ),2015,282,371,89,31.56028368794326
Manwat,Soybean,2015,3230,3319,89,2.7554179566563466
Pavani,Paddy-Unhusked,2015,1642,1731,89,5.420219244823386
Barshi,Bitter Gourd,2014,135,224,89,65.92592592592592
Navapur,MAIZE,2016,1200,1289,89,7.416666666666667
Aurangabad,Bottle Gourd,2016,185,274,89,48.108108108108105
Taloda,Bajri,2015,1082,1171,89,8.22550831792976
Zarijamini,Ground Nut Pods (Dry),2016,4775,4864,89,1.8638743455497382
Sailu,BLACK GRAM,2016,5511,5600,89,1.614951914353112
Lonar,Sorgum(Jawar),2016,1152,1241,89,7.725694444444445
Savali,Paddy-Unhusked,2016,1806,1895,89,4.9280177187153935
Nilanga,Wheat(Husked),2014,1400,1488,88,6.285714285714286
Sangamner,Maize,2016,1397,1485,88,6.299212598425197
Armori,Paddy-Unhusked,2016,1893,1981,88,4.648705758055995
Mangrulpeer,Sorgum(Jawar),2014,1416,1504,88,6.214689265536723
Kada,Sunflower,2016,2626,2714,88,3.351104341203351
Vasai,Paddy-Unhusked,2016,1469,1557,88,5.990469707283866
Shahada,Maize,2016,1282,1370,88,6.86427457098284
Khed (Shel Pimpalgaon),FLOWER,2016,480,568,88,18.333333333333332
Sangli-Miraj,WHEAT(UNHUSKED),2016,3570,3658,88,2.4649859943977592
Manmad,Maize,2016,1383,1471,88,6.36297903109183
Mantha,Gram,2015,3850,3938,88,2.2857142857142856
Jalgaon,Wheat(Husked),2014,1405,1493,88,6.263345195729538
Barshi,Maize,2015,1197,1285,88,7.351712614870509
Armori,Paddy-Unhusked,2015,1493,1581,88,5.8941728064300065
Alibag,Paddy-Unhusked,2016,1450,1538,88,6.068965517241379
Barshi,Brinjal,2016,88,176,88,100.0
Vaijapur,Sorgum(Jawar),2015,1562,1650,88,5.633802816901408
Kada,Maize,2016,1321,1409,88,6.661619984859954
Washim,Wheat(Husked),2016,2205,2293,88,3.9909297052154193
Tasgaon,Sorgum(Jawar),2016,1725,1813,88,5.101449275362318
Tasgaon,Sorgum(Jawar),2015,1583,1671,88,5.559065066329754
Islampur,BRINJAL,2016,104,192,88,84.61538461538461
Morshi,Sorgum(Jawar),2016,1375,1463,88,6.4
Dudhani,Black Gram,2015,8666,8754,88,1.0154627279021464
Newasa,Gram,2015,3300,3388,88,2.6666666666666665
Dhamangaon-Rly,Cotton,2015,3893,3981,88,2.260467505779604
Gangapur,Maize,2016,1317,1405,88,6.681852695520122
Mukhed,Pigeon Pea (Tur),2016,7725,7813,88,1.13915857605178
Lonar,Wheat(Husked),2015,1646,1734,88,5.34629404617254
Jawala-Bajar,Soybean,2016,3655,3743,88,2.4076607387140903
Dudhani,Wheat(Husked),2016,1611,1699,88,5.462445685909373
Yeola,Soybean,2015,3798,3886,88,2.3170089520800423
Kada,Maize,2015,1390,1478,88,6.330935251798561
Brahmpuri,Paddy-Unhusked,2015,1800,1888,88,4.888888888888889
Bhokardan-Pimpalgaon Renu,Gram,2015,3675,3763,88,2.3945578231292517
Partur,Sorgum(Jawar),2016,1714,1802,88,5.134189031505251
Umarga,Bajri,2016,1298,1386,88,6.779661016949152
Parli-Vaijnath,Sorgum(Jawar),2016,1565,1653,88,5.623003194888179
Tuljapur,Sorgum(Jawar),2015,1068,1156,88,8.239700374531836
Murum,Wheat(Unhusked),2015,2846,2934,88,3.0920590302178494
Partur,Bajri,2016,1500,1588,88,5.866666666666666
Ahmedpur,Bajri,2015,1258,1346,88,6.995230524642289
Loha,Sorgum(Jawar),2016,1616,1704,88,5.445544554455446
Parbhani,Soybean,2016,3383,3471,88,2.601241501625776
Mangalwedha,Maize,2016,1473,1561,88,5.974202308214529
Telhara,Cotton,2015,3947,4035,88,2.2295414238662277
Morshi,Wheat(Husked),2015,1556,1644,88,5.655526992287918
Jalna-Badnapur,Bajri,2015,1229,1317,88,7.160292921074044
Kopargaon,Maize,2015,1153,1241,88,7.632263660017346
Shrirampur,Maize,2015,1213,1301,88,7.254740313272877
Bhiwapur,Soybean,2015,3167,3255,88,2.778654878433849
Achalpur,Maize,2016,1392,1480,88,6.32183908045977
Akluj,Wheat(Husked),2015,1519,1607,88,5.793285055957867
Yawal,Banana,2015,455,543,88,19.34065934065934
Khamgaon,BAJRI,2016,1416,1504,88,6.214689265536723
Dharni,Wheat(Husked),2016,1600,1688,88,5.5
Washim,Sorgum(Jawar),2016,1419,1507,88,6.2015503875969
Jalgaon,Sorgum(Jawar),2014,1504,1592,88,5.851063829787234
Purna,Soybean,2016,3472,3560,88,2.5345622119815667
Aheri,Sorgum(Jawar),2015,1071,1159,88,8.216619981325863
Bhokardan-Pimpalgaon Renu,Gram,2015,3163,3250,87,2.750553272209927
Yeola,Bajri,2015,1297,1384,87,6.707787201233616
Wardha,Wheat(Husked),2014,1454,1541,87,5.983493810178817
Parli-Vaijnath,Gram,2016,6018,6105,87,1.4456630109670987
Satana,Maize,2014,1113,1200,87,7.816711590296496
Varud-Rajura Bazar,Wheat(Husked),2015,1412,1499,87,6.161473087818697
Lasalgaon,Rice(Paddy-Hus),2016,1751,1838,87,4.9685893774985725
Bhiwapur,Gram,2015,3100,3187,87,2.806451612903226
Ahmedpur,Sorgum(Jawar),2015,1598,1685,87,5.444305381727159
Pandharpur,Banana,2016,251,338,87,34.66135458167331
Arvi,Cotton,2014,4026,4113,87,2.1609538002980626
Ramtek,Gram,2016,5067,5154,87,1.7169923031379515
Shrirampur,Maize,2015,1122,1209,87,7.754010695187166
Shegaon,Wheat(Husked),2016,1436,1523,87,6.0584958217270195
Manora,Green Gram,2016,5241,5328,87,1.659988551803091
Shahada,Bajri,2015,1165,1252,87,7.467811158798283
Nampur,Bajri,2016,1666,1753,87,5.222088835534214
Pavani,Paddy-Unhusked,2015,1733,1820,87,5.020196191575303
Sillod-Bharadi,Maize,2016,1333,1420,87,6.5266316579144785
Barshi,Bajri,2014,1405,1492,87,6.192170818505338
Telhara,Sorgum(Jawar),2015,1253,1340,87,6.943335993615324
Bhokardan,Soybean,2015,3494,3581,87,2.4899828277046363
Malkapur,Black Gram,2015,5583,5670,87,1.5583019881783986
Parbhani,Soybean,2015,3713,3800,87,2.343118771882575
Jintur,Wheat(Husked),2015,1579,1666,87,5.509816339455352
Manmad,Maize,2015,1213,1300,87,7.1723000824402305
Lonar,Maize,2015,1120,1207,87,7.767857142857143
Malkapur,Sorgum(Jawar),2016,1281,1368,87,6.791569086651054
Osmanabad,Soybean,2015,3514,3601,87,2.475811041548093
Akot,Sorgum(Jawar),2016,1274,1361,87,6.828885400313972
Kalamb (Os),Sunflower,2015,3034,3121,87,2.867501647989453
Dhamangaon-Rly,Wheat(Husked),2014,1437,1524,87,6.054279749478079
Indapur (Nimgaon Ketki),Maize,2015,1382,1469,87,6.295224312590449
Ramtek,Ladies Finger,2015,194,281,87,44.845360824742265
Umarga,Wheat(Unhusked),2014,3178,3265,87,2.737570799244808
Vaijapur,Maize,2014,1156,1243,87,7.525951557093426
Risod,Green Gram,2016,5215,5302,87,1.6682646212847556
Vaduj,Wheat(Husked),2015,1588,1675,87,5.478589420654912
Vaduj,Soybean,2016,2863,2950,87,3.038770520433112
Kalvan,Maize,2016,1403,1490,87,6.2009978617248755
Dhule,Soybean,2015,3093,3180,87,2.812803103782735
Khamgaon,Other Oil Seeds,2015,3361,3448,87,2.588515322820589
Sakri,Wheat(Husked),2016,1413,1500,87,6.1571125265392785
Sailu,Soybean,2016,3236,3323,87,2.688504326328801
Sakri,Maize,2016,1241,1328,87,7.01047542304593
Gadchiroli,Paddy-Unhusked,2016,1582,1669,87,5.49936788874842
Khamgaon,Maize,2015,1141,1228,87,7.6248904469763366
Dhadgaon,BHAGAR/VARI,2016,1413,1500,87,6.1571125265392785
Daryapur,Green Gram,2016,6594,6681,87,1.3193812556869882
Devala,Wheat(Husked),2015,1529,1616,87,5.689993459777632
Rahuri-Vambori,Pigeon Pea (Tur),2015,9086,9172,86,0.9465111160026414
Pune,Maize,2015,1434,1520,86,5.99721059972106
Pavani,Paddy-Unhusked,2016,2032,2118,86,4.232283464566929
Dondaicha,Cotton,2015,3956,4042,86,2.1739130434782608
Sillod-Bharadi,Bajri,2016,1332,1418,86,6.456456456456457
Paithan,Sorgum(Jawar),2016,1600,1686,86,5.375
Newasa,Wheat(Husked),2016,1764,1850,86,4.875283446712018
Barshi,Paddy-Unhusked,2015,1435,1521,86,5.993031358885017
Aurad Shahajani,Soybean,2016,3565,3651,86,2.41234221598878
Chalisgaon,Sorgum(Jawar),2016,1306,1392,86,6.584992343032159
Parli-Vaijnath,Wheat(Husked),2014,1364,1450,86,6.3049853372434015
Indapur,Maize,2016,1606,1692,86,5.354919053549191
Jalna,Wheat(Husked),2016,1846,1932,86,4.658721560130011
Malegaon,Cowpea,2014,3580,3666,86,2.4022346368715084
Ralegaon,Cotton,2015,3933,4019,86,2.1866259852529875
Ahmedpur,Sunflower,2016,3580,3666,86,2.4022346368715084
Murbad,Paddy-Unhusked,2015,1850,1936,86,4.648648648648648
Dhule,Soybean,2015,3004,3090,86,2.862849533954727
Dharangaon,Wheat(Husked),2016,1583,1669,86,5.432722678458623
Islampur,FLOWER,2016,85,171,86,101.17647058823529
Savner,Sorgum(Jawar),2015,1041,1127,86,8.261287223823247
Dudhani,Maize,2014,986,1072,86,8.72210953346856
Indapur (Nimgaon Ketki),Maize,2016,1593,1679,86,5.398618957940992
Ghoti,Ladies Finger,2014,2400,2486,86,3.5833333333333335
Kalvan,Tamarind,2016,2742,2828,86,3.136396790663749
Chopda,Bajri,2015,1267,1353,86,6.787687450670876
Yeola,Maize,2015,1167,1253,86,7.369323050556984
Parli-Vaijnath,Wheat(Husked),2015,1307,1393,86,6.5799540933435345
Kolhapur,Banana,2016,347,433,86,24.78386167146974
Jalkot,Sorgum(Jawar),2015,1440,1526,86,5.972222222222222
Kalamb (Os),Maize,2016,1707,1793,86,5.038078500292912
Indapur-Bhigwan,Rice(Paddy-Hus),2015,1380,1466,86,6.231884057971015
Chakur,PUNVAD,2016,2635,2721,86,3.2637571157495255
Umared,Sorgum(Jawar),2016,1900,1986,86,4.526315789473684
Bhokardan,Wheat(Husked),2016,1566,1652,86,5.491698595146871
Navapur,Sorgum(Jawar),2015,1250,1336,86,6.88
Jalgaon,Wheat(Husked),2016,1694,1780,86,5.076741440377804
Partur,Sorgum(Jawar),2016,1595,1681,86,5.391849529780564
Jalgaon,Wheat(Husked),2015,1429,1515,86,6.018194541637508
Aamgaon,Paddy-Unhusked,2015,1470,1556,86,5.850340136054422
Akola,Maize,2016,1430,1516,86,6.013986013986014
Dharni,Sorgum(Jawar),2016,1567,1653,86,5.488194001276324
Parli-Vaijnath,Bajri,2016,1404,1490,86,6.1253561253561255
Goregaon,PADDY-UNHUSKED,2016,1533,1619,86,5.609915198956295
Shegaon,Sorgum(Jawar),2016,1404,1490,86,6.1253561253561255
Pandharpur,Sorgum(Jawar),2015,1716,1802,86,5.011655011655011
Goregaon,Paddy-Unhusked,2016,1393,1479,86,6.173725771715722
Katol,Wheat(Husked),2015,1351,1437,86,6.365655070318283
Chakur,Sorgum(Jawar),2016,1716,1802,86,5.011655011655011
Lonar,Bajri,2015,1310,1396,86,6.564885496183206
Newasa,Wheat(Husked),2016,1579,1664,85,5.383153894870171
Umarga,Soybean,2016,3806,3891,85,2.233315817130846
Pusad,Sorgum(Jawar),2015,1309,1394,85,6.4935064935064934
Kolhapur,Raddish,2016,135,220,85,62.96296296296296
Pune-Pimpri,Carrot,2016,2086,2171,85,4.074784276126558
Akluj,Maize,2014,1360,1445,85,6.25
Umarga,Sunflower,2015,3055,3140,85,2.7823240589198037
Murum,Sorgum(Jawar),2015,2096,2181,85,4.055343511450381
Gondpimpri,Paddy-Unhusked,2016,1836,1921,85,4.62962962962963
Ashti (Wardha),Cotton,2015,4266,4351,85,1.9924988279418658
Ahmedpur,Soybean,2016,3675,3760,85,2.312925170068027
Nira-Saswad,Maize,2016,1500,1585,85,5.666666666666667
Nanded,Sorgum(Jawar),2015,1147,1232,85,7.410636442894507
Murum,Soybean,2016,3889,3974,85,2.1856518385188997
Bhiwapur,Cotton,2016,4473,4558,85,1.9002906326849989
Achalpur,Wheat(Husked),2015,1498,1583,85,5.674232309746328
Mangaon(Bhadav),Paddy-Unhusked,2016,1410,1495,85,6.028368794326241
Indapur-Bhigwan,Rice(Paddy-Hus),2016,1626,1711,85,5.227552275522755
Kada,Maize,2016,1329,1414,85,6.395786305492852
Pandharkawada,Pigeon Pea (Tur),2016,8295,8380,85,1.024713682941531
Pune,Maize,2015,1412,1497,85,6.019830028328612
Soygaon,Maize,2016,1315,1400,85,6.4638783269961975
Amalner,Maize,2015,1262,1347,85,6.735340729001585
Morshi,Sorgum(Jawar),2015,1079,1164,85,7.877664504170529
Baramati,Maize,2014,1400,1485,85,6.071428571428571
Paranda,Maize,2015,1125,1210,85,7.555555555555555
Palghar(Bevur),Potato,2015,1201,1286,85,7.077435470441299
Chalisgaon,Banana,2016,170,255,85,50.0
Pusad,Bajri,2016,1532,1617,85,5.5483028720626635
Yeola,Sorgum(Jawar),2014,1716,1801,85,4.953379953379954
Morshi,Sorgum(Jawar),2015,1256,1341,85,6.767515923566879
Shevgaon-Bodhegaon,Maize,2014,960,1045,85,8.854166666666666
Korpana,Soybean,2014,2923,3008,85,2.907971262401642
Baramati,Maize,2016,1511,1596,85,5.625413633355394
Jamner,Maize,2016,1325,1410,85,6.415094339622642
Shrigonda,Maize,2015,1411,1496,85,6.024096385542169
Pune,Jaggery,2016,3656,3741,85,2.324945295404814
Korpana,Soybean,2015,2850,2935,85,2.982456140350877
Akola,Bajri,2016,1940,2025,85,4.381443298969073
Rahuri,Wheat(Husked),2015,1479,1564,85,5.747126436781609
Dondaicha,Maize,2015,1250,1335,85,6.8
Murtizapur,Wheat(Husked),2015,1377,1462,85,6.172839506172839
Barshi,Ladies Finger,2014,99,184,85,85.85858585858585
Bhokardan-Pimpalgaon Renu,Soybean,2015,3500,3585,85,2.4285714285714284
Murum,Gram,2014,2596,2681,85,3.274268104776579
Chalisgaon,Sorgum(Jawar),2016,1269,1354,85,6.698187549251379
Akot,Maize,2016,1050,1135,85,8.095238095238095
Kurdwadi,Wheat(Husked),2014,1485,1570,85,5.723905723905724
Jalgaon,Cluster Bean,2015,3386,3471,85,2.510336680448907
Sillod,Maize,2015,1328,1413,85,6.400602409638554
Akot,Cotton,2016,4749,4834,85,1.7898504948410192
Shrirampur-Belapur,Maize,2016,1204,1289,85,7.059800664451827
Jintur,Soybean,2014,3104,3189,85,2.73840206185567
Partur,Sorgum(Jawar),2016,1738,1823,85,4.890678941311853
Chimur,Cotton,2014,4096,4181,85,2.0751953125
Palus,BOTTLE GOURD,2016,533,617,84,15.75984990619137
Barshi,Lemon,2014,158,242,84,53.164556962025316
Rahata,Maize,2016,1086,1170,84,7.734806629834254
Tiroda,Paddy-Unhusked,2015,1445,1529,84,5.813148788927336
Ausa,Maize,2014,1074,1158,84,7.82122905027933
Khamgaon,Cotton,2014,3966,4050,84,2.118003025718608
Parli-Vaijnath,Gram,2015,4284,4368,84,1.9607843137254901
Mandhal,Wheat(Husked),2015,1419,1503,84,5.919661733615222
Pachora,Sorgum(Jawar),2015,1289,1373,84,6.516679596586501
Shegaon,Green Gram,2016,7092,7176,84,1.1844331641285957
Lasalgaon-Vinchur,Maize,2016,1418,1502,84,5.923836389280677
Raver,Maize,2014,1018,1102,84,8.25147347740668
Yeola,Sorgum(Jawar),2016,1631,1715,84,5.150214592274678
Lasur Station,Soybean,2015,3469,3553,84,2.4214471029115017
Chopda,Green Gram,2016,5453,5537,84,1.5404364569961488
Chamorshi,Paddy-Unhusked,2016,2345,2429,84,3.582089552238806
Rahuri-Vambori,Wheat(Husked),2016,1663,1747,84,5.051112447384245
Udgir,Wheat(Husked),2015,1361,1445,84,6.171932402645114
Achalpur,Sorgum(Jawar),2016,1308,1392,84,6.422018348623853
Brahmpuri,Paddy-Unhusked,2014,1702,1786,84,4.9353701527614575
Vaijapur,Pigeon Pea (Tur),2016,5850,5934,84,1.435897435897436
Dhule,Black Gram,2015,5134,5218,84,1.6361511492014025
Mangrulpeer,Sorgum(Jawar),2015,1110,1194,84,7.5675675675675675
Shrirampur,Maize,2015,1131,1215,84,7.427055702917772
Barshi,Lemon,2016,158,242,84,53.164556962025316
Purna,Wheat(Husked),2016,1690,1774,84,4.970414201183432
Sillod-Bharadi,Wheat(Husked),2016,1489,1573,84,5.641370047011417
Buldhana,Maize,2015,1083,1167,84,7.756232686980609
Dudhani,Wheat(Husked),2015,1365,1449,84,6.153846153846154
Akola,Safflower,2015,2358,2442,84,3.5623409669211195
Chopda,Bajri,2016,1697,1781,84,4.949911608721273
Digras,Wheat(Husked),2016,1694,1778,84,4.958677685950414
Raver,Sorgum(Jawar),2015,1269,1353,84,6.619385342789598
Shirur,Gram,2014,2356,2440,84,3.565365025466893
Rahuri-Vambori,Soybean,2014,3199,3283,84,2.62582056892779
Shirur,Wheat(Husked),2015,1404,1488,84,5.982905982905983
Bhokardan-Pimpalgaon Renu,Wheat(Husked),2015,1423,1507,84,5.903021784961349
Sindkhed Raja,Sorgum(Jawar),2016,1606,1690,84,5.23038605230386
Kille Dharur,Maize,2016,1391,1475,84,6.03882099209202
Jintur-Bori,Sorgum(Jawar),2016,1279,1363,84,6.5676309616888195
Rahata,Wheat(Husked),2016,1495,1579,84,5.618729096989966
Pathardi,Bajri,2015,1253,1337,84,6.70391061452514
Ghoti,Flower,2014,1783,1867,84,4.711160964666293
Satana,Maize,2016,1425,1509,84,5.894736842105263
Tasgaon,Maize,2014,1117,1201,84,7.520143240823635
Pune,MAIZE,2016,1434,1518,84,5.857740585774058
Nandurbar,Maize,2015,1387,1471,84,6.056236481614996
Pune,Jaggery,2014,2621,2705,84,3.20488363220145
Barshi,Maize,2015,1108,1191,83,7.490974729241877
Rahata,Carrot,2014,1417,1500,83,5.857445306986591
Telhara,Sorgum(Jawar),2015,1123,1206,83,7.390917186108638
Armori,Paddy-Unhusked,2015,1525,1608,83,5.442622950819672
Morshi,Sorgum(Jawar),2016,1417,1500,83,5.857445306986591
Sangali,Maize,2015,1497,1580,83,5.544422177688711
Hingna,Soybean,2015,3084,3167,83,2.6913099870298316
Phaltan,Jaggery,2015,2389,2472,83,3.4742570113018
Nilanga,Wheat(Husked),2014,1428,1511,83,5.812324929971989
Jalgaon,Black Gram,2015,5485,5568,83,1.5132178669097538
Jalna-Badnapur,Sorgum(Jawar),2016,1701,1784,83,4.879482657260435
Palghar(Bevur),Potato,2016,1238,1321,83,6.704361873990307
Mantha,Black Gram,2014,4502,4585,83,1.843625055530875
Mantha,Cotton,2014,3887,3970,83,2.135322871108824
Barshi-Vairag,Maize,2014,1055,1138,83,7.867298578199052
Khamgaon,Sorgum(Jawar),2014,1068,1151,83,7.771535580524344
Rahata,Ghevda,2016,6917,7000,83,1.1999421714616163
Armori,Paddy-Unhusked,2014,2026,2109,83,4.096742349457058
Murud,Paddy-Unhusked,2016,1450,1533,83,5.724137931034483
Barshi,Maize,2015,1240,1323,83,6.693548387096774
Pune,Jaggery,2016,3627,3710,83,2.288392610973256
Purna,Wheat(Husked),2015,1535,1618,83,5.407166123778501
Rahata,Small Gourd,2015,1667,1750,83,4.979004199160168
Barshi,Bor,2016,79,162,83,105.0632911392405
Nandurbar,Sunflower,2015,3171,3254,83,2.617470829391359
Partur,Cotton,2015,4052,4135,83,2.048371174728529
Nandurbar,Green Gram,2016,6653,6736,83,1.2475574928603637
Sillod,Sorgum(Jawar),2015,1367,1450,83,6.071689831748354
Dhadgaon,Bhagar/Vari,2016,1225,1308,83,6.775510204081633
Mangrulpeer,Sorgum(Jawar),2016,1307,1390,83,6.350420811017598
Udgir,Sorgum(Jawar),2015,1254,1337,83,6.618819776714513
Newasa,Sorgum(Jawar),2016,1638,1721,83,5.067155067155067
Sailu,Gram,2015,3248,3331,83,2.5554187192118225
Lonar,Neem-Seed,2015,621,704,83,13.365539452495975
Bhokardan-Pimpalgaon Renu,Maize,2016,1300,1383,83,6.384615384615385
Shegaon,Wheat(Husked),2014,1428,1511,83,5.812324929971989
Lonar,Wheat(Husked),2015,1487,1570,83,5.581708137188971
Murum,Pigeon Pea (Tur),2015,10934,11017,83,0.7591000548747028
Lonar,Wheat(Husked),2015,1376,1459,83,6.031976744186046
Islampur,GINGER (FRESH),2016,147,230,83,56.46258503401361
Chamorshi,Paddy-Unhusked,2015,1896,1979,83,4.377637130801688
Nilanga,Soybean,2015,3267,3350,83,2.5405570860116313
Bhokardan-Pimpalgaon Renu,Bajri,2016,1280,1363,83,6.484375
Islampur,LADIES FINGER,2016,190,273,83,43.68421052631579
Parli-Vaijnath,GREEN GRAM,2016,4178,4261,83,1.9865964576352322
Chopda,Bajri,2016,1653,1736,83,5.021173623714459
Barshi,Grapes,2015,100,183,83,83.0
Rahata,Shevga,2016,4667,4750,83,1.778444396828798
Dharangaon,Green Gram,2016,4684,4767,83,1.77198975234842
Sengaon,Soybean,2015,3289,3372,83,2.5235633931286103
Jamkhed,Cotton,2014,3950,4033,83,2.1012658227848102
Koregaon,Gram,2015,3217,3300,83,2.5800435188063413
Jalgaon,Soybean,2014,2992,3075,83,2.7740641711229945
Kurdwadi,BLACK GRAM,2016,4984,5067,83,1.6653290529695024
Pune-Manjri,Onion,2016,650,733,83,12.76923076923077
Goregaon,Paddy-Unhusked,2016,1477,1560,83,5.619498984427894
Varud-Rajura Bazar,Gram,2015,5256,5339,83,1.5791476407914764
Tiroda,Paddy-Unhusked,2015,1371,1454,83,6.0539752005835155
Khed (Shel Pimpalgaon),Flower,2016,1610,1693,83,5.15527950310559
Shirur,Wheat(Husked),2015,1377,1460,83,6.027596223674655
Malkapur,Bajri,2016,1259,1342,83,6.59253375694996
Sailu,Sorgum(Jawar),2015,1220,1303,83,6.80327868852459
Sillod,Bajri,2016,1200,1283,83,6.916666666666667
Ahmedpur,Wheat(Husked),2016,1386,1469,83,5.988455988455988
Devala,Maize,2015,1364,1447,83,6.085043988269795
Malkapur,Maize,2015,1338,1421,83,6.203288490284006
Palghar(Bevur),Potato,2015,960,1043,83,8.645833333333334
Aamgaon,Paddy-Unhusked,2015,1520,1603,83,5.4605263157894735
Barshi-Vairag,Maize,2016,1355,1438,83,6.125461254612546
Devala,Wheat(Husked),2015,1460,1543,83,5.684931506849315
Amarawati,Gram,2015,4369,4452,83,1.8997482261387044
Savner,Sorgum(Jawar),2016,1166,1249,83,7.1183533447684395
Bhokardan-Pimpalgaon Renu,Soybean,2015,3150,3233,83,2.634920634920635
Naigaon,Soybean,2014,3313,3396,83,2.505282221551464
Ausa,Sunflower,2015,3026,3109,83,2.7428949107732983
Rahata,Maize,2015,1231,1314,83,6.742485783915516
Bhokardan-Pimpalgaon Renu,Soybean,2016,3550,3633,83,2.3380281690140845
Narkhed,Cotton,2015,3821,3904,83,2.172206228735933
Mohol,GRAM,2016,7385,7468,83,1.1238997968855788
Bhokardan-Pimpalgaon Renu,Soybean,2016,3467,3550,83,2.394000576867609
Achalpur,Maize,2014,1317,1400,83,6.302201974183751
Bhokardan-Pimpalgaon Renu,Soybean,2014,3181,3263,82,2.5778057214712353
Mohol,Maize,2016,1401,1483,82,5.8529621698786585
Jawala-Bajar,Cotton,2014,3963,4045,82,2.0691395407519555
Jalgaon,Maize,2015,1212,1294,82,6.765676567656766
Sillod,Maize,2016,1301,1383,82,6.302843966179862
Aamgaon,Paddy-Unhusked,2015,1651,1733,82,4.966686856450636
Shirur,SOYBEAN,2016,2459,2541,82,3.3346888979259863
Nandurbar,Rice(Paddy-Hus),2016,2959,3041,82,2.7712064886786076
Jalgaon,Wheat(Husked),2015,1352,1434,82,6.06508875739645
Akot,Cotton,2015,4478,4560,82,1.831174631531934
Morshi,Wheat(Husked),2015,1481,1563,82,5.536799459824443
Sakri,Bajri,2015,1048,1130,82,7.824427480916031
Dound,Maize,2016,1492,1574,82,5.49597855227882
Pandharpur,Maize,2016,1766,1848,82,4.64326160815402
Umarga,Bajri,2015,1145,1227,82,7.1615720524017465
Bhokardan,Soybean,2016,3527,3609,82,2.32492203005387
Dound,Maize,2014,1158,1240,82,7.081174438687392
Umarga,Sorgum(Jawar),2014,1254,1336,82,6.539074960127592
Ausa,Maize,2015,1063,1145,82,7.714016933207902
Paithan,Bajri,2015,1254,1336,82,6.539074960127592
Achalpur,Wheat(Husked),2015,1493,1575,82,5.492297387809779
Tuljapur,Maize,2015,1411,1493,82,5.811481218993621
Ahmedpur,Wheat(Husked),2016,1314,1396,82,6.2404870624048705
Sengaon,Pigeon Pea (Tur),2015,7085,7167,82,1.1573747353563868
Wardha,Sorgum(Jawar),2016,1385,1467,82,5.92057761732852
Barshi-Vairag,Soybean,2015,3286,3368,82,2.4954351795496046
Hingoli,Cotton,2016,4550,4632,82,1.8021978021978022
Sangali,Maize,2015,1481,1563,82,5.536799459824443
Bhusaval,Wheat(Husked),2015,1146,1228,82,7.155322862129145
Barshi,Tomato,2016,50,132,82,164.0
Shevgaon-Bodhegaon,Gram,2015,3636,3718,82,2.255225522552255
Lonar,Wheat(Husked),2016,1685,1767,82,4.8664688427299705
Chamorshi,Paddy-Unhusked,2016,2323,2405,82,3.5299182092122257
Dhule,Soybean,2015,2968,3050,82,2.7628032345013476
Bhiwapur,Gram,2015,3540,3622,82,2.3163841807909606
Jalgaon-Masawat,Sorgum(Jawar),2016,1162,1244,82,7.056798623063683
Lakhandur,Coriander (Dry),2016,6979,7061,82,1.1749534317237427
Karjat (Raigad),Paddy-Unhusked,2015,1358,1440,82,6.0382916053019144
Raver,Maize,2015,1299,1381,82,6.312548113933795
Malegaon,Maize,2016,1395,1477,82,5.878136200716846
Tuljapur,Pigeon Pea (Tur),2016,7784,7866,82,1.0534429599177801
Sindevahi,Paddy-Unhusked,2015,1802,1884,82,4.550499445061043
Hadgaon,Soybean,2014,3218,3300,82,2.54816656308266
Shahada,Bajri,2014,1212,1294,82,6.765676567656766
Wardha,Wheat(Husked),2016,1654,1736,82,4.957678355501813
Latur,Maize,2016,1438,1519,81,5.632823365785813
Sangli-Miraj,Wheat(Unhusked),2016,3778,3859,81,2.1439915299100054
Bhokardan,Wheat(Husked),2016,1519,1600,81,5.332455562870309
Lohara,Sorgum(Jawar),2016,1887,1968,81,4.292527821939586
Akhadabalapur,Gram,2015,3113,3194,81,2.6019916479280436
Pandharkawada,Soybean,2016,3446,3527,81,2.3505513639001743
Varud,Cotton,2014,3927,4008,81,2.0626432391138274
Beed,Gram,2016,5444,5525,81,1.4878765613519471
Barshi-Vairag,Soybean,2015,3190,3271,81,2.5391849529780566
Bhokardan,Soybean,2016,3513,3594,81,2.3057216054654144
Khamgaon,Sorgum(Jawar),2016,1484,1565,81,5.45822102425876
Rahata,Bajri,2015,1205,1286,81,6.721991701244813
Bhokardan,Gram,2015,3269,3350,81,2.4778219639033345
Jintur,Wheat(Husked),2015,1693,1774,81,4.784406379208505
Kinwat,Cotton,2015,4061,4142,81,1.9945826151194288
Bhokardan,Bajri,2015,1276,1357,81,6.347962382445141
Bhokardan-Pimpalgaon Renu,Black Gram,2016,5525,5606,81,1.4660633484162895
Dondaicha,Bajri,2015,1124,1205,81,7.2064056939501775
Bhokar,Maize,2016,1258,1339,81,6.43879173290938
Bhokardan,Wheat(Husked),2015,1425,1506,81,5.684210526315789
Kille Dharur,Soybean,2015,3183,3264,81,2.5447690857681433
Jalkot,Soybean,2016,3838,3919,81,2.1104742053152683
Bhokardan,Sorgum(Jawar),2016,1250,1331,81,6.48
Ahmedpur,Gram,2016,4182,4263,81,1.9368723098995695
Digras,Green Gram,2016,5155,5236,81,1.571290009699321
Khed (Shel Pimpalgaon),Bottle Gourd,2016,991,1072,81,8.173562058526741
Rajura,Soybean,2016,3519,3600,81,2.3017902813299234
Parbhani,Soybean,2016,3161,3242,81,2.56248022777602
Lonar,Wheat(Husked),2015,1451,1532,81,5.582356995175741
Vaduj,Gram,2015,4500,4581,81,1.8
Ausa,Maize,2016,1369,1450,81,5.91672753834916
Kalamb (Os),Maize,2015,1324,1405,81,6.117824773413897
Morshi,Sorgum(Jawar),2016,1338,1419,81,6.053811659192825
Shevgaon-Bodhegaon,Gram,2015,2938,3019,81,2.7569775357385975
Morshi,Wheat(Husked),2015,1400,1481,81,5.785714285714286
Ramtek,Spinach,2015,90,171,81,90.0
Nandgaon,Maize,2016,1598,1679,81,5.068836045056321
Kej,Tamarind Seed,2016,1674,1755,81,4.838709677419355
Kej,Maize,2015,1418,1499,81,5.712270803949224
Jalgaon,Wheat(Husked),2015,1446,1527,81,5.601659751037344
Gadchiroli,Paddy-Unhusked,2015,1574,1655,81,5.146124523506988
Telhara,Wheat(Husked),2015,1294,1375,81,6.259659969088099
Tiroda,Paddy-Unhusked,2016,1553,1634,81,5.215711526078557
Ausa,Maize,2015,1297,1378,81,6.245181187355436
Indapur-Bhigwan,Soybean,2015,3319,3400,81,2.4404941247363663
Goregaon,Paddy-Unhusked,2015,1581,1662,81,5.1233396584440225
Nandurbar,Cluster Bean,2015,4063,4144,81,1.993600787595373
Kurdwadi,Maize,2014,1121,1202,81,7.225691347011597
Pachora,Maize,2016,1479,1560,81,5.476673427991886
Vaijapur,Maize,2016,1558,1639,81,5.198973042362002
Newasa,Gram,2015,3144,3225,81,2.5763358778625953
Barshi,Brinjal,2015,55,136,81,147.27272727272728
Chopda,Bajri,2015,1078,1159,81,7.513914656771799
Katol,Wheat(Husked),2015,1498,1579,81,5.4072096128170895
Amalner,Ground Nut Pods (Dry),2016,5640,5720,80,1.4184397163120568
Shevgaon-Bodhegaon,Wheat(Husked),2016,1758,1838,80,4.550625711035267
Amarawati,Soybean,2014,3163,3243,80,2.5292443882390137
Umarga,Bajri,2016,1316,1396,80,6.079027355623101
Yeola,Maize,2015,1227,1307,80,6.519967400162999
Bhiwapur,Paddy-Unhusked,2016,2288,2368,80,3.4965034965034967
Roha,Paddy-Unhusked,2015,1320,1400,80,6.0606060606060606
Roha,Paddy-Unhusked,2015,1320,1400,80,6.0606060606060606
Kalamb (Os),Jaggery,2015,2060,2140,80,3.883495145631068
Umarga,Safflower,2014,2400,2480,80,3.3333333333333335
Shirala,Maize,2014,1320,1400,80,6.0606060606060606
Tuljapur,MAIZE,2016,1210,1290,80,6.6115702479338845
Bhokar,Cotton,2014,3902,3982,80,2.0502306509482318
Roha,Paddy-Unhusked,2015,1320,1400,80,6.0606060606060606
Soygaon,Maize,2015,1290,1370,80,6.2015503875969
Mangalwedha,Wheat(Unhusked),2015,2690,2770,80,2.973977695167286
Roha,Paddy-Unhusked,2015,1320,1400,80,6.0606060606060606
Bhokardan-Pimpalgaon Renu,Wheat(Husked),2016,1500,1580,80,5.333333333333333
Rahata,Maize,2015,1109,1189,80,7.21370604147881
Dharni,Wheat(Husked),2016,1605,1685,80,4.984423676012461
Mandhal,Cotton,2016,4170,4250,80,1.9184652278177459
Roha,Paddy-Unhusked,2015,1320,1400,80,6.0606060606060606
Goregaon,Paddy-Unhusked,2016,1303,1383,80,6.139677666922487
Telhara,Sorgum(Jawar),2016,1229,1309,80,6.509357200976404
Parli-Vaijnath,Bajri,2016,1525,1605,80,5.245901639344262
Indapur-Bhigwan,Rice(Paddy-Hus),2016,1537,1617,80,5.204944697462589
Aurangabad,Math (Bhaji),2014,130,210,80,61.53846153846154
Bhiwapur,Wheat(Husked),2015,1300,1380,80,6.153846153846154
Chandrapur,Soybean,2016,3584,3664,80,2.232142857142857
Rajura,Soybean,2016,3756,3836,80,2.1299254526091587
Roha,Paddy-Unhusked,2015,1320,1400,80,6.0606060606060606
Roha,Paddy-Unhusked,2015,1320,1400,80,6.0606060606060606
Yawal,Maize,2014,1208,1288,80,6.622516556291391
Malegaon,Pigeon Pea (Tur),2015,4620,4700,80,1.7316017316017316
Karanja,Black Gram,2015,5120,5200,80,1.5625
Devala,Pigeon Pea (Tur),2015,4418,4498,80,1.810774105930285
Jalna,Jaggery,2015,2262,2342,80,3.5366931918656057
Shrirampur,Maize,2015,1113,1193,80,7.187780772686433
Purna,Turmeric,2016,6375,6455,80,1.2549019607843137
Bhokardan-Pimpalgaon Renu,Wheat(Husked),2016,1520,1600,80,5.2631578947368425
Shevgaon-Bodhegaon,Wheat(Husked),2015,1523,1603,80,5.252790544977019
Karjat (Raigad),Paddy-Unhusked,2015,1360,1440,80,5.882352941176471
Karjat (Raigad),PADDY-UNHUSKED,2016,1470,1550,80,5.442176870748299
Umari,Soybean,2016,3600,3680,80,2.2222222222222223
Karjat (Raigad),Paddy-Unhusked,2016,1470,1550,80,5.442176870748299
Dhadgaon,Maize,2015,1150,1230,80,6.956521739130435
Ghansawangi,Cotton,2014,3900,3980,80,2.051282051282051
Achalpur,Maize,2015,1310,1390,80,6.106870229007634
Roha,Paddy-Unhusked,2015,1320,1400,80,6.0606060606060606
Morshi,Sorgum(Jawar),2016,1431,1511,80,5.590496156533892
Bhokardan,Bajri,2016,1279,1359,80,6.254886630179828
Partur,Soybean,2015,3266,3346,80,2.449479485609308
Barshi,Carrot,2014,50,130,80,160.0
Sengaon,SOYBEAN,2016,2767,2847,80,2.8912179255511385
Sindi,Cotton,2015,3870,3950,80,2.0671834625322996
Sinner,Maize,2014,1242,1322,80,6.4412238325281805
Dound,Maize,2016,1381,1461,80,5.792903692976104
Korpana,Pigeon Pea (Tur),2016,7000,7080,80,1.1428571428571428
Mantha,Gram,2015,3860,3940,80,2.0725388601036268
Sakri,Wheat(Husked),2014,1246,1326,80,6.420545746388443
Shrirampur-Belapur,Gram,2015,2880,2960,80,2.7777777777777777
Chopda,Wheat(Husked),2015,1533,1613,80,5.218525766470972
Chopda,Bajri,2014,1156,1236,80,6.920415224913495
Pune,Maize,2016,1639,1719,80,4.881025015253203
Hinganghat,Green Gram,2016,5378,5458,80,1.4875418371141689
Barshi,Bor,2015,98,178,80,81.63265306122449
Nilanga,Sorgum(Jawar),2015,1234,1314,80,6.482982171799027
Tasgaon,Sorgum(Jawar),2016,1674,1754,80,4.778972520908005
Chimur,Gram,2015,3280,3360,80,2.4390243902439024
Arjuni Morgaon,Paddy-Unhusked,2015,2045,2125,80,3.9119804400977993
Nanded,Wheat(Husked),2016,1612,1692,80,4.962779156327543
Brahmpuri,Paddy-Unhusked,2014,1772,1852,80,4.514672686230249
Washi(Osmanabad),Maize,2015,1356,1436,80,5.899705014749262
Sangali,Maize,2016,1722,1802,80,4.645760743321719
Rahata,Wheat(Husked),2016,1570,1650,80,5.095541401273885
Chopda,Wheat(Husked),2015,1490,1570,80,5.369127516778524
Wardha,Wheat(Husked),2016,1688,1768,80,4.739336492890995
Kille Dharur,Gram,2016,4145,4225,80,1.9300361881785284
Kalvan,Tamarind,2015,1554,1634,80,5.148005148005148
Ambejogai,Sunflower,2015,3130,3210,80,2.5559105431309903
Lonar,Wheat(Husked),2015,1466,1546,80,5.457025920873124
Nandurbar,Cotton,2014,4050,4130,80,1.9753086419753085
Loha,Turmeric,2015,8987,9067,80,0.8901746967842439
Lonar,Maize,2015,1078,1158,80,7.421150278293135
Fulambri,Maize,2014,870,950,80,9.195402298850574
Kalamb (Os),Maize,2014,1039,1119,80,7.699711260827719
Pune-Pimpri,Potato,2016,840,920,80,9.523809523809524
Kalvan,Wheat(Husked),2014,1459,1539,80,5.483207676490747
Nandurbar,Maize,2014,1210,1290,80,6.6115702479338845
Lonar,Wheat(Husked),2014,1402,1482,80,5.706134094151213
Islampur,Tomato,2016,89,169,80,89.88764044943821
Sillod-Bharadi,Sorgum(Jawar),2016,1220,1300,80,6.557377049180328
Gangapur,Maize,2016,1343,1422,79,5.882352941176471
Karmala,Maize,2016,1352,1431,79,5.84319526627219
Pune,Jaggery,2015,2422,2501,79,3.2617671345995047
Pathari,Sorgum(Jawar),2016,1580,1659,79,5.0
Kille Dharur,Maize,2015,1440,1519,79,5.486111111111111
Chikhali,Maize,2014,1119,1198,79,7.059874888293119
Chopda,Maize,2014,1069,1148,79,7.390084190832554
Gondpimpri,Paddy-Unhusked,2014,2016,2095,79,3.9186507936507935
Bhokardan,Sorgum(Jawar),2016,1225,1304,79,6.448979591836735
Aamgaon,Paddy-Unhusked,2015,1452,1531,79,5.440771349862259
Newasa,Bajri,2014,1364,1443,79,5.7917888563049855
Rahuri-Vambori,Bajri,2015,1433,1512,79,5.512909979064899
Dhadgaon,Sorgum(Jawar),2016,1265,1344,79,6.24505928853755
Telhara,Sorgum(Jawar),2015,1156,1235,79,6.833910034602076
Kille Dharur,Cotton,2016,4633,4712,79,1.705158644506799
Dharangaon,Gram,2016,4966,5045,79,1.5908175594039469
Savner,Maize,2016,1248,1327,79,6.330128205128205
Nilanga,Soybean,2015,3334,3413,79,2.369526094781044
Ramtek,Coriander  ,2015,267,346,79,29.588014981273407
Nanded,Sorgum(Jawar),2015,1109,1188,79,7.123534715960325
Lakhani,Paddy-Unhusked,2016,2164,2243,79,3.6506469500924212
Umarga,Sunflower,2015,3196,3275,79,2.471839799749687
Gangapur,Maize,2015,1161,1240,79,6.804478897502153
Manmad,Maize,2015,1211,1290,79,6.5235342691990095
Digras,Wheat(Husked),2015,1555,1634,79,5.080385852090032
Jalna,Wheat(Husked),2016,1843,1922,79,4.286489419424851
Mandhal,Soybean,2016,3550,3629,79,2.2253521126760565
Pavani,Paddy-Unhusked,2016,1978,2057,79,3.993933265925177
Jalgaon,Sorgum(Jawar),2016,1803,1882,79,4.381586245146977
Murum,Green Gram,2016,5226,5305,79,1.5116724071947953
Rahuri-Vambori,Maize,2015,1395,1474,79,5.663082437275985
Rahata,Bajri,2015,1306,1385,79,6.049004594180705
Sangali,Maize,2016,1497,1576,79,5.277221108884436
Barshi,Flower,2016,94,173,79,84.04255319148936
Umarga,Sorgum(Jawar),2016,1705,1784,79,4.633431085043989
Barshi,Ladies Finger,2016,114,193,79,69.29824561403508
Murtizapur,Wheat(Husked),2014,1426,1505,79,5.539971949509116
Jalgaon,Sorgum(Jawar),2015,1342,1421,79,5.886736214605067
Chopda,Wheat(Husked),2015,1436,1515,79,5.5013927576601676
Ausa,Sunflower,2016,3399,3478,79,2.3242130038246542
Jalgaon,Spinach,2015,1132,1211,79,6.978798586572438
Udgir,Soybean,2014,3405,3484,79,2.320117474302496
Barshi,Lemon,2016,103,182,79,76.69902912621359
Tuljapur,Maize,2016,1347,1426,79,5.864884929472903
Akluj,Bajri,2014,1434,1513,79,5.509065550906555
Khed (Shel Pimpalgaon),Green Chilli,2015,1843,1922,79,4.286489419424851
Dudhani,Maize,2016,1352,1431,79,5.84319526627219
Sangamner,Wheat(Husked),2016,1686,1764,78,4.6263345195729535
Lonar,Sorgum(Jawar),2015,1247,1325,78,6.255012028869286
Nandgaon,Sorgum(Jawar),2015,1447,1525,78,5.3904630269523155
Arjuni Morgaon,Paddy-Unhusked,2014,1851,1929,78,4.213938411669368
Taloda,Maize,2015,1168,1246,78,6.678082191780822
Lonar,Wheat(Husked),2015,1486,1564,78,5.248990578734858
Sonpeth,Soybean,2015,3202,3280,78,2.4359775140537163
Chopda,Soybean,2015,3242,3320,78,2.405922270203578
Barshi,Cucumber,2016,94,172,78,82.97872340425532
Dhadgaon,Maize,2016,1425,1503,78,5.473684210526316
Parbhani,Wheat(Husked),2014,1429,1507,78,5.4583624912526245
Ambejogai,Bajri,2014,1538,1616,78,5.071521456436931
Jalna-Badnapur,Sorgum(Jawar),2015,1194,1272,78,6.532663316582915
Sakri,Maize,2015,1044,1122,78,7.471264367816092
Morshi,Wheat(Husked),2014,1433,1511,78,5.443126308443824
Morshi,Wheat(Husked),2014,1444,1522,78,5.401662049861496
Morshi,Sorgum(Jawar),2015,1238,1316,78,6.30048465266559
Morshi,Sorgum(Jawar),2015,1322,1400,78,5.900151285930408
Khamgaon,Sunflower,2016,3393,3471,78,2.2988505747126435
Palghar(Bevur),Potato,2016,1008,1086,78,7.738095238095238
Barshi,Bajri,2016,1581,1659,78,4.933586337760911
Rahata,Soybean,2015,3525,3603,78,2.2127659574468086
Indapur (Nimgaon Ketki),Maize,2016,1610,1688,78,4.84472049689441
Dudhani,Gram,2015,4569,4647,78,1.707156927117531
Dudhani,Wheat(Husked),2015,1345,1423,78,5.799256505576208
Jalgaon,Maize,2015,1297,1375,78,6.013878180416345
Udgir,Wheat(Husked),2015,1315,1393,78,5.931558935361217
Shirur,Bajri,2014,1353,1431,78,5.764966740576496
Jintur,Soybean,2016,3146,3224,78,2.479338842975207
Achalpur,Sorgum(Jawar),2016,1523,1601,78,5.121470781352594
Bori Arab,Soybean,2015,3475,3553,78,2.2446043165467624
Bhiwapur,Paddy-Unhusked,2015,1863,1941,78,4.186795491143317
Shirpur,Ground Nut Pods (Dry),2015,4545,4623,78,1.716171617161716
Nampur,Wheat(Husked),2016,1547,1625,78,5.042016806722689
Tumsar,Gram,2016,4166,4244,78,1.872299567930869
Kalamnuri,Soybean,2016,3638,3716,78,2.144035184167125
Mandhal,Soybean,2016,3307,3385,78,2.3586332022981553
Kalamb (Os),Soybean,2015,3539,3617,78,2.204012432890647
Tuljapur,Gram,2014,2381,2459,78,3.2759344813103737
Vaduj,Bajri,2015,1400,1478,78,5.571428571428571
Katol,Black Gram,2016,6211,6289,78,1.2558364192561584
Sinner,Soybean,2016,3473,3551,78,2.2458969190901237
Malegaon,Maize,2016,1616,1694,78,4.826732673267327
Kalvan,Maize,2015,1209,1287,78,6.451612903225806
Gangapur,Maize,2015,1192,1270,78,6.543624161073826
Malkapur,Wheat(Husked),2014,1411,1489,78,5.527994330262225
Hingoli,Black Gram,2015,5022,5100,78,1.5531660692951015
Kolhapur-Malkapur,FLOWER,2016,113,191,78,69.02654867256638
Savner,Wheat(Husked),2016,1555,1633,78,5.016077170418006
Kopargaon,Maize,2016,1338,1416,78,5.829596412556054
Indapur,Maize,2016,1416,1494,78,5.508474576271187
Barshi-Vairag,Maize,2015,1498,1576,78,5.2069425901201605
Vaijapur,Gram,2015,4285,4363,78,1.8203033838973162
Chopda,Soybean,2015,3595,3673,78,2.1696801112656465
Barshi,Chikoo,2016,151,228,77,50.99337748344371
Goregaon,Paddy-Unhusked,2016,1435,1512,77,5.365853658536586
Wardha,Wheat(Husked),2014,1425,1502,77,5.4035087719298245
Gangapur,Green Gram,2014,6766,6843,77,1.138043156961277
Vani,Green Gram,2016,4900,4977,77,1.5714285714285714
Devala,Wheat(Husked),2016,1466,1543,77,5.252387448840382
Pachora,Sorgum(Jawar),2016,1548,1625,77,4.974160206718346
Gadchiroli,Paddy-Unhusked,2016,1658,1735,77,4.644149577804584
Kalvan,Sunflower,2015,3600,3677,77,2.138888888888889
Indapur-Bhigwan,Maize,2016,1458,1535,77,5.2812071330589845
Jawala-Bajar,Soybean,2016,3650,3727,77,2.1095890410958904
Shirur,Wheat(Husked),2016,1551,1628,77,4.964539007092198
Ner Parasopant,Gram,2016,6338,6415,77,1.2148942884190597
Nilanga,Sorgum(Jawar),2016,1356,1433,77,5.678466076696165
Nagpur,Lemon,2015,203,280,77,37.93103448275862
Rahata,Bajri,2016,1607,1684,77,4.791537025513379
Ghoti,Bitter Gourd,2015,3000,3077,77,2.566666666666667
Pandharpur,Gram,2015,3530,3607,77,2.181303116147309
Pune,Jaggery,2015,2739,2816,77,2.8112449799196786
Dudhani,Maize,2015,1088,1165,77,7.077205882352941
Sakri,Bajri,2014,1207,1284,77,6.379453189726595
Malegaon,Soybean,2015,3212,3289,77,2.3972602739726026
Khed (Shel Pimpalgaon),Bottle Gourd,2016,715,792,77,10.76923076923077
Mangalwedha,Maize,2015,1602,1679,77,4.80649188514357
Jamner,Maize,2015,1325,1402,77,5.811320754716981
Amarawati,Soybean,2015,3551,3628,77,2.168403266685441
Dhadgaon,Wheat(Husked),2016,1530,1607,77,5.032679738562091
Dhadgaon,Sorgum(Jawar),2016,1389,1466,77,5.543556515478762
Barshi,Bor,2016,92,169,77,83.69565217391305
Amarawati,Cotton,2016,4463,4540,77,1.7252968855030248
Barshi-Vairag,Wheat(Husked),2014,1782,1859,77,4.320987654320987
Mangalwedha,Bajri,2015,1329,1406,77,5.793829947328819
Jintur-Bori,Pigeon Pea (Tur),2015,7111,7188,77,1.0828294192096752
Dhadgaon,Maize,2016,1230,1307,77,6.260162601626016
Paithan,Bajri,2015,1298,1375,77,5.932203389830509
Sonpeth,Bajri,2016,1520,1597,77,5.065789473684211
Sakri,Maize,2016,1264,1341,77,6.091772151898734
Ahmedpur,Soybean,2015,3593,3670,77,2.1430559421096578
Ausa,Soybean,2015,3232,3309,77,2.382425742574257
Sillod-Bharadi,Wheat(Husked),2016,1554,1631,77,4.954954954954955
Ambejogai,Soybean,2015,3399,3476,77,2.26537216828479
Ambejogai,Soybean,2015,3223,3300,77,2.3890784982935154
Kej,Maize,2016,1402,1479,77,5.492154065620542
Jawala-Bajar,Soybean,2016,3896,3973,77,1.9763860369609856
Ambejogai,Black Gram,2016,6567,6644,77,1.1725293132328307
Sinner,Maize,2015,1217,1294,77,6.327033689400165
Chimur,Paddy-Unhusked,2016,2309,2386,77,3.3347769597228236
Rahata,Ginger (Fresh),2014,6308,6385,77,1.2206721623335448
Daryapur,Sorgum(Jawar),2015,1100,1177,77,7.0
Rahata,Bajri,2015,1187,1264,77,6.4869418702611625
Pavani,Paddy-Unhusked,2016,1756,1833,77,4.38496583143508
Vani,Gram,2014,2361,2438,77,3.2613299449385855
Lasur Station,Maize,2015,1348,1425,77,5.712166172106825
Phaltan,Maize,2014,1133,1210,77,6.796116504854369
Pune-Pimpri,Onion,2016,633,710,77,12.164296998420221
Kopargaon,Maize,2015,1138,1215,77,6.766256590509666
Sangli-Phale Bhajipalam,Water Melon,2016,78,155,77,98.71794871794872
Dudhani,Maize,2015,1154,1230,76,6.58578856152513
Akot,COTTON,2016,5085,5161,76,1.494591937069813
Khamgaon,Sorgum(Jawar),2015,1258,1334,76,6.041335453100159
Ahmedpur,Wheat(Husked),2014,1224,1300,76,6.209150326797386
Chopda,Maize,2015,1130,1206,76,6.725663716814159
Ausa,Maize,2014,1229,1305,76,6.183889340927584
Kolhapur,Banana,2016,1210,1286,76,6.2809917355371905
Mangalwedha,Maize,2015,1504,1580,76,5.053191489361702
Barshi,Capsicum,2015,121,197,76,62.8099173553719
Dondaicha-Sindkheda,Maize,2016,1369,1445,76,5.551497443389335
Sonpeth,Cotton,2014,3921,3997,76,1.9382810507523591
Achalpur,Maize,2015,1330,1406,76,5.714285714285714
Mangrulpeer,Green Gram,2016,4293,4369,76,1.7703237829023992
Shirur,Gram,2015,3099,3175,76,2.452404001290739
Pachora,Sorgum(Jawar),2015,1244,1320,76,6.109324758842444
Kille Dharur,Cotton,2015,4349,4425,76,1.7475281673948033
Goregaon,Paddy-Unhusked,2016,1418,1494,76,5.359661495063469
Wardha,Wheat(Husked),2015,1430,1506,76,5.314685314685315
Sillod,Wheat(Husked),2015,1398,1474,76,5.436337625178827
Malegaon,GROUND NUT PODS (DRY),2016,4526,4602,76,1.6791869200176757
Akot,Sorgum(Jawar),2016,1318,1394,76,5.7663125948406675
Rahata,Wheat(Husked),2016,1617,1693,76,4.700061842918986
Bhokardan,Soybean,2014,3162,3238,76,2.4035420619860846
Vani,Soybean,2014,3044,3120,76,2.4967148488830486
Bhusaval,Gram,2015,3696,3772,76,2.0562770562770565
Indapur-Bhigwan,Maize,2016,1430,1506,76,5.314685314685315
Telhara,Wheat(Husked),2015,1393,1469,76,5.455850681981335
Partur,Bajri,2015,1236,1312,76,6.148867313915858
Ashti (Jalna),Wheat(Husked),2015,1405,1481,76,5.409252669039146
Partur,Bajri,2015,1200,1276,76,6.333333333333333
Pune,Maize,2015,1604,1680,76,4.738154613466334
Pulgaon,Soybean,2015,3375,3451,76,2.251851851851852
Taloda,Sorgum(Jawar),2015,1425,1501,76,5.333333333333333
Umarga,Wheat(Unhusked),2015,2800,2876,76,2.7142857142857144
Akot,Maize,2016,1529,1605,76,4.970568999345978
Sinner,Ground Nut Pods (Dry),2015,6300,6376,76,1.2063492063492063
Lasur Station,Maize,2016,1737,1813,76,4.375359815774323
Parli-Vaijnath,Sorgum(Jawar),2015,1259,1335,76,6.036536934074663
Tiroda,Paddy-Unhusked,2016,1573,1649,76,4.831532104259377
Vasai,Paddy-Unhusked,2016,1473,1549,76,5.159538357094365
Parola,Sorgum(Jawar),2015,1244,1320,76,6.109324758842444
Barshi,Ladies Finger,2015,100,176,76,76.0
Vani,Green Gram,2016,5190,5266,76,1.464354527938343
Partur,Soybean,2016,3137,3213,76,2.4226968441185845
Ausa,Sunflower,2015,3128,3204,76,2.4296675191815855
Shirur,Sorgum(Jawar),2016,1541,1617,76,4.931862426995457
Shirur,Wheat(Husked),2015,1402,1478,76,5.420827389443652
Majalgaon,Cotton,2015,4273,4349,76,1.778609875965364
Bhokardan,Soybean,2016,3497,3573,76,2.1732913926222475
Pachora,Wheat(Husked),2016,1455,1531,76,5.223367697594502
Ahmedpur,Hemp-Seed,2016,2095,2170,75,3.579952267303103
Buldhana,Maize,2015,1425,1500,75,5.2631578947368425
Jalna,Maize,2016,1586,1661,75,4.7288776796973515
Lonar,Maize,2014,1075,1150,75,6.976744186046512
Lasalgaon,Rice(Paddy-Hus),2015,1525,1600,75,4.918032786885246
Morshi,Sorgum(Jawar),2015,1200,1275,75,6.25
Ashti-Karanja,Wheat(Husked),2015,1400,1475,75,5.357142857142857
Aurangabad,Cotton,2015,3850,3925,75,1.948051948051948
Parola,Wheat(Husked),2016,1549,1624,75,4.841833440929632
Tumsar,Linseed,2016,5267,5342,75,1.4239605088285552
Bhokardan-Pimpalgaon Renu,Soybean,2016,3775,3850,75,1.9867549668874172
Umari,Gram,2016,5075,5150,75,1.477832512315271
Murbad,Brinjal,2015,2350,2425,75,3.1914893617021276
Bhokar,Soybean,2016,3209,3284,75,2.337176690557806
Pandharpur,Wheat(Husked),2016,1801,1876,75,4.16435313714603
Varud-Rajura Bazar,Mustard,2015,3175,3250,75,2.3622047244094486
Achalpur,Maize,2016,1525,1600,75,4.918032786885246
Khed,Bottle Gourd,2014,555,630,75,13.513513513513514
Gondpimpri,Paddy-Unhusked,2016,2433,2508,75,3.082614056720099
Mangrulpeer,Sorgum(Jawar),2016,1433,1508,75,5.2337752965806
Lasur Station,Soybean,2016,3091,3166,75,2.4263992235522487
Bhusaval,Gram,2016,3875,3950,75,1.935483870967742
Umared,Sorgum(Jawar),2015,1200,1275,75,6.25
Sangamner,Gram,2014,3200,3275,75,2.34375
Loha,Sorgum(Jawar),2016,1537,1612,75,4.879635653871178
Sangali,Maize,2015,1364,1439,75,5.4985337243401755
Babhulgaon,Cotton,2016,4575,4650,75,1.639344262295082
Pune-Manjri,Ambat Chuka,2016,875,950,75,8.571428571428571
Sangali,Maize,2016,1825,1900,75,4.109589041095891
Shevgaon,MAIZE,2016,1091,1166,75,6.8744271310724105
Khed (Shel Pimpalgaon),Flower,2016,1075,1150,75,6.976744186046512
Parli-Vaijnath,Bajri,2015,1221,1296,75,6.142506142506143
Parbhani,Sorgum(Jawar),2015,1600,1675,75,4.6875
Nilanga,Wheat(Husked),2015,1550,1625,75,4.838709677419355
Nilanga,Wheat(Husked),2015,1425,1500,75,5.2631578947368425
Devala,Pigeon Pea (Tur),2015,4709,4784,75,1.5926948396687195
Umari,Soybean,2016,3616,3691,75,2.0741150442477876
Balapur,Green Gram,2016,3700,3775,75,2.027027027027027
Palam,Soybean,2015,3476,3551,75,2.15765247410817
Murum,Wheat(Husked),2014,1418,1493,75,5.289139633286319
Bhadrawati,COTTON,2016,4814,4889,75,1.557955961778147
Parli-Vaijnath,Gram,2016,4110,4185,75,1.8248175182481752
Karanja,Ground Nut Pods (Dry),2016,4890,4965,75,1.5337423312883436
Koregaon,Wheat(Husked),2015,1825,1900,75,4.109589041095891
Raver,Black Gram,2015,5219,5294,75,1.437056907453535
Chopda,Soybean,2016,3194,3269,75,2.34815278647464
Parli-Vaijnath,Gram,2015,3906,3981,75,1.9201228878648233
Barshi,Sunflower,2015,2950,3025,75,2.542372881355932
Lonar,Maize,2016,1450,1525,75,5.172413793103448
Lonar,Maize,2016,1151,1226,75,6.516072980017376
Tiroda,Paddy-Unhusked,2015,1430,1505,75,5.244755244755245
Murum,Green Gram,2016,6350,6425,75,1.1811023622047243
Jalna-Badnapur,Bajri,2016,1325,1400,75,5.660377358490566
Bhokardan-Pimpalgaon Renu,Wheat(Husked),2016,1569,1644,75,4.780114722753346
Morshi,Sorgum(Jawar),2016,1364,1439,75,5.4985337243401755
Ahmedpur,BAJRI,2016,1133,1208,75,6.619593998234775
Mangrulpeer,Green Gram,2016,6454,6529,75,1.1620700340873877
Shevgaon,Maize,2015,1026,1101,75,7.309941520467836
Shrirampur,Pigeon Pea (Tur),2016,6269,6344,75,1.1963630563088212
Ausa,Soybean,2015,3432,3507,75,2.1853146853146854
Jalgaon Jamod-Aasalgaon,Maize,2015,1150,1225,75,6.521739130434782
Rahata,Bajri,2015,1250,1325,75,6.0
Bhusaval,Black Gram,2014,4050,4125,75,1.8518518518518519
Umarga,Wheat(Unhusked),2015,3550,3625,75,2.112676056338028
Barshi,Tomato,2015,71,146,75,105.63380281690141
Dharni,Maize,2016,1391,1466,75,5.391804457225018
Phaltan,Maize,2015,1147,1222,75,6.538796861377507
Kalmeshwar,Soybean,2016,3140,3215,75,2.388535031847134
Phaltan,Jaggery,2016,3850,3925,75,1.948051948051948
Purna,Soybean,2016,3767,3842,75,1.9909742500663659
Khamgaon,Sunflower,2014,2600,2675,75,2.8846153846153846
Umared,Sorgum(Jawar),2015,1475,1550,75,5.084745762711864
Naigaon,Soybean,2014,3200,3275,75,2.34375
Bhusaval,Bajri,2016,1625,1700,75,4.615384615384615
Sailu,Wheat(Husked),2016,1600,1675,75,4.6875
Brahmpuri,Paddy-Unhusked,2014,2240,2315,75,3.3482142857142856
Akhadabalapur,Castor Seed,2016,3050,3125,75,2.459016393442623
Sangamner,Soybean,2015,3625,3700,75,2.0689655172413794
Parli-Vaijnath,Wheat(Husked),2016,1686,1761,75,4.448398576512456
Hadgaon,Gram,2014,2375,2450,75,3.1578947368421053
Ahmednagar,Bajri,2015,1503,1578,75,4.990019960079841
Ahmednagar,Maize,2015,1456,1531,75,5.1510989010989015
Akhadabalapur,Wheat(Husked),2015,1750,1825,75,4.285714285714286
Hadgaon,Pigeon Pea (Tur),2014,4425,4500,75,1.694915254237288
Buldhana,Maize,2015,990,1065,75,7.575757575757576
Hadgaon,Soybean,2014,3675,3750,75,2.0408163265306123
Jalgaon,Sorgum(Jawar),2015,1236,1311,75,6.067961165048544
Umared,Green Gram,2014,4703,4778,75,1.594726770146715
Loha,Maize,2014,1700,1775,75,4.411764705882353
Ambejogai,Maize,2015,1213,1288,75,6.183017312448475
Pune,Maize,2016,1850,1925,75,4.054054054054054
Beed,Pigeon Pea (Tur),2014,4922,4997,75,1.5237708248679398
Khed-Chakan,Shepu,2016,400,475,75,18.75
Gevrai,Sunflower,2016,3364,3439,75,2.2294887039239
Risod,GREEN GRAM,2016,5225,5300,75,1.4354066985645932
Varud-Rajura Bazar,Maize,2014,1300,1375,75,5.769230769230769
Jalgaon Jamod,Maize,2015,963,1038,75,7.788161993769471
Telhara,Wheat(Husked),2014,1361,1436,75,5.510653930933137
Jintur,Horse Gram,2015,3800,3875,75,1.9736842105263157
Khamgaon,Ground Nut Pods (Dry),2015,3425,3500,75,2.18978102189781
Nandurbar,Matki,2015,6647,6722,75,1.128328569279374
Malkapur,Bajri,2014,1132,1207,75,6.625441696113074
Navapur,COTTON,2016,4667,4742,75,1.6070280694236125
Koregaon,Maize,2016,1400,1475,75,5.357142857142857
Parli-Vaijnath,Sorgum(Jawar),2015,1311,1386,75,5.720823798627002
Koregaon,Ghevda Seed,2016,3975,4050,75,1.8867924528301887
Partur,Cotton,2015,3889,3964,75,1.9285163281049114
Kurdwadi,Maize,2015,1128,1203,75,6.648936170212766
Bhokardan-Pimpalgaon Renu,Wheat(Husked),2015,1506,1581,75,4.9800796812749
Khamgaon,Mustard,2015,3025,3100,75,2.479338842975207
Akluj,Wheat(Husked),2014,1440,1515,75,5.208333333333333
Armori,Paddy-Unhusked,2016,1978,2053,75,3.7917087967644085
Jalna,Green Gram,2016,4663,4738,75,1.608406605189792
Umarkhed-Danki,Wheat(Husked),2016,1500,1575,75,5.0
Bhokardan-Pimpalgaon Renu,Soybean,2015,3513,3588,75,2.134927412467976
Solapur,Hemp,2016,425,500,75,17.647058823529413
Bhokardan-Pimpalgaon Renu,Soybean,2015,3450,3525,75,2.1739130434782608
Basmat,Cotton,2015,4200,4275,75,1.7857142857142858
Malkapur,Bajri,2016,1578,1653,75,4.752851711026616
Mantha,Cotton,2015,3875,3950,75,1.935483870967742
Barshi-Vairag,Soybean,2016,3634,3709,75,2.0638414969730325
Chopda,Green Gram,2015,6398,6473,75,1.172241325414192
Pandharkawada,Soybean,2016,3363,3438,75,2.230151650312221
Kurdwadi,Wheat(Husked),2015,1789,1864,75,4.192286193404136
Navapur,Soybean,2015,3606,3681,75,2.0798668885191347
Jalgaon,Amla,2015,1450,1525,75,5.172413793103448
Mohol,Wheat(Husked),2015,1813,1888,75,4.136789851075565
Umarga,Sorgum(Jawar),2015,1515,1590,75,4.9504950495049505
Partur,Bajri,2016,1300,1375,75,5.769230769230769
Pune,Maize,2016,1875,1950,75,4.0
Jalna,Safflower,2016,2525,2600,75,2.9702970297029703
Raver,Maize,2015,1052,1127,75,7.129277566539924
Ambejogai,Soybean,2015,3277,3352,75,2.2886786695148
Pune-Manjri,Onion,2016,633,708,75,11.848341232227488
Arjuni Morgaon,Paddy-Unhusked,2015,1750,1825,75,4.285714285714286
Nandurbar,Sunflower,2014,2875,2950,75,2.608695652173913
Rajura,Gram,2015,4075,4150,75,1.8404907975460123
Malegaon,Sorgum(Jawar),2016,1613,1688,75,4.6497210167389955
Umared,Mustard,2015,2898,2973,75,2.587991718426501
Loha,Gram,2016,3978,4053,75,1.885369532428356
Satana,Maize,2015,1407,1482,75,5.330490405117271
Indapur,Bajri,2015,1504,1579,75,4.986702127659575
Daryapur,Cotton,2014,4000,4075,75,1.875
Kalvan,Wheat(Husked),2016,1775,1850,75,4.225352112676056
Newasa,Sorgum(Jawar),2016,1600,1675,75,4.6875
Rahata,Wheat(Husked),2016,1453,1528,75,5.161734342739161
Telhara,Sorgum(Jawar),2015,1245,1320,75,6.024096385542169
Manmad,Wheat(Husked),2016,1702,1777,75,4.406580493537016
Gondiya,Paddy-Unhusked,2015,1667,1742,75,4.499100179964008
Shrirampur,Pigeon Pea (Tur),2015,7325,7400,75,1.023890784982935
Chikhali,Bajri,2016,1388,1463,75,5.403458213256484
Parbhani,Wheat(Husked),2016,1700,1775,75,4.411764705882353
Shahada,Bajri,2015,1302,1377,75,5.76036866359447
Sangamner,Maize,2015,1554,1629,75,4.826254826254826
Indapur-Bhigwan,Horse Gram,2015,3900,3975,75,1.9230769230769231
Ahmednagar,Bajri,2016,1645,1720,75,4.5592705167173255
Navapur,Gram,2016,4038,4113,75,1.8573551263001487
Kuntur,Soybean,2016,3650,3725,75,2.0547945205479454
Nandurbar,Cluster Bean,2015,4000,4075,75,1.875
Kalamb (Os),Green Gram,2015,5525,5600,75,1.3574660633484164
Ghoti,Flower,2016,925,1000,75,8.108108108108109
Shahada,Maize,2016,1596,1670,74,4.636591478696742
Kurdwadi,GREEN GRAM,2016,4176,4250,74,1.7720306513409962
Pune,Jaggery,2015,2232,2306,74,3.315412186379928
Rahata,Wheat(Husked),2014,1458,1532,74,5.075445816186557
Lasalgaon-Niphad,Wheat(Husked),2016,1777,1851,74,4.164321890827237
Ahmedpur,Maize,2016,1332,1406,74,5.555555555555555
Barshi,Bajri,2015,1655,1729,74,4.471299093655589
Mukhed,Green Gram,2016,4776,4850,74,1.5494137353433837
Nanded,Pigeon Pea (Tur),2014,4026,4100,74,1.8380526577247889
Jalna,COTTON,2016,4857,4931,74,1.5235742227712579
Arjuni Morgaon,Paddy-Unhusked,2015,1596,1670,74,4.636591478696742
Bhokardan,Wheat(Husked),2016,1528,1602,74,4.842931937172775
Mehkar,Sorgum(Jawar),2016,1579,1653,74,4.686510449651678
Parli-Vaijnath,Soybean,2015,3223,3297,74,2.2959975178405214
Pune,Maize,2015,1716,1790,74,4.312354312354312
Phaltan,Maize,2014,1160,1234,74,6.379310344827586
Gangapur,Pigeon Pea (Tur),2016,7876,7950,74,0.9395632300660234
Jamner-Neri,Maize,2016,1325,1399,74,5.584905660377358
Chopda,Soybean,2015,3120,3194,74,2.371794871794872
Shevgaon,WHEAT(HUSKED),2016,1633,1707,74,4.53153704837722
Chopda,Ground Nut Pods (Dry),2014,3526,3600,74,2.098695405558707
Bhiwapur,Cotton,2015,3754,3828,74,1.9712306872669152
Navapur,Cabbage,2016,373,447,74,19.839142091152816
Chandvad,Maize,2016,1381,1455,74,5.358435916002897
Akhadabalapur,SOYBEAN,2016,2778,2852,74,2.663786897048236
Umared,Coriander (Dry),2015,8655,8729,74,0.8549971114962449
Mangaon(Bhadav),Paddy-Unhusked,2016,1384,1458,74,5.3468208092485545
Majalgaon,Soybean,2016,2767,2841,74,2.674376581134803
Umarga,Maize,2015,1254,1328,74,5.901116427432217
Parli-Vaijnath,Sorgum(Jawar),2016,1551,1625,74,4.771115409413282
Kurdwadi-Modnimb,Wheat(Husked),2016,1624,1698,74,4.556650246305419
Gadchiroli,Paddy-Unhusked,2016,1612,1685,73,4.528535980148884
Bhiwapur,Paddy-Unhusked,2016,2135,2208,73,3.4192037470725993
Parbhani,Cotton,2015,4113,4186,73,1.774860199367858
Bhokardan-Pimpalgaon Renu,Maize,2015,1335,1408,73,5.468164794007491
Kalamb (Os),Safflower,2015,2758,2831,73,2.6468455402465554
Kej,Wheat(Husked),2014,1415,1488,73,5.159010600706714
Sakri,Bajri,2015,1301,1374,73,5.611068408916219
Chalisgaon,Maize,2016,1364,1437,73,5.351906158357771
Indapur-Bhigwan,Maize,2015,1417,1490,73,5.151729004940014
Aamgaon,Paddy-Unhusked,2014,1481,1554,73,4.929101958136394
Shevgaon,SOYBEAN,2016,2456,2529,73,2.972312703583062
Akot,Sorgum(Jawar),2016,1435,1508,73,5.087108013937282
Lonar,Sorgum(Jawar),2015,1158,1231,73,6.303972366148532
Devala,Wheat(Husked),2014,1562,1635,73,4.673495518565941
Gevrai,Soybean,2016,3491,3564,73,2.0910913778287026
Parbhani,Soybean,2015,3157,3230,73,2.3123218245169466
Dhadgaon,Sorgum(Jawar),2016,1204,1277,73,6.06312292358804
Vaijapur,Maize,2014,1008,1081,73,7.242063492063492
Indapur (Nimgaon Ketki),Bajri,2015,1438,1511,73,5.076495132127955
Ambejogai,Sorgum(Jawar),2016,1840,1913,73,3.967391304347826
Shegaon,Sorgum(Jawar),2014,1132,1205,73,6.448763250883392
Yeola,Soybean,2014,3126,3199,73,2.3352527191298784
Partur,Bajri,2015,1091,1164,73,6.691109074243813
Nandurbar,Chillies(Red),2015,2000,2073,73,3.65
Barshi,Maize,2016,1412,1485,73,5.169971671388102
Lonar,Wheat(Husked),2014,1433,1506,73,5.094207955338451
Vaijapur,HORSE GRAM,2016,2939,3012,73,2.4838380401497107
Rahata,WALVAD,2016,683,756,73,10.68814055636896
Sinner,Maize,2016,1346,1419,73,5.423476968796434
Khamgaon,Maize,2015,1085,1158,73,6.728110599078341
Devala,Green Gram,2014,7498,7571,73,0.973592958122166
Khed (Shel Pimpalgaon),Bottle Gourd,2016,705,778,73,10.354609929078014
Rahuri,Wheat(Husked),2015,1438,1511,73,5.076495132127955
Katol,Wheat(Husked),2016,1521,1594,73,4.799474030243261
Mohol,Maize,2014,1389,1462,73,5.255579553635709
Gondpimpri,Paddy-Unhusked,2014,2048,2121,73,3.564453125
Pune,Jaggery,2016,3317,3390,73,2.200783840820018
Chandur Rly.,Cotton,2015,4256,4329,73,1.7152255639097744
Jintur,Wheat(Husked),2016,1879,1952,73,3.8850452368281
Ambejogai,Sunflower,2014,3025,3098,73,2.4132231404958677
Sinner,Tamarind,2015,1434,1506,72,5.02092050209205
Dudhani,Maize,2015,1215,1287,72,5.925925925925926
Shegaon,Mustard,2015,3173,3245,72,2.269145918688938
Akot,Cotton,2015,4174,4246,72,1.7249640632486822
Dharni,Maize,2016,1264,1336,72,5.69620253164557
Dudhani,MAIZE,2016,1161,1233,72,6.2015503875969
Varud-Rajura Bazar,Wheat(Husked),2014,1397,1469,72,5.153901216893343
Varud-Rajura Bazar,Castor Seed,2015,3006,3078,72,2.395209580838323
Pune-Pimpri,Beet Root,2016,1264,1336,72,5.69620253164557
Lasur Station,Safflower,2015,2364,2436,72,3.045685279187817
Pandharpur,Wheat(Husked),2016,1773,1845,72,4.060913705583756
Brahmpuri,Paddy-Unhusked,2016,1802,1874,72,3.995560488346282
Rahuri-Vambori,Bajri,2016,1760,1832,72,4.090909090909091
Dharni,Sorgum(Jawar),2016,1371,1443,72,5.25164113785558
Shegaon,Mustard,2014,2764,2836,72,2.6049204052098407
Khamgaon,Bajri,2015,1096,1168,72,6.569343065693431
Lasur Station,Maize,2016,1535,1607,72,4.690553745928339
Kej,Maize,2016,1456,1528,72,4.945054945054945
Pune,Maize,2014,1432,1504,72,5.027932960893855
Bhokar,Soybean,2015,3207,3279,72,2.245088868101029
Devala,Maize,2016,1577,1649,72,4.56563094483196
Rahuri,Gram,2015,3130,3202,72,2.3003194888178915
Shirur,Bajri,2015,1333,1405,72,5.401350337584396
Amarawati,Soybean,2015,3241,3313,72,2.2215365627892627
Parola,Maize,2016,1336,1408,72,5.389221556886228
Mangalwedha,Maize,2014,1385,1457,72,5.1985559566787005
Jalna,Maize,2015,1360,1432,72,5.294117647058823
Kalamb (Os),Bajri,2015,1208,1280,72,5.960264900662252
Ausa,Sunflower,2015,3111,3183,72,2.314368370298939
Tumsar,Paddy-Unhusked,2015,1610,1682,72,4.472049689440993
Achalpur,Maize,2016,1275,1347,72,5.647058823529412
Kurdwadi,Wheat(Husked),2015,1524,1596,72,4.724409448818897
Sonpeth,Bajri,2016,1538,1610,72,4.681404421326398
Kopargaon,Maize,2016,1373,1445,72,5.243991260014567
Kalvan,Soybean,2016,2761,2833,72,2.6077508149221296
Parbhani,Cotton,2015,3884,3956,72,1.8537590113285274
Udgir,Sorgum(Jawar),2016,1208,1280,72,5.960264900662252
Lakhandur,Gram,2016,5201,5273,72,1.3843491636223804
Kannad,Sorgum(Jawar),2015,1157,1229,72,6.222990492653414
Navapur,SORGUM(JAWAR),2016,1203,1275,72,5.985037406483791
Pavani,Paddy-Unhusked,2015,1625,1697,72,4.430769230769231
Lasur Station,Soybean,2015,3404,3475,71,2.0857814336075204
Barshi,Lemon,2016,220,291,71,32.27272727272727
Partur,Soybean,2015,3188,3259,71,2.2271016311166876
Pachora,Wheat(Husked),2015,1419,1490,71,5.003523608174771
Pune-Pimpri,Ginger (Dry),2015,3500,3571,71,2.0285714285714285
Newasa,Wheat(Husked),2014,1457,1528,71,4.87302676733013
Dhamangaon-Rly,Wheat(Husked),2014,1442,1513,71,4.923717059639389
Barshi-Vairag,Maize,2015,1111,1182,71,6.390639063906391
Savner,Maize,2015,1169,1240,71,6.073567151411463
Chopda,Wheat(Husked),2015,1416,1487,71,5.0141242937853105
Shirur,Gram,2014,2250,2321,71,3.1555555555555554
Bhusaval,Green Gram,2016,3982,4053,71,1.783023606228026
Sangali,Maize,2015,1535,1606,71,4.625407166123779
Khamgaon,Bajri,2015,1112,1183,71,6.384892086330935
Telhara,Sorgum(Jawar),2015,1187,1258,71,5.981465880370682
Armori,Paddy-Unhusked,2016,1550,1621,71,4.580645161290323
Manmad,Sorgum(Jawar),2016,1790,1861,71,3.9664804469273744
Devala,Sorgum(Jawar),2015,1268,1339,71,5.599369085173501
Amarawati,COTTON,2016,4936,5007,71,1.4384116693679092
Shrirampur,Soybean,2015,3088,3159,71,2.2992227979274613
Aurad Shahajani,Safflower,2016,2700,2771,71,2.6296296296296298
Jalna,Jaggery,2015,2273,2344,71,3.1236251649802025
Rahata,Cluster Bean,2015,2643,2714,71,2.686341278849792
Nanded,Sorgum(Jawar),2015,1102,1173,71,6.442831215970962
Nanded,Sorgum(Jawar),2015,1238,1309,71,5.735056542810986
Achalpur,Sorgum(Jawar),2016,1322,1393,71,5.3706505295007565
Newasa,Gram,2015,3200,3271,71,2.21875
Pachora,Maize,2016,1566,1637,71,4.533844189016603
Achalpur,Sorgum(Jawar),2016,1603,1674,71,4.429195258889582
Shevgaon-Bodhegaon,Wheat(Husked),2015,1692,1763,71,4.196217494089835
Dhamangaon-Rly,Wheat(Husked),2016,1651,1722,71,4.300423985463356
Bhokardan,Wheat(Husked),2016,1493,1564,71,4.755525787006028
Murbad,Ghosali(Bhaji),2015,2700,2771,71,2.6296296296296298
Shevgaon-Bodhegaon,Wheat(Husked),2014,1442,1513,71,4.923717059639389
Jalna,Maize,2016,1562,1633,71,4.545454545454546
Pandharpur,Sorgum(Jawar),2015,1673,1744,71,4.243873281530186
Udgir,Soybean,2016,3892,3963,71,1.8242548818088387
Digras,Wheat(Husked),2015,1517,1588,71,4.680290046143704
Kej,Maize,2015,1389,1460,71,5.111591072714183
Indapur,Maize,2015,1463,1534,71,4.853041695146958
Shirur,Wheat(Husked),2016,1541,1612,71,4.6073977936404935
Paithan,Sorgum(Jawar),2015,1563,1634,71,4.54254638515675
Tuljapur,Sorgum(Jawar),2014,1155,1226,71,6.147186147186147
Tuljapur,SORGUM(JAWAR),2016,1986,2057,71,3.5750251762336354
Gangapur,Maize,2014,1248,1319,71,5.689102564102564
Dharangaon,Sorgum(Jawar),2016,1116,1187,71,6.362007168458781
Aamgaon,Paddy-Unhusked,2015,1529,1600,71,4.643557880967953
Gadchiroli,Paddy-Unhusked,2015,1656,1727,71,4.28743961352657
Islampur,Cabbage,2016,68,139,71,104.41176470588235
Khamgaon,Mustard,2015,3243,3314,71,2.1893308664816526
Khamgaon,MAIZE,2016,1124,1195,71,6.316725978647687
Dudhani,Bajri,2016,1421,1492,71,4.9964813511611545
Shevgaon-Bodhegaon,MATKI,2016,6204,6275,71,1.1444229529335912
Sakri,Wheat(Husked),2015,1348,1419,71,5.267062314540059
Barshi,Spinach,2016,110,180,70,63.63636363636363
Rahata,Soybean,2015,3185,3255,70,2.197802197802198
Parbhani,Wheat(Husked),2016,1500,1570,70,4.666666666666667
Varud-Rajura Bazar,Wheat(Husked),2015,1460,1530,70,4.794520547945205
Ghoti,Ladies Finger,2014,2930,3000,70,2.3890784982935154
Taloda,Maize,2015,1090,1160,70,6.422018348623853
Varud,Cotton,2015,3800,3870,70,1.8421052631578947
Jalgaon-Masawat,MAIZE,2016,1047,1117,70,6.685768863419293
Yeola,Wheat(Husked),2014,1553,1623,70,4.507405022537025
Mohol,Black Gram,2014,4580,4650,70,1.5283842794759825
Mohol,Maize,2014,1144,1214,70,6.118881118881119
Wardha,Wheat(Husked),2015,1495,1565,70,4.682274247491639
Vaijapur,Maize,2015,1390,1460,70,5.0359712230215825
Rajura,Soybean,2016,3657,3727,70,1.914137270987148
Barshi,Maize,2015,1218,1288,70,5.747126436781609
Mangalwedha,Maize,2016,1690,1760,70,4.1420118343195265
Ahmedpur,Bajri,2015,1180,1250,70,5.932203389830509
Sonpeth,Cotton,2014,3925,3995,70,1.78343949044586
Rajura,Green Gram,2016,6033,6103,70,1.1602850986242335
Devala,Wheat(Husked),2016,1496,1566,70,4.679144385026738
Barshi-Vairag,Ground Nut Pods (Dry),2015,4851,4921,70,1.443001443001443
Pune,Jaggery,2016,3385,3455,70,2.06794682422452
Dhule,Maize,2016,1580,1650,70,4.430379746835443
Barshi,Maize,2014,1300,1370,70,5.384615384615385
Chopda,Sorgum(Jawar),2015,1448,1518,70,4.834254143646409
Kej,Soybean,2014,3228,3298,70,2.168525402726146
Kille Dharur,Maize,2016,1508,1578,70,4.641909814323608
Phaltan,Jaggery,2014,2436,2506,70,2.8735632183908044
Solapur,Papai,2015,199,269,70,35.175879396984925
Kej,Pigeon Pea (Tur),2016,5201,5271,70,1.3458950201884252
Gangapur,Maize,2014,1092,1162,70,6.410256410256411
Hingoli,Gram,2016,4517,4587,70,1.5497011290679654
Ausa,Sunflower,2015,3116,3186,70,2.246469833119384
Sinner,Black Gram,2015,5175,5245,70,1.3526570048309179
Tumsar,Wheat(Husked),2016,1657,1727,70,4.224502112251056
Sonpeth,Cotton,2015,4279,4349,70,1.6358962374386539
Kille Dharur,Maize,2015,1530,1600,70,4.57516339869281
Raver,Rice(Paddy-Hus),2016,1740,1810,70,4.022988505747127
Shrirampur-Belapur,Wheat(Husked),2016,1505,1575,70,4.651162790697675
Khed (Shel Pimpalgaon),Brinjal,2015,385,455,70,18.181818181818183
Bhusaval,Wheat(Husked),2015,1342,1412,70,5.216095380029806
Bhokar,Gram,2015,3182,3252,70,2.1998742928975488
Sinner,Rice(Paddy-Hus),2015,1443,1513,70,4.851004851004851
Vadvani,BAJRI,2016,1600,1670,70,4.375
Parli-Vaijnath,Sorgum(Jawar),2016,1588,1658,70,4.408060453400504
Kej,Rala,2015,1078,1148,70,6.4935064935064934
Ahmedpur,Sorgum(Jawar),2016,1500,1570,70,4.666666666666667
Solapur,Pigeon Pea (Tur),2014,4680,4750,70,1.4957264957264957
Islampur,Tomato,2014,100,170,70,70.0
Palghar(Bevur),Wheat(Husked),2014,1901,1971,70,3.682272488164124
Pune-Manjri,Hemp,2016,874,944,70,8.009153318077804
Baramati,Wheat(Unhusked),2016,3351,3421,70,2.0889286780065652
Palghar(Bevur),Onion,2016,1071,1141,70,6.5359477124183005
Shahada,Black Gram,2015,5559,5629,70,1.2592192840438927
Pune,Maize,2015,1590,1660,70,4.40251572327044
Lakhandur,Green Gram,2016,5587,5657,70,1.2529085376767497
Kalamb (Os),Maize,2014,1225,1295,70,5.714285714285714
Parshiwani,Cotton,2016,4505,4575,70,1.5538290788013318
Devala,Maize,2016,1370,1440,70,5.109489051094891
Kalamb (Os),Maize,2015,1071,1141,70,6.5359477124183005
Nanded,Sorgum(Jawar),2015,1319,1389,70,5.307050796057619
Vaduj,Maize,2016,1549,1619,70,4.519044544867657
Lonar,Maize,2015,1070,1140,70,6.542056074766355
Akluj,Sorgum(Jawar),2015,1181,1251,70,5.927180355630822
Kille Dharur,Maize,2016,1415,1485,70,4.946996466431095
Devala,Wheat(Husked),2014,1497,1567,70,4.676018704074816
Chikhali,Sorgum(Jawar),2014,1080,1150,70,6.481481481481482
Barshi,Bor,2014,107,177,70,65.42056074766356
Barshi,Ridge Gourd,2015,80,150,70,87.5
Phaltan,MAIZE,2016,1280,1350,70,5.46875
Yeola,Maize,2016,1380,1450,70,5.072463768115942
Umared,Sorgum(Jawar),2015,1710,1780,70,4.093567251461988
Hadgaon,Cotton,2014,4070,4140,70,1.71990171990172
Khed (Shel Pimpalgaon),Cabbage,2015,650,719,69,10.615384615384615
Parbhani,Soybean,2016,3742,3811,69,1.8439337252805985
Yeotmal,Wheat(Husked),2014,1380,1449,69,5.0
Malkapur,Sorgum(Jawar),2016,1266,1335,69,5.450236966824645
Barshi,Maize,2016,1592,1661,69,4.334170854271357
Rahata,Maize,2015,1204,1273,69,5.730897009966777
Ramtek,Green Chilli,2015,615,684,69,11.21951219512195
Wardha,Wheat(Husked),2014,1479,1548,69,4.665314401622718
Rajura,Pigeon Pea (Tur),2015,4439,4508,69,1.5544041450777202
Varud-Rajura Bazar,Castor Seed,2016,3011,3080,69,2.2915974759216207
Yeola,Maize,2016,1751,1820,69,3.9406053683609366
Morshi,Sorgum(Jawar),2015,1131,1200,69,6.10079575596817
Telhara,Cotton,2014,3875,3944,69,1.7806451612903227
Partur,Cotton,2015,4304,4373,69,1.6031598513011152
Devala,Tamarind,2015,1402,1471,69,4.921540656205421
Kada,Maize,2015,1274,1343,69,5.416012558869702
Bhokardan,Wheat(Husked),2015,1439,1508,69,4.794996525364836
Gangapur,Green Gram,2015,8126,8195,69,0.8491262613832143
Dudhani,Bajri,2015,1138,1207,69,6.063268892794376
Shrigonda,Green Gram,2016,5331,5400,69,1.2943162633652223
Taloda,Sorgum(Jawar),2015,1483,1552,69,4.652730950775455
Purna,Soybean,2016,3456,3525,69,1.9965277777777777
Jawala-Bajar,Soybean,2016,3600,3669,69,1.9166666666666667
Aamgaon,Paddy-Unhusked,2016,1489,1558,69,4.633982538616521
Bhokar,Gram,2015,4016,4085,69,1.7181274900398407
Rahuri,Wheat(Husked),2014,1474,1543,69,4.681139755766622
Nandgaon Khandeshwar,Wheat(Husked),2016,1497,1566,69,4.609218436873747
Parli-Vaijnath,Sorgum(Jawar),2016,1663,1732,69,4.149128081779915
Telhara,Sorgum(Jawar),2015,1384,1453,69,4.985549132947977
Aarni,Sorgum(Jawar),2015,1244,1313,69,5.546623794212219
Ahmedpur,Soybean,2016,3371,3440,69,2.046870364876891
Wardha,WHEAT(HUSKED),2016,1863,1932,69,3.7037037037037037
Savali,Paddy-Unhusked,2016,2406,2475,69,2.8678304239401498
Aurad Shahajani,Soybean,2015,3518,3587,69,1.961341671404207
Pusad,Sesamum,2015,6198,6267,69,1.1132623426911907
Morshi,Sorgum(Jawar),2015,1094,1163,69,6.307129798903108
Chandrapur,Gram,2014,2096,2165,69,3.2919847328244276
Ambejogai,Black Gram,2014,5323,5392,69,1.2962615066691716
Devala,Wheat(Husked),2015,1461,1530,69,4.722792607802875
Phaltan,Maize,2015,1265,1334,69,5.454545454545454
Kolhapur,Banana,2015,757,826,69,9.114927344782034
Malkapur,Black Gram,2015,7169,7238,69,0.9624773329613614
Navapur,Wheat(Husked),2016,1483,1552,69,4.652730950775455
Dound,Maize,2014,1155,1224,69,5.974025974025974
Pune-Manjri,Other Vegetables,2016,1731,1800,69,3.9861351819757367
Bhiwapur,Paddy-Unhusked,2015,1917,1986,69,3.599374021909233
Rahata,Sorgum(Jawar),2016,1244,1313,69,5.546623794212219
Bhokardan,Maize,2016,1084,1153,69,6.365313653136531
Palghar(Bevur),Potato,2016,1412,1481,69,4.886685552407932
Kannad,Sorgum(Jawar),2015,1325,1394,69,5.2075471698113205
Khamgaon,Bajri,2015,1135,1204,69,6.079295154185022
Malegaon,Maize,2016,1401,1470,69,4.925053533190578
Pune-Manjri,Mint,2016,1769,1838,69,3.9005087620124366
Akot,Sorgum(Jawar),2016,1361,1430,69,5.069801616458486
Kalvan,Wheat(Husked),2015,1522,1591,69,4.533508541392904
Shevgaon-Bodhegaon,Wheat(Husked),2015,1675,1744,69,4.119402985074627
Mahad,Paddy-Unhusked,2016,1411,1480,69,4.890148830616584
Kalamb (Os),Sunflower,2016,3385,3454,69,2.0384047267355982
Indapur (Nimgaon Ketki),Gram,2016,5206,5274,68,1.3061851709565886
Nanded,Sorgum(Jawar),2015,1126,1194,68,6.039076376554174
Jalgaon,Bajri,2014,1298,1366,68,5.238828967642527
Washim,Paddy-Unhusked,2014,1273,1341,68,5.341712490180676
Chandur Rly.,Soybean,2016,3110,3178,68,2.1864951768488745
Shirur,Bajri,2014,1373,1441,68,4.95265841223598
Lonar,Wheat(Husked),2014,1457,1525,68,4.667124227865477
Barshi,Maize,2016,1417,1485,68,4.798870853916726
Nandgaon,Maize,2016,1356,1424,68,5.014749262536873
Chopda,Sesamum,2015,8624,8692,68,0.7884972170686456
Sillod,Maize,2015,1272,1340,68,5.345911949685535
Mangalwedha,Maize,2016,1468,1536,68,4.632152588555858
Umared,Lang,2015,2070,2138,68,3.285024154589372
Kalamb (Os),Safflower,2016,2556,2624,68,2.6604068857589986
Shirur,Maize,2015,1191,1259,68,5.709487825356843
Kolhapur,Banana,2015,719,787,68,9.457579972183588
Varud-Rajura Bazar,Green Chilli,2016,363,431,68,18.732782369146005
Ahmednagar,MAIZE,2016,1204,1272,68,5.647840531561462
Jamner-Neri,Maize,2015,1325,1393,68,5.132075471698113
Jamner-Neri,Cotton,2015,4032,4100,68,1.6865079365079365
Chandur Rly.,GREEN GRAM,2016,5110,5178,68,1.3307240704500978
Lasur Station,Castor Seed,2014,3300,3368,68,2.0606060606060606
Lasalgaon-Niphad,Maize,2016,1417,1485,68,4.798870853916726
Barshi,Tomato,2015,90,158,68,75.55555555555556
Umared,Green Peas (Dry),2016,2962,3030,68,2.2957461174881835
Solapur,Banana,2016,796,864,68,8.542713567839195
Barshi,Brinjal,2015,20,88,68,340.0
Manmad,Maize,2015,1262,1330,68,5.3882725832012675
Chopda,Sorgum(Jawar),2016,1334,1402,68,5.097451274362818
Dudhani,Bajri,2016,1688,1756,68,4.028436018957346
Jawala-Bajar,Soybean,2016,3681,3749,68,1.8473240967128497
Hingoli,Wheat(Husked),2016,2200,2268,68,3.090909090909091
Barshi,Tamarind Seed,2015,1711,1779,68,3.974284044418469
Barshi,Maize,2015,1394,1462,68,4.878048780487805
Jalgaon,Maize,2015,1060,1128,68,6.415094339622642
Barshi,Cabbage,2016,47,115,68,144.68085106382978
Shahada,Bajri,2014,1313,1381,68,5.178979436405179
Bhandara,Wheat(Husked),2016,1579,1647,68,4.306523115896137
Beed,Maize,2016,1358,1426,68,5.007363770250368
Solapur,Grapes,2015,50,118,68,136.0
Morshi,Sorgum(Jawar),2015,1100,1168,68,6.181818181818182
Kille Dharur,Cotton,2015,3904,3972,68,1.7418032786885247
Rahata,Sorgum(Jawar),2015,1152,1220,68,5.902777777777778
Savner,Sorgum(Jawar),2015,901,969,68,7.547169811320755
Barshi,Tomato,2015,82,150,68,82.92682926829268
Shrigonda,Bajri,2015,1500,1567,67,4.466666666666667
Tasgaon,Maize,2016,1375,1442,67,4.872727272727273
Kurdwadi,Wheat(Husked),2016,1725,1792,67,3.8840579710144927
Mangalwedha,Maize,2015,1557,1624,67,4.303147077713552
Sillod,Sorgum(Jawar),2016,1050,1117,67,6.380952380952381
Jalgaon,Spinach,2015,1073,1140,67,6.244175209692451
Barshi-Vairag,Ground Nut Pods (Dry),2016,5477,5544,67,1.2232974255979552
Shirur,INDIAN BEAN,2016,3208,3275,67,2.0885286783042396
Khamgaon,Bajri,2016,1266,1333,67,5.292259083728278
Navapur,Onion,2016,1000,1067,67,6.7
Kurdwadi,Maize,2015,1577,1644,67,4.24857324032974
Mehkar,Maize,2016,1623,1690,67,4.128157732593962
Ghatanji,Gram,2015,3357,3424,67,1.9958296097706285
Khamgaon,Sunflower,2015,3275,3342,67,2.045801526717557
Pandharpur,Gram,2016,5100,5167,67,1.3137254901960784
Barshi,Lemon,2015,82,149,67,81.70731707317073
Shegaon,Sunflower,2015,2970,3037,67,2.255892255892256
Tumsar,Gram,2016,4135,4202,67,1.6203143893591294
Bhusaval,Pigeon Pea (Tur),2016,6333,6400,67,1.057950418443076
Parbhani,Pigeon Pea (Tur),2016,5992,6059,67,1.1181575433911883
Kada (Ashti),Maize,2015,1166,1233,67,5.746140651801029
Ner Parasopant,Gram,2016,6533,6600,67,1.025562528700444
Washim,Paddy-Unhusked,2015,1403,1470,67,4.775481111903065
Sinner,Castor Seed,2016,2667,2734,67,2.512185976752906
Washim-Ansing,Wheat(Husked),2016,1640,1707,67,4.085365853658536
Arvi,Cotton,2016,5058,5125,67,1.324634242783709
Pune-Pimpri,WALVAD,2016,2133,2200,67,3.1411157993436474
Satana,Maize,2016,1421,1488,67,4.714989444053484
Sillod-Bharadi,Sorgum(Jawar),2016,1383,1450,67,4.844540853217643
Ausa,Sunflower,2015,3098,3165,67,2.1626856036152358
Tuljapur,Gram,2015,4383,4450,67,1.5286333561487566
Paithan,Bajri,2015,1271,1338,67,5.271439811172305
Jalna-Badnapur,SORGUM(JAWAR),2016,1850,1917,67,3.6216216216216215
Kada (Ashti),Gram,2016,5633,5700,67,1.1894194922776495
Shevgaon,Pigeon Pea (Tur),2016,8300,8367,67,0.8072289156626506
Sonpeth,Gram,2015,4083,4150,67,1.6409502816556454
Bori Arab,Pigeon Pea (Tur),2016,7860,7927,67,0.8524173027989822
Umarga,Safflower,2014,2384,2451,67,2.8104026845637584
Sangali,Maize,2015,1310,1377,67,5.114503816793893
Telhara,Wheat(Husked),2014,1395,1462,67,4.802867383512544
Newasa,Wheat(Husked),2016,1600,1667,67,4.1875
Ramtek,WHEAT(HUSKED),2016,1750,1817,67,3.8285714285714287
Balapur,WHEAT(HUSKED),2016,1733,1800,67,3.866128101557992
Armori,Paddy-Unhusked,2014,2552,2619,67,2.6253918495297808
Rahuri-Vambori,Soybean,2016,3392,3459,67,1.9752358490566038
Newasa,Wheat(Husked),2015,1454,1521,67,4.607977991746905
Kada,Soybean,2014,2963,3030,67,2.261221734728316
Anajngaon Surji,Sorgum(Jawar),2014,1375,1442,67,4.872727272727273
Washim-Ansing,Sorgum(Jawar),2016,1276,1343,67,5.2507836990595615
Dudhani,Maize,2015,1468,1535,67,4.564032697547684
Katol,Green Gram,2016,4483,4550,67,1.4945349096587106
Lasur Station,Maize,2016,1410,1477,67,4.75177304964539
Shegaon,Maize,2015,998,1065,67,6.713426853707415
Khamgaon,Neem-Seed,2015,750,817,67,8.933333333333334
Mandhal,Green Gram,2015,5464,5531,67,1.226207906295754
Shrirampur-Belapur,Green Gram,2016,4433,4500,67,1.5113918339724792
Pune-Pimpri,Capsicum,2016,2533,2600,67,2.6450848795894197
Rahata,Ground Nut Pods (Dry),2015,4000,4067,67,1.675
Bhokardan,Maize,2015,1313,1380,67,5.102817974105103
Vaduj,Bajri,2015,1400,1467,67,4.785714285714286
Jalkot,Sorgum(Jawar),2016,1750,1817,67,3.8285714285714287
Devala,Tamarind,2015,1450,1517,67,4.620689655172414
Beed,Maize,2016,1454,1521,67,4.607977991746905
Ahmedpur,Safflower,2016,2384,2451,67,2.8104026845637584
Pune,Jaggery,2015,2325,2392,67,2.881720430107527
Devala,Maize,2016,1383,1450,67,4.844540853217643
Indapur (Nimgaon Ketki),Bajri,2016,1534,1601,67,4.367666232073011
Beed,Soybean,2015,3303,3370,67,2.0284589766878596
Parli-Vaijnath,Gram,2016,5012,5079,67,1.3367916999201916
Parli-Vaijnath,Gram,2016,4171,4238,67,1.606329417405898
Khultabad,Maize,2014,900,967,67,7.444444444444445
Solapur,Papai,2016,425,492,67,15.764705882352942
Dhule,Cowpea,2015,3566,3633,67,1.878855860908581
Bhokar,Soybean,2015,3188,3255,67,2.1016311166875785
Indapur (Nimgaon Ketki),Maize,2016,1631,1698,67,4.1079092581238505
Khed (Shel Pimpalgaon),Flower,2016,783,850,67,8.55683269476373
Shirur,Tamarind,2015,1617,1683,66,4.081632653061225
Jalgaon Jamod,Pigeon Pea (Tur),2014,3367,3433,66,1.9602019602019602
Jalgaon Jamod,Wheat(Husked),2016,1467,1533,66,4.4989775051124745
Basmat,Soybean,2015,3220,3286,66,2.049689440993789
Gangapur,Maize,2015,1129,1195,66,5.845881310894597
Devala,Black Gram,2015,5418,5484,66,1.2181616832779623
Barshi-Vairag,Ground Nut Pods (Dry),2016,5459,5525,66,1.2090126396775966
Pune-Pimpri,Beet Root,2016,1856,1922,66,3.5560344827586206
Gevrai,Soybean,2015,3119,3185,66,2.1160628406540556
Rajura,Gram,2016,4032,4098,66,1.6369047619047619
Latur-Murud,Sorgum(Jawar),2016,1506,1572,66,4.382470119521912
Pavani,Paddy-Unhusked,2015,1737,1803,66,3.7996545768566494
Tumsar,Other Cereals,2016,4053,4119,66,1.6284233900814211
Telhara,Cotton,2015,3917,3983,66,1.6849629818738832
Lohara,Sorgum(Jawar),2015,1962,2028,66,3.363914373088685
Partur,Bajri,2015,1151,1217,66,5.734144222415291
Sillod,Maize,2016,1357,1423,66,4.8636698599852615
Jalgaon,Cluster Bean,2015,4306,4372,66,1.5327450069670228
Jalgaon,Wheat(Husked),2016,1784,1850,66,3.6995515695067263
Yeola,Maize,2016,1359,1425,66,4.856512141280353
Yeotmal,Ground Nut Pods (Dry),2015,5347,5413,66,1.2343370114082663
Shrirampur-Belapur,Sorgum(Jawar),2016,1567,1633,66,4.211869814932993
Ahmednagar,Maize,2015,1455,1521,66,4.536082474226804
Pavani,PADDY-UNHUSKED,2016,1807,1873,66,3.652462645268401
Chimur,Paddy-Unhusked,2016,1859,1925,66,3.5502958579881656
Soygaon,Maize,2015,1067,1133,66,6.185567010309279
Hadgaon,Pigeon Pea (Tur),2014,4467,4533,66,1.4775016789791806
Balapur,Soybean,2015,2967,3033,66,2.224469160768453
Kamthi,Potato,2015,1178,1244,66,5.602716468590832
Raver,Maize,2016,1630,1696,66,4.049079754601227
Paithan,Sorgum(Jawar),2016,1625,1691,66,4.061538461538461
Umarga,Safflower,2016,2447,2513,66,2.6971802206783817
Aheri,Green Gram,2016,5967,6033,66,1.1060834590246356
Dhadgaon,Sorgum(Jawar),2016,1450,1516,66,4.551724137931035
Chandrapur,Green Gram,2015,6392,6458,66,1.032540675844806
Gondpimpri,Paddy-Unhusked,2016,2168,2234,66,3.044280442804428
Sakri,Bajri,2015,1177,1243,66,5.607476635514018
Umared,Lang,2014,1592,1658,66,4.1457286432160805
Rahata,Soybean,2015,3515,3581,66,1.8776671408250356
Khed (Shel Pimpalgaon),Bottle Gourd,2014,653,719,66,10.10719754977029
Ausa,Soybean,2015,3292,3358,66,2.0048602673147022
Pune-Pimpri,Pavtta,2014,2367,2433,66,2.788339670468948
Kannad,Black Gram,2016,6167,6233,66,1.0702124209502188
Dound,Pigeon Pea (Tur),2016,6767,6833,66,0.9753214127382888
Dhadgaon,Maize,2016,1442,1508,66,4.5769764216366156
Pandharpur,Sorgum(Jawar),2016,1958,2024,66,3.3707865168539324
Shegaon,Green Gram,2016,6102,6168,66,1.0816125860373649
Shevgaon,Bajri,2015,1272,1338,66,5.188679245283019
Jawala-Bajar,Soybean,2014,3174,3240,66,2.0793950850661624
Arjuni Morgaon,Paddy-Unhusked,2014,1588,1654,66,4.156171284634761
Mangalwedha,Maize,2014,1100,1166,66,6.0
Loha,Soybean,2014,3225,3291,66,2.046511627906977
Newasa,Wheat(Husked),2014,1456,1522,66,4.532967032967033
Indapur (Nimgaon Ketki),Maize,2016,1380,1446,66,4.782608695652174
Kurdwadi,Wheat(Husked),2015,1674,1740,66,3.942652329749104
Umared,Linseed,2015,4343,4409,66,1.5196868524061709
Udgir,Soybean,2014,3173,3239,66,2.0800504254648597
Gevrai,Maize,2015,1336,1402,66,4.940119760479042
Achalpur,Sorgum(Jawar),2016,1383,1449,66,4.772234273318872
Armori,Paddy-Unhusked,2015,1425,1491,66,4.631578947368421
Bhokardan-Pimpalgaon Renu,Green Gram,2016,5092,5158,66,1.296150824823252
Savner,Cotton,2016,4422,4488,66,1.492537313432836
Jalkot,Gram,2014,3117,3183,66,2.1174205967276225
Manchar,Kanda Pat,2016,466,532,66,14.163090128755364
Devala,Wheat(Husked),2016,1452,1518,66,4.545454545454546
Savner,Maize,2014,998,1064,66,6.613226452905812
Dudhani,Maize,2015,1088,1154,66,6.0661764705882355
Jalgaon Jamod,Sorgum(Jawar),2016,1167,1233,66,5.655526992287918
Gevrai,Maize,2015,1120,1186,66,5.892857142857143
Bhokardan-Pimpalgaon Renu,Gram,2016,4667,4733,66,1.414184701092779
Jawala-Bajar,Sorgum(Jawar),2016,1585,1650,65,4.100946372239748
Sinner,Maize,2015,1476,1541,65,4.403794037940379
Vaijapur,Soybean,2015,3770,3835,65,1.7241379310344827
Solapur,Bajri,2014,1359,1424,65,4.7829286239882265
Lakhandur,Linseed,2016,4600,4665,65,1.4130434782608696
Shrirampur,Soybean,2015,3087,3152,65,2.105604146420473
Barshi,Paddy-Unhusked,2016,1742,1807,65,3.7313432835820897
Kolhapur,Banana,2015,536,601,65,12.126865671641792
Pune,Maize,2015,1438,1503,65,4.520166898470097
Goregaon,Paddy-Unhusked,2015,1462,1527,65,4.4459644322845415
Rajura,Cotton,2015,3938,4003,65,1.6505840528186897
Nampur,Wheat(Husked),2016,1512,1577,65,4.298941798941799
Parli-Vaijnath,Pigeon Pea (Tur),2016,5810,5875,65,1.1187607573149743
Akot,Sorgum(Jawar),2016,1463,1528,65,4.442925495557074
Lasur Station,Soybean,2015,3134,3199,65,2.0740268028079134
Bhusaval,Sorgum(Jawar),2014,1036,1101,65,6.274131274131274
Bhiwapur,Wheat(Husked),2015,1300,1365,65,5.0
Dudhani,Maize,2015,1036,1101,65,6.274131274131274
Solapur,Bajri,2015,1586,1651,65,4.098360655737705
Deglur,Soybean,2015,3660,3725,65,1.7759562841530054
Telhara,Wheat(Husked),2015,1410,1475,65,4.609929078014185
Zarijamini,Soybean,2016,3221,3286,65,2.018006830176964
Kalmeshwar,Wheat(Husked),2016,1571,1636,65,4.137492043284532
Malegaon,Soybean,2015,3192,3257,65,2.036340852130326
Kinwat,Cotton,2015,3778,3843,65,1.7204870301746955
Lonar,Maize,2015,1043,1108,65,6.2320230105465
Rahata,Soybean,2015,3184,3249,65,2.041457286432161
Barshi,Cucumber,2016,85,150,65,76.47058823529412
Manwat,Cotton,2015,4107,4172,65,1.5826637448259069
Pune,Jaggery,2016,3807,3872,65,1.7073811400052534
Digras,Wheat(Husked),2016,1596,1661,65,4.072681704260652
Arvi,Cotton,2016,4844,4909,65,1.3418662262592898
Savner,Cotton,2015,3776,3841,65,1.7213983050847457
Rahuri-Vambori,Soybean,2015,3138,3203,65,2.07138304652645
Parola,Sorgum(Jawar),2016,1418,1483,65,4.58392101551481
Darwha,Soybean,2014,3098,3163,65,2.0981278244028405
Umarga,Soybean,2016,3261,3326,65,1.9932536031892059
Shevgaon-Bodhegaon,Wheat(Husked),2015,1555,1620,65,4.180064308681672
Rahuri,Sorgum(Jawar),2014,1590,1655,65,4.088050314465409
Navapur,Maize,2016,1288,1353,65,5.046583850931677
Tuljapur,Maize,2015,1186,1251,65,5.480607082630692
Jalna,Mustard,2015,3321,3386,65,1.9572417946401686
Pachora,Sorgum(Jawar),2015,1335,1400,65,4.868913857677903
Nanded,Sorgum(Jawar),2016,1310,1375,65,4.961832061068702
Rahata,Maize,2015,1061,1126,65,6.126295947219604
Jalgaon,Sorgum(Jawar),2015,1251,1316,65,5.1958433253397285
Dound,Maize,2015,1366,1431,65,4.758418740849195
Satana,Maize,2016,1422,1487,65,4.571026722925457
Barshi-Vairag,Maize,2015,1259,1324,65,5.162827640984909
Wardha,Sorgum(Jawar),2015,1342,1407,65,4.843517138599106
Sonpeth,Bajri,2016,1463,1528,65,4.442925495557074
Vani,Pigeon Pea (Tur),2016,6335,6400,65,1.0260457774269929
Pune-Pimpri,Wal Papdi,2014,3114,3179,65,2.0873474630700066
Nandgaon,Maize,2016,1388,1453,65,4.68299711815562
Bhusaval,Sorgum(Jawar),2015,1299,1364,65,5.003849114703618
Paithan,Soybean,2015,3488,3553,65,1.863532110091743
Ahmedpur,Maize,2016,1451,1516,65,4.479669193659545
Basmat,Gram,2016,4113,4178,65,1.5803549720398735
Akot,Cotton,2016,5405,5470,65,1.2025901942645698
Shegaon,Black Gram,2016,8393,8458,65,0.7744549028952699
Islampur,Ladies Finger,2016,150,215,65,43.333333333333336
Aamgaon,Paddy-Unhusked,2016,1526,1591,65,4.259501965923985
Vaijapur,Sorgum(Jawar),2016,1718,1783,65,3.783469150174622
Vaijapur,Pigeon Pea (Tur),2016,8462,8527,65,0.7681399196407469
Karmala,Maize,2015,1310,1375,65,4.961832061068702
Devala,Pigeon Pea (Tur),2015,5727,5791,64,1.1175135323904313
Ashti (Jalna),Bajri,2015,1343,1407,64,4.7654504839910645
Bhusaval,Sorgum(Jawar),2015,1198,1262,64,5.342237061769616
Tasgaon,SOYBEAN,2016,2788,2852,64,2.2955523672883786
Sillod,Bajri,2015,1253,1317,64,5.107741420590583
Nanded,Soybean,2014,3246,3310,64,1.9716574245224892
Sonpeth,Safflower,2016,2544,2608,64,2.5157232704402515
Sangali,Maize,2015,1500,1564,64,4.266666666666667
Dound,Maize,2016,1506,1570,64,4.249667994687915
Lonand,Maize,2015,1420,1484,64,4.507042253521127
Morshi,Wheat(Husked),2015,1450,1514,64,4.413793103448276
Jalgaon,Sorgum(Jawar),2016,1662,1726,64,3.8507821901323704
Khamgaon,Maize,2015,1061,1125,64,6.032045240339302
Ashti (Jalna),Soybean,2016,3329,3393,64,1.922499249023731
Varora,Wheat(Husked),2015,1313,1377,64,4.874333587204874
Gondpimpri,Paddy-Unhusked,2016,2280,2344,64,2.807017543859649
Chopda,Sorgum(Jawar),2015,1290,1354,64,4.961240310077519
Akot,Sorgum(Jawar),2016,1337,1401,64,4.786836200448766
Mohol,Maize,2015,1552,1616,64,4.123711340206185
Jintur-Bori,Soybean,2016,3699,3763,64,1.7301973506353068
Pachora,Gram,2016,5931,5995,64,1.0790760411397742
Katol,MAIZE,2016,1179,1243,64,5.4283290924512295
Rahuri-Vambori,Maize,2016,1340,1404,64,4.776119402985074
Parbhani,Cotton,2014,3983,4047,64,1.6068290233492342
Savner,Wheat(Husked),2015,1340,1404,64,4.776119402985074
Kannad,Maize,2015,895,959,64,7.150837988826815
Baramati,Maize,2015,1311,1375,64,4.881769641495042
Parbhani,Wheat(Husked),2015,1479,1543,64,4.3272481406355645
Barshi,Jaggery,2015,2221,2285,64,2.881584871679424
Wardha,Wheat(Husked),2015,1465,1529,64,4.368600682593857
Umari,Soybean,2016,3679,3743,64,1.7396031530307148
Palghar(Bevur),Onion,2015,1517,1581,64,4.218852999340804
Amalner,Wheat(Husked),2015,1440,1504,64,4.444444444444445
Jalgaon,Maize,2014,1014,1078,64,6.31163708086785
Devala,Sorgum(Jawar),2016,1785,1849,64,3.585434173669468
Barshi-Vairag,Soybean,2014,3280,3344,64,1.951219512195122
Sangali,Maize,2016,1491,1555,64,4.292421193829645
Bhiwapur,Green Chilli,2015,2106,2170,64,3.038936372269706
Telhara,Sorgum(Jawar),2016,1207,1271,64,5.302402651201326
Pune-Pimpri,Beet Root,2015,1627,1691,64,3.933620159803319
Sinner,Pigeon Pea (Tur),2015,3303,3367,64,1.937632455343627
Murum,Pigeon Pea (Tur),2014,4800,4864,64,1.3333333333333333
Dhule,Maize,2015,1399,1463,64,4.5746962115797
Palghar(Bevur),WHEAT(HUSKED),2016,2283,2347,64,2.803328953131844
Vaijapur,Sorgum(Jawar),2015,1422,1486,64,4.50070323488045
Ahmedpur,Soybean,2015,3385,3449,64,1.8906942392909896
Vasai,Paddy-Unhusked,2016,1468,1532,64,4.359673024523161
Indapur,Maize,2016,1384,1448,64,4.624277456647399
Shrirampur,Maize,2016,1286,1350,64,4.976671850699844
Akhadabalapur,Sorgum(Jawar),2016,1450,1513,63,4.344827586206897
Gondpimpri,Paddy-Unhusked,2016,1848,1911,63,3.409090909090909
Mangalwedha,WHEAT(HUSKED),2016,2231,2294,63,2.823845809054236
Beed,Sesamum,2014,11250,11313,63,0.56
Jalgaon,Bajri,2016,1737,1800,63,3.626943005181347
Kalamb (Os),Safflower,2014,2335,2398,63,2.6980728051391862
Rahata,Ghevda,2014,2875,2938,63,2.1913043478260867
Indapur (Nimgaon Ketki),Maize,2016,1458,1521,63,4.320987654320987
Shirur,Wheat(Husked),2014,1415,1478,63,4.4522968197879855
Kada,Maize,2015,1388,1451,63,4.538904899135447
Wardha,Wheat(Husked),2015,1460,1523,63,4.315068493150685
Rahata,Wheat(Husked),2016,1646,1709,63,3.827460510328068
Shegaon,Wheat(Husked),2016,1481,1544,63,4.25388251181634
Lonar,Wheat(Husked),2014,1391,1454,63,4.529115744069015
Bhokardan,Bajri,2016,1412,1475,63,4.461756373937677
Ramtek,Gram,2015,4050,4113,63,1.5555555555555556
Achalpur,Sorgum(Jawar),2016,1453,1516,63,4.335856847900895
Aamgaon,PADDY-UNHUSKED,2016,1388,1451,63,4.538904899135447
Basmat,Green Gram,2015,8208,8271,63,0.7675438596491229
Bhokardan,Bajri,2016,1400,1463,63,4.5
Ashti (Jalna),Bajri,2016,1356,1419,63,4.646017699115045
Shrirampur-Belapur,Wheat(Husked),2016,1581,1644,63,3.984819734345351
Mukhed,Soybean,2015,3599,3662,63,1.7504862461794943
Gangapur,Maize,2016,1490,1553,63,4.228187919463087
Newasa,Bajri,2016,1337,1400,63,4.712041884816754
Parbhani,Soybean,2015,3133,3196,63,2.010852218321098
Rahata,Carrot,2015,1650,1713,63,3.8181818181818183
Amarawati,Cotton,2015,4150,4213,63,1.5180722891566265
Telhara,Black Gram,2015,4609,4672,63,1.3668908656975483
Purna,Wheat(Husked),2016,1776,1839,63,3.5472972972972974
Bhokardan-Pimpalgaon Renu,Wheat(Husked),2016,1500,1563,63,4.2
Bhokar,SESAMUM,2016,6025,6088,63,1.045643153526971
Umari,Sorgum(Jawar),2016,1301,1364,63,4.842428900845503
Digras,Wheat(Husked),2015,1543,1606,63,4.082955281918341
Khed (Shel Pimpalgaon),Brinjal,2015,1391,1454,63,4.529115744069015
Sengaon,Gram,2015,4010,4073,63,1.571072319201995
Devala,Sorgum(Jawar),2014,2698,2761,63,2.335063009636768
Barshi,Cabbage,2015,50,113,63,126.0
Bhiwapur,Paddy-Unhusked,2015,1875,1938,63,3.36
Lonand,Gram,2016,4100,4163,63,1.5365853658536586
Jalgaon,Cotton,2015,3975,4038,63,1.5849056603773586
Shirpur,Soybean,2015,3023,3086,63,2.0840224942110486
Kille Dharur,Maize,2016,1520,1583,63,4.144736842105263
Partur,Bajri,2016,1275,1338,63,4.9411764705882355
Nilanga,Sorgum(Jawar),2014,1078,1141,63,5.8441558441558445
Gevrai,Matki,2014,6434,6497,63,0.979173142679515
Lasur Station,Maize,2016,1526,1589,63,4.128440366972477
Yeola,Maize,2015,1259,1322,63,5.003971405877681
Sillod,Wheat(Husked),2015,1491,1554,63,4.225352112676056
Kannad,Sorgum(Jawar),2015,1275,1338,63,4.9411764705882355
Umared,Lang,2015,1720,1783,63,3.6627906976744184
Lonar,Neem-Seed,2016,1081,1144,63,5.827937095282146
Indapur,Ground Nut Pods (Dry),2016,4725,4788,63,1.3333333333333333
Kada (Ashti),Bajri,2015,1225,1288,63,5.142857142857143
Rahuri,Wheat(Husked),2015,1400,1463,63,4.5
Lonand,Maize,2014,1400,1463,63,4.5
Dondaicha-Sindkheda,Pigeon Pea (Tur),2015,8188,8251,63,0.769418661455789
Parli-Vaijnath,Bajri,2015,1225,1288,63,5.142857142857143
Vani,Soybean,2016,2888,2950,62,2.146814404432133
Umari,Sorgum(Jawar),2016,1267,1329,62,4.89344909234412
Newasa,Gram,2015,3146,3208,62,1.9707565162110616
Pune,Jaggery,2015,2568,2630,62,2.4143302180685358
Bhokardan,Soybean,2015,3519,3581,62,1.7618641659562375
Rahuri-Vambori,Sunflower,2015,2752,2814,62,2.252906976744186
Jalgaon,Bajri,2015,1275,1337,62,4.862745098039215
Barshi,Cucumber,2014,84,146,62,73.80952380952381
Parshiwani,COTTON,2016,4824,4886,62,1.285240464344942
Pandharpur,Wheat(Husked),2016,1738,1800,62,3.567318757192175
Indapur,Maize,2016,1423,1485,62,4.356992269852425
Malkapur,Sorgum(Jawar),2016,1517,1579,62,4.0870138431114045
Aamgaon,Paddy-Unhusked,2016,1602,1664,62,3.8701622971285894
Akot,Sorgum(Jawar),2016,1449,1511,62,4.278812974465148
Kalamb (Os),Maize,2016,1400,1462,62,4.428571428571429
Jawala-Bajar,Soybean,2015,3201,3263,62,1.936894720399875
Nandurbar,Black Gram,2015,5585,5647,62,1.1101163831692031
Akhadabalapur,Sorgum(Jawar),2015,1588,1650,62,3.9042821158690177
Washim,Green Gram,2016,4346,4408,62,1.4265991716520938
Sinner,Wheat(Husked),2015,1481,1543,62,4.186360567184335
Manchar,Kanda Pat,2014,496,558,62,12.5
Islampur,Tomato,2016,54,116,62,114.81481481481481
Ahmedpur,Safflower,2015,2350,2412,62,2.6382978723404253
Kille Dharur,COTTON,2016,4946,5008,62,1.253538212697129
Sangli-Miraj,Maize,2016,1489,1551,62,4.163868368032237
Bhokardan-Pimpalgaon Renu,Bajri,2016,1444,1506,62,4.293628808864266
Rahuri,Sorgum(Jawar),2014,1488,1550,62,4.166666666666667
Shegaon,Sunflower,2014,2869,2931,62,2.1610317183687697
Savner,Maize,2016,1223,1285,62,5.069501226492232
Barshi,Paddy-Unhusked,2015,1469,1531,62,4.220558202859088
Ahmedpur,Wheat(Husked),2015,1196,1258,62,5.183946488294314
Kalamb (Os),Safflower,2015,2448,2510,62,2.5326797385620914
Digras,Sorgum(Jawar),2016,1545,1607,62,4.0129449838187705
Lasalgaon-Vinchur,Sorgum(Jawar),2016,1630,1692,62,3.803680981595092
Yeotmal,Wheat(Husked),2014,1450,1512,62,4.275862068965517
Sangrampur,Sorgum(Jawar),2014,988,1050,62,6.275303643724697
Umared,Green Gram,2015,5862,5924,62,1.0576595018764927
Kurdwadi,Green Gram,2016,3883,3945,62,1.5967035797064126
Kurdwadi,Maize,2016,1383,1445,62,4.483007953723789
Tumsar,Lentil,2016,4415,4477,62,1.404303510758777
Dhadgaon,Sorgum(Jawar),2016,1223,1285,62,5.069501226492232
Khed (Shel Pimpalgaon),Cucumber,2015,454,516,62,13.656387665198238
Nampur,Maize,2016,1326,1388,62,4.675716440422323
Jalgaon-Masawat,SORGUM(JAWAR),2016,1107,1169,62,5.600722673893405
Tasgaon,Maize,2016,1328,1390,62,4.668674698795181
Mandhal,Wheat(Husked),2015,1428,1490,62,4.341736694677871
Lasur Station,Mustard,2015,3494,3556,62,1.7744705208929594
Lasur Station,Mustard,2015,3765,3827,62,1.6467463479415672
Shirur,Wheat(Husked),2015,1391,1453,62,4.457225017972681
Katol,Maize,2015,1063,1125,62,5.832549388523048
Gondpimpri,Paddy-Unhusked,2016,2184,2246,62,2.838827838827839
Parli-Vaijnath,Sorgum(Jawar),2016,1539,1601,62,4.028589993502274
Rahata,Lemon,2015,3438,3500,62,1.8033740546829553
Kille Dharur,MAIZE,2016,1388,1450,62,4.46685878962536
Tuljapur,Pigeon Pea (Tur),2014,4382,4444,62,1.4148790506617983
Shahada,Maize,2016,1348,1410,62,4.599406528189911
Junnar (Narayangaon),Tomato,2016,138,200,62,44.927536231884055
Basmat,Cotton,2015,3888,3950,62,1.5946502057613168
Jintur,Wheat(Husked),2016,1730,1792,62,3.5838150289017343
Navapur,Maize,2016,1315,1377,62,4.714828897338403
Hingoli,Cotton,2015,4707,4769,62,1.3171871680475886
Gangapur,Cotton,2015,3883,3945,62,1.5967035797064126
Parli-Vaijnath,Bajri,2014,1391,1453,62,4.457225017972681
Chandrapur,Pigeon Pea (Tur),2016,5748,5810,62,1.0786360473208072
Dhamangaon-Rly,Cotton,2015,3919,3981,62,1.582036233733095
Devala,Wheat(Husked),2015,1465,1527,62,4.2320819112627985
Ghoti,Bitter Gourd,2016,1588,1650,62,3.9042821158690177
Chandur Rly.,Soybean,2015,3082,3144,62,2.011680726800779
Gangapur,Maize,2015,1350,1412,62,4.592592592592593
Gondpimpri,Paddy-Unhusked,2016,1909,1971,62,3.247773703509691
Kolhapur,Banana,2015,813,875,62,7.626076260762607
Jamner,Cotton,2015,4038,4100,62,1.5354135710747896
Morshi,Wheat(Husked),2015,1538,1600,62,4.031209362808843
Pune-Pimpri,Jaggery,2016,2576,2638,62,2.406832298136646
Jalgaon,Maize,2015,1121,1183,62,5.530776092774309
Manmad,Maize,2016,1626,1688,62,3.8130381303813037
Tasgaon,Sorgum(Jawar),2016,1713,1775,62,3.619381202568593
Bhokardan-Pimpalgaon Renu,Wheat(Husked),2015,1453,1515,62,4.267033723331039
Shirpur,Sesamum,2015,7507,7569,62,0.8258958305581457
Nandurbar,Soybean,2015,3112,3174,62,1.9922879177377892
Newasa,Wheat(Husked),2014,1463,1525,62,4.237867395762133
Parbhani,Wheat(Husked),2014,1514,1576,62,4.095112285336856
Ramtek,Wheat(Husked),2015,1438,1499,61,4.242002781641168
Satana,Maize,2016,1609,1670,61,3.7911746426351773
Shrirampur,Maize,2015,1111,1172,61,5.4905490549054905
Kada (Ashti),Maize,2015,1200,1261,61,5.083333333333333
Telhara,Sorgum(Jawar),2015,1054,1115,61,5.787476280834914
Nandurbar,Soybean,2015,3052,3113,61,1.998689384010485
Indapur (Nimgaon Ketki),Maize,2015,1461,1522,61,4.175222450376454
Bhokardan-Pimpalgaon Renu,Wheat(Husked),2015,1414,1475,61,4.314002828854314
Parli-Vaijnath,Bajri,2016,1549,1610,61,3.938024531956101
Bhokardan,Wheat(Husked),2015,1525,1586,61,4.0
Mangalwedha,Maize,2015,1278,1339,61,4.773082942097027
Rahuri,Wheat(Husked),2014,1455,1516,61,4.1924398625429555
Murum,Sorgum(Jawar),2015,2291,2352,61,2.6625927542557837
Newasa,Wheat(Husked),2015,1450,1511,61,4.206896551724138
Armori,Paddy-Unhusked,2016,1625,1686,61,3.753846153846154
Barshi-Vairag,Soybean,2016,3814,3875,61,1.599370739381227
Barshi,Cabbage,2015,44,105,61,138.63636363636363
Parola,Maize,2016,1279,1340,61,4.769351055512119
Bhusaval,Sorgum(Jawar),2015,1360,1421,61,4.485294117647059
Barshi,Paddy-Unhusked,2015,1362,1423,61,4.47870778267254
Jalgaon-Masawat,Green Gram,2016,4793,4854,61,1.2726893386188192
Bhokardan-Pimpalgaon Renu,SOYBEAN,2016,2640,2701,61,2.3106060606060606
Malkapur,Maize,2015,1239,1300,61,4.923325262308313
Barshi,Paddy-Unhusked,2015,1524,1585,61,4.002624671916011
Jalgaon,Spinach,2015,1848,1909,61,3.3008658008658007
Taloda,Black Gram,2015,2980,3041,61,2.046979865771812
Rahuri-Vambori,Maize,2015,1203,1264,61,5.070656691604323
Katol,Maize,2016,1250,1311,61,4.88
Kalamb (Os),Sunflower,2016,3458,3519,61,1.7640254482359745
Shirur,Wheat(Husked),2014,1424,1485,61,4.283707865168539
Udgir,Soybean,2014,3302,3363,61,1.8473652331920047
Bhusaval,Sorgum(Jawar),2016,1203,1264,61,5.070656691604323
Basmat,Soybean,2016,3578,3639,61,1.7048630519843488
Pandharpur,Sorgum(Jawar),2016,1733,1794,61,3.5199076745527984
Pune,Jaggery,2015,2309,2370,61,2.6418362927674317
Vaduj,Maize,2016,1439,1500,61,4.2390548992355805
Manora,Green Gram,2016,5234,5295,61,1.165456629728697
Jalkot,Sorgum(Jawar),2015,1384,1445,61,4.407514450867052
Kannad,Sorgum(Jawar),2016,1578,1639,61,3.865652724968314
Sangamner,Sorgum(Jawar),2016,1669,1730,61,3.6548831635710006
Gondpimpri,Paddy-Unhusked,2014,2039,2100,61,2.9916625796959293
Latur-Murud,Green Gram,2016,4845,4906,61,1.2590299277605779
Jalna-Badnapur,Bajri,2015,1241,1302,61,4.915390813859791
Lakhandur,Oth.Split Pulses,2016,2587,2648,61,2.3579435639737145
Kalamb (Os),Maize,2015,1095,1156,61,5.570776255707763
Jalna,Mustard,2015,3450,3511,61,1.7681159420289856
Telhara,Sorgum(Jawar),2016,1252,1313,61,4.872204472843451
Manmad,Maize,2015,1194,1255,61,5.108877721943049
Bhiwapur,Paddy-Unhusked,2015,1754,1815,61,3.4777651083238315
Loha,Sorgum(Jawar),2015,1500,1561,61,4.066666666666666
Kille Dharur,Maize,2015,1419,1480,61,4.298801973220578
Umarga,Maize,2015,1420,1481,61,4.295774647887324
Amarawati,Soybean,2015,3219,3280,61,1.8949984467225847
Ahmedpur,Maize,2015,1406,1467,61,4.338549075391181
Sonpeth,Gram,2014,2140,2200,60,2.803738317757009
Shrirampur,Bajri,2016,1653,1713,60,3.629764065335753
Kolhapur-Malkapur,Cucumber,2016,30,90,60,200.0
Murum,Bajri,2016,1662,1722,60,3.6101083032490973
Chopda,Sunflower,2015,2460,2520,60,2.4390243902439024
Shirala,Paddy-Unhusked,2014,1360,1420,60,4.411764705882353
Jalgaon,Wheat(Husked),2016,1470,1530,60,4.081632653061225
Nilanga,Sorgum(Jawar),2016,1450,1510,60,4.137931034482759
Jintur-Bori,Soybean,2016,3490,3550,60,1.7191977077363896
Achalpur,Maize,2014,1310,1370,60,4.580152671755725
Lohara,Soybean,2016,3532,3592,60,1.6987542468856172
Umarga,Sunflower,2015,3134,3194,60,1.9144862795149968
Bhokardan-Pimpalgaon Renu,Sorgum(Jawar),2016,1560,1620,60,3.8461538461538463
Murbad,Paddy-Unhusked,2015,1850,1910,60,3.2432432432432434
Malegaon,Castor Seed,2016,2870,2930,60,2.0905923344947737
Kalvan,Soybean,2015,3797,3857,60,1.5801948907031866
Murbad,Bottle Gourd,2015,2192,2252,60,2.7372262773722627
Gevrai,Maize,2015,1143,1203,60,5.2493438320209975
Bhusaval,Black Gram,2015,5000,5060,60,1.2
Soygaon,Maize,2016,1300,1360,60,4.615384615384615
Bhusaval,Sorgum(Jawar),2014,1088,1148,60,5.514705882352941
Sindi,Cotton,2015,3879,3939,60,1.5467904098994587
Ahmedpur,Soybean,2015,3414,3474,60,1.757469244288225
Phaltan,Jaggery,2016,2630,2690,60,2.2813688212927756
Ramtek,Garlic,2015,687,747,60,8.733624454148472
Khamgaon,Cotton,2015,4250,4310,60,1.411764705882353
Ramtek,Paddy-Unhusked,2016,1768,1828,60,3.3936651583710407
Chandvad,Maize,2015,1476,1536,60,4.065040650406504
Rahata,Gram,2015,3773,3833,60,1.590246488205672
Kej,Wheat(Husked),2016,2061,2121,60,2.911208151382824
Balapur,Black Gram,2015,9465,9525,60,0.6339144215530903
Bhokar,Wheat(Husked),2016,1483,1543,60,4.045853000674309
Indapur,Bajri,2016,1611,1671,60,3.7243947858473
Yeola,Maize,2016,1627,1687,60,3.6877688998156115
Goregaon,Paddy-Unhusked,2015,1350,1410,60,4.444444444444445
Bhokar,Wheat(Husked),2015,1395,1455,60,4.301075268817204
Udgir,Safflower,2016,2771,2831,60,2.165283291230603
Barshi,Lemon,2014,136,196,60,44.11764705882353
Shevgaon,Cotton,2015,4200,4260,60,1.4285714285714286
Varora,Cotton,2015,3900,3960,60,1.5384615384615385
Darwha,Cotton,2015,3940,4000,60,1.5228426395939085
Savner,Cotton,2016,4366,4426,60,1.3742556115437472
Dharmabad,Soybean,2015,3660,3720,60,1.639344262295082
Sindi,Wheat(Husked),2015,1250,1310,60,4.8
Soygaon,Cotton,2015,4070,4130,60,1.4742014742014742
Islampur,Tomato,2016,36,96,60,166.66666666666666
Umarga,Safflower,2015,2524,2584,60,2.3771790808240887
Ghoti,Bitter Gourd,2015,1280,1340,60,4.6875
Brahmpuri,Paddy-Unhusked,2015,1900,1960,60,3.1578947368421053
Nandurbar,Maize,2016,1631,1691,60,3.678724708767627
Jalna,Jaggery,2016,3483,3543,60,1.7226528854435832
Barshi,Ladies Finger,2015,100,160,60,60.0
Sailu,Bajri,2015,1490,1550,60,4.026845637583893
Kannad,Sorgum(Jawar),2016,1534,1594,60,3.911342894393742
Kalmeshwar,Cotton,2015,4239,4299,60,1.4154281670205238
Shirur,Indian Bean,2015,3340,3400,60,1.7964071856287425
Kalamb (Os),Black Gram,2016,8960,9020,60,0.6696428571428571
Barshi,Paddy-Unhusked,2016,1559,1619,60,3.8486209108402822
Khamgaon,Maize,2016,1235,1295,60,4.8582995951417
Pune,Maize,2015,1605,1665,60,3.7383177570093458
Pune-Pimpri,Beet Root,2015,740,800,60,8.108108108108109
Barshi,Green Gram,2015,6300,6360,60,0.9523809523809523
Barshi-Vairag,Maize,2015,1213,1273,60,4.9464138499587795
Navapur,Black Gram,2016,5007,5067,60,1.1983223487118035
Latur,Tamarind Seed,2016,1767,1827,60,3.395585738539898
Latur-Murud,Wheat(Husked),2016,1760,1820,60,3.409090909090909
Ambejogai,Green Gram,2015,7090,7150,60,0.846262341325811
Brahmpuri,Paddy-Unhusked,2016,1874,1934,60,3.2017075773746
Vaduj,Maize,2015,1425,1485,60,4.2105263157894735
Buldhana,Maize,2015,1118,1178,60,5.366726296958855
Shegaon,Sorgum(Jawar),2014,1003,1063,60,5.982053838484546
Barshi,Neem-Seed,2015,818,878,60,7.334963325183374
Ahmedpur,Bajri,2015,1279,1339,60,4.691164972634871
Vaduj,Maize,2015,1214,1274,60,4.942339373970346
Manmad,Maize,2016,1682,1742,60,3.56718192627824
Jalgaon,Bajri,2015,1346,1406,60,4.457652303120357
Manora,GREEN GRAM,2016,5240,5300,60,1.1450381679389312
Barshi,Squash Gourd,2015,140,200,60,42.857142857142854
Telhara,Cotton,2014,3988,4048,60,1.5045135406218655
Bhokardan,Bajri,2016,1216,1276,60,4.934210526315789
Bhokardan,Bajri,2016,1413,1473,60,4.246284501061571
Barshi,Ridge Gourd,2015,140,200,60,42.857142857142854
Barshi,Ridge Gourd,2015,140,200,60,42.857142857142854
Rahata,Small Gourd,2015,1600,1660,60,3.75
Barshi,Maize,2015,1547,1607,60,3.878474466709761
Tasgaon,Maize,2015,1310,1370,60,4.580152671755725
Khed (Shel Pimpalgaon),Walvad,2016,1080,1140,60,5.555555555555555
Mohol,Maize,2014,1109,1169,60,5.410279531109107
Shirur,Ground Nut Pods (Dry),2016,3501,3561,60,1.713796058269066
Mangalwedha,Maize,2015,1156,1216,60,5.190311418685121
Pune-Pimpri,Walvad,2014,3100,3160,60,1.935483870967742
Basmat,Soybean,2016,3500,3560,60,1.7142857142857142
Rahata,Maize,2015,1266,1326,60,4.739336492890995
Parbhani,Sorgum(Jawar),2016,1590,1650,60,3.7735849056603774
Mangalwedha,Maize,2014,1225,1285,60,4.8979591836734695
Ghoti,Cabbage,2016,1250,1310,60,4.8
Akkalkuwa,Sorgum(Jawar),2015,1350,1410,60,4.444444444444445
Varud-Rajura Bazar,Wheat(Husked),2015,1422,1482,60,4.219409282700422
Tumsar,Green Gram,2016,5176,5236,60,1.1591962905718702
Dhamangaon-Rly,Wheat(Husked),2016,1704,1763,59,3.4624413145539905
Aurad Shahajani,Sorgum(Jawar),2016,1425,1484,59,4.140350877192983
Lakhandur,Paddy-Unhusked,2015,1503,1562,59,3.925482368596141
Sangamner,Maize,2015,1355,1414,59,4.354243542435424
Murum,Soybean,2016,3740,3799,59,1.5775401069518717
Ramtek,Tomato,2015,245,304,59,24.081632653061224
Shahada,Maize,2015,1171,1230,59,5.038428693424423
Barshi,Paddy-Unhusked,2015,1441,1500,59,4.094378903539209
Gangapur,Bajri,2015,1417,1476,59,4.1637261820748055
Indapur (Nimgaon Ketki),Maize,2016,1436,1495,59,4.108635097493036
Ambejogai,Bajri,2015,1586,1645,59,3.720050441361917
Jawala-Bajar,Cotton,2015,4094,4153,59,1.441133365901319
Sangamner,Sorgum(Jawar),2015,1621,1680,59,3.6397285626156695
Manmad,Flower,2016,113,172,59,52.21238938053097
Kalamb (Os),Maize,2016,1685,1744,59,3.5014836795252227
Yeotmal,Wheat(Husked),2015,1454,1513,59,4.05777166437414
Shahada,Pigeon Pea (Tur),2015,4611,4670,59,1.2795489047928865
Manchar,Shepu,2015,184,243,59,32.06521739130435
Partur,Cotton,2014,3987,4046,59,1.4798093804865813
Bhusaval,Sorgum(Jawar),2015,1234,1293,59,4.781199351701783
Rahata,Sorgum(Jawar),2014,1381,1440,59,4.272266473569877
Amarawati,Cotton,2016,5019,5078,59,1.1755329746961547
Katol,Wheat(Husked),2016,1568,1627,59,3.7627551020408165
Arjuni Morgaon,Paddy-Unhusked,2014,1465,1524,59,4.027303754266212
Dondaicha-Sindkheda,Sorgum(Jawar),2016,1689,1748,59,3.493191237418591
Telhara,Sorgum(Jawar),2015,1134,1193,59,5.202821869488536
Newasa,Wheat(Husked),2015,1458,1517,59,4.046639231824417
Rahata,Wheat(Husked),2015,1441,1500,59,4.094378903539209
Savali,Paddy-Unhusked,2016,2332,2391,59,2.530017152658662
Ausa,Linseed,2015,4634,4693,59,1.273198100992663
Kada,Soybean,2015,3187,3246,59,1.8512707875745216
Jamner,Maize,2016,1325,1384,59,4.452830188679245
Vaijapur,Tamarind,2016,2591,2650,59,2.2771130837514475
Ambejogai,Sorgum(Jawar),2016,1764,1823,59,3.3446712018140587
Parli-Vaijnath,Sorgum(Jawar),2016,1575,1634,59,3.746031746031746
Murum,Sesamum,2014,9117,9176,59,0.6471427004497093
Tuljapur,Sorgum(Jawar),2015,1069,1128,59,5.519176800748363
Rahata,Bajri,2014,1360,1419,59,4.338235294117647
Kej,Maize,2015,1572,1631,59,3.753180661577608
Nanded,Wheat(Husked),2016,1640,1699,59,3.597560975609756
Armori,Paddy-Unhusked,2016,1832,1891,59,3.2205240174672487
Akkolkot,Bajri,2014,1370,1429,59,4.306569343065694
Chakur,Sorgum(Jawar),2016,1863,1922,59,3.166935050993022
Pusad,Sesamum,2016,5901,5960,59,0.9998305371970853
Bhokar,Soybean,2015,3249,3307,58,1.7851646660510927
Karmala,Maize,2016,1339,1397,58,4.33159073935773
Karmala,Maize,2016,1378,1436,58,4.2089985486211905
Solapur,Maize,2016,1497,1555,58,3.8744154976619907
Jalna,Black Gram,2015,5120,5178,58,1.1328125
Parbhani,Wheat(Husked),2015,1464,1522,58,3.9617486338797816
Morshi,Wheat(Husked),2016,1679,1737,58,3.4544371649791543
Ramtek,Mango,2015,203,261,58,28.571428571428573
Kolhapur,Banana,2016,542,600,58,10.70110701107011
Manmad,Maize,2016,1733,1791,58,3.346797461050202
Bhusaval,Wheat(Husked),2016,1446,1504,58,4.011065006915629
Parbhani,COTTON,2016,5073,5131,58,1.1433077074709246
Jalgaon-Masawat,Sorgum(Jawar),2016,1479,1537,58,3.9215686274509802
Jalgaon,Sorgum(Jawar),2016,1672,1730,58,3.4688995215311005
Vaijapur,Soybean,2016,3259,3317,58,1.7796870205584534
Bhokardan,Green Gram,2016,4822,4880,58,1.2028204064703443
Tuljapur,Maize,2015,1152,1210,58,5.034722222222222
Parli-Vaijnath,Sorgum(Jawar),2016,1637,1695,58,3.54306658521686
Lasalgaon-Niphad,Maize,2016,1360,1418,58,4.264705882352941
Gevrai,Maize,2014,1168,1226,58,4.965753424657534
Aamgaon,Paddy-Unhusked,2015,1367,1425,58,4.242867593269934
Umarga,Wheat(Husked),2014,1416,1474,58,4.096045197740113
Dudhani,Wheat(Husked),2016,1893,1951,58,3.0639197041732698
Amalner,Maize,2015,1257,1315,58,4.614160700079554
Khed (Shel Pimpalgaon),Farshi,2016,2201,2259,58,2.635165833711949
Raver-Sawada,MAIZE,2016,925,983,58,6.27027027027027
Lonand,Maize,2015,1330,1388,58,4.360902255639098
Barshi,Grapes,2016,202,260,58,28.712871287128714
Nampur,Pigeon Pea (Tur),2016,4976,5034,58,1.1655948553054662
Barshi,Paddy-Unhusked,2016,1583,1641,58,3.663929248262792
Murtizapur,Wheat(Husked),2015,1396,1454,58,4.154727793696275
Khed (Shel Pimpalgaon),Ladies Finger,2015,1374,1432,58,4.2212518195050945
Kurdwadi-Modnimb,WHEAT(HUSKED),2016,1315,1373,58,4.4106463878327
Ghoti,Paddy-Unhusked,2015,1749,1807,58,3.316180674671241
Chopda,WHEAT(HUSKED),2016,1743,1801,58,3.327596098680436
Chandrapur,Soybean,2015,3525,3583,58,1.6453900709219857
Mohol,Maize,2015,1253,1311,58,4.628890662410216
Satana,Maize,2015,1279,1337,58,4.534792806880375
Sailu,Cotton,2015,4132,4190,58,1.4036786060019362
Vaduj,Bajri,2015,1400,1458,58,4.142857142857143
Shirpur,Soybean,2015,3417,3475,58,1.6973953760608722
Kalamb (Os),Maize,2015,1188,1246,58,4.882154882154882
Khamgaon,Sunflower,2016,3172,3230,58,1.828499369482976
Newasa,Gram,2015,3442,3500,58,1.68506682161534
Gevrai,Safflower,2016,2154,2212,58,2.692664809656453
Arvi,COTTON,2016,4929,4987,58,1.176709271657537
Aheri,Sorgum(Jawar),2015,1342,1400,58,4.321907600596125
Newasa,Sorgum(Jawar),2016,1625,1683,58,3.5692307692307694
Sangali,Maize,2015,1334,1392,58,4.3478260869565215
Jintur,Ground Nut Pods (Dry),2015,3842,3900,58,1.5096304008328996
Nandura,Bajri,2015,1114,1172,58,5.206463195691203
Lakhandur,Gram,2016,4105,4163,58,1.412911084043849
Newasa,Bajri,2016,1392,1450,58,4.166666666666667
Mehkar,Sorgum(Jawar),2016,1624,1682,58,3.5714285714285716
Bhusaval,Sorgum(Jawar),2016,1377,1434,57,4.139433551198257
Arvi,Cotton,2015,3878,3935,57,1.4698298091799897
Arvi,Cotton,2015,4256,4313,57,1.3392857142857142
Parli-Vaijnath,Bajri,2014,1641,1698,57,3.473491773308958
Pune,Jaggery,2016,3724,3781,57,1.530612244897959
Bhusaval,Sorgum(Jawar),2016,1255,1312,57,4.54183266932271
Lakhandur,Black Gram,2016,8633,8690,57,0.6602571527858219
Chandvad,Maize,2016,1356,1413,57,4.20353982300885
Gevrai,Maize,2016,1304,1361,57,4.371165644171779
Jalna,Black Gram,2015,7765,7822,57,0.7340631036703155
Partur,Sorgum(Jawar),2016,1575,1632,57,3.619047619047619
Sillod-Bharadi,Soybean,2016,3632,3689,57,1.5693832599118942
Barshi,Cucumber,2016,43,100,57,132.5581395348837
Lonar,Neem-Seed,2015,704,761,57,8.096590909090908
Aamgaon,Paddy-Unhusked,2015,1505,1562,57,3.787375415282392
Gondpimpri,Paddy-Unhusked,2016,2423,2480,57,2.352455633512175
Mangrulpeer,Sorgum(Jawar),2016,1259,1316,57,4.527402700555997
Sailu,Green Gram,2015,7560,7617,57,0.753968253968254
Katol,Wheat(Husked),2015,1481,1538,57,3.848750844024308
Palghar(Bevur),Onion,2015,1647,1704,57,3.4608378870673953
Shrirampur-Belapur,Wheat(Husked),2016,1593,1650,57,3.5781544256120528
Mohol,MAIZE,2016,1219,1276,57,4.6759639048400325
Yeotmal,Wheat(Husked),2016,1652,1709,57,3.450363196125908
Kalvan,SOYBEAN,2016,2653,2710,57,2.148511119487373
Soygaon,Maize,2015,1330,1387,57,4.285714285714286
Nanded,Sorgum(Jawar),2016,1377,1434,57,4.139433551198257
Arjuni Morgaon,Paddy-Unhusked,2015,1551,1608,57,3.6750483558994196
Vaijapur,Safflower,2016,2814,2871,57,2.025586353944563
Murum,Bajri,2014,1468,1525,57,3.88283378746594
Shevgaon-Bodhegaon,GREEN GRAM,2016,4243,4300,57,1.343389111477728
Soygaon,Maize,2016,1308,1365,57,4.3577981651376145
Ahmednagar,Maize,2016,1431,1488,57,3.9832285115303985
Shegaon,Green Gram,2016,6789,6846,57,0.8395934600088378
Chandur Rly.,Cotton,2015,3950,4007,57,1.4430379746835442
Pune,Jaggery,2015,2543,2600,57,2.2414471097129374
Barshi,Paddy-Unhusked,2016,1732,1789,57,3.2909930715935336
Purna,Wheat(Husked),2016,1571,1628,57,3.6282622533418203
Umarga,Maize,2014,1142,1199,57,4.991243432574431
Katol,SORGUM(JAWAR),2016,1194,1251,57,4.773869346733668
Sakri,Sorgum(Jawar),2015,1094,1151,57,5.210237659963437
Lonand,Maize,2016,1431,1488,57,3.9832285115303985
Ambejogai,Black Gram,2014,4859,4916,57,1.1730808808396789
Sailu,Wheat(Husked),2014,1512,1569,57,3.7698412698412698
Kurdwadi,Maize,2016,1468,1525,57,3.88283378746594
Basmat,Soybean,2015,3433,3490,57,1.6603553743081854
Parli-Vaijnath,Bajri,2016,1182,1239,57,4.822335025380711
Manmad,Wheat(Husked),2015,1493,1550,57,3.8178164768921636
Ahmedpur,Wheat(Husked),2016,1395,1452,57,4.086021505376344
Bhandara,SOYBEAN,2016,2711,2768,57,2.1025451862781264
Solapur,Bajri,2015,1472,1529,57,3.8722826086956523
Bhokardan,Bajri,2016,1433,1490,57,3.977669225401256
Kille Dharur,Cotton,2015,4158,4215,57,1.3708513708513708
Indapur (Nimgaon Ketki),Maize,2015,1472,1529,57,3.8722826086956523
Kalvan,Tamarind,2015,1625,1681,56,3.4461538461538463
Sinner,Soybean,2015,3453,3509,56,1.6217781639154358
Rahata,Ginger (Fresh),2014,6333,6389,56,0.8842570661613769
Rahuri-Vambori,Maize,2015,1105,1161,56,5.067873303167421
Latur,Sorgum(Jawar),2014,1183,1239,56,4.733727810650888
Sinner,Maize,2016,1381,1437,56,4.055032585083273
Rahata,Beet Root,2015,1222,1278,56,4.582651391162029
Vaijapur,Maize,2015,1664,1720,56,3.3653846153846154
Barshi,Shevga,2016,24,80,56,233.33333333333334
Chimur,Paddy-Unhusked,2015,1893,1949,56,2.958267300581088
Bhokardan-Pimpalgaon Renu,Maize,2016,1600,1656,56,3.5
Ahmedpur,Wheat(Husked),2016,1403,1459,56,3.991446899501069
Kolhapur,Banana,2015,572,628,56,9.79020979020979
Indapur-Bhigwan,Rice(Paddy-Hus),2016,1550,1606,56,3.6129032258064515
Chopda,Wheat(Husked),2016,1679,1735,56,3.3353186420488385
Dhadgaon,Maize,2016,1267,1323,56,4.419889502762431
Ausa,Safflower,2014,2341,2397,56,2.392140111063648
Satana,Maize,2014,1199,1255,56,4.670558798999166
Newasa,Wheat(Husked),2015,1463,1519,56,3.827751196172249
Partur,Soybean,2016,3800,3856,56,1.4736842105263157
Manchar,Kanda Pat,2015,480,536,56,11.666666666666666
Purna,Soybean,2015,3455,3511,56,1.6208393632416787
Karmala,Maize,2016,1582,1638,56,3.5398230088495577
Shirur,Wheat(Husked),2015,1394,1450,56,4.017216642754663
Gondiya,Paddy-Unhusked,2014,1403,1459,56,3.991446899501069
Barshi,Maize,2014,1126,1182,56,4.9733570159857905
Dondaicha-Sindkheda,Bajri,2016,1321,1377,56,4.239212717638153
Ahmednagar,Maize,2015,1345,1401,56,4.163568773234201
Savali,Paddy-Unhusked,2016,2399,2455,56,2.334305960817007
Arjuni Morgaon,Paddy-Unhusked,2015,1620,1676,56,3.45679012345679
Parbhani,Wheat(Husked),2014,1452,1508,56,3.8567493112947657
Murum,Soybean,2015,3687,3743,56,1.518850013561161
Tumsar,Other Cereals,2016,2718,2774,56,2.060338484179544
Murum,Soybean,2015,3479,3535,56,1.6096579476861168
Bhokardan-Pimpalgaon Renu,Wheat(Husked),2015,1407,1463,56,3.9800995024875623
Nanded,Wheat(Husked),2014,1495,1551,56,3.745819397993311
Bhokardan-Pimpalgaon Renu,Sorgum(Jawar),2015,1225,1281,56,4.571428571428571
Washim-Ansing,Sorgum(Jawar),2016,1271,1327,56,4.405979543666405
Wardha,Wheat(Husked),2016,1720,1776,56,3.255813953488372
Dudhani,Maize,2015,1478,1534,56,3.7889039242219216
Savner,Sorgum(Jawar),2015,1144,1200,56,4.895104895104895
Mangalwedha,Maize,2015,1539,1595,56,3.6387264457439894
Tumsar,Castor Seed,2016,3067,3123,56,1.8258884903814803
Lasalgaon,Ground Nut Pods (Dry),2015,6388,6444,56,0.8766437069505323
Nandura,Cotton,2014,3994,4050,56,1.4021031547320981
Telhara,Maize,2016,1267,1323,56,4.419889502762431
Kille Dharur,Maize,2016,1489,1545,56,3.760913364674278
Jamner,Maize,2015,1325,1381,56,4.226415094339623
Bhiwapur,Wheat(Husked),2016,1513,1569,56,3.701255783212161
Udgir,Soybean,2016,3380,3436,56,1.6568047337278107
Umarga,Sorgum(Jawar),2014,1063,1119,56,5.268109125117592
Umarga,Soybean,2015,3112,3167,55,1.7673521850899743
Bhokardan-Pimpalgaon Renu,Sorgum(Jawar),2015,1133,1188,55,4.854368932038835
Shirur,Wheat(Husked),2015,1448,1503,55,3.798342541436464
Vaijapur,Tamarind,2016,2443,2498,55,2.251330331559558
Bhokardan,Sorgum(Jawar),2015,1183,1238,55,4.649196956889265
Dound,Maize,2015,1282,1337,55,4.290171606864274
Rahuri,Wheat(Husked),2014,1450,1505,55,3.793103448275862
Jalgaon,Bajri,2016,1705,1760,55,3.225806451612903
Lakhandur,Rice(Paddy-Hus),2015,1494,1549,55,3.681392235609103
Bhusaval,Sorgum(Jawar),2016,1240,1295,55,4.435483870967742
Shirur,Sorgum(Jawar),2014,1569,1624,55,3.5054174633524537
Bhokardan,Gram,2015,3056,3111,55,1.799738219895288
Gangakhed,SORGUM(JAWAR),2016,1625,1680,55,3.3846153846153846
Bhokardan-Pimpalgaon Renu,Bajri,2016,1460,1515,55,3.767123287671233
Dhule,Soybean,2016,3471,3526,55,1.5845577643330453
Shevgaon-Bodhegaon,Wheat(Husked),2015,1524,1579,55,3.608923884514436
Barshi,Coriander (Dry),2014,9978,10033,55,0.5512126678693124
Ahmedpur,Wheat(Husked),2015,1266,1321,55,4.344391785150079
Amarawati,MAIZE,2016,1294,1349,55,4.250386398763524
Lasalgaon,Rice(Paddy-Hus),2016,1646,1701,55,3.341433778857837
Parli-Vaijnath,Bajri,2014,1557,1612,55,3.5324341682723186
Telhara,Sorgum(Jawar),2015,1087,1142,55,5.059797608095677
Jintur,Wheat(Husked),2016,1683,1738,55,3.2679738562091503
Bhandara,Pigeon Pea (Tur),2016,6756,6811,55,0.8140911782119598
Navapur,Wheat(Husked),2015,1439,1494,55,3.822098679638638
Murum,Wheat(Unhusked),2015,2676,2731,55,2.0553064275037367
Chandur Rly.,Green Gram,2016,4437,4492,55,1.2395762902862295
Ashti (Jalna),Gram,2016,3975,4030,55,1.3836477987421383
Umarga,Wheat(Husked),2016,1776,1831,55,3.0968468468468466
Udgir,Soybean,2015,3477,3532,55,1.5818234109864826
Kada,Soybean,2014,3118,3173,55,1.763951250801796
Lakhandur,Gram,2015,4500,4555,55,1.2222222222222223
Arvi,Cotton,2016,4518,4573,55,1.217352810978309
Nilanga,Sunflower,2015,3462,3517,55,1.588677065280185
Shrirampur,Soybean,2015,3370,3425,55,1.632047477744807
Parola,Sorgum(Jawar),2016,1479,1534,55,3.7187288708586883
Umared,Coriander (Dry),2015,9130,9185,55,0.6024096385542169
Bhokardan,Wheat(Husked),2015,1489,1544,55,3.6937541974479515
Savner,Wheat(Husked),2016,1604,1659,55,3.428927680798005
Barshi,Tomato,2015,55,110,55,100.0
Pavani,Paddy-Unhusked,2016,1787,1842,55,3.077783995523223
Kannad,Sorgum(Jawar),2016,1685,1740,55,3.264094955489614
Kalamb (Os),Maize,2015,1233,1288,55,4.4606650446066505
Zarijamini,Gram,2016,3748,3803,55,1.4674493062966916
Nanded,Sorgum(Jawar),2015,1131,1186,55,4.862953138815207
Devala,Maize,2016,1587,1642,55,3.465658475110271
Arjuni Morgaon,Paddy-Unhusked,2015,1512,1567,55,3.6375661375661377
Pune,Maize,2015,1531,1586,55,3.5924232527759634
Majalgaon,Gram,2015,4095,4150,55,1.343101343101343
Ramtek,Rice(Paddy-Hus),2015,1310,1365,55,4.198473282442748
Bhokardan-Pimpalgaon Renu,Wheat(Husked),2016,1546,1601,55,3.557567917205692
Barshi,Chikoo,2015,158,213,55,34.81012658227848
Taloda,Bajri,2015,1194,1249,55,4.606365159128978
Chopda,Sorgum(Jawar),2015,1271,1326,55,4.327301337529504
Dondaicha,Bajri,2014,1270,1325,55,4.330708661417323
Devani,Gram,2015,4476,4531,55,1.2287756925826632
Barshi,Kharbuj,2014,65,120,55,84.61538461538461
Achalpur,Sorgum(Jawar),2015,1515,1570,55,3.6303630363036303
Barshi,Bajri,2016,1764,1818,54,3.061224489795918
Navapur,Paddy-Unhusked,2016,1214,1268,54,4.448105436573312
Aamgaon,Paddy-Unhusked,2016,1630,1684,54,3.312883435582822
Kolhapur-Laxmipuri,Paddy-Unhusked,2016,1813,1867,54,2.978488692774407
Sengaon,Soybean,2015,3261,3315,54,1.655933762649494
Pune-Pimpri,Jaggery,2015,2516,2570,54,2.146263910969793
Sillod,Maize,2016,1322,1376,54,4.084720121028744
Barshi-Vairag,Maize,2016,1453,1507,54,3.7164487267721955
Digras,Soybean,2015,3097,3151,54,1.7436228608330642
Khamgaon,Cotton,2014,3996,4050,54,1.3513513513513513
Barshi,Capsicum,2015,150,204,54,36.0
Latur,Sorgum(Jawar),2014,1100,1154,54,4.909090909090909
Manmad,Maize,2015,1374,1428,54,3.930131004366812
Shevgaon-Bodhegaon,Bajri,2015,1158,1212,54,4.66321243523316
Barshi,Flower,2015,50,104,54,108.0
Purna,Wheat(Husked),2015,1564,1618,54,3.452685421994885
Solapur,Papai,2015,469,523,54,11.513859275053305
Yeola,Maize,2016,1374,1428,54,3.930131004366812
Shirur,Bajri,2015,1341,1395,54,4.026845637583893
Taloda,Bajri,2015,1215,1269,54,4.444444444444445
Kille Dharur,Maize,2016,1413,1467,54,3.821656050955414
Bhokardan-Pimpalgaon Renu,MAIZE,2016,1020,1074,54,5.294117647058823
Murum,SOYBEAN,2016,2791,2845,54,1.9347903977069152
Bhokardan-Pimpalgaon Renu,Maize,2016,1350,1404,54,4.0
Nandurbar,Cotton,2014,4050,4104,54,1.3333333333333333
Lakhandur,Coriander (Dry),2016,6527,6581,54,0.8273326183545273
Barshi,Lemon,2014,288,342,54,18.75
Murum,Bajri,2016,1602,1656,54,3.3707865168539324
Indapur (Nimgaon Ketki),Maize,2016,1731,1785,54,3.119584055459272
Latur-Murud,Sorgum(Jawar),2015,1550,1604,54,3.4838709677419355
Karanja,Sorgum(Jawar),2016,1555,1609,54,3.472668810289389
Sengaon,Soybean,2015,3374,3428,54,1.6004742145820985
Nanded,Sorgum(Jawar),2016,1354,1408,54,3.9881831610044314
Barshi,Ridge Gourd,2015,100,154,54,54.0
Shrirampur-Belapur,Wheat(Husked),2016,1513,1567,54,3.5690680766688696
Shrirampur,Bajri,2015,1436,1490,54,3.7604456824512535
Nandura,Bajri,2015,1100,1154,54,4.909090909090909
Bhokar,Black Gram,2014,4800,4854,54,1.125
Dharangaon,Maize,2016,1383,1437,54,3.9045553145336225
Kolhapur,Banana,2016,317,371,54,17.034700315457414
Jalgaon,Bajri,2015,1450,1504,54,3.7241379310344827
Lasalgaon-Vinchur,Maize,2015,1371,1425,54,3.938730853391685
Nanded,Soybean,2015,3644,3698,54,1.481888035126235
Mantha,Bajri,2016,1530,1584,54,3.5294117647058822
Newasa,Wheat(Husked),2015,1471,1525,54,3.6709721278042147
Savner,Cotton,2014,3906,3960,54,1.3824884792626728
Nampur,Bajri,2016,1629,1683,54,3.314917127071823
Hingoli,Sorgum(Jawar),2015,1668,1721,53,3.1774580335731413
Kalvan,Soybean,2016,3664,3717,53,1.4465065502183405
Bhokardan-Pimpalgaon Renu,Sorgum(Jawar),2015,1187,1240,53,4.465037910699242
Kalamb (Os),Bajri,2016,1566,1619,53,3.384418901660281
Bhusaval,Sorgum(Jawar),2015,1128,1181,53,4.698581560283688
Shrirampur-Belapur,Wheat(Husked),2016,1547,1600,53,3.425985778926955
Kalvan,Tamarind,2016,2633,2686,53,2.0129130269654385
Kalamb (Os),Maize,2016,1696,1749,53,3.125
Katol,Wheat(Husked),2015,1494,1547,53,3.5475234270414995
Lasur Station,Mustard,2015,3358,3411,53,1.5783204288266826
Sinner,Maize,2016,1379,1432,53,3.843364757070341
Vani,Pigeon Pea (Tur),2014,4623,4676,53,1.146441704520874
Bhokardan-Pimpalgaon Renu,BAJRI,2016,1405,1458,53,3.772241992882562
Achalpur,Sorgum(Jawar),2016,1325,1378,53,4.0
Akluj,Gram,2015,3230,3283,53,1.6408668730650156
Tuljapur,Soybean,2015,3542,3595,53,1.4963297571993224
Bhokardan,Soybean,2015,3100,3153,53,1.7096774193548387
Pandharpur,Wheat(Husked),2015,1605,1658,53,3.3021806853582554
Sangali,MAIZE,2016,1387,1440,53,3.8211968276856525
Tumsar,Other Cereals,2016,3425,3478,53,1.5474452554744527
Digras,Sorgum(Jawar),2016,1493,1546,53,3.549899531145345
Bhokardan,Wheat(Husked),2016,1588,1641,53,3.3375314861460956
Jalgaon,Cluster Bean,2015,3747,3800,53,1.4144649052575393
Gadchiroli,Paddy-Unhusked,2015,1559,1612,53,3.399615137908916
Gadchiroli,Paddy-Unhusked,2015,1628,1681,53,3.2555282555282554
Indapur,Maize,2016,1466,1519,53,3.6152796725784446
Buldhana,Maize,2015,1200,1253,53,4.416666666666667
Manmad,Maize,2016,1364,1417,53,3.8856304985337244
Pandharpur,Sorgum(Jawar),2016,1886,1939,53,2.8101802757158008
Shahada,Bajri,2015,1159,1212,53,4.57290767903365
Parshiwani,Cotton,2016,4403,4456,53,1.2037247331364977
Bhiwapur,Coriander (Dry),2016,6800,6853,53,0.7794117647058824
Yeotmal,Wheat(Husked),2015,1474,1527,53,3.5956580732700134
Kalamb (Os),Safflower,2016,2464,2517,53,2.1509740259740258
Sakri,Soybean,2015,3403,3456,53,1.5574493094328534
Tasgaon,Sorgum(Jawar),2016,1627,1680,53,3.2575291948371237
Pavani,Paddy-Unhusked,2015,1838,1891,53,2.883569096844396
Barshi-Vairag,Maize,2015,1488,1541,53,3.5618279569892475
Bhokardan,Maize,2016,1349,1401,52,3.85470719051149
Navapur,Paddy-Unhusked,2016,1207,1259,52,4.308202154101077
Bhokardan-Pimpalgaon Renu,Wheat(Husked),2015,1493,1545,52,3.48292029470864
Arvi,Cotton,2016,4490,4542,52,1.158129175946548
Bhokardan,Wheat(Husked),2015,1408,1460,52,3.6931818181818183
Phaltan,Jaggery,2016,3550,3602,52,1.4647887323943662
Pune,Jaggery,2016,3918,3970,52,1.3272077590607452
Ahmednagar,Maize,2016,1490,1542,52,3.48993288590604
Kalamb (Os),Safflower,2015,2568,2620,52,2.0249221183800623
Navapur,Paddy-Unhusked,2015,1165,1217,52,4.463519313304721
Nagpur,Maize,2016,1320,1372,52,3.9393939393939394
Shirur,Wheat(Husked),2015,1396,1448,52,3.7249283667621778
Bhokar,Soybean,2015,3379,3431,52,1.5389168393015684
Navapur,Maize,2016,1467,1519,52,3.5446489434219495
Kolhapur,Banana,2015,456,508,52,11.403508771929825
Gevrai,Maize,2016,1319,1371,52,3.9423805913570886
Gangapur,Maize,2015,1216,1268,52,4.276315789473684
Pachora,Bajri,2015,1359,1411,52,3.8263428991905815
Jamner,Maize,2016,1325,1377,52,3.9245283018867925
Armori,Paddy-Unhusked,2015,1504,1556,52,3.4574468085106385
Nandgaon,Maize,2016,1377,1429,52,3.776325344952796
Gondpimpri,Paddy-Unhusked,2016,1944,1996,52,2.674897119341564
Digras,Cotton,2015,3911,3963,52,1.3295832267962158
Wardha,Wheat(Husked),2015,1453,1505,52,3.5788024776324847
Digras,Sorgum(Jawar),2016,1544,1596,52,3.3678756476683938
Mohol,Maize,2015,1186,1238,52,4.3844856661045535
Jalgaon,Sorgum(Jawar),2015,1355,1407,52,3.837638376383764
Rahata,Bajri,2016,1502,1554,52,3.4620505992010653
Bhandara,Pigeon Pea (Tur),2016,7767,7819,52,0.6694991631260461
Pune-Moshi,Beet Root,2016,1024,1076,52,5.078125
Latur-Murud,Soybean,2015,3238,3290,52,1.605929586164299
Pune,Jaggery,2015,2409,2461,52,2.1585720215857203
Kej,Castor Seed,2016,2821,2873,52,1.8433179723502304
Umarga,Bajri,2016,1228,1280,52,4.234527687296417
Malkapur,Maize,2015,1385,1437,52,3.7545126353790614
Fulambri,Maize,2014,963,1015,52,5.399792315680166
Manmad,Maize,2016,1412,1464,52,3.68271954674221
Parli-Vaijnath,Bajri,2015,1466,1518,52,3.5470668485675305
Islampur,Cabbage,2016,59,111,52,88.13559322033899
Barshi,Brinjal,2016,73,125,52,71.23287671232876
Bhusaval,Wheat(Husked),2015,1306,1358,52,3.9816232771822357
Bhusaval,Wheat(Husked),2015,1227,1279,52,4.2379788101059495
Hingoli,Wheat(Husked),2015,1948,2000,52,2.6694045174537986
Kolhapur,Banana,2016,338,390,52,15.384615384615385
Manwat,Soybean,2015,3297,3349,52,1.5771913861085836
Rahata,Sorgum(Jawar),2014,1410,1462,52,3.6879432624113475
Basmat,Cotton,2015,4286,4338,52,1.2132524498366775
Shegaon,Maize,2016,1172,1224,52,4.436860068259386
Kalamb (Os),Bajri,2015,1442,1494,52,3.606102635228849
Rahuri-Vambori,Soybean,2015,4000,4052,52,1.3
Umari,Sorgum(Jawar),2016,1286,1338,52,4.043545878693624
Jalgaon,Wheat(Husked),2015,1334,1386,52,3.898050974512744
Dudhani,Maize,2014,1226,1278,52,4.241435562805873
Dharangaon,Maize,2016,1300,1352,52,4.0
Palghar(Bevur),Onion,2016,907,959,52,5.733186328555678
Sangli-Miraj,Maize,2016,1862,1913,51,2.7389903329752956
Umared,Coriander (Dry),2016,7155,7206,51,0.7127882599580713
Lasalgaon,Sorgum(Jawar),2015,1504,1555,51,3.390957446808511
Kille Dharur,Maize,2016,1391,1442,51,3.6664270309130123
Dound,Maize,2015,1233,1284,51,4.13625304136253
Chopda,Ground Nut Pods (Dry),2016,5612,5663,51,0.9087669280114041
Shrirampur,Maize,2016,1386,1437,51,3.6796536796536796
Jalgaon,Sorgum(Jawar),2015,1212,1263,51,4.207920792079208
Yeola,Sorgum(Jawar),2016,1601,1652,51,3.1855090568394755
Yeotmal,Wheat(Husked),2016,1491,1542,51,3.420523138832998
Sangali,Maize,2015,1359,1410,51,3.752759381898455
Tumsar,Linseed,2016,4750,4801,51,1.0736842105263158
Gadchiroli,Paddy-Unhusked,2015,1585,1636,51,3.217665615141956
Lohara,Maize,2015,1300,1351,51,3.923076923076923
Patan,Tomato,2015,202,253,51,25.247524752475247
Raver,Maize,2014,1177,1228,51,4.333050127442651
Kalvan,Gram,2016,6033,6084,51,0.8453505718547986
Indapur,Sunflower,2016,2700,2751,51,1.8888888888888888
Manwat,Soybean,2015,3191,3242,51,1.598245064243184
Bhusaval,Sorgum(Jawar),2014,1274,1325,51,4.003139717425432
Bhokardan,Sorgum(Jawar),2015,1158,1209,51,4.404145077720207
Jalgaon,Maize,2016,1339,1390,51,3.8088125466766245
Nandura,Bajri,2015,1047,1098,51,4.871060171919771
Dudhani,Bajri,2016,1510,1561,51,3.377483443708609
Bhokardan,Maize,2015,1291,1342,51,3.9504260263361735
Kej,Maize,2016,1383,1434,51,3.6876355748373104
Telhara,Green Gram,2016,5000,5051,51,1.02
Chopda,Soybean,2015,3428,3479,51,1.4877479579929989
Nampur,Maize,2016,1428,1479,51,3.5714285714285716
Armori,Paddy-Unhusked,2015,1495,1546,51,3.411371237458194
Lakhandur,Green Gram,2015,6300,6351,51,0.8095238095238095
Amarawati,Soybean,2015,3425,3476,51,1.489051094890511
Varud,Cotton,2015,4200,4251,51,1.2142857142857142
Parli-Vaijnath,Gram,2015,3488,3539,51,1.4621559633027523
Sakri,Maize,2016,1298,1349,51,3.9291217257318953
Telhara,Wheat(Husked),2014,1381,1432,51,3.6929761042722666
Chopda,Bajri,2016,1484,1535,51,3.4366576819407006
Chopda,Bajri,2015,1167,1218,51,4.370179948586118
Lasalgaon,Rice(Paddy-Hus),2016,1651,1702,51,3.0890369473046637
Jalgaon,Black Gram,2015,5503,5554,51,0.9267672178811557
Parli-Vaijnath,Sorgum(Jawar),2016,1559,1610,51,3.2713277742142397
Ahmedpur,Bajri,2016,1250,1301,51,4.08
Rahata,Maize,2015,1196,1247,51,4.264214046822742
Shrirampur,Maize,2015,1336,1387,51,3.817365269461078
Dhamangaon-Rly,Cotton,2015,4050,4101,51,1.2592592592592593
Ausa,Maize,2015,1600,1651,51,3.1875
Barshi,Soybean,2016,3800,3851,51,1.3421052631578947
Tuljapur,Soybean,2015,3704,3755,51,1.376889848812095
Shevgaon-Bodhegaon,WHEAT(HUSKED),2016,1958,2009,51,2.6046986721144023
Shahada,Sorgum(Jawar),2015,1390,1441,51,3.6690647482014387
Tuljapur,Soybean,2014,3267,3318,51,1.5610651974288339
Mangalwedha,Maize,2015,1532,1583,51,3.328981723237598
Ausa,Mustard,2014,3301,3352,51,1.5449863677673432
Kolhapur,Banana,2016,1013,1063,50,4.935834155972359
Akkolkot,GREEN GRAM,2016,4450,4500,50,1.1235955056179776
Ghoti,Capsicum,2016,1375,1425,50,3.6363636363636362
Navapur,Gram,2016,4400,4450,50,1.1363636363636365
Bhusaval,Sorgum(Jawar),2015,1147,1197,50,4.3591979075850045
Bhokardan-Pimpalgaon Renu,Gram,2015,3100,3150,50,1.6129032258064515
Barshi-Vairag,Ground Nut Pods (Dry),2015,4300,4350,50,1.1627906976744187
Shegaon,Mustard,2015,3061,3111,50,1.633453119895459
Khed (Shel Pimpalgaon),Brinjal,2016,905,955,50,5.524861878453039
Barshi,Flower,2015,100,150,50,50.0
Bhokardan-Pimpalgaon Renu,Sorgum(Jawar),2015,1150,1200,50,4.3478260869565215
Solapur,Grapes,2016,65,115,50,76.92307692307692
Newasa,SORGUM(JAWAR),2016,1810,1860,50,2.7624309392265194
Washim,Black Gram,2015,5125,5175,50,0.975609756097561
Parli-Vaijnath,Bajri,2014,1696,1746,50,2.94811320754717
Amarawati,Cotton,2016,4677,4727,50,1.0690613641223006
Sillod-Bharadi,Soybean,2016,3425,3475,50,1.4598540145985401
Nandura,Sesamum,2016,4863,4913,50,1.0281719103434095
Barshi,Flower,2015,50,100,50,100.0
Dhadgaon,Sorgum(Jawar),2015,1150,1200,50,4.3478260869565215
Kalamnuri,Wheat(Husked),2016,1533,1583,50,3.2615786040443573
Nandura,Sesamum,2016,5597,5647,50,0.8933357155619082
Manwat,Pigeon Pea (Tur),2016,5700,5750,50,0.8771929824561403
Maregaon,Cotton,2015,4050,4100,50,1.2345679012345678
Kolhapur-Laxmipuri,Paddy-Unhusked,2016,1850,1900,50,2.7027027027027026
Ghoti,BITTER GOURD,2016,900,950,50,5.555555555555555
Vaijapur,Safflower,2016,2400,2450,50,2.0833333333333335
Newasa,Wheat(Husked),2015,1543,1593,50,3.240440699935191
Jawala-Bajar,Soybean,2015,3200,3250,50,1.5625
Dhule,Castor Seed,2015,3150,3200,50,1.5873015873015872
Bhokardan,Maize,2015,1258,1308,50,3.97456279809221
Pandharpur,Potato,2015,650,700,50,7.6923076923076925
Buldhana-Dhad,Maize,2015,1450,1500,50,3.4482758620689653
Vaduj,Maize,2015,1500,1550,50,3.3333333333333335
Akhadabalapur,Wheat(Husked),2016,1763,1813,50,2.836074872376631
Kannad,Sorgum(Jawar),2014,1340,1390,50,3.7313432835820897
Kolhapur,Banana,2015,805,855,50,6.211180124223603
Pune,Maize,2016,1635,1685,50,3.058103975535168
Malkapur,Black Gram,2015,6350,6400,50,0.7874015748031497
Sangamner,Sorgum(Jawar),2014,1969,2019,50,2.5393600812595225
Barshi,Brinjal,2015,150,200,50,33.333333333333336
Barshi,Brinjal,2015,100,150,50,50.0
Solapur,Matki,2015,6517,6567,50,0.7672241829062452
Bhokardan-Pimpalgaon Renu,Bajri,2016,1500,1550,50,3.3333333333333335
Indapur,Sunflower,2015,2550,2600,50,1.9607843137254901
Tumsar,Green Gram,2016,4199,4249,50,1.1907597046915932
Umarga,Soybean,2016,3746,3796,50,1.3347570742124932
Navapur,WHEAT(HUSKED),2016,1700,1750,50,2.9411764705882355
Akhadabalapur,Wheat(Husked),2014,1775,1825,50,2.816901408450704
Navapur,Sorgum(Jawar),2016,1367,1417,50,3.6576444769568397
Dound,Maize,2015,1251,1301,50,3.9968025579536373
Taloda,Wheat(Husked),2016,1650,1700,50,3.0303030303030303
Bhokardan-Pimpalgaon Renu,Sorgum(Jawar),2015,1083,1133,50,4.616805170821792
Bhokardan-Pimpalgaon Renu,Sorgum(Jawar),2015,1200,1250,50,4.166666666666667
Akhadabalapur,Sorgum(Jawar),2014,1500,1550,50,3.3333333333333335
Jalgaon Jamod,Sorgum(Jawar),2014,1125,1175,50,4.444444444444445
Daryapur,Cotton,2014,4000,4050,50,1.25
Gevrai,Mustard,2015,3650,3700,50,1.36986301369863
Indapur,Rice(Paddy-Hus),2015,1129,1179,50,4.428697962798937
Daryapur,Cotton,2015,4038,4088,50,1.2382367508667658
Udgir,Soybean,2015,3600,3650,50,1.3888888888888888
Pandharkawada,Cotton,2015,4100,4150,50,1.2195121951219512
Newasa,Sorgum(Jawar),2016,1658,1708,50,3.0156815440289506
Barshi-Vairag,Black Gram,2015,10300,10350,50,0.4854368932038835
Akkalkuwa,Sorgum(Jawar),2016,1300,1350,50,3.8461538461538463
Dhule,Castor Seed,2015,3050,3100,50,1.639344262295082
Kolhapur-Malkapur,SNAKE GOURD,2016,100,150,50,50.0
Dound,Gram,2014,2335,2385,50,2.1413276231263385
Kalvan,Soybean,2016,3700,3750,50,1.3513513513513513
Khed (Shel Pimpalgaon),Brinjal,2016,2304,2354,50,2.170138888888889
Bhokardan,Gram,2015,3100,3150,50,1.6129032258064515
Gevrai,Sesamum,2015,10220,10270,50,0.4892367906066536
Palus,Sweet Potato,2016,850,900,50,5.882352941176471
Kolhapur-Malkapur,Snake Gourd,2016,100,150,50,50.0
Udgir,Soybean,2015,3883,3933,50,1.2876641771825907
Digras,Black Gram,2015,8525,8575,50,0.5865102639296188
Tasgaon,Maize,2014,1350,1400,50,3.7037037037037037
Barshi,Cabbage,2015,50,100,50,100.0
Kalamb (Os),Sunflower,2015,3005,3055,50,1.663893510815308
Jintur-Bori,Wheat(Husked),2015,1538,1588,50,3.250975292587776
Sailu,Bajri,2016,1500,1550,50,3.3333333333333335
Mantha,BAJRI,2016,1400,1450,50,3.5714285714285716
Kolhapur,Banana,2015,609,659,50,8.210180623973727
Mangaon(Bhadav),Paddy-Unhusked,2015,1300,1350,50,3.8461538461538463
Ambejogai,Wheat(Husked),2014,1561,1611,50,3.2030749519538757
Akhadabalapur,Wheat(Husked),2015,1788,1838,50,2.796420581655481
Brahmpuri,Paddy-Unhusked,2015,1900,1950,50,2.6315789473684212
Kalvan,Maize,2016,1676,1726,50,2.983293556085919
Brahmpuri,Paddy-Unhusked,2015,1900,1950,50,2.6315789473684212
Ghansawangi,Wheat(Husked),2014,1800,1850,50,2.7777777777777777
Partur,BAJRI,2016,1250,1300,50,4.0
Barshi,Cabbage,2016,50,100,50,100.0
Navapur,Cotton,2015,3580,3630,50,1.3966480446927374
Jalgaon,Cotton,2015,3900,3950,50,1.2820512820512822
Beed,Soybean,2016,3638,3688,50,1.3743815283122596
Brahmpuri,Paddy-Unhusked,2016,1821,1871,50,2.745744096650192
Nandurbar,Cluster Bean,2016,3567,3617,50,1.4017381553125876
Akola,Bajri,2015,1200,1250,50,4.166666666666667
Nandurbar,Soybean,2015,3546,3596,50,1.410039481105471
Barshi,Tomato,2015,100,150,50,50.0
Barshi,Spinach,2016,250,300,50,20.0
Barshi,Tomato,2015,100,150,50,50.0
Jalgaon Jamod,Sorgum(Jawar),2015,1250,1300,50,4.0
Kurdwadi,Wheat(Husked),2016,2167,2217,50,2.3073373327180433
Sillod-Bharadi,Bajri,2015,1200,1250,50,4.166666666666667
Navapur,Sorgum(Jawar),2016,1819,1869,50,2.748763056624519
Kannad,Maize,2014,1050,1100,50,4.761904761904762
Beed,Maize,2015,1276,1326,50,3.9184952978056424
Mangrulpeer,Green Gram,2014,7301,7351,50,0.6848376934666484
Bhokardan,Sorgum(Jawar),2016,1603,1653,50,3.119151590767311
Shirur,Maize,2015,1195,1245,50,4.184100418410042
Bhokardan,Sorgum(Jawar),2016,1488,1538,50,3.360215053763441
Barshi,Maize,2016,1723,1773,50,2.901915264074289
Mangaon(Bhadav),Paddy-Unhusked,2016,1410,1460,50,3.5460992907801416
Ambejogai,Maize,2014,1250,1300,50,4.0
Khed (Shel Pimpalgaon),Brinjal,2015,1101,1151,50,4.541326067211626
Ambejogai,Safflower,2014,2250,2300,50,2.2222222222222223
Khed (Shel Pimpalgaon),Cucumber,2016,329,379,50,15.19756838905775
Vaduj,Wheat(Husked),2015,1500,1550,50,3.3333333333333335
Parbhani,Cotton,2015,3900,3950,50,1.2820512820512822
Ghatanji,Gram,2015,3150,3200,50,1.5873015873015872
Jintur-Bori,Gram,2016,4884,4934,50,1.0237510237510237
Ahmednagar,Wheat(Husked),2016,1831,1881,50,2.7307482250136537
Shirur,Ground Nut Pods (Dry),2015,3200,3250,50,1.5625
Ner Parasopant,Gram,2015,3700,3750,50,1.3513513513513513
Parli-Vaijnath,Bajri,2015,1399,1449,50,3.5739814152966405
Barshi,Kharbuj,2015,50,100,50,100.0
Devani,GREEN GRAM,2016,4486,4536,50,1.1145786892554614
Umared,Lang,2014,1514,1564,50,3.3025099075297226
Shirur,Green Gram,2014,5863,5913,50,0.8528057308545114
Parli-Vaijnath,Wheat(Husked),2014,1353,1403,50,3.695491500369549
Kurdwadi,Wheat(Husked),2015,1578,1628,50,3.1685678073510775
Aheri,Sorgum(Jawar),2015,1150,1200,50,4.3478260869565215
Mantha,Gram,2014,2500,2550,50,2.0
Jawala-Bajar,Pigeon Pea (Tur),2015,4350,4400,50,1.1494252873563218
Bhokardan-Pimpalgaon Renu,Gram,2014,3050,3100,50,1.639344262295082
Shrirampur-Belapur,Sorgum(Jawar),2015,1050,1100,50,4.761904761904762
Vaduj,Maize,2015,1383,1433,50,3.6153289949385394
Washim,Mustard,2015,3100,3150,50,1.6129032258064515
Washim,Mustard,2015,3000,3050,50,1.6666666666666667
Mantha,Bajri,2015,1200,1250,50,4.166666666666667
Sangamner,Maize,2015,1350,1400,50,3.7037037037037037
Jalna-Badnapur,Bajri,2015,1342,1392,50,3.7257824143070044
Bhokardan-Pimpalgaon Renu,Soybean,2015,3188,3238,50,1.5683814303638646
Latur-Murud,Soybean,2015,3250,3300,50,1.5384615384615385
Varud,PIGEON PEA (TUR),2016,5350,5400,50,0.9345794392523364
Raver,Bajri,2015,1191,1241,50,4.198152812762385
Newasa,Cotton,2015,4050,4100,50,1.2345679012345678
Paranda,Maize,2015,1491,1541,50,3.35345405767941
Akhadabalapur,Sorgum(Jawar),2015,1500,1550,50,3.3333333333333335
Sillod-Bharadi,Gram,2015,4000,4050,50,1.25
Udgir,Wheat(Husked),2015,1332,1382,50,3.7537537537537538
Newasa,Bajri,2015,1323,1373,50,3.7792894935752077
Newasa,Bajri,2015,1325,1375,50,3.7735849056603774
Manchar,Potato,2015,850,900,50,5.882352941176471
Umarkhed,Cotton,2015,3900,3950,50,1.2820512820512822
Vaduj,Bajri,2015,1400,1450,50,3.5714285714285716
Akhadabalapur,Sorgum(Jawar),2015,1600,1650,50,3.125
Akhadabalapur,Sorgum(Jawar),2015,1550,1600,50,3.225806451612903
Kalamb (Os),Maize,2016,1403,1453,50,3.563791874554526
Kannad,Gram,2016,3900,3950,50,1.2820512820512822
Mangalwedha,Wheat(Unhusked),2016,2800,2850,50,1.7857142857142858
Gondpimpri,Gram,2014,3025,3075,50,1.6528925619834711
Khed (Shel Pimpalgaon),Tomato,2016,750,800,50,6.666666666666667
Sadak Arjuni,Paddy-Unhusked,2016,1600,1650,50,3.125
Bhokardan,BLACK GRAM,2016,5000,5050,50,1.0
Varud-Rajura Bazar,Sorgum(Jawar),2015,1243,1293,50,4.022526146419952
Washim,Green Gram,2016,5225,5275,50,0.9569377990430622
Paranda,Green Gram,2015,6300,6350,50,0.7936507936507936
Barshi,Capsicum,2015,100,150,50,50.0
Umarga,Bajri,2016,1221,1271,50,4.095004095004095
Sillod-Bharadi,Wheat(Husked),2016,1571,1621,50,3.1826861871419476
Sonpeth,Sesamum,2016,5088,5138,50,0.9827044025157232
Osmanabad,Tomato,2016,650,700,50,7.6923076923076925
Indapur-Bhigwan,Sunflower,2014,2800,2850,50,1.7857142857142858
Indapur,MAIZE,2016,1231,1281,50,4.061738424045491
Raver-Sawada,Maize,2016,1400,1450,50,3.5714285714285716
Baramati,Banana,2015,200,250,50,25.0
Kalamb (Os),Tamarind,2015,3656,3706,50,1.3676148796498906
Murum,Pigeon Pea (Tur),2015,9667,9717,50,0.5172235440157236
Bhiwapur,Green Gram,2016,4850,4900,50,1.0309278350515463
Murum,Pigeon Pea (Tur),2015,7700,7750,50,0.6493506493506493
Dudhani,Maize,2016,1510,1560,50,3.3112582781456954
Bhiwapur,Green Peas (Dry),2016,2800,2850,50,1.7857142857142858
Lasalgaon-Niphad,Maize,2015,1245,1295,50,4.016064257028113
Koregaon,Cowpea,2016,4250,4300,50,1.1764705882352942
Udgir,Tamarind Seed,2016,1700,1750,50,2.9411764705882355
Chandrapur,Cotton,2016,4500,4550,50,1.1111111111111112
Osmanabad,Potato,2015,500,550,50,10.0
Achalpur,Mustard,2016,3250,3300,50,1.5384615384615385
Kalamnuri,Gram,2015,3600,3650,50,1.3888888888888888
Chalisgaon,Cucumber,2016,1550,1600,50,3.225806451612903
Lakhandur,Pigeon Pea (Tur),2016,6507,6557,50,0.768403258029814
Jawala-Bajar,Wheat(Husked),2016,1700,1750,50,2.9411764705882355
Alibag,Paddy-Unhusked,2016,1500,1550,50,3.3333333333333335
Nira-Saswad,Maize,2016,1631,1681,50,3.065603923973023
Ausa,Sunflower,2015,3032,3082,50,1.6490765171503958
Raver-Sawada,Wheat(Husked),2016,1700,1750,50,2.9411764705882355
Lohara,Sorgum(Jawar),2016,1950,2000,50,2.5641025641025643
Chalisgaon,Castor Seed,2016,2750,2800,50,1.8181818181818181
Bhokardan-Pimpalgaon Renu,Gram,2016,7000,7050,50,0.7142857142857143
Kalvan,Pigeon Pea (Tur),2014,3050,3100,50,1.639344262295082
Shevgaon-Bodhegaon,Wheat(Husked),2015,1700,1750,50,2.9411764705882355
Shevgaon-Bodhegaon,Wheat(Husked),2015,1621,1671,50,3.0845157310302285
Alibag,Paddy-Unhusked,2016,1500,1550,50,3.3333333333333335
Baramati,Pigeon Pea (Tur),2015,7500,7550,50,0.6666666666666666
Shevgaon,Maize,2015,1275,1325,50,3.9215686274509802
Achalpur,Rice(Paddy-Hus),2014,1700,1750,50,2.9411764705882355
Shirpur,Maize,2015,1247,1297,50,4.0096230954290295
Ahmedpur,Tamarind,2015,2500,2550,50,2.0
Tadkalas,Ground Nut Pods (Dry),2014,1876,1926,50,2.6652452025586353
Alibag,Paddy-Unhusked,2016,1450,1500,50,3.4482758620689653
Jalgaon,Wheat(Husked),2016,1433,1483,50,3.4891835310537336
Balapur,Bajri,2015,1250,1300,50,4.0
Jalgaon,Maize,2014,1250,1300,50,4.0
Vaduj,Maize,2014,1350,1400,50,3.7037037037037037
Indapur-Bhigwan,Sunflower,2016,2700,2750,50,1.8518518518518519
Lohara,Soybean,2016,3570,3620,50,1.4005602240896358
Achalpur,Maize,2016,1550,1600,50,3.225806451612903
Shrirampur,Bajri,2015,1446,1496,50,3.4578146611341634
Ahmedpur,Maize,2016,1303,1353,50,3.837298541826554
Kada,Soybean,2015,3150,3200,50,1.5873015873015872
Murud,Paddy-Unhusked,2016,1450,1500,50,3.4482758620689653
Naigaon,Sorgum(Jawar),2014,1000,1050,50,5.0
Murud,Paddy-Unhusked,2016,1493,1543,50,3.348961821835231
Soygaon,Maize,2015,1033,1083,50,4.84027105517909
Achalpur,Green Gram,2015,5800,5850,50,0.8620689655172413
Kada,Tamarind,2015,3600,3650,50,1.3888888888888888
Rahata,Melon,2016,326,376,50,15.337423312883436
Kada,Sunflower,2015,3008,3058,50,1.6622340425531914
Hadgaon,Sorgum(Jawar),2014,1550,1600,50,3.225806451612903
Jalgaon,Green Gram,2016,5470,5520,50,0.9140767824497258
Bhiwapur,Wheat(Husked),2016,1400,1450,50,3.5714285714285716
Bhiwapur,Paddy-Unhusked,2016,2300,2350,50,2.1739130434782608
Aurangabad,Banana,2015,600,650,50,8.333333333333334
Nagpur,Custard Apple,2015,200,250,50,25.0
Jalgaon,Maize,2016,1607,1657,50,3.1113876789047916
Bhokardan-Pimpalgaon Renu,Green Gram,2016,4300,4350,50,1.1627906976744187
Fulambri,Maize,2016,1350,1400,50,3.7037037037037037
Soygaon,Cotton,2015,3950,4000,50,1.2658227848101267
Kille Dharur,Niger-Seed,2015,4000,4050,50,1.25
Bhiwapur,Gram,2015,3900,3950,50,1.2820512820512822
Naigaon,COTTON,2016,4800,4850,50,1.0416666666666667
Dhadgaon,Sorgum(Jawar),2016,1200,1250,50,4.166666666666667
Islampur,Brinjal,2014,150,200,50,33.333333333333336
Tuljapur,Pigeon Pea (Tur),2016,8215,8265,50,0.6086427267194157
Murtizapur,Sunflower,2015,2901,2951,50,1.723543605653223
Rahata,Papai,2016,550,600,50,9.090909090909092
Patur,Gram,2015,3150,3200,50,1.5873015873015872
Bhiwapur,Soybean,2016,3500,3550,50,1.4285714285714286
Bhokar,Sunflower,2015,3100,3150,50,1.6129032258064515
Karmala,Bajri,2016,1851,1901,50,2.7012425715829282
Sillod,Bajri,2015,1243,1293,50,4.022526146419952
Yeotmal,Wheat(Husked),2015,1536,1586,50,3.2552083333333335
Jalna-Badnapur,Bajri,2016,1675,1725,50,2.985074626865672
Sengaon,Sorgum(Jawar),2015,1350,1400,50,3.7037037037037037
Lasur Station,Soybean,2016,3463,3513,50,1.443834825295986
Telhara,COTTON,2016,4850,4900,50,1.0309278350515463
Bhokardan-Pimpalgaon Renu,SORGUM(JAWAR),2016,1600,1650,50,3.125
Baramati,Wheat(Unhusked),2016,3523,3573,50,1.419244961680386
Achalpur,Green Gram,2016,5250,5300,50,0.9523809523809523
Barshi,Wheat(Unhusked),2014,2613,2663,50,1.9135093761959434
Barshi,Flower,2014,52,102,50,96.15384615384616
Umarkhed,Cotton,2015,3900,3950,50,1.2820512820512822
Purna,Green Gram,2015,8260,8310,50,0.6053268765133172
Sangamner,Gram,2014,3238,3288,50,1.5441630636195183
Nira,Maize,2015,1400,1450,50,3.5714285714285716
Ausa,Sunflower,2015,3116,3166,50,1.6046213093709885
Mahad,Paddy-Unhusked,2015,1400,1450,50,3.5714285714285716
Kalamb (Os),Jaggery,2014,2250,2300,50,2.2222222222222223
Bhokardan-Pimpalgaon Renu,Sorgum(Jawar),2016,1480,1530,50,3.3783783783783785
Sillod,Sorgum(Jawar),2014,1400,1450,50,3.5714285714285716
Barshi,Cucumber,2014,67,117,50,74.6268656716418
Gangapur,Pigeon Pea (Tur),2014,4750,4800,50,1.0526315789473684
Lonand,Maize,2014,1383,1433,50,3.6153289949385394
Lasalgaon-Vinchur,Bajri,2015,1482,1532,50,3.3738191632928474
Nira-Saswad,Maize,2016,1450,1500,50,3.4482758620689653
Pune-Pimpri,Hemp-Seed,2016,250,300,50,20.0
Washim,Bajri,2015,1400,1450,50,3.5714285714285716
Arvi,Cotton,2015,4064,4114,50,1.2303149606299213
Jalkot,Sorgum(Jawar),2015,1275,1325,50,3.9215686274509802
Arvi,Cotton,2016,4599,4649,50,1.0871928680147858
Aheri,Sesamum,2016,4821,4871,50,1.0371292263015972
Jalna,Green Gram,2015,6450,6500,50,0.7751937984496124
Bhiwapur,Paddy-Unhusked,2015,1800,1850,50,2.7777777777777777
Indapur-Bhigwan,Black Gram,2015,6500,6550,50,0.7692307692307693
Bhokardan-Pimpalgaon Renu,Sorgum(Jawar),2016,1606,1656,50,3.1133250311332503
Umarga,Paddy-Unhusked,2015,1210,1260,50,4.132231404958677
Dhadgaon,Maize,2016,1283,1333,50,3.897116134060795
Murum,Bajri,2016,1600,1650,50,3.125
Barshi,Ridge Gourd,2015,80,129,49,61.25
Shirur,Maize,2016,1314,1363,49,3.7290715372907153
Gondpimpri,Paddy-Unhusked,2016,2348,2397,49,2.0868824531516186
Pandharpur,Gram,2016,5051,5100,49,0.9701049297168878
Aamgaon,Paddy-Unhusked,2015,1481,1530,49,3.3085752869682645
Kalamb (Os),Maize,2015,1192,1241,49,4.110738255033557
Barshi,Tomato,2014,66,115,49,74.24242424242425
Islampur,Cabbage,2016,38,87,49,128.94736842105263
Pachora,Pigeon Pea (Tur),2016,5229,5278,49,0.9370816599732262
Palam,Soybean,2016,3551,3600,49,1.3798929878907351
Pavani,Paddy-Unhusked,2016,2058,2107,49,2.380952380952381
Loha,Ground Nut Pods (Dry),2016,5501,5550,49,0.8907471368842028
Kada,Sunflower,2014,2972,3021,49,1.648721399730821
Nanded,Wheat(Husked),2016,1607,1656,49,3.0491599253266957
Dharangaon,Sorgum(Jawar),2016,1511,1560,49,3.242885506287227
Barshi,Tomato,2015,48,97,49,102.08333333333333
Manchar,Kanda Pat,2014,802,851,49,6.109725685785536
Ahmedpur,Maize,2016,1281,1330,49,3.8251366120218577
Dondaicha,Pigeon Pea (Tur),2014,4033,4082,49,1.2149764443342426
Kej,Pigeon Pea (Tur),2014,4366,4415,49,1.1223087494273936
Hingoli-Kanegaon Naka,SOYBEAN,2016,2854,2903,49,1.7168885774351788
Tuljapur,Gram,2016,5308,5357,49,0.9231348907309721
Ramtek,Gram,2015,3451,3500,49,1.4198782961460445
Murud,Paddy-Unhusked,2016,1499,1548,49,3.268845897264843
Purna,Soybean,2016,3260,3309,49,1.5030674846625767
Indapur-Bhigwan,Rice(Paddy-Hus),2015,1391,1440,49,3.5226455787203452
Alibag,Paddy-Unhusked,2016,1499,1548,49,3.268845897264843
Gangapur,Maize,2016,1712,1761,49,2.8621495327102804
Pandharpur,Wheat(Husked),2015,1521,1570,49,3.2215647600262987
Dondaicha-Sindkheda,Sorgum(Jawar),2016,1449,1498,49,3.3816425120772946
Lonar,Neem-Seed,2016,1042,1091,49,4.702495201535509
Kej,Maize,2016,1424,1473,49,3.441011235955056
Gangapur,Maize,2016,1569,1618,49,3.123008285532186
Ahmednagar,Maize,2015,1425,1474,49,3.43859649122807
Udgir,Soybean,2015,3774,3823,49,1.298357180710122
Varud-Rajura Bazar,Wheat(Husked),2016,1549,1598,49,3.1633311814073597
Bhokardan,SOYBEAN,2016,2692,2741,49,1.8202080237741456
Mohol,Maize,2015,1119,1168,49,4.378909740840036
Bhokardan-Pimpalgaon Renu,Maize,2016,1574,1623,49,3.1130876747141043
Pandharpur,Wheat(Husked),2015,1484,1533,49,3.30188679245283
Bhusaval,Wheat(Husked),2015,1380,1428,48,3.4782608695652173
Pandharpur,Wheat(Husked),2014,1502,1550,48,3.195739014647137
Indapur,Banana,2016,360,408,48,13.333333333333334
Jalgaon,Maize,2015,1363,1411,48,3.521643433602348
Savner,Sorgum(Jawar),2016,1261,1309,48,3.8065027755749403
Nanded,Wheat(Husked),2015,1518,1566,48,3.1620553359683794
Katol,WHEAT(HUSKED),2016,1930,1978,48,2.4870466321243523
Sinner,Tamarind,2016,1530,1578,48,3.1372549019607843
Bhokardan-Pimpalgaon Renu,Maize,2015,1225,1273,48,3.9183673469387754
Sakri,Maize,2015,1070,1118,48,4.485981308411215
Mangaon(Bhadav),Paddy-Unhusked,2015,1302,1350,48,3.686635944700461
Shevgaon,Maize,2015,1400,1448,48,3.4285714285714284
Manmad,Maize,2015,1324,1372,48,3.6253776435045317
Jalgaon,Bajri,2014,1400,1448,48,3.4285714285714284
Sengaon,Green Gram,2016,5259,5307,48,0.9127210496292071
Washim-Ansing,Sorgum(Jawar),2016,1385,1433,48,3.4657039711191335
Shegaon,Bajri,2016,1270,1318,48,3.779527559055118
Raver,Maize,2016,1474,1522,48,3.2564450474898234
Savner,Wheat(Husked),2014,1341,1389,48,3.5794183445190155
Murum,Soybean,2015,3708,3756,48,1.2944983818770226
Palghar(Bevur),Rice(Paddy-Hus),2016,2640,2688,48,1.8181818181818181
Barshi,Maize,2015,1464,1512,48,3.278688524590164
Akot,Sorgum(Jawar),2016,1320,1368,48,3.6363636363636362
Bhusaval,Wheat(Husked),2016,1548,1596,48,3.10077519379845
Bhokardan-Pimpalgaon Renu,Soybean,2015,3150,3198,48,1.5238095238095237
Indapur-Bhigwan,Rice(Paddy-Hus),2015,1413,1461,48,3.397027600849257
Rahata,Bajri,2016,1577,1625,48,3.0437539632213064
Bhokardan-Pimpalgaon Renu,Sorgum(Jawar),2016,1602,1650,48,2.9962546816479403
Jintur-Bori,Sorgum(Jawar),2014,1187,1234,47,3.9595619208087616
Devala,Sorgum(Jawar),2015,1399,1446,47,3.359542530378842
Kalvan,Maize,2016,1570,1617,47,2.9936305732484074
Pulgaon,Wheat(Husked),2015,1329,1376,47,3.5364936042136943
Ramtek,Cabbage,2015,214,261,47,21.962616822429908
Sakri,Bajri,2016,1420,1467,47,3.3098591549295775
Murud,Paddy-Unhusked,2016,1498,1545,47,3.137516688918558
Gangapur,Maize,2016,1364,1411,47,3.4457478005865103
Hingoli,Cotton,2016,4452,4499,47,1.05570530098832
Rahuri-Vambori,Soybean,2015,3146,3193,47,1.4939605848696758
Pandharpur,Maize,2014,1099,1146,47,4.276615104640582
Rahuri-Vambori,Maize,2015,1105,1152,47,4.253393665158371
Nanded,Wheat(Husked),2014,1536,1583,47,3.0598958333333335
Latur-Murud,WHEAT(HUSKED),2016,2282,2329,47,2.0595968448729183
Kopargaon,Maize,2015,1320,1367,47,3.5606060606060606
Sonpeth,Safflower,2016,2650,2697,47,1.7735849056603774
Mangalwedha,Maize,2016,1411,1458,47,3.330970942593905
Rahuri-Vambori,Bajri,2015,1398,1445,47,3.3619456366237483
Akluj,Bajri,2014,1517,1564,47,3.098220171390903
Bhusaval,Wheat(Husked),2016,1550,1597,47,3.032258064516129
Bhokardan,Sorgum(Jawar),2015,1250,1297,47,3.76
Jalna,Cotton,2015,4096,4143,47,1.1474609375
Navapur,Maize,2015,1323,1370,47,3.5525321239606953
Bhokardan-Pimpalgaon Renu,Maize,2015,1253,1300,47,3.750997605746209
Jalgaon,Sorgum(Jawar),2015,1164,1211,47,4.037800687285223
Udgir,Safflower,2016,2634,2681,47,1.7843583902809415
Yeola,Maize,2015,1213,1260,47,3.8746908491343777
Lonand,Maize,2014,1378,1425,47,3.410740203193033
Vaduj,Maize,2015,1456,1503,47,3.228021978021978
Ahmedpur,Sunflower,2016,3432,3479,47,1.3694638694638694
Mukhed,GREEN GRAM,2016,4554,4601,47,1.0320597277119017
Rahuri-Vambori,Bajri,2016,1716,1763,47,2.738927738927739
Lakhandur,Paddy-Unhusked,2016,1686,1733,47,2.7876631079478056
Pune-Pimpri,Beet Root,2016,1415,1462,47,3.3215547703180213
Jamner-Neri,Maize,2016,1325,1372,47,3.547169811320755
Partur,Bajri,2016,1541,1588,47,3.0499675535366646
Pavani,Paddy-Unhusked,2016,1928,1975,47,2.4377593360995853
Lakhandur,Green Peas (Dry),2016,2558,2605,47,1.8373729476153244
Washim,Paddy-Unhusked,2016,1200,1247,47,3.9166666666666665
Pune-Pimpri,Ground Nut Pods (Dry),2016,4024,4071,47,1.1679920477137178
Amalner,Bajri,2015,1214,1261,47,3.871499176276771
Jalgaon,Maize,2015,1107,1154,47,4.245709123757904
Wardha,Wheat(Husked),2014,1479,1526,47,3.1778228532792427
Dudhani,Bajri,2014,1068,1115,47,4.400749063670412
Bhokardan-Pimpalgaon Renu,Soybean,2014,3163,3210,47,1.4859310780904205
Palghar(Bevur),Onion,2015,1134,1181,47,4.144620811287478
Digras,Soybean,2015,3262,3309,47,1.4408338442673208
Barshi,Cabbage,2015,47,94,47,100.0
Chandur Rly.,PIGEON PEA (TUR),2016,5455,5501,46,0.843263061411549
Sailu,Wheat(Husked),2014,1490,1536,46,3.087248322147651
Rahata,Maize,2015,1322,1368,46,3.479576399394856
Digras,Wheat(Husked),2015,1534,1580,46,2.9986962190352022
Murum,Soybean,2016,3721,3767,46,1.236226820747111
Khed (Shel Pimpalgaon),Green Chilli,2015,2185,2231,46,2.1052631578947367
Shrirampur,Pigeon Pea (Tur),2016,6400,6446,46,0.71875
Paithan,Sorgum(Jawar),2015,790,836,46,5.822784810126582
Nandurbar,Soybean,2016,3639,3685,46,1.2640835394339105
Rahata,Maize,2016,1328,1374,46,3.463855421686747
Kurdwadi,Wheat(Husked),2014,1413,1459,46,3.2554847841472045
Indapur,Banana,2016,836,882,46,5.502392344497608
Barshi-Vairag,Maize,2015,1221,1267,46,3.7674037674037675
Gangakhed,Cotton,2015,4093,4139,46,1.1238700219887614
Shevgaon-Bodhegaon,Wheat(Husked),2016,1631,1677,46,2.8203556100551808
Mangalwedha,Maize,2016,1511,1557,46,3.044341495698213
Wardha,Wheat(Husked),2015,1478,1524,46,3.1123139377537212
Pune,Jaggery,2016,2610,2656,46,1.7624521072796935
Savner,WHEAT(HUSKED),2016,1651,1697,46,2.786190187764991
Pune-Pimpri,Jaggery,2016,2647,2693,46,1.7378163959199093
Sonpeth,Wheat(Husked),2014,1635,1681,46,2.8134556574923546
Newasa,Wheat(Husked),2015,1456,1502,46,3.159340659340659
Bhusaval,Sorgum(Jawar),2015,1282,1328,46,3.5881435257410295
Khamgaon,Bajri,2016,1619,1665,46,2.8412600370599135
Kej,Maize,2016,1445,1491,46,3.1833910034602075
Ambejogai,Sorgum(Jawar),2016,1612,1658,46,2.8535980148883375
Sangli-Miraj,Maize,2016,1482,1528,46,3.1039136302294197
Khed (Shel Pimpalgaon),Cluster Bean,2015,1891,1937,46,2.4325753569539925
Ramtek,Rice(Paddy-Hus),2016,1751,1797,46,2.627070245573958
Shegaon,Maize,2015,903,949,46,5.094130675526024
Sengaon,Black Gram,2015,7745,7791,46,0.5939315687540349
Savner,Wheat(Husked),2014,1367,1413,46,3.3650329188002925
Pandharpur,Gram,2016,4114,4160,46,1.118133203694701
Barshi,Flower,2014,47,93,46,97.87234042553192
Gevrai,Bhagar/Vari,2015,2354,2400,46,1.9541206457094307
Murud,Paddy-Unhusked,2016,1451,1497,46,3.1702274293590627
Lakhandur,Gram,2016,3957,4003,46,1.1624968410411929
Parbhani,Wheat(Husked),2014,1457,1503,46,3.157172271791352
Katol,Wheat(Husked),2016,1689,1734,45,2.664298401420959
Bhokardan,Sorgum(Jawar),2015,1179,1224,45,3.816793893129771
Nampur,Wheat(Husked),2016,1442,1487,45,3.1206657420249653
Jintur,Turmeric,2016,8102,8147,45,0.5554184152061219
Udgir,Soybean,2015,3221,3266,45,1.3970816516609748
Washim-Ansing,Wheat(Husked),2016,1675,1720,45,2.6865671641791047
Sangli-Miraj,Maize,2016,1576,1621,45,2.8553299492385786
Umarga,Sunflower,2015,3230,3275,45,1.3931888544891642
Bhokardan,Sorgum(Jawar),2015,1212,1257,45,3.712871287128713
Devala,Tamarind,2015,1796,1841,45,2.505567928730512
Nanded,SORGUM(JAWAR),2016,1206,1251,45,3.7313432835820897
Yeola,Maize,2016,1380,1425,45,3.260869565217391
Vaijapur,Maize,2016,1562,1607,45,2.880921895006402
Mangalwedha,Maize,2016,1691,1736,45,2.6611472501478417
Arvi,Cotton,2015,4321,4366,45,1.0414255959268688
Sangamner,Maize,2015,1355,1400,45,3.321033210332103
Kille Dharur,Wheat(Husked),2016,1743,1788,45,2.5817555938037864
Kalamb (Os),Safflower,2016,2495,2540,45,1.8036072144288577
Jamner,Maize,2016,1612,1657,45,2.791563275434243
Arjuni Morgaon,Paddy-Unhusked,2015,1492,1537,45,3.0160857908847185
Shirur,Green Gram,2016,6373,6418,45,0.7061038757257179
Sillod-Bharadi,Maize,2016,1428,1473,45,3.1512605042016806
Palghar(Bevur),Paddy-Unhusked,2016,1410,1455,45,3.1914893617021276
Ashti (Wardha),Cotton,2015,4598,4643,45,0.97868638538495
Varud-Rajura Bazar,Maize,2016,1361,1406,45,3.3063923585598824
Jalgaon,Sorgum(Jawar),2015,1262,1307,45,3.565768621236133
Kurdwadi,Bajri,2016,1249,1294,45,3.602882305844676
Rahata,Maize,2015,1217,1262,45,3.697617091207888
Armori,Paddy-Unhusked,2015,1498,1543,45,3.0040053404539386
Barshi,Flower,2015,55,100,45,81.81818181818181
Atpadi,MAIZE,2016,1390,1435,45,3.237410071942446
Gevrai,Maize,2016,1303,1348,45,3.453568687643899
Dudhani,Wheat(Husked),2015,1490,1535,45,3.0201342281879193
Lakhandur,Green Gram,2016,5695,5740,45,0.7901668129938543
Mohol,Maize,2015,1225,1270,45,3.673469387755102
Lonar,Maize,2016,1060,1105,45,4.245283018867925
Bhokardan-Pimpalgaon Renu,Sorgum(Jawar),2015,1125,1170,45,4.0
Barshi,Maize,2016,1487,1532,45,3.0262273032952254
Raver,Gram,2015,2924,2969,45,1.5389876880984952
Jintur-Bori,Gram,2015,3941,3986,45,1.141842172037554
Panvel,Rice(Paddy-Hus),2016,1410,1455,45,3.1914893617021276
Sailu,Wheat(Husked),2015,1542,1587,45,2.9182879377431905
Lonand,Maize,2015,1349,1394,45,3.3358042994810972
Chopda,Bajri,2015,1205,1250,45,3.7344398340248963
Akluj,Maize,2016,1725,1770,45,2.608695652173913
Pune,Jaggery,2016,2817,2862,45,1.597444089456869
Bhokardan-Pimpalgaon Renu,WHEAT(HUSKED),2016,1600,1645,45,2.8125
Ghansawangi,Cotton,2014,3975,4020,45,1.1320754716981132
Paithan,Sorgum(Jawar),2015,1594,1639,45,2.823086574654956
Barshi,Cabbage,2016,38,83,45,118.42105263157895
Jalgaon,Bajri,2015,1095,1140,45,4.109589041095891
Pune-Manjri,Cabbage,2016,972,1017,45,4.62962962962963
Karmala,Maize,2016,1467,1512,45,3.067484662576687
Jalna-Badnapur,MAIZE,2016,993,1038,45,4.531722054380665
Rahata,Bajri,2015,1330,1375,45,3.3834586466165413
Kalyan,Paddy-Unhusked,2016,1410,1455,45,3.1914893617021276
Ghatanji,Soybean,2015,3487,3532,45,1.2905075996558646
Devala,Sorgum(Jawar),2016,1429,1474,45,3.1490552834149756
Panvel,Rice(Paddy-Hus),2016,1410,1455,45,3.1914893617021276
Patan,Cucumber,2016,115,160,45,39.130434782608695
Shirur,Wheat(Husked),2016,1527,1572,45,2.9469548133595285
Ahmedpur,Soybean,2016,3654,3699,45,1.2315270935960592
Nilanga,Wheat(Husked),2014,1433,1477,44,3.0704815073272855
Solapur,Grapes,2015,69,113,44,63.768115942028984
Sinner,Soybean,2015,3292,3336,44,1.336573511543135
Digras,Sesamum,2015,6657,6701,44,0.6609583896650143
Bhiwapur,Paddy-Unhusked,2016,2229,2273,44,1.9739793629430238
Gevrai,Soybean,2016,3829,3873,44,1.1491250979367982
Gangapur,Maize,2016,1696,1740,44,2.5943396226415096
Pune,Jaggery,2016,2598,2642,44,1.6936104695919938
Sangali,Maize,2015,1350,1394,44,3.259259259259259
Bhokardan,Maize,2016,1607,1651,44,2.7380211574362168
Varud-Rajura Bazar,Wheat(Husked),2015,1306,1350,44,3.3690658499234303
Savner,Maize,2016,1211,1255,44,3.6333608587943846
Palghar(Bevur),Wheat(Husked),2016,2179,2223,44,2.0192748967416247
Jalgaon,Wheat(Husked),2015,1462,1506,44,3.009575923392613
Mandhal,Sunflower,2016,3826,3870,44,1.150026136957658
Ramtek,Wheat(Husked),2016,1695,1739,44,2.5958702064896757
Ramtek,Wheat(Husked),2015,1401,1445,44,3.140613847251963
Dhule,Matki,2015,7154,7198,44,0.6150405367626502
Katol,Wheat(Husked),2015,1382,1426,44,3.183791606367583
Nandurbar,Gram,2015,4352,4396,44,1.0110294117647058
Bhokardan,Wheat(Husked),2015,1406,1450,44,3.1294452347083928
Ambejogai,Sorgum(Jawar),2016,1769,1813,44,2.4872809496890897
Ambejogai,Sorgum(Jawar),2016,1692,1736,44,2.600472813238771
Pulgaon,Wheat(Husked),2016,1459,1503,44,3.015764222069911
Bhokardan-Pimpalgaon Renu,Soybean,2014,2853,2897,44,1.5422362425517
Chandur Rly.,Cotton,2016,4573,4617,44,0.9621692543188279
Shirur,Maize,2014,1216,1260,44,3.6184210526315788
Bhokardan,Sorgum(Jawar),2015,1094,1138,44,4.021937842778794
Pandharpur,Sorgum(Jawar),2016,1908,1952,44,2.3060796645702304
Dondaicha,Maize,2016,1695,1739,44,2.5958702064896757
Lasalgaon-Niphad,Maize,2016,1403,1447,44,3.136136849607983
Bhokardan,Maize,2015,1333,1377,44,3.3008252063015755
Telhara,Sorgum(Jawar),2014,914,958,44,4.814004376367615
Bhokardan-Pimpalgaon Renu,Gram,2015,3050,3094,44,1.4426229508196722
Akkalkuwa,Maize,2015,1321,1365,44,3.330809992429977
Nashik-Devlali,Spinach,2016,93,137,44,47.31182795698925
Newasa,Wheat(Husked),2015,1450,1494,44,3.0344827586206895
Manmad,Maize,2016,1385,1429,44,3.1768953068592056
Sailu,Soybean,2015,3270,3313,43,1.3149847094801224
Umarga,Safflower,2016,2550,2593,43,1.6862745098039216
Sailu,Soybean,2015,3190,3233,43,1.347962382445141
Umarga,Sunflower,2016,3472,3515,43,1.2384792626728112
Ahmedpur,Rice(Paddy-Hus),2016,1480,1523,43,2.9054054054054053
Pachora,SUNFLOWER,2016,2595,2638,43,1.6570327552986512
Akluj,Gram,2015,4024,4067,43,1.0685884691848906
Pune,Maize,2016,1663,1706,43,2.585688514732411
Parbhani,Wheat(Husked),2015,1520,1563,43,2.8289473684210527
Rahuri-Vambori,Soybean,2015,3500,3543,43,1.2285714285714286
Kej,Maize,2015,1343,1386,43,3.2017870439314966
Jalgaon,Bajri,2016,1756,1799,43,2.44874715261959
Sillod-Bharadi,Maize,2016,1398,1441,43,3.0758226037195993
Jalgaon,Bajri,2015,1314,1357,43,3.2724505327245055
Beed,Soybean,2015,3228,3271,43,1.332094175960347
Pune-Pimpri,Wal Papdi,2014,2843,2886,43,1.5124868097080548
Dudhani,Gram,2015,4935,4978,43,0.8713272543059777
Satana,Soybean,2015,3290,3333,43,1.3069908814589666
Malkapur,Bajri,2016,1350,1393,43,3.185185185185185
Manmad,Wheat(Husked),2015,1542,1585,43,2.788586251621271
Bhusaval,Wheat(Husked),2014,1300,1343,43,3.3076923076923075
Basmat,Soybean,2014,3203,3246,43,1.3424914142990947
Shirur,Pigeon Pea (Tur),2015,4643,4686,43,0.9261253499892311
Shirur,Pigeon Pea (Tur),2015,3964,4007,43,1.084762865792129
Bhokardan,Bajri,2016,1388,1431,43,3.0979827089337175
Malkapur,Maize,2016,1632,1675,43,2.6348039215686274
Vaijapur,Soybean,2015,3346,3389,43,1.2851165570830843
Mandhal,Cotton,2015,3886,3929,43,1.1065362840967576
Umared,Lentil,2015,3951,3994,43,1.088332067830929
Pune-Pimpri,Beet Root,2014,1686,1729,43,2.550415183867141
Sangali,Maize,2016,1825,1868,43,2.356164383561644
Savner,Wheat(Husked),2014,1391,1434,43,3.0913012221423437
Lonand,Maize,2016,1413,1456,43,3.043170559094126
Bhusaval,Sorgum(Jawar),2015,1083,1126,43,3.9704524469067404
Bori Arab,Soybean,2015,3446,3489,43,1.2478235635519443
Tuljapur,Maize,2015,1143,1186,43,3.7620297462817147
Deglur,Soybean,2014,3021,3064,43,1.4233697451175107
Kalamb (Os),Bajri,2015,1428,1471,43,3.011204481792717
Varud-Rajura Bazar,Wheat(Husked),2016,1700,1743,43,2.5294117647058822
Pune-Manjri,Onion,2016,1093,1136,43,3.9341262580054894
Varud-Rajura Bazar,Wheat(Husked),2016,1664,1707,43,2.5841346153846154
Bhiwapur,Paddy-Unhusked,2015,1917,1960,43,2.2430881585811164
Kolhapur-Laxmipuri,Maize,2016,1795,1838,43,2.395543175487465
Mohol,Maize,2016,1559,1602,43,2.758178319435536
Barshi,Flower,2016,57,100,43,75.43859649122807
Khamgaon,Bajri,2015,1035,1078,43,4.154589371980676
Bhokardan-Pimpalgaon Renu,Maize,2016,1345,1388,43,3.197026022304833
Nampur,Maize,2016,1307,1350,43,3.2899770466717673
Jalgaon,WHEAT(HUSKED),2016,1858,1900,42,2.2604951560818085
Varud-Rajura Bazar,Sorgum(Jawar),2015,1333,1375,42,3.150787696924231
Yeola,Sorgum(Jawar),2016,1607,1649,42,2.613565650280025
Pavani,Paddy-Unhusked,2016,2173,2215,42,1.932811780947998
Barshi,Ridge Gourd,2015,80,122,42,52.5
Barshi,Tomato,2016,39,81,42,107.6923076923077
Gevrai,Soybean,2015,3188,3230,42,1.3174404015056462
Shirur,Gram,2015,3575,3617,42,1.1748251748251748
Murum,Maize,2015,1413,1455,42,2.9723991507430996
Ambejogai,Sorgum(Jawar),2015,2591,2633,42,1.6209957545349285
Chandur Rly.,Pigeon Pea (Tur),2014,4750,4792,42,0.8842105263157894
Barshi,Shevga,2016,73,115,42,57.534246575342465
Pune,Maize,2015,1424,1466,42,2.949438202247191
Satana,Maize,2016,1405,1447,42,2.9893238434163703
Sakri,Wheat(Husked),2015,1392,1434,42,3.0172413793103448
Barshi,Rice(Paddy-Hus),2016,1725,1767,42,2.4347826086956523
Barshi,Tomato,2015,37,79,42,113.51351351351352
Lasalgaon-Niphad,Maize,2016,1402,1444,42,2.9957203994293864
Barshi,Paddy-Unhusked,2015,1483,1525,42,2.832097100472016
Bhokardan,Sorgum(Jawar),2016,1608,1650,42,2.611940298507463
Arjuni Morgaon,Paddy-Unhusked,2015,1662,1704,42,2.527075812274368
Phaltan,Jaggery,2014,2660,2702,42,1.5789473684210527
Ausa,Safflower,2015,2397,2439,42,1.7521902377972465
Umared,Green Peas (Dry),2015,2363,2405,42,1.7774016081252646
Devala,Sorgum(Jawar),2015,1301,1343,42,3.2282859338970025
Chopda,Bajri,2016,1483,1525,42,2.832097100472016
Yeola,Maize,2015,1216,1258,42,3.4539473684210527
Bhiwapur,Paddy-Unhusked,2014,2500,2542,42,1.68
Sakri,Maize,2016,1207,1249,42,3.47970173985087
Khamgaon,Bajri,2015,1101,1143,42,3.8147138964577656
Shrirampur,Maize,2015,1221,1263,42,3.43980343980344
Shegaon,Mustard,2015,3177,3219,42,1.3220018885741265
Indapur-Bhigwan,Rice(Paddy-Hus),2016,1767,1809,42,2.3769100169779285
Shegaon,Mustard,2015,2929,2971,42,1.4339364970979858
Shahada,Sorgum(Jawar),2016,1555,1597,42,2.7009646302250805
Bhiwapur,Paddy-Unhusked,2016,2083,2125,42,2.0163226116178588
Dudhani,Bajri,2015,1137,1179,42,3.6939313984168867
Kalamb (Os),Safflower,2014,2380,2422,42,1.7647058823529411
Indapur-Bhigwan,Rice(Paddy-Hus),2016,1763,1805,42,2.38230289279637
Chopda,Sorgum(Jawar),2015,1330,1372,42,3.1578947368421053
Umarga,Bajri,2015,1233,1275,42,3.40632603406326
Savner,Sorgum(Jawar),2016,1136,1178,42,3.6971830985915495
Yeola,Wheat(Husked),2015,1534,1576,42,2.7379400260756195
Barshi,Cabbage,2015,27,69,42,155.55555555555554
Lakhandur,Oth.Split Pulses,2016,2443,2485,42,1.7191977077363896
Ahmednagar,Maize,2015,1338,1380,42,3.1390134529147984
Malegaon,Sorgum(Jawar),2015,1530,1572,42,2.7450980392156863
Soygaon,Maize,2016,1310,1352,42,3.2061068702290076
Bhokardan-Pimpalgaon Renu,Maize,2015,1334,1376,42,3.1484257871064467
Sailu,Cotton,2015,4351,4393,42,0.9652953344058837
Jamner-Neri,Maize,2016,1325,1367,42,3.169811320754717
Gevrai,Maize,2016,1254,1296,42,3.349282296650718
Devala,Horse Gram,2016,2646,2688,42,1.5873015873015872
Navapur,PADDY-UNHUSKED,2016,1242,1284,42,3.3816425120772946
Kopargaon,Pigeon Pea (Tur),2015,4880,4921,41,0.8401639344262295
Sakri,Bajri,2014,1132,1173,41,3.6219081272084805
Aurad Shahajani,Wheat(Husked),2015,1260,1301,41,3.253968253968254
Sadak Arjuni,Paddy-Unhusked,2016,1434,1475,41,2.8591352859135286
Bhokardan,Wheat(Husked),2015,1400,1441,41,2.9285714285714284
Kalamb (Os),Sunflower,2014,2772,2813,41,1.479076479076479
Barshi,Flower,2016,41,82,41,100.0
Mangalwedha,Bajri,2015,1414,1455,41,2.8995756718528995
Khed (Shel Pimpalgaon),Brinjal,2015,1256,1297,41,3.2643312101910826
Bhokardan,Soybean,2015,3150,3191,41,1.3015873015873016
Umared,Linseed,2015,4622,4663,41,0.8870618779749027
Chopda,Bajri,2016,1582,1623,41,2.5916561314791404
Arvi,Cotton,2016,4710,4751,41,0.8704883227176221
Umarga,Safflower,2015,2600,2641,41,1.5769230769230769
Dhamangaon-Rly,Cotton,2014,4019,4060,41,1.0201542672306545
Pen,Paddy-Unhusked,2015,1359,1400,41,3.0169242089771893
Telhara,Sorgum(Jawar),2015,1017,1058,41,4.031465093411996
Gangapur,Maize,2016,1385,1426,41,2.96028880866426
Chopda,Maize,2016,1543,1584,41,2.657161373946857
Pune-Pimpri,Brinjal,2014,2317,2358,41,1.7695295640914976
Parbhani,Cotton,2014,4009,4050,41,1.02269892741332
Dondaicha-Sindkheda,Maize,2015,1272,1313,41,3.2232704402515724
Nandurbar,Gram,2015,3935,3976,41,1.0419313850063532
Bhiwapur,Wheat(Husked),2016,1400,1441,41,2.9285714285714284
Barshi,Lemon,2015,141,182,41,29.078014184397162
Sonpeth,Cotton,2015,4112,4153,41,0.9970817120622568
Savner,Sorgum(Jawar),2016,1126,1167,41,3.641207815275311
Bhokar,Gram,2015,4388,4429,41,0.9343664539653601
Savner,Cotton,2016,4591,4632,41,0.8930516227401437
Barshi,Cucumber,2014,34,75,41,120.58823529411765
Tuljapur,Bajri,2016,1217,1258,41,3.3689400164338537
Barshi,Tomato,2015,30,71,41,136.66666666666666
Dharangaon,Sorgum(Jawar),2016,1440,1481,41,2.8472222222222223
Kej,Maize,2014,1362,1403,41,3.0102790014684286
Kalmeshwar,Wheat(Husked),2015,1453,1494,41,2.8217481073640744
Malegaon,Castor Seed,2015,3435,3476,41,1.1935953420669578
Sinner,Soybean,2015,3247,3288,41,1.2627040344933784
Ambejogai,Sorgum(Jawar),2016,1851,1892,41,2.215018908698001
Beed,Wheat(Husked),2014,1774,1815,41,2.3111612175873733
Barshi,Cabbage,2015,26,67,41,157.69230769230768
Varud-Rajura Bazar,Sorgum(Jawar),2015,1175,1216,41,3.4893617021276597
Barshi,Lemon,2015,100,140,40,40.0
Barshi,Kharbuj,2015,80,120,40,50.0
Bhokardan-Pimpalgaon Renu,Maize,2016,1400,1440,40,2.857142857142857
Pen,Paddy-Unhusked,2015,1360,1400,40,2.9411764705882355
Pen,Paddy-Unhusked,2015,1410,1450,40,2.8368794326241136
Bhusaval,Gram,2014,2914,2954,40,1.3726835964310227
Palghar(Bevur),Potato,2015,875,915,40,4.571428571428571
Bhokardan-Pimpalgaon Renu,Sorgum(Jawar),2015,1088,1128,40,3.676470588235294
Pen,Paddy-Unhusked,2015,1360,1400,40,2.9411764705882355
Aurangabad,Math (Bhaji),2015,80,120,40,50.0
Mohol,Wheat(Husked),2015,1941,1981,40,2.0607934054611023
Vaduj,Maize,2015,1411,1451,40,2.8348688873139616
Barshi,Kharbuj,2014,80,120,40,50.0
Barshi-Vairag,Ground Nut Pods (Dry),2015,3970,4010,40,1.0075566750629723
Pen,Paddy-Unhusked,2015,1360,1400,40,2.9411764705882355
Devala,Sorgum(Jawar),2015,1308,1348,40,3.058103975535168
Barshi,Flower,2015,30,70,40,133.33333333333334
Pandharpur,Maize,2014,1067,1107,40,3.7488284910965324
Pen,Paddy-Unhusked,2015,1360,1400,40,2.9411764705882355
Pen,Paddy-Unhusked,2015,1360,1400,40,2.9411764705882355
Vaduj,Maize,2015,1283,1323,40,3.117692907248636
Sadak Arjuni,Paddy-Unhusked,2016,1410,1450,40,2.8368794326241136
Khed,Kanda Pat,2015,470,510,40,8.51063829787234
Kej,Soybean,2015,3171,3211,40,1.261431725007884
Sadak Arjuni,Paddy-Unhusked,2016,1678,1718,40,2.3837902264600714
Yeotmal,Cotton,2015,3900,3940,40,1.0256410256410255
Dondaicha,Maize,2014,1058,1098,40,3.780718336483932
Akluj,Gram,2016,5170,5210,40,0.7736943907156673
Buldhana,Maize,2015,1080,1120,40,3.7037037037037037
Katol,Sorgum(Jawar),2016,1277,1317,40,3.1323414252153485
Sadak Arjuni,Paddy-Unhusked,2016,1410,1450,40,2.8368794326241136
Rahata,Soybean,2016,3528,3568,40,1.1337868480725624
Shirala,Maize,2014,1360,1400,40,2.9411764705882355
Bhokardan,Maize,2016,1576,1616,40,2.5380710659898478
Mangaon(Bhadav),Paddy-Unhusked,2016,1410,1450,40,2.8368794326241136
Rahuri-Vambori,Sunflower,2016,3394,3434,40,1.1785503830288744
Murum,Bajri,2015,1529,1569,40,2.616088947024199
Kalamb (Os),Jaggery,2015,1852,1892,40,2.159827213822894
Devri,PADDY-UNHUSKED,2016,1470,1510,40,2.7210884353741496
Shahapur,Paddy-Unhusked,2016,1410,1450,40,2.8368794326241136
Sadak Arjuni,Paddy-Unhusked,2016,1410,1450,40,2.8368794326241136
Manmad,Ladies Finger,2016,210,250,40,19.047619047619047
Ausa,Maize,2016,1436,1476,40,2.785515320334262
Barshi,Paddy-Unhusked,2015,1402,1442,40,2.8530670470756063
Shegaon,Maize,2014,955,995,40,4.18848167539267
Pen,Paddy-Unhusked,2014,1360,1400,40,2.9411764705882355
Pen,Paddy-Unhusked,2014,1360,1400,40,2.9411764705882355
Pen,Paddy-Unhusked,2014,1360,1400,40,2.9411764705882355
Barshi,Cabbage,2016,47,87,40,85.1063829787234
Fulambri,Maize,2016,1330,1370,40,3.007518796992481
Akluj,Wheat(Husked),2014,1559,1599,40,2.5657472738935216
Rahata,Small Gourd,2016,2660,2700,40,1.5037593984962405
Pandharkawada,Cotton,2015,4037,4077,40,0.9908347783007183
Lakhandur,Green Gram,2016,5770,5810,40,0.6932409012131716
Achalpur,Maize,2015,1340,1380,40,2.985074626865672
Newasa,Cotton,2014,4050,4090,40,0.9876543209876543
Pen,Paddy-Unhusked,2015,1360,1400,40,2.9411764705882355
Savner,Wheat(Husked),2015,1368,1408,40,2.9239766081871346
Sillod-Bharadi,Bajri,2016,1580,1620,40,2.5316455696202533
Sillod-Bharadi,Gram,2016,6640,6680,40,0.6024096385542169
Shahada,Maize,2015,1077,1117,40,3.714020427112349
Islampur,Cucumber,2016,40,80,40,100.0
Newasa,Sorgum(Jawar),2016,1620,1660,40,2.4691358024691357
Tasgaon,Sorgum(Jawar),2014,1560,1600,40,2.5641025641025643
Bhokar,Gram,2016,4095,4135,40,0.9768009768009768
Pen,Paddy-Unhusked,2016,1410,1450,40,2.8368794326241136
Ambejogai,Sorgum(Jawar),2016,1690,1730,40,2.366863905325444
Lakhandur,Linseed,2016,5187,5227,40,0.771158665895508
Pune-Pimpri,Pavtta,2015,2120,2160,40,1.8867924528301887
Lakhandur,Indian Bean,2016,2802,2842,40,1.4275517487508922
Lakhandur,Indian Bean,2016,3868,3908,40,1.0341261633919339
Umared,Green Peas (Dry),2015,2100,2140,40,1.9047619047619047
Akhadabalapur,Wheat(Husked),2016,1790,1830,40,2.2346368715083798
Mahad,Paddy-Unhusked,2015,1360,1400,40,2.9411764705882355
Zarijamini,Soybean,2016,3350,3390,40,1.1940298507462686
Pen,Paddy-Unhusked,2016,1410,1450,40,2.8368794326241136
Samudrapur,Gram,2015,3500,3540,40,1.1428571428571428
Chopda,Maize,2015,1350,1390,40,2.962962962962963
Pen,PADDY-UNHUSKED,2016,1470,1510,40,2.7210884353741496
Pen,Paddy-Unhusked,2016,1466,1506,40,2.728512960436562
Pen,Paddy-Unhusked,2016,1410,1450,40,2.8368794326241136
Pen,Paddy-Unhusked,2015,1374,1414,40,2.911208151382824
Kopargaon,Maize,2016,1439,1479,40,2.779708130646282
Lasalgaon-Vinchur,Maize,2015,1417,1457,40,2.8228652081863093
Pen,Paddy-Unhusked,2016,1410,1450,40,2.8368794326241136
Pen,Paddy-Unhusked,2016,1410,1450,40,2.8368794326241136
Shrirampur-Belapur,Soybean,2015,3440,3480,40,1.1627906976744187
Jamner,Maize,2016,1325,1365,40,3.018867924528302
Pen,Paddy-Unhusked,2016,1410,1450,40,2.8368794326241136
Kalamb (Os),Safflower,2016,2489,2529,40,1.6070711128967456
Atpadi,Maize,2015,1330,1370,40,3.007518796992481
Pen,Paddy-Unhusked,2015,1360,1400,40,2.9411764705882355
Umarga,Gram,2016,5218,5258,40,0.7665772326561902
Sengaon,Wheat(Husked),2015,1636,1676,40,2.444987775061125
Ramtek,Wheat(Husked),2016,1514,1554,40,2.642007926023778
Bhokardan,Soybean,2014,3141,3181,40,1.2734797835084368
Pen,Paddy-Unhusked,2016,1410,1450,40,2.8368794326241136
Ashti (Wardha),Cotton,2016,4604,4644,40,0.8688097306689835
Pen,Paddy-Unhusked,2015,1410,1450,40,2.8368794326241136
Pune-Pimpri,Onion,2014,2400,2440,40,1.6666666666666667
Pen,Paddy-Unhusked,2016,1410,1450,40,2.8368794326241136
Nanded,Wheat(Husked),2015,1513,1553,40,2.6437541308658297
Malegaon,Soybean,2015,3166,3206,40,1.2634238787113077
Mahad,Paddy-Unhusked,2016,1412,1452,40,2.8328611898016995
Solapur,Pigeon Pea (Tur),2015,6185,6225,40,0.6467259498787389
Navapur,Wheat(Husked),2016,1520,1560,40,2.6315789473684212
Pen,Paddy-Unhusked,2016,1410,1450,40,2.8368794326241136
Ner Parasopant,Green Gram,2014,6140,6180,40,0.6514657980456026
Lasur Station,Soybean,2014,2972,3012,40,1.3458950201884252
Jalgaon,Wheat(Husked),2014,1444,1484,40,2.770083102493075
Pune-Pimpri,Potato,2016,896,935,39,4.352678571428571
Kalamb (Os),Sunflower,2015,2980,3019,39,1.308724832214765
Rahata,Maize,2015,1319,1358,39,2.9567854435178167
Ramtek,Potato,2015,209,248,39,18.660287081339714
Varud-Rajura Bazar,Wheat(Husked),2014,1415,1454,39,2.756183745583039
Sangali,Maize,2016,1436,1475,39,2.715877437325905
Mahad,Paddy-Unhusked,2016,1414,1453,39,2.758132956152758
Lakhandur,Pigeon Pea (Tur),2016,6893,6932,39,0.5657913825620194
Shirur,Maize,2015,1184,1223,39,3.293918918918919
Loha,TURMERIC,2016,6811,6850,39,0.572603141976215
Ramtek,Paddy-Unhusked,2016,2050,2089,39,1.9024390243902438
Barshi,Paddy-Unhusked,2015,1575,1614,39,2.4761904761904763
Lonand,Maize,2015,1320,1359,39,2.9545454545454546
Tumsar,Other Cereals,2016,2596,2635,39,1.50231124807396
Sangamner,SORGUM(JAWAR),2016,1754,1793,39,2.2234891676168758
Mandhal,Wheat(Husked),2015,1420,1459,39,2.7464788732394365
Mandhal,COTTON,2016,4733,4772,39,0.8240016902598775
Partur,Bajri,2016,1561,1600,39,2.498398462524023
Bhokardan,Sorgum(Jawar),2016,1609,1648,39,2.4238657551274083
Palghar(Bevur),Wheat(Husked),2015,1890,1929,39,2.0634920634920637
Ramtek,Ladies Finger,2015,165,204,39,23.636363636363637
Jalna-Badnapur,Cotton,2015,4316,4355,39,0.9036144578313253
Ahmedpur,Soybean,2015,3276,3315,39,1.1904761904761905
Mangalwedha,Maize,2016,1817,1856,39,2.1463951568519537
Pen,Paddy-Unhusked,2015,1303,1342,39,2.9930928626247124
Mohol,Maize,2015,1215,1254,39,3.2098765432098766
Achalpur,Maize,2016,1315,1354,39,2.9657794676806084
Dhamangaon-Rly,Cotton,2014,3968,4007,39,0.9828629032258065
Mangalwedha,Bajri,2014,1323,1362,39,2.947845804988662
Manwat,Bajri,2015,1242,1281,39,3.140096618357488
Dharangaon,Sorgum(Jawar),2016,1393,1432,39,2.799712849964106
Vaijapur,Maize,2016,1405,1444,39,2.775800711743772
Barshi,Paddy-Unhusked,2016,1701,1740,39,2.292768959435626
Devala,Maize,2016,1366,1405,39,2.8550512445095166
Palghar(Bevur),Wheat(Husked),2016,2204,2243,39,1.7695099818511797
Savner,Maize,2014,989,1028,39,3.9433771486349847
Arjuni Morgaon,Paddy-Unhusked,2016,2024,2063,39,1.9268774703557312
Barshi,Maize,2016,1403,1442,39,2.77975766215253
Pachora,Bajri,2015,1460,1499,39,2.671232876712329
Bhokardan,Maize,2016,1346,1385,39,2.8974739970282317
Rahuri-Vambori,Pigeon Pea (Tur),2016,7464,7503,39,0.522508038585209
Umarga,Maize,2015,1222,1261,39,3.1914893617021276
Sakri,Bajri,2016,1638,1677,39,2.380952380952381
Sangli-Miraj,Maize,2016,1763,1802,39,2.212138400453772
Palghar(Bevur),Onion,2016,813,852,39,4.797047970479705
Dharangaon,Wheat(Husked),2016,1777,1815,38,2.1384355655599325
Mohol,Maize,2015,1252,1290,38,3.0351437699680512
Indapur-Bhigwan,Rice(Paddy-Hus),2015,1425,1463,38,2.6666666666666665
Akola,MAIZE,2016,1470,1508,38,2.5850340136054424
Bhusaval,Maize,2015,1100,1138,38,3.4545454545454546
Chopda,Gram,2015,3550,3588,38,1.0704225352112675
Chopda,Bajri,2015,1275,1313,38,2.980392156862745
Kej,Soybean,2015,3254,3292,38,1.1677934849416103
Ghoti,FLOWER,2016,980,1018,38,3.877551020408163
Pune,Jaggery,2015,2465,2503,38,1.54158215010142
Malegaon,Maize,2016,1652,1690,38,2.3002421307506054
Lakhandur,Paddy-Unhusked,2016,1677,1715,38,2.2659511031604054
Kurdwadi,Maize,2016,1440,1478,38,2.638888888888889
Shegaon,Green Gram,2015,5813,5851,38,0.653707207982109
Bhokardan-Pimpalgaon Renu,Soybean,2015,3050,3088,38,1.2459016393442623
Navapur,Flower,2016,1077,1115,38,3.5283194057567315
Pandharpur,Wheat(Husked),2015,1425,1463,38,2.6666666666666665
Shegaon,Mustard,2015,3140,3178,38,1.2101910828025477
Dharangaon,Wheat(Husked),2016,1637,1675,38,2.321319486866219
Shegaon,Bajri,2015,1313,1351,38,2.8941355674028943
Jintur-Bori,Gram,2016,4080,4118,38,0.9313725490196079
Jalna,Maize,2016,1700,1738,38,2.235294117647059
Sangli-Miraj,MAIZE,2016,1410,1448,38,2.6950354609929077
Ahmednagar,Maize,2016,1515,1553,38,2.5082508250825084
Indapur-Bhigwan,Rice(Paddy-Hus),2015,1436,1474,38,2.6462395543175488
Rahata,Soybean,2016,3533,3571,38,1.075573167279932
Sakri,Wheat(Husked),2015,1270,1308,38,2.9921259842519685
Gevrai,Mustard,2016,3500,3538,38,1.0857142857142856
Shahada,Bajri,2016,1493,1531,38,2.5452109845947755
Shahada,Bajri,2016,1755,1793,38,2.1652421652421654
Tuljapur,Paddy-Unhusked,2014,775,813,38,4.903225806451613
Arvi,Cotton,2015,3904,3942,38,0.9733606557377049
Latur-Murud,Maize,2016,1350,1388,38,2.814814814814815
Raver,Bajri,2015,1185,1223,38,3.2067510548523206
Jalgaon,Sorgum(Jawar),2016,1350,1388,38,2.814814814814815
Akluj,Pigeon Pea (Tur),2015,4350,4388,38,0.8735632183908046
Nanded,Soybean,2016,3546,3584,38,1.071630005640158
Arjuni Morgaon,Paddy-Unhusked,2016,1964,2002,38,1.934826883910387
Rahuri-Vambori,Soybean,2016,3610,3648,38,1.0526315789473684
Lonand,Maize,2015,1450,1488,38,2.6206896551724137
Lasur Station,Soybean,2016,3775,3813,38,1.0066225165562914
Mandhal,Soybean,2016,3195,3233,38,1.189358372456964
Devala,Green Gram,2015,7599,7637,38,0.5000657981313331
Tuljapur,Turmeric,2015,5839,5877,38,0.6507963692413085
Nanded,Soybean,2015,3253,3291,38,1.168152474638795
Bhokardan,Maize,2015,1253,1291,38,3.0327214684756583
Nandurbar,Pigeon Pea (Tur),2016,6961,6999,38,0.5458985777905473
Shirur,Ground Nut Pods (Dry),2015,3650,3688,38,1.0410958904109588
Murtizapur,Wheat(Husked),2015,1401,1439,38,2.712348322626695
Ramtek,PADDY-UNHUSKED,2016,1706,1744,38,2.2274325908558033
Barshi-Vairag,Maize,2016,1439,1477,38,2.640722724113968
Barshi-Vairag,Maize,2015,1378,1416,38,2.7576197387518144
Jalgaon,Bajri,2015,1373,1411,38,2.767662053896577
Washim-Ansing,Wheat(Husked),2016,1490,1528,38,2.5503355704697985
Katol,Maize,2015,1216,1254,38,3.125
Sangamner,Sorgum(Jawar),2016,1870,1908,38,2.0320855614973263
Bhusaval,Sorgum(Jawar),2016,1413,1451,38,2.689313517338995
Vaduj,MAIZE,2016,1335,1373,38,2.846441947565543
Dhadgaon,Maize,2016,1283,1321,38,2.9618082618862043
Kalamb (Os),Sunflower,2016,3271,3309,38,1.1617242433506574
Sangamner,Maize,2016,1397,1434,37,2.6485325697924123
Pune-Pimpri,Beet Root,2016,1645,1682,37,2.2492401215805473
Bhokardan,BAJRI,2016,1403,1440,37,2.6372059871703493
Udgir,Soybean,2015,3287,3324,37,1.1256464861575906
Bhokardan-Pimpalgaon Renu,Wheat(Husked),2015,1413,1450,37,2.618542108987969
Pandharpur,Wheat(Husked),2014,1560,1597,37,2.371794871794872
Ahmedpur,Soybean,2016,3607,3644,37,1.0257831993346271
Jintur-Bori,Wheat(Husked),2015,1710,1747,37,2.1637426900584797
Jintur-Bori,Sorgum(Jawar),2014,1190,1227,37,3.1092436974789917
Jalgaon,Maize,2015,1258,1295,37,2.9411764705882355
Washim-Ansing,Green Gram,2016,5763,5800,37,0.6420267221933021
Bhokardan-Pimpalgaon Renu,Maize,2015,1253,1290,37,2.9529130087789306
Shahada,Bajri,2015,1115,1152,37,3.318385650224215
Khed (Shel Pimpalgaon),Ladies Finger,2016,2803,2840,37,1.3200142704245452
Pune,Jaggery,2015,2376,2413,37,1.5572390572390573
Devala,Soup Berries,2016,593,630,37,6.239460370994941
Shegaon,Bajri,2015,1409,1446,37,2.62597586941093
Bhokardan-Pimpalgaon Renu,Sorgum(Jawar),2014,1208,1245,37,3.062913907284768
Tumsar,Linseed,2016,5803,5840,37,0.6376012407375495
Dharangaon,Bajri,2016,1681,1718,37,2.201070791195717
Barshi,Flower,2015,41,78,37,90.2439024390244
Shahada,Bajri,2016,1680,1717,37,2.2023809523809526
Digras,WHEAT(HUSKED),2016,1752,1789,37,2.1118721461187215
Rahata,Sorgum(Jawar),2015,1421,1458,37,2.6038001407459537
Parbhani,Cotton,2015,4223,4260,37,0.8761543926118873
Sangli-Miraj,Maize,2016,1464,1501,37,2.5273224043715845
Khed (Shel Pimpalgaon),Flower,2015,513,550,37,7.212475633528265
Pune-Pimpri,Chavli (Shenga ),2016,2038,2075,37,1.815505397448479
Akhadabalapur,Wheat(Husked),2014,1788,1825,37,2.069351230425056
Barshi,Cucumber,2014,41,78,37,90.2439024390244
Bhokardan-Pimpalgaon Renu,Maize,2016,1318,1355,37,2.8072837632776935
Shrigonda,Maize,2016,1413,1450,37,2.618542108987969
Gevrai,Sunflower,2016,3457,3494,37,1.0702921608330922
Gevrai,Soybean,2016,3445,3482,37,1.0740203193033382
Sillod-Bharadi,Maize,2015,1385,1422,37,2.6714801444043323
Lasalgaon-Niphad,Maize,2016,1440,1477,37,2.5694444444444446
Chandur Rly.,Wheat(Husked),2014,1375,1412,37,2.690909090909091
Gevrai,Safflower,2016,2222,2259,37,1.6651665166516652
Alibag,Paddy-Unhusked,2016,1489,1526,37,2.4848891873740766
Sakri,Bajri,2016,1344,1381,37,2.7529761904761907
Ambejogai,Sorgum(Jawar),2016,1720,1757,37,2.1511627906976742
Lasalgaon-Vinchur,Bajri,2015,1453,1490,37,2.5464556090846524
Dudhani,Maize,2016,1428,1465,37,2.5910364145658265
Kalamb (Os),Sunflower,2015,2949,2986,37,1.2546625974906749
Sangali,Maize,2016,1483,1520,37,2.4949426837491573
Nanded,Wheat(Husked),2015,1547,1584,37,2.391725921137686
Lasur Station,Castor Seed,2015,3101,3138,37,1.1931634956465655
Yeola,Sorgum(Jawar),2016,1818,1855,37,2.0352035203520353
Murum,Soybean,2014,3288,3325,37,1.1253041362530414
Paithan,Sorgum(Jawar),2015,1543,1580,37,2.3979261179520415
Aurangabad,Soybean,2014,3164,3201,37,1.1694058154235145
Devala,Wheat(Husked),2014,1523,1560,37,2.4294156270518714
Tuljapur,Gram,2015,3775,3812,37,0.9801324503311258
Kada,Maize,2015,1417,1454,37,2.611150317572336
Jalgaon,Wheat(Husked),2015,1498,1535,37,2.4699599465954605
Sindi,Cotton,2014,3921,3958,37,0.9436368273399643
Barshi,Cabbage,2015,50,87,37,74.0
Navapur,Wheat(Husked),2015,1493,1530,37,2.478231748158071
Lakhandur,Coriander (Dry),2016,6878,6915,37,0.5379470776388485
Jintur,Turmeric,2014,4501,4538,37,0.822039546767385
Mohol,Maize,2016,1410,1447,37,2.624113475177305
Pusad,Rice(Paddy-Hus),2015,750,786,36,4.8
Jamner,Maize,2016,1325,1361,36,2.7169811320754715
Dound,Maize,2015,1480,1516,36,2.4324324324324325
Chalisgaon,Rice(Paddy-Hus),2015,1300,1336,36,2.769230769230769
Kannad,Sorgum(Jawar),2016,1501,1537,36,2.3984010659560293
Vaijapur,Maize,2015,1159,1195,36,3.106125970664366
Raver,Rice(Paddy-Hus),2016,1500,1536,36,2.4
Pen,Paddy-Unhusked,2014,1318,1354,36,2.731411229135053
Arjuni Morgaon,Paddy-Unhusked,2016,1597,1633,36,2.2542266750156545
Akhadabalapur,Wheat(Husked),2016,1764,1800,36,2.0408163265306123
Sailu,Wheat(Husked),2014,1457,1493,36,2.4708304735758406
Nanded,Wheat(Husked),2015,1574,1610,36,2.2871664548919948
Lakhani,Paddy-Unhusked,2016,2315,2351,36,1.5550755939524838
Shrirampur-Belapur,Gram,2015,3459,3495,36,1.0407632263660018
Karanja,Black Gram,2015,5903,5939,36,0.6098593935287142
Sangli-Miraj,Maize,2016,1514,1550,36,2.3778071334214004
Ashti (Wardha),Cotton,2016,4811,4847,36,0.7482851797963002
Ashti (Wardha),Cotton,2016,4958,4994,36,0.7260992335619201
Dharangaon,Sorgum(Jawar),2016,1461,1497,36,2.4640657084188913
Varud-Rajura Bazar,Sorgum(Jawar),2016,1435,1471,36,2.508710801393728
Parli-Vaijnath,Sunflower,2015,3440,3476,36,1.0465116279069768
Sillod-Bharadi,Maize,2016,1570,1606,36,2.2929936305732483
Bhusaval,Sorgum(Jawar),2016,1471,1507,36,2.4473147518694764
Lakhandur,Paddy-Unhusked,2015,1595,1631,36,2.25705329153605
Shrirampur-Belapur,Wheat(Husked),2016,1507,1543,36,2.38885202388852
Kolhapur,Banana,2016,1023,1059,36,3.5190615835777126
Dudhani,Maize,2015,1396,1432,36,2.5787965616045847
Vaijapur,Soybean,2015,3729,3765,36,0.9654062751407884
Indapur-Bhigwan,Rice(Paddy-Hus),2016,1745,1781,36,2.0630372492836675
Yeotmal,Wheat(Husked),2015,1524,1560,36,2.3622047244094486
Udgir,Soybean,2015,3630,3666,36,0.9917355371900827
Umarga,Bajri,2016,1401,1437,36,2.569593147751606
Vaijapur,Maize,2016,1390,1426,36,2.5899280575539567
Pandharpur,Sorgum(Jawar),2015,1866,1902,36,1.9292604501607717
Chandur Rly.,Wheat(Husked),2016,1457,1493,36,2.4708304735758406
Umarga,Bajri,2015,1124,1160,36,3.202846975088968
Kej,Maize,2016,1416,1452,36,2.542372881355932
Bori Arab,Gram,2016,3973,4009,36,0.9061162849232318
Bhokardan,Sorgum(Jawar),2015,1089,1125,36,3.3057851239669422
Rahata,Bajri,2014,1385,1421,36,2.5992779783393503
Pune,Maize,2015,1427,1463,36,2.5227750525578134
Barshi,Lemon,2015,100,136,36,36.0
Shirur,Maize,2015,1184,1220,36,3.0405405405405403
Aurad Shahajani,Sorgum(Jawar),2016,1570,1605,35,2.229299363057325
Bhokardan,MAIZE,2016,1055,1090,35,3.3175355450236967
Shirpur,Matki,2015,6939,6974,35,0.5043954460296872
Aurangabad,Spinach,2016,65,100,35,53.84615384615385
Indapur-Bhigwan,Rice(Paddy-Hus),2015,1415,1450,35,2.4734982332155475
Karanja,Cotton,2014,4021,4056,35,0.870430241233524
Ahmedpur,Maize,2015,1331,1366,35,2.629601803155522
Bhokardan,Sorgum(Jawar),2015,1088,1123,35,3.2169117647058822
Sengaon,Gram,2015,4215,4250,35,0.830367734282325
Hadgaon,Cotton,2014,3968,4003,35,0.8820564516129032
Shahada,Maize,2016,1524,1559,35,2.2965879265091864
Nanded,Sorgum(Jawar),2015,1226,1261,35,2.8548123980424145
Nashik-Devlali,Chavli (Pala),2016,500,535,35,7.0
Kille Dharur,Maize,2015,1365,1400,35,2.5641025641025643
Tasgaon,Maize,2016,1385,1420,35,2.527075812274368
Tasgaon,Maize,2016,1385,1420,35,2.527075812274368
Kalamb (Os),Bajri,2015,1454,1489,35,2.407152682255846
Sangamner,Sorgum(Jawar),2016,1738,1773,35,2.013808975834292
Savner,Cotton,2016,4343,4378,35,0.8058945429426664
Beed,Maize,2016,1539,1574,35,2.2742040285899936
Jalgaon,Wheat(Husked),2014,1459,1494,35,2.3989033584647017
Ambejogai,Sorgum(Jawar),2015,2635,2670,35,1.3282732447817838
Dharangaon,Bajri,2016,1586,1621,35,2.2068095838587642
Dharangaon,Bajri,2016,1702,1737,35,2.056404230317274
Bhokardan,Bajri,2015,1283,1318,35,2.7279812938425567
Washim,Mustard,2015,3150,3185,35,1.1111111111111112
Parli-Vaijnath,Wheat(Husked),2014,1360,1395,35,2.573529411764706
Beed,Soybean,2014,3200,3235,35,1.09375
Raver,Maize,2015,1300,1335,35,2.6923076923076925
Arjuni Morgaon,Paddy-Unhusked,2015,1558,1593,35,2.246469833119384
Arjuni Morgaon,Paddy-Unhusked,2016,1688,1723,35,2.0734597156398102
Bhokar,Soybean,2015,3529,3564,35,0.9917823746103712
Indapur (Nimgaon Ketki),Maize,2016,1531,1566,35,2.286087524493795
Navapur,CABBAGE,2016,442,477,35,7.918552036199095
Bhokardan,Soybean,2014,2853,2888,35,1.2267788293024886
Vasai,Paddy-Unhusked,2016,1470,1505,35,2.380952380952381
Osmanabad,Wheat(Husked),2014,1417,1452,35,2.4700070571630204
Malegaon,Castor Seed,2014,3356,3391,35,1.0429082240762813
Bhokardan,SORGUM(JAWAR),2016,1610,1645,35,2.1739130434782608
Bhokardan-Pimpalgaon Renu,Sorgum(Jawar),2016,1550,1585,35,2.2580645161290325
Barshi,Black Gram,2015,8086,8121,35,0.4328468958694039
Murum,Soybean,2014,3135,3170,35,1.1164274322169059
Bhokardan-Pimpalgaon Renu,Wheat(Husked),2015,1400,1435,35,2.5
Tuljapur,Gram,2014,2328,2363,35,1.5034364261168385
Kalamb (Os),Castor Seed,2016,2692,2727,35,1.300148588410104
Shegaon,Thymol/Lovage,2014,6229,6264,35,0.5618879434901268
Shevgaon-Bodhegaon,Wheat(Husked),2016,1786,1821,35,1.9596864501679732
Bhokardan-Pimpalgaon Renu,Sorgum(Jawar),2015,1225,1260,35,2.857142857142857
Shrirampur-Belapur,Wheat(Husked),2016,1628,1663,35,2.14987714987715
Sakri,Bajri,2015,1159,1194,35,3.019844693701467
Kalamb (Os),Castor Seed,2016,3133,3168,35,1.117140121289499
Pandharpur,Maize,2016,1442,1477,35,2.4271844660194173
Bhokardan-Pimpalgaon Renu,Maize,2015,1175,1210,35,2.978723404255319
Akot,Maize,2016,1265,1300,35,2.766798418972332
Kej,Tamarind Seed,2016,1748,1783,35,2.002288329519451
Sailu,Bajri,2014,1550,1585,35,2.2580645161290325
Rahuri-Vambori,Maize,2015,1206,1241,35,2.902155887230514
Jalna-Badnapur,Sorgum(Jawar),2016,1488,1523,35,2.3521505376344085
Bhusaval,Wheat(Husked),2016,1404,1439,35,2.492877492877493
Pandharpur,MAIZE,2016,1298,1333,35,2.6964560862865947
Devala,Sorgum(Jawar),2015,1657,1692,35,2.112251056125528
Jalgaon,Spinach,2015,1695,1730,35,2.0648967551622417
Lohara,Bajri,2016,1273,1307,34,2.670856245090338
Nanded,Wheat(Husked),2015,1382,1416,34,2.460202604920405
Navapur,Maize,2016,1533,1567,34,2.217873450750163
Parli-Vaijnath,Wheat(Husked),2015,1333,1367,34,2.550637659414854
Hingoli,Cotton,2015,4020,4054,34,0.845771144278607
Tuljapur,Maize,2016,1358,1392,34,2.503681885125184
Sillod-Bharadi,Maize,2016,1379,1413,34,2.4655547498187094
Barshi,Bajri,2015,1329,1363,34,2.558314522197141
Indapur-Bhigwan,Rice(Paddy-Hus),2014,1429,1463,34,2.3792862141357594
Umared,Coriander (Dry),2016,5833,5867,34,0.5828904508829076
Yeola,Maize,2015,1379,1413,34,2.4655547498187094
Ahmednagar,Bajri,2016,1733,1767,34,1.9619157530294287
Jalgaon,Black Gram,2016,7133,7167,34,0.476657787747091
Dhule,Maize,2016,1627,1661,34,2.089735709895513
Pune-Pimpri,Beet Root,2015,1533,1567,34,2.217873450750163
Udgir,Soybean,2016,3765,3799,34,0.9030544488711819
Dudhani,Bajri,2016,1606,1640,34,2.1170610211706102
Dondaicha-Sindkheda,Wheat(Husked),2015,1479,1513,34,2.2988505747126435
Bhiwapur,Paddy-Unhusked,2016,2313,2347,34,1.4699524427150887
Khamgaon,Bajri,2015,1019,1053,34,3.336604514229637
Sangali,Maize,2016,1466,1500,34,2.319236016371078
Tumsar,Green Gram,2016,4072,4106,34,0.8349705304518664
Bhokardan-Pimpalgaon Renu,Maize,2015,1154,1188,34,2.946273830155979
Arjuni Morgaon,Paddy-Unhusked,2016,1781,1815,34,1.9090398652442448
Shegaon,Sunflower,2015,2968,3002,34,1.1455525606469004
Purna,Sorgum(Jawar),2016,1476,1510,34,2.303523035230352
Rahuri,Bajri,2014,1351,1385,34,2.516654330125833
Indapur-Bhigwan,Sunflower,2015,2650,2684,34,1.2830188679245282
Mandhal,Wheat(Husked),2015,1460,1494,34,2.328767123287671
Sinner,Sorgum(Jawar),2016,1558,1592,34,2.1822849807445444
Nanded,Sorgum(Jawar),2015,1310,1344,34,2.595419847328244
Manchar,Shepu,2015,1176,1210,34,2.891156462585034
Bhokardan,Maize,2016,1340,1374,34,2.537313432835821
Kalamb (Os),Maize,2015,1138,1172,34,2.9876977152899826
Indapur,Bajri,2016,1663,1697,34,2.0444978953698136
Murum,Gram,2016,7227,7261,34,0.47045800470458005
Rahata,Maize,2016,1299,1333,34,2.617397998460354
Chopda,Bajri,2015,1225,1259,34,2.7755102040816326
Kurdwadi,Maize,2015,1496,1530,34,2.272727272727273
Umarga,Bajri,2016,1470,1504,34,2.312925170068027
Katol,Sorgum(Jawar),2015,1255,1289,34,2.7091633466135456
Mangrulpeer,Green Gram,2016,5310,5344,34,0.64030131826742
Barshi,Sunflower,2014,3133,3167,34,1.0852218321097988
Vaijapur,Maize,2016,1749,1783,34,1.9439679817038307
Malegaon,Castor Seed,2015,3395,3429,34,1.0014727540500736
Lakhani,Paddy-Unhusked,2015,2366,2400,34,1.4370245139475908
Rahuri-Vambori,Soybean,2015,3600,3634,34,0.9444444444444444
Katol,Wheat(Husked),2015,1557,1591,34,2.1836865767501608
Dhule,Matki,2015,6108,6142,34,0.5566470203012442
Indapur-Bhigwan,Soybean,2016,3333,3367,34,1.02010201020102
Khed (Shel Pimpalgaon),Farshi,2015,2283,2317,34,1.4892685063512923
Barshi,Tomato,2014,42,76,34,80.95238095238095
Mangalwedha,Maize,2016,1422,1456,34,2.390998593530239
Nandurbar,Maize,2015,1200,1234,34,2.8333333333333335
Pune-Pimpri,Beet Root,2016,1433,1467,34,2.3726448011165386
Rahata,Soybean,2016,3554,3588,34,0.9566685424873382
Tumsar,Sarsav,2016,2983,3017,34,1.1397921555481059
Ahmednagar,Maize,2016,1608,1642,34,2.1144278606965172
Lasalgaon,Sorgum(Jawar),2015,1273,1307,34,2.670856245090338
Mangalwedha,Maize,2015,1507,1541,34,2.2561380225613803
Bhokardan,Cotton,2015,4147,4181,34,0.8198697853870268
Akluj,Math (Bhaji),2016,101,135,34,33.663366336633665
Tuljapur,Soybean,2015,3528,3562,34,0.963718820861678
Lakhani,Paddy-Unhusked,2016,1665,1699,34,2.042042042042042
Ahmedpur,Soybean,2016,3683,3717,34,0.9231604670105892
Bhusaval,Wheat(Husked),2016,1649,1683,34,2.0618556701030926
Akluj,Coriander  ,2016,68,102,34,50.0
Ambejogai,Sesamum,2015,7875,7908,33,0.41904761904761906
Lakhandur,PADDY-UNHUSKED,2016,1542,1575,33,2.140077821011673
Rahuri,Gram,2015,3322,3355,33,0.9933774834437086
Mandhal,Cotton,2015,4117,4150,33,0.801554529997571
Barshi,Flower,2015,20,53,33,165.0
Bhokar,Gram,2015,3186,3219,33,1.0357815442561205
Khamgaon,Maize,2016,1446,1479,33,2.2821576763485476
Jalgaon Jamod-Aasalgaon,Maize,2014,1067,1100,33,3.0927835051546393
Bhokardan-Pimpalgaon Renu,Maize,2016,1567,1600,33,2.1059349074664966
Bhokar,Cotton,2014,3956,3989,33,0.8341759352881699
Tumsar,Sarsav,2016,2900,2933,33,1.1379310344827587
Devala,Matki,2016,6715,6748,33,0.4914370811615786
Bhokardan-Pimpalgaon Renu,Maize,2015,1050,1083,33,3.142857142857143
Khamgaon,Bajri,2016,1592,1625,33,2.0728643216080402
Lasalgaon,Rice(Paddy-Hus),2015,1628,1661,33,2.027027027027027
Pandharpur,Sorgum(Jawar),2015,1769,1802,33,1.8654607122668174
Newasa,Bajri,2015,1302,1335,33,2.5345622119815667
Ghatanji,Cotton,2015,4012,4045,33,0.8225324027916251
Dudhani,Bajri,2015,1114,1147,33,2.96229802513465
Udgir,Soybean,2014,3270,3303,33,1.0091743119266054
Barshi,Tomato,2014,27,60,33,122.22222222222223
Nira-Saswad,Maize,2016,1557,1590,33,2.1194605009633913
Pune-Pimpri,Squash Gourd,2015,1167,1200,33,2.827763496143959
Koregaon,Gram,2014,2967,3000,33,1.1122345803842264
Sonpeth,Gram,2014,2534,2567,33,1.3022888713496448
Bhokardan,Sorgum(Jawar),2016,1552,1585,33,2.1262886597938144
Shevgaon-Bodhegaon,Maize,2015,1011,1044,33,3.264094955489614
Barshi,PIGEON PEA (TUR),2016,5167,5200,33,0.6386684730017418
Gangapur,SOYBEAN,2016,2628,2661,33,1.2557077625570776
Kalamb (Os),Sesamum,2015,6550,6583,33,0.5038167938931297
Sangamner,Soybean,2015,4000,4033,33,0.825
Shirur,Maize,2016,1467,1500,33,2.2494887525562373
Barshi,Water Melon,2016,43,76,33,76.74418604651163
Sengaon,Wheat(Husked),2015,1592,1625,33,2.0728643216080402
Shevgaon-Bodhegaon,Wheat(Husked),2016,1767,1800,33,1.867572156196944
Udgir,Soybean,2015,3287,3320,33,1.0039549741405538
Udgir,SORGUM(JAWAR),2016,1134,1167,33,2.9100529100529102
Osmanabad,Pigeon Pea (Tur),2016,8267,8300,33,0.3991774525220757
Nanded,Green Gram,2015,6617,6650,33,0.498715429953151
Navapur,Onion,2016,717,750,33,4.602510460251046
Ausa,Castor Seed,2015,3001,3034,33,1.0996334555148284
Murud,Paddy-Unhusked,2016,1489,1522,33,2.216252518468771
Rahata,Sorgum(Jawar),2015,1221,1254,33,2.7027027027027026
Solapur,Papai,2015,217,250,33,15.2073732718894
Navapur,Paddy-Unhusked,2016,1200,1233,33,2.75
Akhadabalapur,Wheat(Husked),2016,1767,1800,33,1.867572156196944
Varud-Rajura Bazar,Sorgum(Jawar),2015,1350,1383,33,2.4444444444444446
Pandharkawada,Soybean,2016,3317,3350,33,0.9948748869460355
Arjuni Morgaon,Paddy-Unhusked,2016,1842,1875,33,1.791530944625407
Pune-Pimpri,Potato,2015,1167,1200,33,2.827763496143959
Tumsar,Other Cereals,2015,1948,1981,33,1.6940451745379876
Savner,Wheat(Husked),2014,1373,1406,33,2.403495994173343
Lakhandur,Paddy-Unhusked,2016,1719,1752,33,1.9197207678883073
Umared,Coriander (Dry),2016,7567,7600,33,0.4361041363816572
Nilanga,Green Gram,2015,7815,7848,33,0.42226487523992323
Nanded,Sorgum(Jawar),2016,1442,1475,33,2.2884882108183078
Kurdwadi,Maize,2016,1414,1447,33,2.333804809052334
Lonand,Maize,2015,1442,1475,33,2.2884882108183078
Savner,Sorgum(Jawar),2016,1152,1184,32,2.7777777777777777
Kalvan,Soybean,2016,4087,4119,32,0.7829703939319794
Barshi,Cabbage,2015,38,70,32,84.21052631578948
Pusad,Bajri,2016,1893,1925,32,1.6904384574749076
Ramtek,Chavli (Shenga ),2015,307,339,32,10.423452768729641
Majalgaon,Sesamum,2015,6968,7000,32,0.4592422502870264
Katol,Wheat(Husked),2015,1452,1484,32,2.203856749311295
Jamner-Neri,Maize,2016,1325,1357,32,2.4150943396226414
Jintur-Bori,Wheat(Husked),2014,1419,1451,32,2.255109231853418
Nanded,Sorgum(Jawar),2016,1524,1556,32,2.099737532808399
Ramtek,Onion,2015,310,342,32,10.32258064516129
Basmat,Castor Seed,2015,3328,3360,32,0.9615384615384616
Bhokardan,WHEAT(HUSKED),2016,1604,1636,32,1.9950124688279303
Ahmedpur,Soybean,2015,3251,3283,32,0.9843125192248539
Manmad,Wheat(Husked),2015,1562,1594,32,2.0486555697823303
Sillod-Bharadi,Maize,2016,1417,1449,32,2.2582921665490474
Bhokardan,Bajri,2015,1200,1232,32,2.6666666666666665
Jalgaon,Wheat(Husked),2016,1721,1753,32,1.8593840790238234
Karanja,Sunflower,2015,2922,2954,32,1.0951403148528405
Indapur-Bhigwan,Rice(Paddy-Hus),2016,1608,1640,32,1.9900497512437811
Katol,Wheat(Husked),2014,1511,1543,32,2.1178027796161483
Yeotmal,Wheat(Husked),2015,1453,1485,32,2.202339986235375
Barshi,Shevga,2016,36,68,32,88.88888888888889
Raver,Bajri,2015,1204,1236,32,2.6578073089700998
Katol,Wheat(Husked),2015,1473,1505,32,2.1724372029871013
Jalgaon,Spinach,2016,1836,1868,32,1.7429193899782136
Udgir,Sorgum(Jawar),2016,1276,1308,32,2.5078369905956115
Varud-Rajura Bazar,Wheat(Husked),2015,1346,1378,32,2.37741456166419
Rahata,Sorgum(Jawar),2015,1222,1254,32,2.618657937806874
Shrirampur,Bajri,2016,1840,1872,32,1.7391304347826086
Arjuni Morgaon,Paddy-Unhusked,2016,2061,2093,32,1.5526443474041727
Devala,Sorgum(Jawar),2016,1449,1481,32,2.2084195997239475
Bhokar,Sesamum,2015,7685,7717,32,0.41639557579700714
Barshi,Flower,2014,34,66,32,94.11764705882354
Devala,Sorgum(Jawar),2016,1484,1516,32,2.1563342318059298
Rahuri-Vambori,Bajri,2016,1450,1482,32,2.206896551724138
Nandurbar,Black Gram,2014,5014,5046,32,0.6382130035899481
Katol,Wheat(Husked),2015,1556,1588,32,2.056555269922879
Vaijapur,Soybean,2015,3610,3642,32,0.8864265927977839
Ramtek,Brinjal,2015,142,174,32,22.535211267605632
Khed (Shel Pimpalgaon),Cucumber,2016,387,419,32,8.268733850129198
Bhokardan-Pimpalgaon Renu,Maize,2016,1538,1569,31,2.0156046814044215
Daryapur,Sorgum(Jawar),2016,1397,1428,31,2.2190408017179672
Udgir,Black Gram,2016,6000,6031,31,0.5166666666666667
Lasalgaon-Vinchur,Maize,2016,1603,1634,31,1.933873986275733
Bhokardan-Pimpalgaon Renu,Sorgum(Jawar),2016,1300,1331,31,2.3846153846153846
Udgir,Soybean,2016,3884,3915,31,0.7981462409886715
Devala,Maize,2016,1399,1430,31,2.2158684774839172
Bhusaval,Maize,2015,1081,1112,31,2.8677150786308974
Dharangaon,Sorgum(Jawar),2016,1422,1453,31,2.180028129395218
Vaduj,Maize,2014,1315,1346,31,2.3574144486692017
Savner,Sorgum(Jawar),2016,1177,1208,31,2.6338147833474936
Pusad,Sesamum,2016,5818,5849,31,0.5328291509109659
Shevgaon-Bodhegaon,Wheat(Husked),2016,1764,1795,31,1.7573696145124718
Shirur,Bajri,2015,1303,1334,31,2.3791250959324635
Rahuri-Vambori,Maize,2015,1318,1349,31,2.3520485584218513
Raver,Rice(Paddy-Hus),2016,1580,1611,31,1.9620253164556962
Murum,Soybean,2014,3196,3227,31,0.9699624530663329
Varud-Rajura Bazar,Pigeon Pea (Tur),2014,4800,4831,31,0.6458333333333334
Mandhal,Sunflower,2016,3827,3858,31,0.8100339691664489
Basmat,Soybean,2016,3559,3590,31,0.8710311885361056
Shahada,Bajri,2015,1238,1269,31,2.504038772213247
Umared,Lang,2015,1787,1818,31,1.7347509792949076
Nanded,Wheat(Husked),2015,1432,1463,31,2.164804469273743
Nanded,Sorgum(Jawar),2016,1492,1523,31,2.0777479892761392
Dhule,Castor Seed,2015,3300,3331,31,0.9393939393939394
Arjuni Morgaon,Paddy-Unhusked,2015,1530,1561,31,2.026143790849673
Rahuri,Maize,2014,1310,1341,31,2.366412213740458
Akkalkuwa,MAIZE,2016,1327,1358,31,2.3360964581763377
Navapur,BRINJAL,2016,575,606,31,5.391304347826087
Parli-Vaijnath,BAJRI,2016,1107,1138,31,2.8003613369467026
Sengaon,Ground Nut Pods (Dry),2015,5419,5450,31,0.5720612659162208
Nandurbar,Soybean,2016,3634,3665,31,0.8530544854155201
Shirur,Wheat(Husked),2016,1501,1532,31,2.0652898067954695
Shevgaon-Bodhegaon,Gram,2014,2700,2731,31,1.1481481481481481
Mangaon(Bhadav),PADDY-UNHUSKED,2016,1470,1500,30,2.0408163265306123
Pandharpur,Wheat(Husked),2015,1550,1580,30,1.935483870967742
Bhokardan,Maize,2015,1061,1091,30,2.827521206409048
Barshi-Vairag,Sunflower,2014,2950,2980,30,1.0169491525423728
Palghar(Bevur),Onion,2015,1467,1497,30,2.044989775051125
Barshi,Shevga,2016,30,60,30,100.0
Ahmednagar,Maize,2014,1454,1484,30,2.063273727647868
Jalna,Safflower,2015,2375,2405,30,1.263157894736842
Mudkhed,Wheat(Husked),2016,1425,1455,30,2.1052631578947367
Barshi,Cabbage,2015,30,60,30,100.0
Barshi,Cabbage,2015,50,80,30,60.0
Barshi,Cabbage,2015,28,58,30,107.14285714285714
Jalgaon,Sorgum(Jawar),2015,1352,1382,30,2.2189349112426036
Barshi-Vairag,Maize,2014,1384,1414,30,2.167630057803468
Barshi,Flower,2015,50,80,30,60.0
Bhokardan-Pimpalgaon Renu,Sorgum(Jawar),2015,1250,1280,30,2.4
Sakri,Wheat(Husked),2014,1356,1386,30,2.2123893805309733
Rahuri-Vambori,Maize,2016,1360,1390,30,2.2058823529411766
Bhokardan,Sorgum(Jawar),2015,1200,1230,30,2.5
Barshi,Tomato,2015,20,50,30,150.0
Bhokardan,Sorgum(Jawar),2015,1140,1170,30,2.6315789473684212
Barshi,Tomato,2015,30,60,30,100.0
Sinner,Maize,2016,1502,1532,30,1.9973368841544608
Bhokardan,Wheat(Husked),2015,1400,1430,30,2.142857142857143
Shegaon,Maize,2015,1145,1175,30,2.6200873362445414
Rahuri-Vambori,Maize,2015,1278,1308,30,2.347417840375587
Barshi,Tomato,2016,20,50,30,150.0
Barshi,Tomato,2015,20,50,30,150.0
Dharangaon,Wheat(Husked),2016,1561,1591,30,1.9218449711723253
Jalna-Badnapur,Bajri,2016,1590,1620,30,1.8867924528301887
Vaijapur,Sorgum(Jawar),2015,1410,1440,30,2.127659574468085
Gevrai,Maize,2016,1398,1428,30,2.1459227467811157
Pusad,Maize,2014,1231,1261,30,2.4370430544272947
Shirur,Wheat(Husked),2014,1425,1455,30,2.1052631578947367
Phaltan,Jaggery,2015,2505,2535,30,1.1976047904191616
Newasa,Bajri,2014,1320,1350,30,2.272727272727273
Tasgaon,Maize,2016,1396,1426,30,2.1489971346704873
Tasgaon,Maize,2016,1390,1420,30,2.158273381294964
Sadak Arjuni,Paddy-Unhusked,2016,1428,1458,30,2.100840336134454
Achalpur,Sorgum(Jawar),2014,1530,1560,30,1.9607843137254901
Pusad,Sesamum,2015,7615,7645,30,0.3939592908732764
Umarga,Black Gram,2015,5404,5434,30,0.5551443375277573
Kalyan,Coriander  ,2015,30,60,30,100.0
Raver,Maize,2015,1426,1456,30,2.1037868162692845
Indapur-Bhigwan,Rice(Paddy-Hus),2015,1518,1548,30,1.976284584980237
Rahuri,Bajri,2014,1352,1382,30,2.2189349112426036
Arjuni Morgaon,Paddy-Unhusked,2015,1429,1459,30,2.099370188943317
Chandrapur,Cotton,2015,4020,4050,30,0.746268656716418
Udgir,Safflower,2016,2705,2735,30,1.1090573012939002
Ashti (Wardha),Cotton,2015,4500,4530,30,0.6666666666666666
Gevrai,Maize,2015,1162,1192,30,2.5817555938037864
Katol,Pigeon Pea (Tur),2014,4518,4548,30,0.6640106241699867
Katol,Wheat(Husked),2014,1469,1499,30,2.0422055820285907
Rahuri-Vambori,Gram,2015,4750,4780,30,0.631578947368421
Nagpur,Lemon,2014,90,120,30,33.333333333333336
Vaijapur,Maize,2016,1441,1471,30,2.081887578070784
Shevgaon-Bodhegaon,Wheat(Husked),2016,1760,1790,30,1.7045454545454546
Pavani,Paddy-Unhusked,2016,2194,2224,30,1.3673655423883317
Barshi-Vairag,Soybean,2016,3516,3546,30,0.8532423208191127
Yeotmal,Wheat(Husked),2014,1457,1487,30,2.059025394646534
Jalgaon,SPINACH,2016,1345,1375,30,2.2304832713754648
Junnar-Otur,Carrot,2016,50,80,30,60.0
Navapur,Sorgum(Jawar),2016,1275,1305,30,2.3529411764705883
Shrirampur,Maize,2015,1264,1294,30,2.3734177215189876
Dharangaon,Sorgum(Jawar),2016,1485,1515,30,2.0202020202020203
Dharangaon,Maize,2016,1358,1388,30,2.2091310751104567
Mahad,Paddy-Unhusked,2016,1420,1450,30,2.112676056338028
Dharangaon,Maize,2016,1685,1715,30,1.7804154302670623
Umarga,Wheat(Unhusked),2015,3480,3510,30,0.8620689655172413
Pune-Pimpri,Potato,2015,815,845,30,3.6809815950920246
Akkalkuwa,Maize,2016,1370,1400,30,2.18978102189781
Basmat,Soybean,2015,3625,3655,30,0.8275862068965517
Jintur-Bori,Safflower,2015,2521,2551,30,1.190003966679889
Akkolkot,Wheat(Husked),2014,1451,1481,30,2.067539627842867
Bhiwapur,Green Chilli,2016,2350,2380,30,1.2765957446808511
Basmat,Gram,2016,4311,4341,30,0.6958942240779401
Beed,Maize,2016,1379,1409,30,2.1754894851341553
Parbhani,Cotton,2014,4022,4051,29,0.7210343112879165
Ausa,Bajri,2016,1471,1500,29,1.9714479945615229
Bori Arab,SOYBEAN,2016,2788,2817,29,1.0401721664275467
Shrirampur-Belapur,Gram,2016,4457,4486,29,0.6506618801884676
Savner,SORGUM(JAWAR),2016,1087,1116,29,2.6678932842686294
Rahuri-Vambori,Maize,2016,1328,1357,29,2.183734939759036
Katol,Wheat(Husked),2014,1489,1518,29,1.9476158495634655
Dhule,Sesamum,2014,9687,9716,29,0.29937029007948796
Kalmeshwar,Pigeon Pea (Tur),2015,6540,6569,29,0.4434250764525994
Shahada,Maize,2015,1202,1231,29,2.4126455906821964
Shirur,Maize,2014,1182,1211,29,2.4534686971235193
Manmad,Maize,2016,1414,1443,29,2.050919377652051
Sonpeth,Bajri,2016,1499,1528,29,1.9346230820547032
Akhadabalapur,Sorgum(Jawar),2014,1500,1529,29,1.9333333333333333
Kalamb (Os),Sunflower,2015,3077,3106,29,0.9424764380890478
Chandur Rly.,Wheat(Husked),2016,1496,1525,29,1.9385026737967914
Rahata,Beet Root,2016,1000,1029,29,2.9
Gevrai,Maize,2015,1301,1330,29,2.229054573405073
Jalkot,Sorgum(Jawar),2016,1471,1500,29,1.9714479945615229
Savner,COTTON,2016,4877,4906,29,0.5946278449866721
Kalamb (Os),Sunflower,2015,2968,2997,29,0.977088948787062
Udgir,Soybean,2015,3327,3356,29,0.8716561466786895
Nanded,Wheat(Husked),2015,1521,1550,29,1.9066403681788298
Achalpur,Sorgum(Jawar),2016,1609,1638,29,1.8023617153511498
Katol,Sorgum(Jawar),2015,1156,1185,29,2.508650519031142
Akluj,Wheat(Husked),2014,1584,1613,29,1.8308080808080809
Tasgaon,Maize,2014,1271,1300,29,2.2816679779701023
Bhandara,Pigeon Pea (Tur),2016,7570,7599,29,0.38309114927344784
Navapur,Onion,2016,750,779,29,3.8666666666666667
Murum,Soybean,2016,3720,3749,29,0.7795698924731183
Ahmedpur,WHEAT(HUSKED),2016,1438,1467,29,2.0166898470097356
Bhokardan,Maize,2015,1136,1165,29,2.5528169014084505
Murum,Soybean,2016,3388,3417,29,0.8559622195985832
Ahmedpur,Neem-Seed,2015,697,726,29,4.160688665710187
Indapur-Bhigwan,Rice(Paddy-Hus),2015,1438,1467,29,2.0166898470097356
Bhandara,Pigeon Pea (Tur),2016,6846,6875,29,0.4236050248320187
Kej,Maize,2016,1457,1486,29,1.990391214824983
Raver,Gram,2014,2217,2246,29,1.3080739738385205
Pulgaon,Pigeon Pea (Tur),2016,6066,6095,29,0.4780745136828223
Mahad,Paddy-Unhusked,2016,1421,1450,29,2.0408163265306123
Parli-Vaijnath,Gram,2016,4217,4246,29,0.6876926725160066
Bhokardan,Soybean,2015,3199,3228,29,0.9065332916536417
Kalamnuri,Soybean,2015,3257,3286,29,0.8903899293828677
Lasalgaon-Vinchur,Maize,2016,1701,1730,29,1.7048794826572604
Murum,Green Gram,2016,5226,5255,29,0.5549177190968235
Bhokardan,Bajri,2016,1200,1229,29,2.4166666666666665
Newasa,Wheat(Husked),2015,1514,1543,29,1.915455746367239
Ghoti,Flower,2014,1782,1811,29,1.627384960718294
Mandhal,Cotton,2016,4221,4250,29,0.6870409855484483
Barshi,Water Melon,2016,55,84,29,52.72727272727273
Malkapur,Bajri,2015,1085,1113,28,2.5806451612903225
Arjuni Morgaon,Paddy-Unhusked,2016,1930,1958,28,1.450777202072539
Kalamb (Os),Safflower,2015,2302,2330,28,1.2163336229365769
Sakri,Sorgum(Jawar),2016,1091,1119,28,2.5664527956003664
Barshi,Flower,2015,45,73,28,62.22222222222222
Udgir,Soybean,2015,3762,3790,28,0.7442849548112705
Sonpeth,Soybean,2014,3228,3256,28,0.8674101610904585
Khultabad,Maize,2015,973,1001,28,2.8776978417266186
Kalamb (Os),Safflower,2015,2547,2575,28,1.099332548095799
Sangamner,Sorgum(Jawar),2016,1675,1703,28,1.671641791044776
Ambejogai,Wheat(Husked),2015,1598,1626,28,1.7521902377972465
Jalna-Badnapur,Bajri,2016,1479,1507,28,1.8931710615280595
Tumsar,Black Gram,2016,10421,10449,28,0.2686882256981096
Shirur,Wheat(Husked),2016,1496,1524,28,1.8716577540106951
Shirpur,Cowpea,2016,4065,4093,28,0.6888068880688807
Tasgaon,Maize,2015,1374,1402,28,2.037845705967977
Lakhandur,Wheat(Husked),2015,1393,1421,28,2.0100502512562812
Basmat,Black Gram,2015,11131,11159,28,0.25154972599047704
Digras,Sorgum(Jawar),2016,1497,1525,28,1.8704074816299265
Ramtek,Green Chilli,2015,340,368,28,8.235294117647058
Ahmedpur,Wheat(Husked),2016,1458,1486,28,1.9204389574759946
Navapur,Maize,2015,1381,1409,28,2.0275162925416366
Barshi,Paddy-Unhusked,2016,1688,1716,28,1.6587677725118484
Katol,Sorgum(Jawar),2015,1182,1210,28,2.3688663282571913
Daryapur,Black Gram,2015,6199,6227,28,0.4516857557670592
Tuljapur,Paddy-Unhusked,2015,930,958,28,3.010752688172043
Basmat,Cotton,2014,4000,4028,28,0.7
Bhokardan,Sorgum(Jawar),2016,1489,1517,28,1.880456682337139
Jalgaon-Masawat,Bajri,2016,1700,1728,28,1.6470588235294117
Indapur-Bhigwan,Rice(Paddy-Hus),2015,1401,1429,28,1.998572448251249
Nandurbar,Maize,2016,1546,1574,28,1.8111254851228977
Jintur,Green Gram,2015,7355,7383,28,0.380693405846363
Sakri,Maize,2016,1360,1388,28,2.0588235294117645
Jamner-Neri,Maize,2016,1325,1353,28,2.1132075471698113
Bhokar,Wheat(Husked),2015,1381,1409,28,2.0275162925416366
Zarijamini,Soybean,2015,2858,2886,28,0.979706088173548
Mangalwedha,Bajri,2016,1822,1850,28,1.5367727771679474
Umarga,Maize,2015,1547,1575,28,1.8099547511312217
Chakur,GUVAR,2016,1087,1114,27,2.483900643974241
Nanded,Sorgum(Jawar),2016,1336,1363,27,2.0209580838323356
Murum,Sorgum(Jawar),2014,2023,2050,27,1.3346515076618883
Shahada,Bajri,2015,1244,1271,27,2.170418006430868
Gangakhed,SOYBEAN,2016,2775,2802,27,0.972972972972973
Murum,Black Gram,2015,5626,5653,27,0.47991468183434055
Kalamb (Os),Bajri,2014,1347,1374,27,2.0044543429844097
Chopda,Maize,2016,1683,1710,27,1.6042780748663101
Kopargaon,Sorgum(Jawar),2015,1310,1337,27,2.0610687022900764
Dharangaon,Bajri,2016,1634,1661,27,1.6523867809057529
Patan,Cucumber,2015,129,156,27,20.930232558139537
Nanded,Sorgum(Jawar),2016,1469,1496,27,1.8379850238257318
Navapur,Cabbage,2015,809,836,27,3.3374536464771323
Jalgaon,Bajri,2015,1262,1289,27,2.13946117274168
Kannad,Sorgum(Jawar),2014,1395,1422,27,1.935483870967742
Nandurbar,Soybean,2016,3607,3634,27,0.748544496811755
Nandurbar,Soybean,2016,3555,3582,27,0.759493670886076
Sironcha,Rice(Paddy-Hus),2016,1980,2007,27,1.3636363636363635
Lakhandur,Green Peas (Dry),2016,2315,2342,27,1.1663066954643628
Shrirampur-Belapur,Maize,2016,1214,1241,27,2.224052718286656
Umarga,Maize,2016,1492,1519,27,1.8096514745308312
Kalyan,SPINACH,2016,154,181,27,17.532467532467532
Barshi,Paddy-Unhusked,2016,1816,1843,27,1.486784140969163
Pusad,Wheat(Husked),2015,1535,1562,27,1.758957654723127
Umared,Linseed,2015,4787,4814,27,0.5640275746814288
Jalgaon-Masawat,Bajri,2016,1163,1190,27,2.3215821152192606
Varud-Rajura Bazar,Wheat(Husked),2016,1669,1696,27,1.6177351707609346
Beed,Maize,2015,1403,1430,27,1.924447612259444
Shirur,Wheat(Husked),2016,1463,1490,27,1.8455228981544771
Newasa,Bajri,2014,1298,1325,27,2.0801232665639446
Solapur,Bajri,2016,1513,1540,27,1.7845340383344348
Khultabad,Maize,2015,1046,1073,27,2.581261950286807
Shirur,Maize,2014,1143,1170,27,2.3622047244094486
Raver,Bajri,2016,1518,1545,27,1.7786561264822134
Sangli-Miraj,Maize,2016,1820,1847,27,1.4835164835164836
Raver,Maize,2016,1499,1526,27,1.801200800533689
Kalamb (Os),Maize,2016,1403,1430,27,1.924447612259444
Kalvan,Maize,2015,1343,1370,27,2.0104244229337302
Savner,Soybean,2016,3100,3127,27,0.8709677419354839
Pulgaon,Wheat(Husked),2015,1325,1351,26,1.9622641509433962
Shirur,Maize,2015,1393,1419,26,1.8664752333094041
Yeotmal,Wheat(Husked),2015,1416,1442,26,1.8361581920903955
Naigaon,Soybean,2015,3706,3732,26,0.7015650296815974
Ramtek,Flower,2015,273,299,26,9.523809523809524
Chandur Rly.,Wheat(Husked),2016,1638,1664,26,1.5873015873015872
Sailu,Sorgum(Jawar),2015,1382,1408,26,1.8813314037626627
Telhara,Wheat(Husked),2014,1399,1425,26,1.858470335954253
Nanded,Wheat(Husked),2015,1553,1579,26,1.674179008370895
Sengaon,Gram,2015,4319,4345,26,0.6019912016670526
Gevrai,Safflower,2016,2290,2316,26,1.1353711790393013
Vaijapur,Maize,2015,1361,1387,26,1.9103600293901544
Rahuri-Vambori,Maize,2014,1118,1144,26,2.3255813953488373
Achalpur,MAIZE,2016,1374,1400,26,1.8922852983988354
Sangli-Miraj,Maize,2016,1842,1868,26,1.4115092290988056
Parli-Vaijnath,Bajri,2015,1275,1301,26,2.0392156862745097
Shevgaon,Maize,2015,1200,1226,26,2.1666666666666665
Yeola,Maize,2014,1188,1214,26,2.1885521885521886
Palghar(Bevur),Potato,2016,1495,1521,26,1.7391304347826086
Ahmednagar,Maize,2015,1417,1443,26,1.834862385321101
Parli-Vaijnath,Wheat(Husked),2014,1341,1367,26,1.9388516032811334
Devala,Maize,2016,1637,1663,26,1.5882712278558337
Jalna,Mustard,2015,3276,3302,26,0.7936507936507936
Barshi,Lemon,2015,101,127,26,25.742574257425744
Jintur,Safflower,2015,2050,2076,26,1.2682926829268293
Parli-Vaijnath,Bajri,2016,1424,1450,26,1.8258426966292134
Partur,Bajri,2016,1275,1301,26,2.0392156862745097
Bhokardan,Sorgum(Jawar),2016,1200,1226,26,2.1666666666666665
Bhokardan,Maize,2016,1589,1615,26,1.6362492133417244
Kille Dharur,Niger-Seed,2016,4599,4625,26,0.5653402913676886
Ahmedpur,Bajri,2016,1308,1334,26,1.9877675840978593
Paithan,Bajri,2015,1345,1371,26,1.933085501858736
Kej,Bajri,2014,1448,1474,26,1.7955801104972375
Amalner,Ground Nut Pods (Dry),2016,5426,5452,26,0.4791743457427202
Kalamb (Os),Jaggery,2015,2061,2087,26,1.2615235322658904
Navapur,Indian Bean,2016,2856,2881,25,0.8753501400560224
Zarijamini,Soybean,2015,2825,2850,25,0.8849557522123894
Barshi-Vairag,Maize,2016,1423,1448,25,1.7568517217146873
Rahata,Soybean,2015,3382,3407,25,0.7392075694855116
Varud-Rajura Bazar,Sorgum(Jawar),2015,1251,1276,25,1.9984012789768186
Mantha,Safflower,2015,2500,2525,25,1.0
Dondaicha,Ground Nut Pods (Dry),2016,4575,4600,25,0.546448087431694
Akole,Maize,2014,1375,1400,25,1.8181818181818181
Ambejogai,Black Gram,2015,8493,8518,25,0.29436006122689273
Barshi,Ground Nut Pods (Dry),2015,5465,5490,25,0.45745654162854527
Jalna,Safflower,2015,2368,2393,25,1.0557432432432432
Shirur,Bajri,2015,1381,1406,25,1.8102824040550325
Sangamner,Gram,2015,3225,3250,25,0.7751937984496124
Chandur Rly.,Wheat(Husked),2016,1678,1703,25,1.4898688915375446
Navapur,Onion,2016,275,300,25,9.090909090909092
Wardha,Sorgum(Jawar),2015,1425,1450,25,1.7543859649122806
Shirur,Bajri,2015,1320,1345,25,1.893939393939394
Lasalgaon,Sorgum(Jawar),2015,1675,1700,25,1.492537313432836
Chandur Rly.,Wheat(Husked),2015,1471,1496,25,1.699524133242692
Koregaon,Gram,2015,3075,3100,25,0.8130081300813008
Khamgaon,Other Oil Seeds,2015,3188,3213,25,0.7841907151819323
Chandur Rly.,Green Gram,2015,7362,7387,25,0.3395816354251562
Shirur,Maize,2016,1412,1437,25,1.7705382436260624
Akhadabalapur,Sorgum(Jawar),2016,1475,1500,25,1.694915254237288
Chandur Rly.,Cotton,2015,4092,4117,25,0.6109481915933529
Kurdwadi,Maize,2014,1308,1333,25,1.9113149847094801
Nandurbar,Rice(Paddy-Hus),2015,2889,2914,25,0.8653513326410522
Korpana,SOYBEAN,2016,2698,2723,25,0.9266123054114158
Dondaicha,Cotton,2015,3900,3925,25,0.6410256410256411
Satana,Soybean,2014,7800,7825,25,0.32051282051282054
Kalamb (Os),Sesamum,2014,8712,8737,25,0.2869605142332415
Jintur-Bori,Wheat(Husked),2015,1520,1545,25,1.644736842105263
Ahmedpur,Neem-Seed,2015,285,310,25,8.771929824561404
Pune-Pimpri,Walvad,2015,1825,1850,25,1.36986301369863
Pulgaon,Wheat(Husked),2016,1715,1740,25,1.4577259475218658
Jalna,Safflower,2016,2506,2531,25,0.9976057462090981
Mangalwedha,Maize,2016,1827,1852,25,1.3683634373289546
Devani,Soybean,2016,3751,3776,25,0.6664889362836577
Bhokardan,Sorgum(Jawar),2014,1200,1225,25,2.0833333333333335
Bhokardan,Bajri,2016,1428,1453,25,1.7507002801120448
Shirur,Pigeon Pea (Tur),2016,6875,6900,25,0.36363636363636365
Ahmedpur,Rice(Paddy-Hus),2014,1526,1551,25,1.6382699868938402
Kalamb (Os),Sesamum,2015,7594,7619,25,0.3292072688964972
Khed (Shel Pimpalgaon),Cucumber,2015,950,975,25,2.6315789473684212
Dondaicha,Cotton,2014,4025,4050,25,0.6211180124223602
Digras,Soybean,2015,3150,3175,25,0.7936507936507936
Sailu,Bajri,2015,1213,1238,25,2.061005770816158
Bhokardan,Maize,2016,1320,1345,25,1.893939393939394
Akluj,Lemon,2016,26,51,25,96.15384615384616
Barshi,Bajri,2016,1560,1585,25,1.6025641025641026
Lakhandur,Mustard,2016,2655,2680,25,0.9416195856873822
Parbhani,Pigeon Pea (Tur),2014,4476,4501,25,0.5585344057193923
Shirur,Maize,2015,1224,1249,25,2.042483660130719
Khamgaon,Maize,2015,1285,1310,25,1.9455252918287937
Ahmednagar,Maize,2016,1367,1392,25,1.8288222384784198
Ramtek,Onion,2015,125,150,25,20.0
Rahuri,Sorgum(Jawar),2015,1750,1775,25,1.4285714285714286
Akola,Bajri,2016,1575,1600,25,1.5873015873015872
Bhiwapur,Pigeon Pea (Tur),2015,6975,7000,25,0.35842293906810035
Varud-Rajura Bazar,Sorgum(Jawar),2014,1274,1299,25,1.9623233908948194
Akhadabalapur,Sorgum(Jawar),2016,1500,1525,25,1.6666666666666667
Tuljapur,Bajri,2016,1375,1400,25,1.8181818181818181
Katol,Maize,2016,1310,1335,25,1.9083969465648856
Vaijapur,Wheat(Husked),2016,1692,1717,25,1.4775413711583925
Akhadabalapur,Wheat(Husked),2015,1775,1800,25,1.408450704225352
Jintur-Bori,Gram,2015,4200,4225,25,0.5952380952380952
Bhusaval,Gram,2016,4125,4150,25,0.6060606060606061
Rahata,Soybean,2016,3125,3150,25,0.8
Akhadabalapur,Wheat(Husked),2015,1775,1800,25,1.408450704225352
Gevrai,Matki,2014,6869,6894,25,0.36395399621487845
Gevrai,Maize,2014,1208,1233,25,2.0695364238410594
Shirpur,Cotton,2015,3846,3871,25,0.6500260010400416
Naigaon,Sorgum(Jawar),2015,1278,1303,25,1.9561815336463224
Naigaon,Sorgum(Jawar),2015,1300,1325,25,1.9230769230769231
Naigaon,Cotton,2015,3925,3950,25,0.6369426751592356
Sakri,Soybean,2015,3401,3426,25,0.7350779182593354
Gangapur,Maize,2016,1556,1581,25,1.6066838046272494
Devala,Pigeon Pea (Tur),2015,5153,5178,25,0.4851542790607413
Gangapur,GREEN GRAM,2016,4575,4600,25,0.546448087431694
Soygaon,Maize,2015,1050,1075,25,2.380952380952381
Soygaon,Maize,2015,1263,1288,25,1.9794140934283453
Kalamb (Os),Jaggery,2015,2200,2225,25,1.1363636363636365
Bhokar,Ground Nut Pods (Dry),2014,3575,3600,25,0.6993006993006993
Manchar,Raddish,2016,226,251,25,11.061946902654867
Solapur,Maize,2016,1625,1650,25,1.5384615384615385
Osmanabad,Onion,2016,525,550,25,4.761904761904762
Gangakhed,Soybean,2016,2775,2800,25,0.9009009009009009
Rahuri-Vambori,Ground Nut Pods (Dry),2015,3588,3613,25,0.6967670011148273
Kalvan,Gram,2015,4056,4081,25,0.616370808678501
Loha,Ground Nut Pods (Dry),2014,3200,3225,25,0.78125
Kalamb (Os),Safflower,2016,2491,2516,25,1.0036130068245686
Pavani,Paddy-Unhusked,2016,1787,1812,25,1.3989927252378287
Bhusaval,Wheat(Husked),2015,1447,1472,25,1.7277125086385625
Jintur-Bori,Wheat(Husked),2014,1475,1500,25,1.694915254237288
Solapur,Bajri,2014,1400,1425,25,1.7857142857142858
Shrigonda,Maize,2016,1425,1450,25,1.7543859649122806
Newasa,Wheat(Husked),2015,1450,1475,25,1.7241379310344827
Shevgaon,Pigeon Pea (Tur),2014,4875,4900,25,0.5128205128205128
Rahuri,Bajri,2014,1325,1350,25,1.8867924528301887
Rahuri,Bajri,2014,1336,1361,25,1.8712574850299402
Bhokardan-Pimpalgaon Renu,Maize,2016,1319,1344,25,1.8953752843062925
Sinner,Maize,2015,1268,1293,25,1.971608832807571
Shirpur,Pigeon Pea (Tur),2016,7267,7292,25,0.3440209164717215
Devala,Tamarind,2015,1616,1641,25,1.547029702970297
Khamgaon,Maize,2014,1270,1295,25,1.968503937007874
Gevrai,Maize,2016,1567,1592,25,1.595405232929164
Malkapur,Bajri,2015,1290,1315,25,1.937984496124031
Newasa,Tamarind,2015,1200,1225,25,2.0833333333333335
Barshi,Bajri,2015,1500,1525,25,1.6666666666666667
Newasa,Maize,2015,1383,1408,25,1.8076644974692697
Umarga,Soybean,2015,3292,3317,25,0.7594167679222357
Jalgaon,Bajri,2016,1778,1803,25,1.40607424071991
Baramati,Ground Nut Pods (Dry),2016,3251,3276,25,0.7689941556444171
Ahmedpur,Black Gram,2016,5840,5865,25,0.4280821917808219
Bhandara,Green Gram,2016,5200,5225,25,0.4807692307692308
Kalamnuri,Cotton,2014,4250,4275,25,0.5882352941176471
Lohara,Safflower,2016,2480,2505,25,1.0080645161290323
Wardha,Sorgum(Jawar),2016,1225,1250,25,2.0408163265306123
Bhusaval,Wheat(Husked),2014,1319,1344,25,1.8953752843062925
Arjuni Morgaon,Paddy-Unhusked,2016,1714,1739,25,1.4585764294049008
Solapur,Black Gram,2014,4921,4946,25,0.5080268238162975
Ahmedpur,Bajri,2016,1438,1463,25,1.7385257301808066
Ramtek,Wheat(Husked),2015,1484,1509,25,1.6846361185983827
Shevgaon,Gram,2015,3300,3325,25,0.7575757575757576
Chandrapur,Pineapple,2016,10,35,25,250.0
Chandrapur,Pineapple,2016,30,55,25,83.33333333333333
Rahuri-Vambori,Bajri,2015,1402,1427,25,1.783166904422254
Varud-Rajura Bazar,Sorgum(Jawar),2016,1550,1574,24,1.5483870967741935
Sonpeth,Bajri,2016,1576,1600,24,1.5228426395939085
Umared,Mustard,2016,3172,3196,24,0.7566204287515763
Varud-Rajura Bazar,Sorgum(Jawar),2016,1516,1540,24,1.5831134564643798
Vaijapur,Pigeon Pea (Tur),2015,5338,5362,24,0.44960659423004873
Tuljapur,Sorgum(Jawar),2015,1497,1521,24,1.6032064128256514
Mandhal,Green Gram,2015,5911,5935,24,0.4060226695990526
Sangli-Miraj,Maize,2016,1453,1477,24,1.6517549896765313
Ahmedpur,Rice(Paddy-Hus),2016,1381,1405,24,1.7378711078928313
Jintur-Bori,Gram,2016,4190,4214,24,0.5727923627684964
Kalamb (Os),Safflower,2014,2323,2347,24,1.0331467929401636
Palghar(Bevur),POTATO,2016,1336,1360,24,1.7964071856287425
Pandharkawada,Pigeon Pea (Tur),2016,8037,8061,24,0.2986188876446435
Bhokardan-Pimpalgaon Renu,Wheat(Husked),2014,1431,1455,24,1.6771488469601676
Jalgaon,Maize,2016,1385,1409,24,1.7328519855595668
Karjat (A- Nagar),Pigeon Pea (Tur),2016,6476,6500,24,0.3705991352686844
Katol,Sorgum(Jawar),2014,1210,1234,24,1.9834710743801653
Parli-Vaijnath,Wheat(Husked),2015,1391,1415,24,1.7253774263120059
Bhandara,Soybean,2015,3060,3084,24,0.7843137254901961
Bhandara,Other Cereals,2016,3805,3829,24,0.6307490144546649
Ambejogai,Safflower,2015,2474,2498,24,0.9700889248181084
Kurdwadi-Modnimb,Bajri,2015,1351,1375,24,1.776461880088823
Bhokardan-Pimpalgaon Renu,Sorgum(Jawar),2016,1500,1524,24,1.6
Indapur,Rice(Paddy-Hus),2016,1176,1200,24,2.0408163265306123
Bhokardan,Wheat(Husked),2015,1400,1424,24,1.7142857142857142
Indapur-Bhigwan,Rice(Paddy-Hus),2015,1433,1457,24,1.674808094905792
Ausa,Maize,2015,1207,1231,24,1.9884009942004972
Bhokardan-Pimpalgaon Renu,Sorgum(Jawar),2014,1245,1269,24,1.927710843373494
Kolhapur-Laxmipuri,Maize,2016,1610,1634,24,1.4906832298136645
Lohara,Soybean,2016,3701,3725,24,0.6484733855714672
Dhule,Maize,2016,1610,1634,24,1.4906832298136645
Barshi,Tamarind Seed,2015,1755,1779,24,1.3675213675213675
Rahuri-Vambori,Sunflower,2014,2868,2892,24,0.8368200836820083
Mahad,Paddy-Unhusked,2015,1445,1469,24,1.6608996539792387
Lasalgaon-Vinchur,Pigeon Pea (Tur),2016,7552,7576,24,0.3177966101694915
Nanded,Soybean,2016,3671,3695,24,0.6537728139471534
Bhokardan,Wheat(Husked),2014,1423,1446,23,1.6163035839775124
Ambejogai,Sunflower,2014,3038,3061,23,0.7570770243581304
Mangalwedha,Bajri,2015,1377,1400,23,1.6702977487291213
Akluj,Wheat(Husked),2014,1587,1610,23,1.4492753623188406
Udgir,Soybean,2015,3694,3717,23,0.6226312939902545
Jalgaon,Bajri,2015,1338,1361,23,1.71898355754858
Washim,Mustard,2016,3150,3173,23,0.7301587301587301
Bhusaval,Wheat(Husked),2015,1370,1393,23,1.6788321167883211
Katol,Wheat(Husked),2016,1725,1748,23,1.3333333333333333
Majalgaon,SOYBEAN,2016,2775,2798,23,0.8288288288288288
Kalvan,Gram,2014,2622,2645,23,0.8771929824561403
Bhokardan-Pimpalgaon Renu,Maize,2014,1314,1337,23,1.7503805175038052
Lakhandur,Pigeon Pea (Tur),2016,6822,6845,23,0.33714453239519204
Pandharpur,Sorgum(Jawar),2016,1951,1974,23,1.1788826242952333
Ashti (Jalna),Sorgum(Jawar),2016,1478,1501,23,1.5561569688768606
Arjuni Morgaon,Paddy-Unhusked,2015,1431,1454,23,1.607267645003494
Barshi,Water Melon,2016,32,55,23,71.875
Rahata,Soybean,2016,3879,3902,23,0.5929363237947924
Devala,Sorgum(Jawar),2016,1952,1975,23,1.1782786885245902
Rahata,Sorgum(Jawar),2015,1429,1452,23,1.609517144856543
Pachora,Rice(Paddy-Hus),2016,1411,1434,23,1.630049610205528
Ashti (Wardha),Cotton,2016,4474,4497,23,0.5140813589628968
Majalgaon,Cotton,2014,4080,4103,23,0.5637254901960784
Indapur-Bhigwan,Rice(Paddy-Hus),2014,1396,1419,23,1.6475644699140402
Sangli-Miraj,Maize,2015,1579,1602,23,1.4566181127295756
Sinner,Pigeon Pea (Tur),2014,3327,3350,23,0.6913134956417193
Shahada,BAJRI,2016,1275,1298,23,1.803921568627451
Bhusaval,Gram,2016,4675,4697,22,0.47058823529411764
Bhokardan-Pimpalgaon Renu,Wheat(Husked),2014,1438,1460,22,1.5299026425591098
Khamgaon,Ground Nut Pods (Dry),2015,4967,4989,22,0.4429232937386753
Shahada,Bajri,2016,1802,1824,22,1.2208657047724751
Akluj,Maize,2015,1221,1243,22,1.8018018018018018
Kalamnuri,Soybean,2014,3007,3029,22,0.7316262055204523
Ahmedpur,Neem-Seed,2015,756,778,22,2.9100529100529102
Shegaon,Bajri,2014,1248,1270,22,1.7628205128205128
Ahmedpur,Sorgum(Jawar),2016,1570,1592,22,1.4012738853503184
Vadvani,COTTON,2016,4858,4880,22,0.45286125977768626
Newasa,BAJRI,2016,1388,1410,22,1.585014409221902
Kille Dharur,Maize,2016,1432,1454,22,1.5363128491620113
Murum,Soybean,2015,3623,3645,22,0.6072315760419542
Pandharpur,Maize,2015,1421,1443,22,1.5482054890921886
Kalamb (Os),Safflower,2016,2589,2611,22,0.8497489378138278
Murum,Soybean,2016,3852,3874,22,0.5711318795430945
Bhusaval,Sorgum(Jawar),2016,1307,1329,22,1.6832440703902065
Kurdwadi,Maize,2014,1315,1337,22,1.673003802281369
Murum,Wheat(Husked),2015,1867,1889,22,1.1783610069630424
Sangamner,Soybean,2016,3528,3550,22,0.6235827664399093
Lasalgaon-Niphad,Maize,2016,1582,1604,22,1.390644753476612
Rahata,Soybean,2015,3117,3139,22,0.7058068655758742
Raver,Black Gram,2014,4976,4998,22,0.44212218649517687
Mandhal,Wheat(Husked),2015,1408,1430,22,1.5625
Katol,Maize,2016,1359,1381,22,1.6188373804267844
Rahata,Bajri,2015,1317,1339,22,1.6704631738800304
Barshi,Bajri,2016,1798,1820,22,1.2235817575083425
Jalna-Badnapur,Bajri,2016,1597,1619,22,1.3775829680651221
Jalgaon,Maize,2015,1297,1319,22,1.6962220508866614
Shrirampur-Belapur,Soybean,2015,3322,3344,22,0.6622516556291391
Raver,Bajri,2016,1610,1632,22,1.3664596273291925
Bhokardan,Maize,2015,1172,1194,22,1.8771331058020477
Barshi-Vairag,Soybean,2016,3963,3985,22,0.5551349987383295
Arjuni Morgaon,Paddy-Unhusked,2016,1782,1804,22,1.2345679012345678
Mangrulpeer,Green Gram,2016,5077,5099,22,0.4333267677762458
Jalgaon,Maize,2016,1325,1347,22,1.6603773584905661
Baramati,Rice(Paddy-Hus),2016,1714,1736,22,1.2835472578763127
Manmad,Wheat(Husked),2016,1611,1633,22,1.3656114214773432
Solapur,Bajri,2014,1317,1339,22,1.6704631738800304
Jalgaon,Wheat(Husked),2016,1753,1775,22,1.2549914432401597
Nanded,Sorgum(Jawar),2015,1363,1384,21,1.540719002201027
Newasa,Sorgum(Jawar),2016,1675,1696,21,1.2537313432835822
Aurad Shahajani,Wheat(Husked),2016,1280,1301,21,1.640625
Devala,Pigeon Pea (Tur),2016,7222,7243,21,0.29077817779008586
Ashti (Wardha),Cotton,2016,4476,4497,21,0.4691689008042895
Jalkot,Sorgum(Jawar),2015,1279,1300,21,1.6419077404222049
Kolhapur,Banana,2016,1143,1164,21,1.837270341207349
Kalamb (Os),Jaggery,2015,1882,1903,21,1.1158342189160468
Naigaon,Soybean,2016,3767,3788,21,0.5574727900185824
Shirur,Cowpea,2015,3800,3821,21,0.5526315789473685
Udgir,Soybean,2016,3856,3877,21,0.5446058091286307
Shahada,Bajri,2016,1536,1557,21,1.3671875
Nampur,Maize,2016,1438,1459,21,1.4603616133518775
Barshi,Tamarind Seed,2015,1751,1772,21,1.1993146773272416
Aamgaon,Paddy-Unhusked,2015,1348,1369,21,1.5578635014836795
Nanded,WHEAT(HUSKED),2016,1746,1767,21,1.2027491408934707
Barshi,Brinjal,2015,30,51,21,70.0
Dound,Maize,2015,1173,1194,21,1.7902813299232736
Shegaon,Sesamum,2015,7376,7397,21,0.28470715835141
Chandur Rly.,Wheat(Husked),2016,1633,1654,21,1.2859767299448868
Chandur Rly.,Wheat(Husked),2015,1544,1565,21,1.3601036269430051
Parola,Maize,2016,1478,1499,21,1.4208389715832206
Sailu,Soybean,2015,3270,3291,21,0.6422018348623854
Bhusaval,Sorgum(Jawar),2015,1072,1093,21,1.958955223880597
Bhusaval,Wheat(Husked),2016,1649,1670,21,1.2734990903577925
Sinner,Castor Seed,2016,3237,3258,21,0.6487488415199258
Bhokardan,Maize,2015,1062,1083,21,1.9774011299435028
Mukhed,Sorgum(Jawar),2015,1311,1332,21,1.6018306636155606
Yeola,SOYBEAN,2016,2777,2798,21,0.7562117392870004
Tumsar,Wheat(Husked),2016,1693,1714,21,1.2404016538688718
Shevgaon,Maize,2016,1354,1375,21,1.5509601181683899
Ramtek,Wheat(Husked),2016,1453,1474,21,1.445285615966965
Katol,Wheat(Husked),2016,1761,1782,21,1.192504258943782
Mehkar,Maize,2016,1990,2011,21,1.0552763819095476
Kalamb (Os),Maize,2016,1503,1524,21,1.3972055888223553
Shirur,Cowpea,2015,4120,4140,20,0.4854368932038835
Nanded,Sorgum(Jawar),2014,1230,1250,20,1.6260162601626016
Lonand,Maize,2015,1336,1356,20,1.4970059880239521
Shevgaon-Bodhegaon,Pigeon Pea (Tur),2016,7680,7700,20,0.2604166666666667
Murud,PADDY-UNHUSKED,2016,1480,1500,20,1.3513513513513513
Nagpur,Lemon,2014,120,140,20,16.666666666666668
Gevrai,Maize,2014,1143,1163,20,1.7497812773403325
Yeola,Pigeon Pea (Tur),2015,4503,4523,20,0.44414834554741284
Nagpur,Lemon,2014,100,120,20,20.0
Jalgaon,Bajri,2015,1395,1415,20,1.4336917562724014
Jalgaon,Maize,2015,1148,1168,20,1.7421602787456445
Malegaon,Castor Seed,2015,3141,3161,20,0.6367398917542184
Shevgaon,Pigeon Pea (Tur),2016,8100,8120,20,0.24691358024691357
Nagpur,Lemon,2015,70,90,20,28.571428571428573
Jalgaon,Bajri,2016,1792,1812,20,1.1160714285714286
Malkapur,Bajri,2015,1108,1128,20,1.8050541516245486
Vaduj,Maize,2015,1310,1330,20,1.5267175572519085
Nagpur,Lemon,2015,80,100,20,25.0
Nagpur,Lemon,2015,90,110,20,22.22222222222222
Ahmedpur,Ground Nut Pods (Dry),2015,5137,5157,20,0.3893322951138797
Chandrapur,Pineapple,2016,25,45,20,80.0
Nanded,Soybean,2015,3586,3606,20,0.5577244841048522
Aurangabad,Coriander  ,2015,65,85,20,30.76923076923077
Bhiwapur,Chillies(Red),2015,53,73,20,37.735849056603776
Ambejogai,Sorgum(Jawar),2015,2752,2772,20,0.7267441860465116
Varud-Rajura Bazar,Wheat(Husked),2014,1451,1471,20,1.3783597518952446
Beed,Soybean,2016,3010,3030,20,0.6644518272425249
Beed,Soybean,2015,3299,3319,20,0.6062443164595331
Varud-Rajura Bazar,Sorgum(Jawar),2015,1170,1190,20,1.7094017094017093
Pusad,Sesamum,2015,7195,7215,20,0.27797081306462823
Varud-Rajura Bazar,Wheat(Husked),2015,1425,1445,20,1.4035087719298245
Basmat,Soybean,2015,3237,3257,20,0.6178560395427866
Rahata,Bajri,2015,1425,1445,20,1.4035087719298245
Rahata,Coriander  ,2015,5,25,20,400.0
Aurangabad,Coriander  ,2015,80,100,20,25.0
Barshi,Water Melon,2016,35,55,20,57.142857142857146
Bhokardan,Maize,2014,1155,1175,20,1.7316017316017316
Barshi,Tomato,2016,24,44,20,83.33333333333333
Rahata,Maize,2016,1354,1374,20,1.4771048744460857
Barshi,Water Melon,2015,40,60,20,50.0
Barshi,Water Melon,2015,40,60,20,50.0
Barshi,Water Melon,2015,47,67,20,42.5531914893617
Barshi,Water Melon,2015,44,64,20,45.45454545454545
Barshi,Water Melon,2015,40,60,20,50.0
Barshi,Tamarind Seed,2015,1529,1549,20,1.3080444735120995
Barshi,Kharbuj,2015,50,70,20,40.0
Barshi,Kharbuj,2015,50,70,20,40.0
Barshi,Flower,2015,20,40,20,100.0
Ramtek,Brinjal,2015,129,149,20,15.503875968992247
Pune-Pimpri,Onion,2015,1600,1620,20,1.25
Bhokardan,Wheat(Husked),2015,1400,1420,20,1.4285714285714286
Nanded,Sorgum(Jawar),2016,1332,1352,20,1.5015015015015014
Chandur Rly.,Cotton,2014,4033,4053,20,0.49590875278948676
Nandurbar,Soybean,2015,3300,3320,20,0.6060606060606061
Dhule,Soybean,2015,3261,3281,20,0.613308800981294
Tasgaon,Maize,2015,1310,1330,20,1.5267175572519085
Navapur,Green Gram,2016,4956,4976,20,0.4035512510088781
Navapur,Paddy-Unhusked,2016,1220,1240,20,1.639344262295082
Navapur,Sorgum(Jawar),2016,1465,1485,20,1.3651877133105803
Navapur,Sorgum(Jawar),2016,1610,1630,20,1.2422360248447204
Savner,Sorgum(Jawar),2014,1360,1380,20,1.4705882352941178
Akkalkuwa,Maize,2016,1390,1410,20,1.4388489208633093
Chopda,Maize,2015,1304,1324,20,1.5337423312883436
Chandur Rly.,Gram,2016,5880,5900,20,0.3401360544217687
Sonpeth,Wheat(Husked),2014,1447,1467,20,1.38217000691085
Akluj,Maize,2014,1197,1217,20,1.670843776106934
Bhokardan,GREEN GRAM,2016,4480,4500,20,0.44642857142857145
Lasur Station,Mustard,2015,3700,3720,20,0.5405405405405406
Akluj,Maize,2015,1520,1540,20,1.3157894736842106
Parli-Vaijnath,Sorgum(Jawar),2016,1596,1616,20,1.2531328320802004
Akola,Maize,2015,1320,1340,20,1.5151515151515151
Pulgaon,Wheat(Husked),2015,1351,1371,20,1.4803849000740192
Bhusaval,Maize,2014,1080,1100,20,1.8518518518518519
Alibag,PADDY-UNHUSKED,2016,1480,1500,20,1.3513513513513513
Bhokardan-Pimpalgaon Renu,Maize,2015,1073,1093,20,1.8639328984156571
Bhokardan-Pimpalgaon Renu,Maize,2015,1063,1083,20,1.881467544684854
Bhokardan-Pimpalgaon Renu,Bajri,2015,1250,1270,20,1.6
Bhokardan-Pimpalgaon Renu,Sorgum(Jawar),2014,1210,1230,20,1.6528925619834711
Bhokardan-Pimpalgaon Renu,Maize,2014,938,958,20,2.1321961620469083
Lasur Station,Soybean,2015,3297,3317,20,0.6066120715802245
Tasgaon,Maize,2015,1318,1338,20,1.5174506828528074
Barshi,Flower,2014,40,60,20,50.0
Achalpur,Sorgum(Jawar),2014,1530,1550,20,1.3071895424836601
Yeotmal,Wheat(Husked),2016,1551,1571,20,1.2894906511927788
Katol,Sorgum(Jawar),2014,1239,1259,20,1.6142050040355125
Kalamb (Os),Safflower,2015,2397,2417,20,0.8343763037129746
Umared,Lang,2015,2086,2106,20,0.9587727708533078
Khed (Shel Pimpalgaon),Cucumber,2016,790,810,20,2.5316455696202533
Kalamb (Os),Castor Seed,2015,3136,3156,20,0.6377551020408163
Katol,Wheat(Husked),2015,1467,1487,20,1.3633265167007498
Kopargaon,Sorgum(Jawar),2014,1396,1416,20,1.4326647564469914
Yeotmal,Sorgum(Jawar),2015,1530,1550,20,1.3071895424836601
Kolhapur-Laxmipuri,Maize,2016,1645,1665,20,1.21580547112462
Katol,Sorgum(Jawar),2016,1291,1311,20,1.549186676994578
Kundalwadi,Sorgum(Jawar),2015,1570,1590,20,1.2738853503184713
Kalyan,Capsicum,2015,200,220,20,10.0
Naigaon,Sorgum(Jawar),2016,1520,1539,19,1.25
Yeotmal,Wheat(Husked),2016,1566,1585,19,1.2132822477650065
Murum,Wheat(Husked),2014,1481,1500,19,1.2829169480081026
Khamgaon,Bajri,2015,1254,1273,19,1.5151515151515151
Bhokardan-Pimpalgaon Renu,Wheat(Husked),2015,1400,1419,19,1.3571428571428572
Bhusaval,Sorgum(Jawar),2016,1391,1410,19,1.3659237958303379
Parli-Vaijnath,Bajri,2016,1496,1515,19,1.2700534759358288
Sangamner,Maize,2015,1429,1448,19,1.3296011196641007
Kurdwadi,Maize,2015,1422,1441,19,1.3361462728551337
Sangamner,Soybean,2015,3076,3095,19,0.6176853055916776
Nanded,Wheat(Husked),2015,1410,1429,19,1.3475177304964538
Gangapur,Maize,2015,1333,1352,19,1.4253563390847712
Nanded,Soybean,2016,3636,3655,19,0.5225522552255225
Yeola,Maize,2016,1662,1681,19,1.1432009626955475
Jintur-Bori,Sorgum(Jawar),2016,1347,1366,19,1.4105419450631032
Pachora,Rice(Paddy-Hus),2016,1553,1572,19,1.2234385061171926
Pachora,Rice(Paddy-Hus),2015,1371,1390,19,1.3858497447118892
Nanded,Soybean,2014,3225,3244,19,0.5891472868217055
Dudhani,Maize,2015,1266,1285,19,1.5007898894154819
Kundalwadi,Soybean,2016,3632,3651,19,0.5231277533039648
Nanded,Soybean,2016,3233,3252,19,0.5876894525208785
Yeola,Maize,2016,1491,1510,19,1.2743125419181758
Hingoli,Cotton,2015,3932,3951,19,0.4832146490335707
Varud-Rajura Bazar,Sorgum(Jawar),2016,1448,1467,19,1.3121546961325967
Barshi,Tamarind Seed,2015,1753,1772,19,1.0838562464346835
Ramtek,Wheat(Husked),2016,1445,1464,19,1.314878892733564
Udgir,Sorgum(Jawar),2016,1505,1524,19,1.2624584717607974
Katol,Sorgum(Jawar),2015,1191,1210,19,1.595298068849706
Barshi-Vairag,Gram,2015,4000,4019,19,0.475
Rahata,Maize,2016,1379,1398,19,1.3778100072516317
Sinner,Tamarind,2016,1940,1959,19,0.979381443298969
Rahuri-Vambori,Ground Nut Pods (Dry),2015,4431,4450,19,0.4287971112615662
Lonand,Maize,2014,1381,1400,19,1.3758146270818248
Karanja,Sorgum(Jawar),2015,1533,1551,18,1.1741682974559686
Devala,Wheat(Husked),2016,1664,1682,18,1.0817307692307692
Raver,Bajri,2015,1176,1194,18,1.530612244897959
Varud-Rajura Bazar,Soybean,2015,3706,3724,18,0.48569886670264434
Umarga,Sorgum(Jawar),2016,1600,1618,18,1.125
Paithan,MAIZE,2016,1140,1158,18,1.5789473684210527
Udgir,Soybean,2016,3726,3744,18,0.4830917874396135
Devala,Maize,2016,1757,1775,18,1.0244735344336937
Ramtek,Wheat(Husked),2016,1515,1533,18,1.188118811881188
Dondaicha,Pigeon Pea (Tur),2014,4062,4080,18,0.4431314623338257
Dharangaon,Bajri,2016,1605,1623,18,1.1214953271028036
Shahada,Maize,2015,1289,1307,18,1.3964313421256789
Pulgaon,PIGEON PEA (TUR),2016,5305,5323,18,0.3393025447690858
Dondaicha-Sindkheda,Sorgum(Jawar),2015,1351,1369,18,1.3323464100666174
Shirur,WHEAT(HUSKED),2016,1605,1623,18,1.1214953271028036
Nanded,Soybean,2015,3669,3687,18,0.49059689288634506
Nanded,Wheat(Husked),2014,1554,1572,18,1.1583011583011582
Gangapur,Cotton,2015,3932,3950,18,0.4577822990844354
Shirur,Pigeon Pea (Tur),2016,6146,6164,18,0.292873413602343
Vaduj,Maize,2014,1310,1328,18,1.3740458015267176
Ghoti,Paddy-Unhusked,2015,2015,2033,18,0.8933002481389578
Bhusaval,Wheat(Husked),2016,1682,1700,18,1.070154577883472
Bori Arab,Soybean,2015,3481,3499,18,0.5170927894283252
Katol,Sorgum(Jawar),2015,1193,1211,18,1.5088013411567478
Kalmeshwar,Wheat(Husked),2015,1450,1468,18,1.2413793103448276
Bhokardan,Sorgum(Jawar),2014,1219,1237,18,1.4766201804758
Bhokardan,Maize,2014,1315,1333,18,1.3688212927756653
Bhokardan,Maize,2014,966,984,18,1.8633540372670807
Pune-Pimpri,Beet Root,2015,1209,1227,18,1.488833746898263
Bhokardan-Pimpalgaon Renu,Wheat(Husked),2015,1400,1418,18,1.2857142857142858
Bhokardan-Pimpalgaon Renu,Maize,2015,1140,1158,18,1.5789473684210527
Bhokardan-Pimpalgaon Renu,Bajri,2015,1275,1293,18,1.411764705882353
Malkapur,Bajri,2015,1325,1343,18,1.3584905660377358
Tumsar,Wheat(Husked),2016,1652,1670,18,1.089588377723971
Kalamb (Os),SAFFLOWER,2016,2431,2449,18,0.7404360345536816
Bhokardan,Maize,2015,1138,1156,18,1.5817223198594024
Bhokardan,Maize,2015,1164,1182,18,1.5463917525773196
Lakhandur,Rice(Paddy-Hus),2015,1515,1532,17,1.1221122112211221
Jalgaon-Masawat,Black Gram,2016,6708,6725,17,0.2534287418008348
Nandura,Bajri,2016,1463,1480,17,1.1619958988380041
Bhokardan,Wheat(Husked),2014,1460,1477,17,1.1643835616438356
Raver,Rice(Paddy-Hus),2016,1404,1421,17,1.210826210826211
Arjuni Morgaon,PADDY-UNHUSKED,2016,1563,1580,17,1.0876519513755598
Lakhandur,Paddy-Unhusked,2016,1622,1639,17,1.0480887792848335
Shirur,Bajri,2015,1344,1361,17,1.2648809523809523
Akola,Maize,2016,1700,1717,17,1.0
Bhokardan,Sorgum(Jawar),2014,1219,1236,17,1.3945857260049221
Barshi-Vairag,Sunflower,2016,3351,3368,17,0.5073112503730229
Jalgaon,Wheat(Husked),2016,1821,1838,17,0.9335529928610653
Shegaon,Maize,2016,1213,1230,17,1.4014839241549877
Shegaon,Maize,2016,1383,1400,17,1.2292118582791034
Tuljapur,Maize,2016,1398,1415,17,1.2160228898426324
Gevrai,Soybean,2016,3245,3262,17,0.5238828967642527
Ghoti,Bitter Gourd,2014,1683,1700,17,1.0101010101010102
Shegaon,Sunflower,2016,3017,3034,17,0.563473649320517
Ambejogai,Wheat(Husked),2015,1713,1730,17,0.99241097489784
Vaduj,Maize,2015,1310,1327,17,1.297709923664122
Kurdwadi,Bajri,2016,1390,1407,17,1.223021582733813
Shirur,Maize,2015,1276,1293,17,1.3322884012539185
Bhokardan,Maize,2015,1051,1068,17,1.6175071360608944
Umarga,Wheat(Husked),2016,1287,1304,17,1.320901320901321
Akkolkot,Bajri,2016,1455,1472,17,1.168384879725086
Udgir,Soybean,2016,4029,4046,17,0.4219409282700422
Sinner,Maize,2015,1617,1634,17,1.051329622758194
Amalner,Maize,2014,1193,1210,17,1.4249790444258172
Lasalgaon-Niphad,Wheat(Husked),2016,1867,1884,17,0.9105516871987145
Chandrapur,Pineapple,2015,25,42,17,68.0
Pandharpur,Gram,2015,3272,3289,17,0.519559902200489
Varud-Rajura Bazar,Wheat(Husked),2015,1552,1569,17,1.0953608247422681
Chandrapur,Pineapple,2016,34,51,17,50.0
Chandrapur,Pineapple,2016,33,50,17,51.515151515151516
Udgir,Soybean,2016,3547,3564,17,0.47927826332111645
Sonpeth,Black Gram,2014,3909,3926,17,0.4348938347403428
Jalna-Badnapur,Bajri,2016,1584,1601,17,1.0732323232323233
Palghar(Bevur),Potato,2016,1596,1613,17,1.0651629072681705
Jalgaon,Wheat(Husked),2014,1454,1471,17,1.169188445667125
Kalmeshwar,Wheat(Husked),2015,1433,1450,17,1.1863224005582693
Kille Dharur,Black Gram,2014,4384,4401,17,0.38777372262773724
Daryapur,Wheat(Husked),2016,1435,1452,17,1.1846689895470384
Savner,Cotton,2015,3850,3867,17,0.44155844155844154
Indapur-Bhigwan,Rice(Paddy-Hus),2016,1711,1728,17,0.9935710111046172
Yeotmal,Wheat(Husked),2014,1444,1461,17,1.1772853185595569
Lonand,Maize,2015,1392,1409,17,1.221264367816092
Rahuri-Vambori,Maize,2015,1417,1433,16,1.1291460832745237
Bhusaval,Wheat(Husked),2015,1415,1431,16,1.1307420494699647
Kalamb (Os),Maize,2014,1159,1175,16,1.380500431406385
Aheri,Green Gram,2015,6017,6033,16,0.2659132458035566
Chakur,Gram,2016,9167,9183,16,0.17453910766881203
Khamgaon,Safflower,2016,2217,2233,16,0.7216959855660803
Shevgaon,Maize,2016,1359,1375,16,1.177336276674025
Rahuri-Vambori,Ground Nut Pods (Dry),2014,3427,3443,16,0.4668806536329151
Parli-Vaijnath,Bajri,2016,1564,1580,16,1.0230179028132993
Varud,WHEAT(HUSKED),2016,1867,1883,16,0.8569898232458489
Khed (Shel Pimpalgaon),Farshi,2015,2063,2079,16,0.7755695588948134
Akhadabalapur,Wheat(Husked),2015,1792,1808,16,0.8928571428571429
Gevrai,Mustard,2015,3427,3443,16,0.4668806536329151
Vita,Green Chilli,2016,45,61,16,35.55555555555556
Aheri,Maize,2015,1134,1150,16,1.4109347442680775
Bhokardan,Wheat(Husked),2014,1425,1441,16,1.1228070175438596
Ambejogai,Sorgum(Jawar),2016,1582,1598,16,1.011378002528445
Aheri,Maize,2015,1237,1253,16,1.2934518997574778
Pandharpur,Wheat(Husked),2014,1615,1631,16,0.9907120743034056
Navapur,Maize,2016,1292,1308,16,1.238390092879257
Barshi,Tamarind Seed,2016,1854,1870,16,0.8629989212513485
Nilanga,Sorgum(Jawar),2014,1000,1016,16,1.6
Barshi-Vairag,Wheat(Husked),2016,2113,2129,16,0.7572172266919073
Barshi-Vairag,Soybean,2015,3347,3363,16,0.4780400358530027
Nanded,Sorgum(Jawar),2016,1283,1299,16,1.2470771628994544
Barshi,Other Pulses,2014,2794,2810,16,0.572655690765927
Bhokardan-Pimpalgaon Renu,Sorgum(Jawar),2014,1230,1246,16,1.3008130081300813
Digras,Sorgum(Jawar),2015,1492,1508,16,1.0723860589812333
Newasa,Sorgum(Jawar),2016,1662,1678,16,0.9626955475330926
Lasur Station,Castor Seed,2015,3067,3083,16,0.5216824258232801
Jalgaon,Bajri,2016,1639,1655,16,0.9762050030506406
Shevgaon-Bodhegaon,Wheat(Husked),2014,1444,1460,16,1.10803324099723
Shirur,Maize,2015,1205,1221,16,1.3278008298755186
Jalgaon,Maize,2016,1294,1310,16,1.2364760432766615
Shirur,Ground Nut Pods (Dry),2015,3600,3616,16,0.4444444444444444
Lasalgaon,Sorgum(Jawar),2015,1782,1798,16,0.8978675645342312
Indapur-Bhigwan,Rice(Paddy-Hus),2016,1603,1619,16,0.9981285090455396
Udgir,Sorgum(Jawar),2016,1507,1523,16,1.06171201061712
Jalgaon,Bajri,2016,1703,1719,16,0.9395184967704052
Mangrulpeer,Sorgum(Jawar),2016,1292,1308,16,1.238390092879257
Jalgaon,Bajri,2015,1516,1532,16,1.0554089709762533
Devala,Rice(Paddy-Hus),2016,1615,1630,15,0.9287925696594427
Chandur Rly.,Wheat(Husked),2015,1536,1551,15,0.9765625
Shirur,Wheat(Husked),2016,1476,1491,15,1.016260162601626
Chandrapur,Pineapple,2015,15,30,15,100.0
Shahada,Bajri,2015,1344,1359,15,1.1160714285714286
Kurdwadi,Maize,2016,1702,1717,15,0.881316098707403
Roha,Paddy-Unhusked,2016,1410,1425,15,1.0638297872340425
Gevrai,Mustard,2015,3550,3565,15,0.4225352112676056
Devala,Tamarind,2016,2483,2498,15,0.6041079339508659
Chandrapur,Pineapple,2016,30,45,15,50.0
Bhokardan,Sorgum(Jawar),2014,1226,1241,15,1.2234910277324633
Akluj,Maize,2014,1205,1220,15,1.2448132780082988
Shrirampur,Maize,2014,1252,1267,15,1.1980830670926517
Tumsar,Lentil,2016,4581,4596,15,0.3274394237066143
Beed,Soybean,2016,3750,3765,15,0.4
Chopda,Sesamum,2015,7705,7720,15,0.1946787800129786
Rahata,Coriander  ,2016,5,20,15,300.0
Bhandara,Other Cereals,2016,3854,3869,15,0.38920601971977165
Majalgaon,WHEAT(HUSKED),2016,1895,1910,15,0.7915567282321899
Pandharpur,Maize,2016,1457,1472,15,1.029512697323267
Darwha,SOYBEAN,2016,2770,2785,15,0.5415162454873647
Mandhal,Gram,2014,2271,2286,15,0.6605019815059445
Khed (Shel Pimpalgaon),Chavli (Shenga ),2015,2031,2046,15,0.7385524372230429
Varud-Rajura Bazar,Castor Seed,2016,3172,3187,15,0.4728877679697352
Vaduj,Maize,2015,1325,1340,15,1.1320754716981132
Shevgaon-Bodhegaon,Wheat(Husked),2014,1515,1530,15,0.9900990099009901
Basmat,Cotton,2015,4100,4115,15,0.36585365853658536
Ahmedpur,Green Gram,2016,6213,6228,15,0.24142926122646063
Bhusaval,Maize,2016,1308,1323,15,1.146788990825688
Jalgaon,Spinach,2015,1135,1150,15,1.3215859030837005
Bhusaval,Sorgum(Jawar),2016,1332,1347,15,1.1261261261261262
Sillod-Bharadi,Wheat(Husked),2015,1543,1558,15,0.9721322099805574
Bhokardan-Pimpalgaon Renu,Wheat(Husked),2014,1476,1491,15,1.016260162601626
Sakri,Maize,2015,1173,1188,15,1.278772378516624
Khed (Shel Pimpalgaon),Cabbage,2014,310,325,15,4.838709677419355
Bhokardan-Pimpalgaon Renu,Maize,2015,1178,1193,15,1.2733446519524618
Vaijapur,Maize,2016,1400,1415,15,1.0714285714285714
Jalgaon,Spinach,2015,1205,1220,15,1.2448132780082988
Sakri,Maize,2015,1240,1255,15,1.2096774193548387
Nanded,Wheat(Husked),2016,1733,1747,14,0.8078476630121177
Kalamb (Os),Bajri,2015,1248,1262,14,1.1217948717948718
Korpana,Cotton,2014,4035,4049,14,0.3469640644361834
Kalvan,Maize,2016,1636,1650,14,0.8557457212713936
Nandurbar,Black Gram,2014,4957,4971,14,0.28242888844058905
Lakhandur,Paddy-Unhusked,2016,1786,1800,14,0.7838745800671892
Dudhani,Bajri,2015,1113,1127,14,1.2578616352201257
Sengaon,Gram,2015,4479,4493,14,0.3125697700379549
Varud-Rajura Bazar,Sorgum(Jawar),2016,1463,1477,14,0.9569377990430622
Jalkot,Soybean,2015,3272,3286,14,0.4278728606356968
Tasgaon,Maize,2015,1313,1327,14,1.0662604722010662
Devani,Sorgum(Jawar),2015,1535,1549,14,0.9120521172638436
Koregaon,Gram,2014,3129,3143,14,0.44742729306487694
Ramtek,Tomato,2015,97,111,14,14.43298969072165
Dhule,Castor Seed,2015,3156,3170,14,0.4435994930291508
Hingoli,Green Gram,2015,7486,7500,14,0.18701576275714668
Rahata,SORGUM(JAWAR),2016,1380,1394,14,1.0144927536231885
Hingoli,Cotton,2015,3956,3970,14,0.3538928210313448
Tumsar,Wheat(Husked),2016,1660,1674,14,0.8433734939759037
Akluj,Maize,2015,1302,1316,14,1.075268817204301
Katol,Wheat(Husked),2016,1747,1761,14,0.8013737836290784
Kurdwadi,Maize,2015,1510,1524,14,0.9271523178807947
Kalamb (Os),Safflower,2015,2405,2419,14,0.5821205821205822
Raver,Rice(Paddy-Hus),2016,1600,1614,14,0.875
Bori Arab,Soybean,2016,3500,3514,14,0.4
Shirur,Maize,2016,1430,1444,14,0.9790209790209791
Barshi,Bajri,2015,1400,1414,14,1.0
Pavani,Paddy-Unhusked,2016,2118,2132,14,0.6610009442870632
Digras,Soybean,2015,3000,3014,14,0.4666666666666667
Katol,Sorgum(Jawar),2016,1292,1306,14,1.08359133126935
Umarga,Safflower,2015,2433,2447,14,0.5754212905877517
Dudhani,Wheat(Husked),2016,1607,1621,14,0.8711885500933416
Roha,Paddy-Unhusked,2016,1410,1424,14,0.9929078014184397
Tuljapur,Black Gram,2015,5372,5386,14,0.2606105733432614
Pachora,Rice(Paddy-Hus),2016,1391,1405,14,1.00647016534867
Chandrapur,Pineapple,2015,25,39,14,56.0
Jalgaon,Wheat(Husked),2015,1484,1497,13,0.876010781671159
Akluj,Maize,2016,1420,1433,13,0.9154929577464789
Lonand,Maize,2016,1456,1469,13,0.8928571428571429
Kada,Tamarind Seed,2015,1666,1679,13,0.78031212484994
Kada,Maize,2014,1394,1407,13,0.9325681492109039
Jalna-Badnapur,Sorgum(Jawar),2016,1675,1688,13,0.7761194029850746
Bori Arab,Gram,2016,3950,3963,13,0.3291139240506329
Pandharpur,Wheat(Husked),2015,1589,1602,13,0.8181246066708622
Khed (Shel Pimpalgaon),Green Chilli,2015,2415,2428,13,0.5383022774327122
Ahmedpur,Ground Nut Pods (Dry),2016,5163,5176,13,0.2517915940344761
Sangamner,Maize,2015,1321,1334,13,0.9841029523088569
Bhandara,Mustard,2016,2575,2588,13,0.5048543689320388
Pandharpur,Maize,2015,1427,1440,13,0.9110021023125437
Shahada,Maize,2014,1281,1294,13,1.014832162373146
Navapur,Paddy-Unhusked,2016,1250,1263,13,1.04
Umared,Linseed,2015,4547,4560,13,0.28590279305036287
Katol,Sorgum(Jawar),2015,1089,1102,13,1.1937557392102847
Ahmedpur,Wheat(Husked),2016,1400,1413,13,0.9285714285714286
Katol,Sorgum(Jawar),2016,1316,1329,13,0.9878419452887538
Ahmedpur,Wheat(Husked),2016,1374,1387,13,0.9461426491994177
Shrirampur,Pigeon Pea (Tur),2015,4100,4113,13,0.3170731707317073
Bhandara,Soybean,2015,3275,3288,13,0.3969465648854962
Digras,Sorgum(Jawar),2015,1450,1463,13,0.896551724137931
Newasa,Sorgum(Jawar),2015,1550,1563,13,0.8387096774193549
Aheri,Paddy-Unhusked,2014,1647,1660,13,0.7893139040680024
Barshi,Sunflower,2016,3039,3052,13,0.4277722935176045
Aheri,Maize,2015,1180,1193,13,1.1016949152542372
Ramtek,Spinach,2015,72,85,13,18.055555555555557
Gangapur,Soybean,2016,3585,3598,13,0.36262203626220363
Shevgaon,Soybean,2014,3050,3063,13,0.4262295081967213
Barshi,Tamarind Seed,2016,1856,1869,13,0.7004310344827587
Barshi,Tamarind Seed,2016,1834,1847,13,0.7088331515812432
Mukhed,Soybean,2016,3675,3688,13,0.35374149659863946
Barshi,Other Cereals,2016,3025,3038,13,0.4297520661157025
Rahata,Soybean,2016,3707,3720,13,0.3506878877798759
Dudhani,Maize,2016,1473,1486,13,0.8825526137135098
Digras,Sorgum(Jawar),2016,1679,1692,13,0.7742703990470519
Newasa,Wheat(Husked),2015,1463,1475,12,0.8202323991797676
Ambejogai,Wheat(Husked),2014,1471,1483,12,0.8157715839564922
Jalgaon,Maize,2015,1121,1133,12,1.0704727921498662
Akluj,Maize,2015,1328,1340,12,0.9036144578313253
Shirur,Wheat(Husked),2016,1547,1559,12,0.7756948933419522
Beed,Maize,2015,1285,1297,12,0.933852140077821
Rahata,Soybean,2015,3338,3350,12,0.35949670461354105
Beed,Maize,2015,1446,1458,12,0.8298755186721992
Raver,Maize,2016,1493,1505,12,0.8037508372404555
Shirur,Maize,2015,1383,1395,12,0.8676789587852495
Bhokardan,Maize,2014,992,1004,12,1.2096774193548387
Rahata,Soybean,2016,3561,3573,12,0.33698399326032014
Shrigonda,Maize,2016,1538,1550,12,0.7802340702210663
Varud-Rajura Bazar,Sorgum(Jawar),2015,1301,1313,12,0.9223674096848578
Majalgaon,Green Gram,2016,5202,5214,12,0.2306805074971165
Kalamb (Os),Maize,2015,1351,1363,12,0.8882309400444115
Chopda,Soybean,2015,3240,3252,12,0.37037037037037035
Rahuri,Bajri,2015,1442,1454,12,0.8321775312066574
Pandharkawada,Soybean,2016,3606,3618,12,0.33277870216306155
Jalna-Badnapur,Cotton,2014,4034,4046,12,0.2974714923153198
Murum,Green Gram,2016,7138,7150,12,0.16811431773606053
Tasgaon,Maize,2015,1328,1340,12,0.9036144578313253
Jalgaon,Bajri,2016,1467,1479,12,0.8179959100204499
Lonand,Maize,2015,1469,1481,12,0.8168822328114363
Nandurbar,Black Gram,2015,8520,8532,12,0.14084507042253522
Parola,Maize,2016,1524,1536,12,0.7874015748031497
Lonand,Maize,2016,1463,1475,12,0.8202323991797676
Kej,Tamarind Seed,2016,1563,1575,12,0.7677543186180422
Yeola,Sorgum(Jawar),2016,1580,1592,12,0.759493670886076
Bhokardan-Pimpalgaon Renu,Maize,2014,1005,1017,12,1.1940298507462686
Akluj,Maize,2016,1460,1472,12,0.821917808219178
Nashik,Raddish,2015,10,22,12,120.0
Aheri,Paddy-Unhusked,2015,1294,1306,12,0.9273570324574961
Khed (Shel Pimpalgaon),Bottle Gourd,2015,714,726,12,1.680672268907563
Lohara,Sunflower,2016,3638,3650,12,0.32985156679494226
Tuljapur,Paddy-Unhusked,2014,825,837,12,1.4545454545454546
Tuljapur,Paddy-Unhusked,2014,1001,1013,12,1.1988011988011988
Jintur-Bori,Sorgum(Jawar),2014,1350,1362,12,0.8888888888888888
Bhusaval,Maize,2015,1141,1153,12,1.0517090271691498
Jintur,Black Gram,2015,5516,5528,12,0.21754894851341552
Pandharpur,Gram,2016,4296,4308,12,0.27932960893854747
Varud-Rajura Bazar,Wheat(Husked),2015,1474,1486,12,0.8141112618724559
Khed (Shel Pimpalgaon),Flower,2014,1161,1172,11,0.9474590869939707
Kalamb (Os),Safflower,2016,2477,2488,11,0.4440855874041179
Ahmedpur,Bajri,2015,1140,1151,11,0.9649122807017544
Bhiwapur,Green Chilli,2015,1611,1622,11,0.6828057107386716
Chandur Rly.,Wheat(Husked),2016,1728,1739,11,0.6365740740740741
Chandur Rly.,BLACK GRAM,2016,6279,6290,11,0.17518713170887085
Yeola,Wheat(Husked),2016,1589,1600,11,0.6922592825676526
Vaduj,Maize,2014,1301,1312,11,0.8455034588777863
Chandur Rly.,Wheat(Husked),2015,1516,1527,11,0.7255936675461742
Palghar(Bevur),Potato,2016,1533,1544,11,0.7175472928897586
Pune-Pimpri,Potato,2014,3868,3879,11,0.2843846949327818
Shirur,Maize,2015,1327,1338,11,0.8289374529012811
Murtizapur,Black Gram,2015,5480,5491,11,0.20072992700729927
Shrirampur,Maize,2014,1546,1557,11,0.7115135834411385
Katol,Wheat(Husked),2016,1697,1708,11,0.648202710665881
Jalna-Badnapur,Cotton,2015,3914,3925,11,0.28104241185487994
Rahuri-Vambori,Maize,2016,1309,1320,11,0.8403361344537815
Vita,Brinjal,2016,17,28,11,64.70588235294117
Shirur,Maize,2015,1349,1360,11,0.815418828762046
Nanded,Wheat(Husked),2014,1564,1575,11,0.7033248081841432
Murum,Soybean,2016,3701,3712,11,0.29721696838692246
Shevgaon-Bodhegaon,Wheat(Husked),2015,1511,1522,11,0.727994705493051
Nandurbar,Maize,2015,1311,1322,11,0.8390541571319603
Yeotmal,Wheat(Husked),2015,1400,1411,11,0.7857142857142857
Barshi,Tamarind Seed,2016,1739,1750,11,0.6325474410580794
Nanded,Soybean,2016,3352,3363,11,0.32816229116945106
Dharangaon,Wheat(Husked),2016,1725,1736,11,0.6376811594202898
Yeotmal,Wheat(Husked),2015,1400,1411,11,0.7857142857142857
Newasa,Bajri,2015,1282,1293,11,0.858034321372855
Mukhed,Soybean,2016,3682,3693,11,0.29875067897881585
Beed,Maize,2016,1372,1383,11,0.8017492711370262
Varud,Wheat(Husked),2016,1750,1761,11,0.6285714285714286
Dondaicha-Sindkheda,Maize,2016,1550,1561,11,0.7096774193548387
Mukhed,Soybean,2016,3678,3689,11,0.29907558455682437
Karanja,Bajri,2015,1571,1582,11,0.7001909611712285
Roha,Paddy-Unhusked,2016,1410,1420,10,0.7092198581560284
Ramtek,Garlic,2015,30,40,10,33.333333333333336
Roha,Paddy-Unhusked,2016,1410,1420,10,0.7092198581560284
Roha,Paddy-Unhusked,2016,1410,1420,10,0.7092198581560284
Roha,Paddy-Unhusked,2016,1410,1420,10,0.7092198581560284
Roha,Paddy-Unhusked,2016,1410,1420,10,0.7092198581560284
Pune-Pimpri,Green Chilli,2016,3750,3760,10,0.26666666666666666
Amarawati,Pineapple,2016,30,40,10,33.333333333333336
Amarawati,Pineapple,2016,23,33,10,43.47826086956522
Roha,Paddy-Unhusked,2016,1410,1420,10,0.7092198581560284
Akluj,Maize,2015,1398,1408,10,0.7153075822603719
Bhokardan,Wheat(Husked),2014,1550,1560,10,0.6451612903225806
Umared,Mustard,2015,3118,3128,10,0.3207184092366902
Vita,Green Chilli,2016,26,36,10,38.46153846153846
Chandrapur,Pineapple,2015,35,45,10,28.571428571428573
Chandrapur,Pineapple,2015,33,43,10,30.303030303030305
Ahmedpur,Neem-Seed,2016,840,850,10,1.1904761904761905
Akluj,Sorgum(Jawar),2015,1590,1600,10,0.6289308176100629
Ramtek,Wheat(Husked),2015,1458,1468,10,0.6858710562414266
Roha,Paddy-Unhusked,2016,1410,1420,10,0.7092198581560284
Shrirampur,Math (Bhaji),2016,20,30,10,50.0
Pulgaon,Gram,2015,3266,3276,10,0.3061849357011635
Pulgaon,Wheat(Husked),2015,1320,1330,10,0.7575757575757576
Murum,Soybean,2015,3226,3236,10,0.30998140111593303
Murum,Soybean,2015,3307,3317,10,0.3023888720895071
Alibag,Coconut,2016,10,20,10,100.0
Ashti (Jalna),Wheat(Husked),2015,1766,1776,10,0.5662514156285391
Patan,Cluster Bean,2015,30,40,10,33.333333333333336
Khamgaon,Maize,2016,1592,1602,10,0.628140703517588
Umarga,Bajri,2014,1065,1075,10,0.9389671361502347
Kalamnuri,Soybean,2014,2910,2920,10,0.3436426116838488
Bhokardan-Pimpalgaon Renu,Wheat(Husked),2014,1550,1560,10,0.6451612903225806
Rajura,Gram,2015,4000,4010,10,0.25
Aurad Shahajani,Sorgum(Jawar),2016,1260,1270,10,0.7936507936507936
Samudrapur,Gram,2016,5200,5210,10,0.19230769230769232
Nandgaon,Soybean,2014,3420,3430,10,0.29239766081871343
Rahata,Flower,2015,10,20,10,100.0
Ahmednagar,Coriander  ,2016,5,15,10,200.0
Ahmednagar,Coriander  ,2016,8,18,10,125.0
Yeotmal,WHEAT(HUSKED),2016,1775,1785,10,0.5633802816901409
Tuljapur,Wheat(Husked),2015,1534,1544,10,0.651890482398957
Barshi,Cabbage,2015,20,30,10,50.0
Bhokardan,Wheat(Husked),2015,1539,1549,10,0.649772579597141
Rahata,Flower,2015,5,15,10,200.0
Chandrapur,Pineapple,2015,36,46,10,27.77777777777778
Jalgaon,Bajri,2015,1256,1266,10,0.7961783439490446
Bhiwapur,Wheat(Husked),2014,1450,1460,10,0.6896551724137931
Navapur,Sorgum(Jawar),2016,1460,1470,10,0.684931506849315
Bhiwapur,Green Chilli,2016,2904,2914,10,0.3443526170798898
Chandur Rly.,Wheat(Husked),2015,1489,1499,10,0.6715916722632639
Chandrapur,Pineapple,2015,35,45,10,28.571428571428573
Rahata,Coriander  ,2016,15,25,10,66.66666666666667
Bhiwapur,Green Chilli,2015,2196,2206,10,0.4553734061930783
Bhiwapur,Green Chilli,2016,2599,2609,10,0.38476337052712584
Bhiwapur,Green Chilli,2015,1809,1819,10,0.552791597567717
Taloda,Wheat(Husked),2015,1686,1696,10,0.5931198102016607
Rahuri,Bajri,2015,1350,1360,10,0.7407407407407407
Katol,Sorgum(Jawar),2015,1240,1250,10,0.8064516129032258
Aheri,Cotton,2015,4020,4030,10,0.24875621890547264
Khed (Shel Pimpalgaon),Shevga,2015,1000,1010,10,1.0
Gangapur,Pigeon Pea (Tur),2016,7483,7493,10,0.13363624214887077
Akhadabalapur,Wheat(Husked),2014,1800,1810,10,0.5555555555555556
Raver,Gram,2015,4500,4510,10,0.2222222222222222
Achalpur,Maize,2014,1310,1320,10,0.7633587786259542
Jintur-Bori,Gram,2016,5025,5035,10,0.19900497512437812
Devala,Sorgum(Jawar),2016,1235,1245,10,0.8097165991902834
Bhiwapur,Green Chilli,2014,1725,1735,10,0.5797101449275363
Jalgaon,Gram,2015,3840,3850,10,0.2604166666666667
Umarkhed,Cotton,2015,3950,3960,10,0.25316455696202533
Akkalkuwa,SORGUM(JAWAR),2016,1340,1350,10,0.746268656716418
Malegaon,Soybean,2014,3051,3060,9,0.2949852507374631
Nashik,Raddish,2015,15,24,9,60.0
Aheri,Paddy-Unhusked,2015,1565,1574,9,0.5750798722044729
Loha,Ground Nut Pods (Dry),2016,5501,5510,9,0.16360661697873113
Lakhandur,Paddy-Unhusked,2016,1663,1672,9,0.5411906193625977
Umarga,Maize,2014,1366,1375,9,0.6588579795021962
Tuljapur,Soybean,2016,3681,3690,9,0.24449877750611246
Shrirampur,Maize,2015,1332,1341,9,0.6756756756756757
Nanded,Wheat(Husked),2015,1546,1555,9,0.5821474773609314
Raver-Sawada,Wheat(Husked),2016,1611,1620,9,0.5586592178770949
Kalyan,CORIANDER ,2016,5,14,9,180.0
Lasur Station,Soybean,2015,3224,3233,9,0.27915632754342434
Palam,Soybean,2016,3591,3600,9,0.2506265664160401
Beed,Soybean,2015,3241,3250,9,0.27769207034865784
Nashik-Devlali,Raddish,2016,5,14,9,180.0
Nashik,Raddish,2016,9,18,9,100.0
Sonpeth,Safflower,2016,2764,2773,9,0.3256150506512301
Murum,Soybean,2016,3688,3697,9,0.2440347071583514
Jalgaon,Maize,2015,1508,1517,9,0.596816976127321
Khamgaon,Bajri,2016,1383,1392,9,0.6507592190889371
Gangapur,Maize,2016,1439,1448,9,0.6254343293954134
Shirur,Wheat(Husked),2016,1500,1508,8,0.5333333333333333
Bhusaval,Sorgum(Jawar),2016,1396,1404,8,0.5730659025787965
Zarijamini,Soybean,2016,3481,3489,8,0.2298190175237001
Barshi,Bajri,2015,1488,1496,8,0.5376344086021505
Zarijamini,Sorgum(Jawar),2015,1166,1174,8,0.6861063464837049
Khamgaon,Bajri,2015,1105,1113,8,0.7239819004524887
Jalgaon,Soybean,2014,3250,3258,8,0.24615384615384617
Bhokardan-Pimpalgaon Renu,Wheat(Husked),2015,1525,1533,8,0.5245901639344263
Navapur,Maize,2016,1321,1329,8,0.6056018168054504
Loha,Green Gram,2016,6491,6499,8,0.12324757356339547
Murum,Bajri,2015,1414,1422,8,0.5657708628005658
Ahmednagar,Math (Bhaji),2016,5,13,8,160.0
Lakhandur,Green Peas (Dry),2016,3239,3247,8,0.2469898116702686
Pavani,Paddy-Unhusked,2015,1796,1804,8,0.44543429844098
Akluj,Maize,2014,1179,1187,8,0.6785411365564037
Amarawati,Pineapple,2015,20,28,8,40.0
Ahmednagar,Maize,2015,1254,1262,8,0.6379585326953748
Newasa,Bajri,2014,1327,1335,8,0.6028636021100227
Dharangaon,Wheat(Husked),2016,1811,1819,8,0.4417448923246825
Kalamb (Os),Safflower,2014,2335,2343,8,0.3426124197002141
Sinner,Pigeon Pea (Tur),2015,4190,4198,8,0.1909307875894988
Jalna-Badnapur,Bajri,2015,1253,1261,8,0.6384676775738228
Jalgaon,Wheat(Husked),2016,1671,1679,8,0.47875523638539796
Shirur,Wheat(Husked),2016,1545,1553,8,0.517799352750809
Shirpur,Soybean,2015,3195,3203,8,0.25039123630672927
Vita,Tomato,2016,14,22,8,57.142857142857146
Pandharpur,Sorgum(Jawar),2016,1896,1904,8,0.4219409282700422
Pandharpur,Sorgum(Jawar),2016,1846,1854,8,0.4333694474539545
Parbhani,Gram,2015,3510,3518,8,0.22792022792022792
Tumsar,Sarsav,2016,2830,2838,8,0.2826855123674912
Ashti (Jalna),Sorgum(Jawar),2015,1626,1633,7,0.43050430504305043
Pune,Coconut,2016,8,15,7,87.5
Vita,Brinjal,2016,16,23,7,43.75
Rajura,Green Gram,2015,6168,6175,7,0.11348897535667964
Ratanagari,Coriander  ,2014,7,14,7,100.0
Karanja,Bajri,2014,1519,1526,7,0.4608294930875576
Pune-Pimpri,Math (Bhaji),2016,4,11,7,175.0
Vadgaon Peth,Coriander  ,2015,6,13,7,116.66666666666667
Rahuri-Vambori,Soybean,2016,3507,3514,7,0.1996007984031936
Tumsar,Sarsav,2016,2648,2655,7,0.26435045317220546
Rahuri-Vambori,Soybean,2015,3125,3132,7,0.224
Beed,Maize,2016,1469,1476,7,0.4765146358066712
Rahata,Cabbage,2015,3,10,7,233.33333333333334
Yeotmal,Wheat(Husked),2016,1541,1548,7,0.45425048669695
Katol,Sorgum(Jawar),2016,1337,1344,7,0.5235602094240838
Vita,Ladies Finger,2016,21,28,7,33.333333333333336
Ulhasnagar,Coconut,2016,10,17,7,70.0
Tumsar,Wheat(Husked),2016,1551,1558,7,0.4513217279174726
Kalvan,Soybean,2015,3358,3365,7,0.2084574151280524
Kalamb (Os),Jaggery,2016,2424,2431,7,0.2887788778877888
Kalamb (Os),Mustard,2015,3466,3473,7,0.20196191575302944
Nashik,Raddish,2015,7,14,7,100.0
Vadgaon Peth,Coriander  ,2016,9,16,7,77.77777777777777
Dondaicha-Sindkheda,Wheat(Husked),2016,1758,1765,7,0.3981797497155859
Dondaicha,Maize,2016,1605,1612,7,0.43613707165109034
Sangamner,Maize,2016,1455,1462,7,0.48109965635738833
Umarga,Soybean,2016,3433,3440,7,0.20390329158170697
Akluj,Maize,2016,1518,1525,7,0.461133069828722
Shevgaon-Bodhegaon,Wheat(Husked),2016,1718,1725,7,0.4074505238649593
Yeola,Pigeon Pea (Tur),2016,6789,6796,7,0.10310796877301517
Vaijapur,Maize,2016,1426,1433,7,0.4908835904628331
Daryapur,Sorgum(Jawar),2016,1303,1310,7,0.5372217958557176
Nashik,Raddish,2015,8,15,7,87.5
Jalgaon,Maize,2015,1155,1162,7,0.6060606060606061
Yeotmal,Green Gram,2016,5438,5445,7,0.12872379551305627
Shrigonda-Ghogargaon,Cotton,2014,4026,4033,7,0.17386984600099353
Pandharpur,Maize,2016,1687,1694,7,0.4149377593360996
Nanded,Wheat(Husked),2016,1705,1712,7,0.41055718475073316
Sangamner,Maize,2015,1399,1405,6,0.42887776983559683
Pandharpur,Bajri,2016,1925,1931,6,0.3116883116883117
Rahata,Curry Leaves,2015,3,9,6,200.0
Yeotmal,Green Gram,2015,5333,5339,6,0.11250703168948059
Yeotmal,Wheat(Husked),2016,1713,1719,6,0.3502626970227671
Sinner,Maize,2015,1349,1355,6,0.4447739065974796
Devala,Sorgum(Jawar),2015,1551,1557,6,0.38684719535783363
Lakhandur,Paddy-Unhusked,2015,1515,1521,6,0.39603960396039606
Kopargaon,Maize,2016,1528,1534,6,0.39267015706806285
Barshi-Vairag,Maize,2016,1404,1410,6,0.42735042735042733
Sengaon,Wheat(Husked),2015,1551,1557,6,0.38684719535783363
Ratanagari,Coriander  ,2015,10,16,6,60.0
Nanded,Wheat(Husked),2016,1599,1605,6,0.37523452157598497
Tasgaon,Maize,2015,1295,1301,6,0.46332046332046334
Shirur,Bajri,2015,1308,1314,6,0.45871559633027525
Pune-Moshi,Shepu,2016,10,16,6,60.0
Rahuri-Vambori,Soybean,2015,3489,3495,6,0.17196904557179707
Pune-Pimpri,Coriander  ,2016,4,10,6,150.0
Rahuri-Vambori,Soybean,2014,3139,3145,6,0.19114367633004142
Vita,Ladies Finger,2016,18,24,6,33.333333333333336
Kalamb (Os),Castor Seed,2015,3406,3412,6,0.17615971814445097
Kurdwadi,Maize,2016,1772,1778,6,0.33860045146726864
Raver,Bajri,2015,1145,1151,6,0.5240174672489083
Rahata,Soybean,2016,3422,3428,6,0.17533606078316774
Malegaon,Soybean,2014,3308,3314,6,0.18137847642079807
Ulhasnagar,Coconut,2016,10,16,6,60.0
Dondaicha-Sindkheda,Maize,2016,1209,1215,6,0.49627791563275436
Rahata,Coriander  ,2016,4,10,6,150.0
Pune-Pimpri,Shepu,2016,3,9,6,200.0
Vadgaon Peth,Methi (Bhaji),2016,9,15,6,66.66666666666667
Tumsar,Castor Seed,2016,2715,2720,5,0.1841620626151013
Chandur Rly.,Wheat(Husked),2016,1567,1572,5,0.3190810465858328
Devala,Pigeon Pea (Tur),2015,8504,8509,5,0.05879586077140169
Newasa,MAIZE,2016,1370,1375,5,0.36496350364963503
Basmat,Sorgum(Jawar),2016,1195,1200,5,0.41841004184100417
Pune-Pimpri,Math (Bhaji),2016,5,10,5,100.0
Pune-Pimpri,Shepu,2016,4,9,5,125.0
Ratanagari,Coriander  ,2016,10,15,5,50.0
Ratanagari,Coriander  ,2016,5,10,5,100.0
Ratanagari,Coriander  ,2016,10,15,5,50.0
Taloda,Wheat(Husked),2015,1470,1475,5,0.3401360544217687
Pune-Pimpri,Coriander  ,2016,5,10,5,100.0
Sakri,Sorgum(Jawar),2015,1160,1165,5,0.43103448275862066
Nashik,Raddish,2015,8,13,5,62.5
Umared,Linseed,2014,4644,4649,5,0.10766580534022395
Tuljapur,Sorgum(Jawar),2015,2032,2037,5,0.24606299212598426
Solapur,Soybean,2014,3274,3279,5,0.15271838729383017
Yeola,Maize,2015,1370,1375,5,0.36496350364963503
Ghoti,Paddy-Unhusked,2015,1963,1968,5,0.2547121752419766
Vadgaon Peth,Coriander  ,2014,5,10,5,100.0
Vadgaon Peth,Spinach,2016,5,10,5,100.0
Naigaon,Soybean,2015,3816,3821,5,0.1310272536687631
Gangapur,Maize,2015,1388,1393,5,0.36023054755043227
Jamner-Neri,Maize,2016,1365,1370,5,0.3663003663003663
Gangapur,Green Gram,2014,7918,7923,5,0.06314725940894166
Tuljapur,Soybean,2016,3403,3408,5,0.14692918013517484
Barshi,Paddy-Unhusked,2016,1797,1802,5,0.27824151363383415
Rahata,Coriander  ,2016,20,25,5,25.0
Rahata,Coriander  ,2016,10,15,5,50.0
Nanded,Soybean,2015,3266,3271,5,0.15309246785058175
Rahata,CURRY LEAVES,2016,5,10,5,100.0
Dondaicha-Sindkheda,Maize,2016,1305,1310,5,0.3831417624521073
Nanded,Wheat(Husked),2016,1602,1607,5,0.3121098626716604
Rahata,Flower,2015,5,10,5,100.0
Rahata,Flower,2015,10,15,5,50.0
Ramtek,Cucumber,2016,15,20,5,33.333333333333336
Rahata,Curry Leaves,2015,5,10,5,100.0
Rahata,Curry Leaves,2015,5,10,5,100.0
Karanja,Bajri,2014,1595,1600,5,0.31347962382445144
Sironcha,Paddy-Unhusked,2016,1422,1427,5,0.35161744022503516
Akluj,Coriander  ,2014,7,12,5,71.42857142857143
Karanja,Cotton,2014,4031,4036,5,0.12403870007442322
Rahata,Cabbage,2015,8,13,5,62.5
Udgir,Sorgum(Jawar),2016,1520,1525,5,0.32894736842105265
Rahata,Cabbage,2015,5,10,5,100.0
Pusad,Gram,2015,4450,4455,5,0.11235955056179775
Yeola,Soybean,2016,2775,2780,5,0.18018018018018017
Katol,Sorgum(Jawar),2016,1273,1278,5,0.3927729772191673
Pune-Moshi,Methi (Bhaji),2016,15,20,5,33.333333333333336
Akluj,Sorgum(Jawar),2016,1902,1907,5,0.2628811777076761
Solapur,MAIZE,2016,1366,1371,5,0.36603221083455345
Kalamnuri,Soybean,2015,3500,3505,5,0.14285714285714285
Ulhasnagar,Coconut,2016,10,15,5,50.0
Ulhasnagar,Coconut,2016,10,15,5,50.0
Akluj,Coriander  ,2016,10,15,5,50.0
Akluj,Coriander  ,2016,5,10,5,100.0
Bhusaval,Maize,2016,1388,1393,5,0.36023054755043227
Pandharpur,Maize,2016,1504,1509,5,0.3324468085106383
Pandharpur,Maize,2016,1755,1760,5,0.2849002849002849
Akluj,Math (Bhaji),2015,10,15,5,50.0
Pandharpur,Maize,2015,1527,1532,5,0.3274394237066143
Pandharpur,Maize,2015,1326,1331,5,0.3770739064856712
Amarawati,Pineapple,2016,20,25,5,25.0
Amarawati,Papnas,2015,15,20,5,33.333333333333336
Akluj,Spinach,2016,5,10,5,100.0
Amarawati,Pineapple,2016,20,25,5,25.0
Aheri,Paddy-Unhusked,2016,1916,1921,5,0.2609603340292276
Ulhasnagar,Coconut,2016,10,15,5,50.0
Pulgaon,Wheat(Husked),2016,1485,1490,5,0.3367003367003367
Phaltan,Coriander  ,2016,3,7,4,133.33333333333334
Shrigonda,Cotton,2014,4085,4089,4,0.09791921664626684
Pandharpur,Wheat(Husked),2016,1733,1737,4,0.2308136180034622
Ramtek,Coriander  ,2015,10,14,4,40.0
Tuljapur,Maize,2014,1271,1275,4,0.3147128245476003
Kalyan,MATH (BHAJI),2016,11,15,4,36.36363636363637
Karad,Math (Bhaji),2015,6,10,4,66.66666666666667
Mauda,Water Melon,2016,8,12,4,50.0
Murum,Wheat(Unhusked),2015,2999,3003,4,0.13337779259753252
Tuljapur,Sorgum(Jawar),2015,2064,2068,4,0.1937984496124031
Tasgaon,Maize,2015,1312,1316,4,0.3048780487804878
Pandharpur,CORIANDER ,2016,1,5,4,400.0
Murum,Soybean,2015,3230,3234,4,0.1238390092879257
Akluj,Maize,2015,1289,1293,4,0.3103180760279286
Jalkot,Sorgum(Jawar),2016,1498,1502,4,0.26702269692923897
Vadgaon Peth,Coriander  ,2014,5,9,4,80.0
Sironcha,Maize,2016,1354,1358,4,0.29542097488921715
Rahata,Cabbage,2015,7,11,4,57.142857142857146
Gevrai,Maize,2016,1642,1646,4,0.243605359317905
Rahata,Cabbage,2015,6,10,4,66.66666666666667
Jintur-Bori,Wheat(Husked),2015,1559,1563,4,0.25657472738935216
Shahapur,Bottle Gourd,2015,5,9,4,80.0
Shahapur,Bottle Gourd,2015,6,10,4,66.66666666666667
Kalyan,Kanda Pat,2016,8,12,4,50.0
Akluj,Maize,2015,1413,1417,4,0.28308563340410475
Pune,Math (Bhaji),2014,4,8,4,100.0
Pune,Shepu,2015,2,6,4,200.0
Karad,Kanda Pat,2015,2,6,4,200.0
Nanded,Soybean,2015,3266,3270,4,0.1224739742804654
Khed (Shel Pimpalgaon),Brinjal,2015,654,658,4,0.6116207951070336
Rahata,Coriander  ,2015,4,8,4,100.0
Chandrapur,Maize(Corn.),2016,1,5,4,400.0
Pune-Moshi,Shepu,2016,13,17,4,30.76923076923077
Savner,Maize,2015,1097,1101,4,0.3646308113035551
Katol,Sorgum(Jawar),2016,1386,1390,4,0.2886002886002886
Tumsar,Sarsav,2015,3308,3312,4,0.12091898428053205
Chandrapur,Maize(Corn.),2016,4,8,4,100.0
Ratanagari,Spinach,2016,6,10,4,66.66666666666667
Ulhasnagar,Coconut,2016,9,13,4,44.44444444444444
Pune-Pimpri,Spinach,2016,4,8,4,100.0
Kalamb (Os),Mustard,2015,3424,3428,4,0.11682242990654206
Savner,Pigeon Pea (Tur),2014,4121,4125,4,0.0970638194612958
Vadgaon Peth,Coriander  ,2016,4,8,4,100.0
Kalamb (Os),Castor Seed,2015,3292,3296,4,0.12150668286755771
Pune-Pimpri,Kanda Pat,2016,4,8,4,100.0
Malkapur,Bajri,2015,1158,1162,4,0.3454231433506045
Lakhani,Paddy-Unhusked,2015,1654,1658,4,0.2418379685610641
Chandvad,MATH (BHAJI),2016,5,9,4,80.0
Vadgaon Peth,Coriander  ,2016,1,5,4,400.0
Pune-Pimpri,Shepu,2015,2,6,4,200.0
Ramtek,Kand,2015,12,15,3,25.0
Shahapur,Bottle Gourd,2015,7,10,3,42.857142857142854
Yeola,Sorgum(Jawar),2016,1579,1582,3,0.18999366687777075
Karad,Spinach,2015,3,6,3,100.0
Nanded,Wheat(Husked),2016,1733,1736,3,0.17311021350259664
Nanded,Wheat(Husked),2016,1602,1605,3,0.18726591760299627
Rahata,Curry Leaves,2015,5,8,3,60.0
Vadgaon Peth,Coriander  ,2014,4,7,3,75.0
Kalyan,Coriander  ,2016,17,20,3,17.647058823529413
Vadgaon Peth,Spinach,2016,2,5,3,150.0
Ratanagari,Coriander  ,2016,5,8,3,60.0
Ramtek,Ladies Finger,2015,18,21,3,16.666666666666668
Chandrapur,Orange,2016,1,4,3,300.0
Vadgaon Peth,Methi (Bhaji),2016,6,9,3,50.0
Ramtek,Onion,2015,17,20,3,17.647058823529413
Vadgaon Peth,Methi (Bhaji),2016,5,8,3,60.0
Pune,Shepu,2015,2,5,3,150.0
Akluj,Spinach,2014,1,4,3,300.0
Pune,SPINACH,2016,3,6,3,100.0
Vadgaon Peth,Coriander  ,2015,3,6,3,100.0
Sonpeth,Safflower,2016,2692,2695,3,0.11144130757800892
Yeotmal,Wheat(Husked),2015,1400,1403,3,0.21428571428571427
Vadgaon Peth,Math (Bhaji),2016,4,7,3,75.0
Vadgaon Peth,Coriander  ,2015,2,5,3,150.0
Gangapur,Cotton,2014,3975,3978,3,0.07547169811320754
Karad,Math (Bhaji),2015,2,5,3,150.0
Karad,Math (Bhaji),2015,2,5,3,150.0
Pune,Spinach,2014,2,5,3,150.0
Rahata,Spinach,2015,4,7,3,75.0
Vadgaon Peth,Coriander  ,2016,2,5,3,150.0
Kalyan,Coriander  ,2016,7,10,3,42.857142857142854
Vadgaon Peth,Methi (Bhaji),2016,3,6,3,100.0
Akluj,Coriander  ,2015,2,5,3,150.0
Pune-Pimpri,Shepu,2015,4,7,3,75.0
Kalyan,SHEPU,2016,8,11,3,37.5
Ratanagari,Coriander  ,2015,12,15,3,25.0
Ahmednagar,Spinach,2015,3,6,3,100.0
Ratanagari,Coriander  ,2015,4,7,3,75.0
Akluj,Math (Bhaji),2015,3,6,3,100.0
Umared,Linseed,2014,4514,4517,3,0.0664599025254763
Kurdwadi,Maize,2015,1564,1567,3,0.1918158567774936
Shrirampur,Soybean,2016,3564,3567,3,0.08417508417508418
Ambejogai,Safflower,2014,2715,2718,3,0.11049723756906077
Khed,Kanda Pat,2016,1,4,3,300.0
Pandharpur,Wheat(Husked),2016,1863,1866,3,0.1610305958132045
Kalyan,RADDISH,2016,15,18,3,20.0
Karanja,Cotton,2015,3966,3969,3,0.07564296520423601
Ahmedpur,Safflower,2016,2555,2558,3,0.11741682974559686
Sangamner,Gram,2015,3288,3291,3,0.09124087591240876
Vadgaon Peth,Coriander  ,2016,2,5,3,150.0
Vita,Tomato,2016,5,8,3,60.0
Phaltan,Math (Bhaji),2016,2,5,3,150.0
Katol,Sorgum(Jawar),2016,1357,1360,3,0.2210759027266028
Rahuri-Vambori,Maize,2015,1275,1278,3,0.23529411764705882
Rahata,Cabbage,2015,5,8,3,60.0
Akluj,Maize,2015,1307,1310,3,0.22953328232593725
Vadgaon Peth,Spinach,2014,2,5,3,150.0
Rahata,Cabbage,2015,5,8,3,60.0
Pune-Pimpri,Math (Bhaji),2016,7,10,3,42.857142857142854
Patan,Coriander  ,2016,3,5,2,66.66666666666667
Kalyan,Coriander  ,2015,5,7,2,40.0
Pune-Pimpri,Shepu,2014,3,5,2,66.66666666666667
Phaltan,Spinach,2016,3,5,2,66.66666666666667
Dudhani,Wheat(Husked),2016,1554,1556,2,0.1287001287001287
Karad,Coriander  ,2014,2,4,2,100.0
Vadgaon Peth,Methi (Bhaji),2016,5,7,2,40.0
Kalyan,Math (Bhaji),2015,7,9,2,28.571428571428573
Vadgaon Peth,Math (Bhaji),2015,3,5,2,66.66666666666667
Vadgaon Peth,Coriander  ,2015,3,5,2,66.66666666666667
Vadgaon Peth,Coriander  ,2015,3,5,2,66.66666666666667
Pune-Pimpri,Spinach,2015,4,6,2,50.0
Vadgaon Peth,Spinach,2016,1,3,2,200.0
Vadgaon Peth,Methi (Bhaji),2015,2,4,2,100.0
Khed,RADDISH,2016,4,6,2,50.0
Patan,Coriander  ,2016,4,6,2,50.0
Murum,Green Gram,2016,5226,5228,2,0.038270187523918864
Vaijapur,Ground Nut Pods (Dry),2015,4475,4477,2,0.0446927374301676
Rahuri-Vambori,Bajri,2016,1506,1508,2,0.13280212483399734
Kalyan,Raddish,2016,18,20,2,11.11111111111111
Vadgaon Peth,Coriander  ,2015,2,4,2,100.0
Chopda,Sunflower,2015,2851,2853,2,0.07015082427218519
Lakhani,Paddy-Unhusked,2015,1810,1812,2,0.11049723756906077
Kalyan,Kanda Pat,2016,10,12,2,20.0
Vadgaon Peth,Leafy Vegetable,2016,4,6,2,50.0
Patan,Coriander  ,2015,3,5,2,66.66666666666667
Vadgaon Peth,Methi (Bhaji),2014,5,7,2,40.0
Jalna-Badnapur,Cotton,2015,3948,3950,2,0.05065856129685917
Vadgaon Peth,Spinach,2015,1,3,2,200.0
Rahata,Coriander ,2015,4,6,2,50.0
Rahata,Cabbage,2015,4,6,2,50.0
Rahata,Cabbage,2015,8,10,2,25.0
Chandrapur,Maize(Corn.),2016,1,3,2,200.0
Pune-Pimpri,Shepu,2016,7,9,2,28.571428571428573
Vadgaon Peth,Math (Bhaji),2014,6,8,2,33.333333333333336
Parli-Vaijnath,Green Gram,2015,7189,7191,2,0.027820280984837947
Dhule,Cowpea,2016,5014,5016,2,0.03988831272437176
Tumsar,Other Cereals,2016,3490,3492,2,0.05730659025787966
Pune-Pimpri,Kanda Pat,2015,5,7,2,40.0
Navapur,Sorgum(Jawar),2015,1200,1202,2,0.16666666666666666
Devala,Sorgum(Jawar),2016,1345,1347,2,0.14869888475836432
Rahata,Flower,2014,8,10,2,25.0
Rahata,Flower,2014,8,10,2,25.0
Vadgaon Peth,Coriander  ,2016,1,3,2,200.0
Pusad,Spilt Pigeon Pea,2016,8912,8914,2,0.02244165170556553
Vadgaon Peth,Coriander  ,2016,5,7,2,40.0
Umarga,Maize,2015,1474,1476,2,0.13568521031207598
Vadgaon Peth,Spinach,2014,2,4,2,100.0
Phaltan,Coriander  ,2016,3,5,2,66.66666666666667
Vadgaon Peth,Spinach,2015,1,3,2,200.0
Parli-Vaijnath,Sunflower,2016,3469,3471,2,0.057653502450273855
Karad,Coriander  ,2015,3,5,2,66.66666666666667
Karad,Math (Bhaji),2015,4,6,2,50.0
Patan,Coriander  ,2015,3,5,2,66.66666666666667
Pune,Rajgira,2016,3,5,2,66.66666666666667
Vadgaon Peth,Coriander  ,2015,2,4,2,100.0
Patan,Coriander  ,2015,10,12,2,20.0
Patan,Coriander  ,2015,3,5,2,66.66666666666667
Vadgaon Peth,Methi (Bhaji),2015,2,4,2,100.0
Rahata,Bajri,2016,1456,1458,2,0.13736263736263737
Patan,Coriander  ,2014,6,8,2,33.333333333333336
Nanded,Soybean,2016,3708,3710,2,0.05393743257820928
Karad,Math (Bhaji),2015,2,4,2,100.0
Patan,Coriander  ,2014,3,5,2,66.66666666666667
Pune-Pimpri,Kanda Pat,2016,5,7,2,40.0
Vadgaon Peth,Methi (Bhaji),2015,5,7,2,40.0
Rahata,Shepu,2015,8,10,2,25.0
Rahata,Math (Bhaji),2015,4,6,2,50.0
Vadgaon Peth,Kanda Pat,2014,3,5,2,66.66666666666667
Karad,Math (Bhaji),2015,8,10,2,25.0
Chopda,Sunflower,2016,3251,3253,2,0.061519532451553366
Mukhed,Sunflower,2015,3410,3412,2,0.05865102639296188
Rahata,Curry Leaves,2015,5,7,2,40.0
Parli-Vaijnath,Wheat(Husked),2016,1511,1513,2,0.13236267372600927
Karad,Spinach,2015,3,5,2,66.66666666666667
Pune-Pimpri,Math (Bhaji),2015,4,6,2,50.0
Shrirampur,Spinach,2016,2,4,2,100.0
Ahmednagar,Spinach,2015,5,7,2,40.0
Ratanagari,Coriander  ,2015,9,11,2,22.22222222222222
Ratanagari,Math (Bhaji),2014,12,14,2,16.666666666666668
Akluj,Bajri,2015,1456,1458,2,0.13736263736263737
Shrirampur,Coriander  ,2016,2,4,2,100.0
Ahmednagar,Spinach,2015,5,7,2,40.0
Alibag,Betelnuts,2016,1,3,2,200.0
Akluj,Coriander  ,2016,3,5,2,66.66666666666667
Shrirampur,Coriander  ,2015,1,3,2,200.0
Shrirampur,Coriander  ,2015,6,8,2,33.333333333333336
Shrirampur,Shepu,2015,2,4,2,100.0
Shahapur,Bottle Gourd,2016,18,20,2,11.11111111111111
Shrirampur,Coriander  ,2015,1,3,2,200.0
Ashti (Jalna),Bajri,2016,1376,1378,2,0.14534883720930233
Ramtek,Lemon,2016,18,20,2,11.11111111111111
Ramtek,Brinjal,2015,7,9,2,28.571428571428573
Ramtek,Cucumber,2016,10,12,2,20.0
Ramtek,Coriander  ,2015,187,189,2,1.0695187165775402
Ramtek,Wal Bhaji,2015,18,20,2,11.11111111111111
Shrirampur,Radish,2015,2,4,2,100.0
Akluj,Coriander  ,2015,4,6,2,50.0
Ratanagari,Math (Bhaji),2016,4,6,2,50.0
Akluj,Coriander  ,2015,2,4,2,100.0
Shrirampur,Radish,2015,2,4,2,100.0
Akluj,Coriander  ,2015,3,5,2,66.66666666666667
Ramtek,Cabbage,2015,6,8,2,33.333333333333336
Akluj,Coriander  ,2014,1,3,2,200.0
Shrirampur,Radish,2015,2,4,2,100.0
Roha,Paddy-Unhusked,2016,1493,1495,2,0.13395847287340926
Ratanagari,Coriander  ,2015,3,5,2,66.66666666666667
Sinner,Rice(Paddy-Hus),2014,1456,1458,2,0.13736263736263737
Shrirampur,Coriander  ,2014,5,7,2,40.0
Ratanagari,Kanda Pat,2015,10,12,2,20.0
Ratanagari,Spinach,2015,7,9,2,28.571428571428573
Shrirampur,Math (Bhaji),2016,8,10,2,25.0
Ratanagari,Spinach,2015,6,8,2,33.333333333333336
Ratanagari,Kanda Pat,2016,7,9,2,28.571428571428573
Ratanagari,SPINACH,2016,6,8,2,33.333333333333336
Ratanagari,Spinach,2015,6,8,2,33.333333333333336
Ratanagari,Math (Bhaji),2016,8,10,2,25.0
Shrirampur,Radish,2014,3,5,2,66.66666666666667
Ratanagari,Math (Bhaji),2015,3,5,2,66.66666666666667
Ratanagari,Math (Bhaji),2015,4,6,2,50.0
Ratanagari,Math (Bhaji),2015,4,6,2,50.0
Ratanagari,Kanda Pat,2016,7,9,2,28.571428571428573
Ratanagari,Spinach,2015,8,10,2,25.0
Ratanagari,Spinach,2015,7,9,2,28.571428571428573
Ratanagari,Coriander  ,2015,9,11,2,22.22222222222222
Ratanagari,MATH (BHAJI),2016,5,7,2,40.0
Ratanagari,Math (Bhaji),2016,8,10,2,25.0
Ramtek,Green-Peas,2015,18,20,2,11.11111111111111
Ratanagari,Coriander  ,2015,20,22,2,10.0
Ratanagari,Coriander  ,2015,4,6,2,50.0
Yeotmal,Wheat(Husked),2016,1788,1790,2,0.11185682326621924
Shahapur,Bottle Gourd,2016,8,10,2,25.0
Ratanagari,Coriander  ,2015,3,5,2,66.66666666666667
Savner,Sorgum(Jawar),2016,950,952,2,0.21052631578947367
Vadgaon Peth,Coriander  ,2015,2,3,1,50.0
Pandharpur,Bajri,2015,1383,1384,1,0.07230657989877079
Katol,Sorgum(Jawar),2016,1462,1463,1,0.06839945280437756
Lasalgaon-Vinchur,Sorgum(Jawar),2016,1787,1788,1,0.05595970900951315
Dhule,Soybean,2015,3055,3056,1,0.03273322422258593
Akluj,Lemon,2015,1,2,1,100.0
Lasalgaon-Vinchur,Rice(Paddy-Hus),2016,1370,1371,1,0.072992700729927
Pandharpur,Maize,2016,1414,1415,1,0.07072135785007072
Pune,Rajgira,2016,4,5,1,25.0
Rahata,Spinach,2016,4,5,1,25.0
Akluj,Shepu,2015,2,3,1,50.0
Pune,Spinach,2015,2,3,1,50.0
Akluj,Maize,2015,1234,1235,1,0.08103727714748785
Kille Dharur,Gram,2015,3550,3551,1,0.028169014084507043
Ahmednagar,Spinach,2015,3,4,1,33.333333333333336
Rahata,Green Gram,2016,4250,4251,1,0.023529411764705882
Rahata,Cabbage,2015,5,6,1,20.0
Beed,Maize,2016,1376,1377,1,0.07267441860465117
Vadgaon Peth,Coriander  ,2016,5,6,1,20.0
Tuljapur,Maize,2016,1395,1396,1,0.07168458781362007
Chopda,Gram,2016,5792,5793,1,0.017265193370165747
Khed (Shel Pimpalgaon),Brinjal,2016,1134,1135,1,0.08818342151675485
Chopda,Soybean,2015,3277,3278,1,0.030515715593530668
Chopda,Sesamum,2015,6000,6001,1,0.016666666666666666
Ahmednagar,Spinach,2015,2,3,1,50.0
Chopda,Sesamum,2015,5670,5671,1,0.01763668430335097
Digras,Soybean,2015,3133,3134,1,0.031918289179699966
Shahada,Cotton,2015,4058,4059,1,0.02464268112370626
Pune-Pimpri,Math (Bhaji),2015,6,7,1,16.666666666666668
Rahata,Flower,2015,5,6,1,20.0
Rahata,Kanda Pat,2015,4,5,1,25.0
Vadgaon Peth,Spinach,2015,2,3,1,50.0
Ramtek,Tomato,2015,4,5,1,25.0
Ramtek,Spinach,2015,4,5,1,25.0
Rahata,Spinach,2015,3,4,1,33.333333333333336
Ramtek,Raddish,2015,4,5,1,25.0
Pune-Moshi,Raddish,2016,8,9,1,12.5
Vadgaon Peth,Coriander  ,2015,2,3,1,50.0
Daryapur,Wheat(Husked),2015,1140,1141,1,0.08771929824561403
Karad,Spinach,2015,2,3,1,50.0
Karad,Coriander  ,2015,2,3,1,50.0
Akluj,Shepu,2016,2,3,1,50.0
Nanded,Wheat(Husked),2016,1700,1701,1,0.058823529411764705
Akluj,Spinach,2016,2,3,1,50.0
Karad,Math (Bhaji),2015,4,5,1,25.0
Akluj,Lemon,2016,1,2,1,100.0
Ramtek,Carrot,2015,9,10,1,11.11111111111111
Akluj,Coriander  ,2016,1,2,1,100.0
Akluj,Maize,2016,1518,1519,1,0.06587615283267458
Kalyan,Spinach,2014,8,9,1,12.5
Dudhani,Wheat(Husked),2016,1434,1435,1,0.0697350069735007
Ahmednagar,Spinach,2016,2,3,1,50.0
Kalyan,Spinach,2015,5,6,1,20.0
Kalyan,Spinach,2016,3,4,1,33.333333333333336
Aamgaon,Paddy-Unhusked,2015,1441,1442,1,0.06939625260235947
Ramtek,Bottle Gourd,2015,4,5,1,25.0
Indapur-Bhigwan,Green Gram,2015,5800,5800,0,0.0
Aheri,Maize,2016,1225,1225,0,0.0
Indapur-Bhigwan,Cowpea,2015,2000,2000,0,0.0
Jalgaon Jamod,Green Gram,2015,6200,6200,0,0.0
Jalgaon Jamod,Green Gram,2015,6000,6000,0,0.0
Indapur-Bhigwan,Pavtta,2015,2000,2000,0,0.0
Indapur-Bhigwan,Coriander (Dry),2015,11000,11000,0,0.0
Indapur-Bhigwan,Pavtta,2015,2900,2900,0,0.0
Indapur-Bhigwan,Mustard,2015,4000,4000,0,0.0
Indapur-Bhigwan,Pavtta,2015,3000,3000,0,0.0
Indapur-Bhigwan,Pavtta,2015,3000,3000,0,0.0
Indapur-Bhigwan,Pavtta,2015,2500,2500,0,0.0
Indapur-Bhigwan,Coriander (Dry),2015,9550,9550,0,0.0
Indapur-Bhigwan,Mustard,2015,4001,4001,0,0.0
Indapur-Bhigwan,Matki,2015,9100,9100,0,0.0
Indapur-Bhigwan,Matki,2015,7000,7000,0,0.0
Indapur-Bhigwan,Green Gram,2015,6000,6000,0,0.0
Jalgaon Jamod,Ground Nut Pods (Dry),2015,3000,3000,0,0.0
Indapur-Bhigwan,Horse Gram,2015,2000,2000,0,0.0
Indapur-Bhigwan,Cowpea,2015,3333,3333,0,0.0
Indapur-Bhigwan,Horse Gram,2015,2250,2250,0,0.0
Indapur-Bhigwan,Pigeon Pea (Tur),2015,4700,4700,0,0.0
Indapur-Bhigwan,Green Peas (Dry),2015,1900,1900,0,0.0
Aheri,Soybean,2016,3300,3300,0,0.0
Indapur-Bhigwan,Green Peas (Dry),2015,2800,2800,0,0.0
Indapur-Bhigwan,Green Peas (Dry),2015,1201,1201,0,0.0
Indapur-Bhigwan,Green Peas (Dry),2015,2500,2500,0,0.0
Aheri,Soybean,2016,3460,3460,0,0.0
Indapur-Bhigwan,Green Gram,2015,5675,5675,0,0.0
Jalgaon,Black Gram,2016,11833,11833,0,0.0
Aheri,Maize,2016,1233,1233,0,0.0
Indapur-Bhigwan,Pigeon Pea (Tur),2015,8050,8050,0,0.0
Aheri,Soybean,2016,3350,3350,0,0.0
Indapur-Bhigwan,Castor Seed,2016,3000,3000,0,0.0
Indapur-Bhigwan,Chillies(Red),2016,7944,7944,0,0.0
Indapur-Bhigwan,Chillies(Red),2016,9400,9400,0,0.0
Indapur-Bhigwan,Chillies(Red),2016,11000,11000,0,0.0
Jalgaon Jamod,Sorgum(Jawar),2014,1500,1500,0,0.0
Jalgaon Jamod,Green Gram,2014,6750,6750,0,0.0
Jalgaon Jamod,Gram,2014,2000,2000,0,0.0
Indapur-Bhigwan,Chillies(Red),2016,9200,9200,0,0.0
Indapur-Bhigwan,Coriander (Dry),2016,7500,7500,0,0.0
Indapur-Bhigwan,Coriander (Dry),2016,6301,6301,0,0.0
Indapur-Bhigwan,Cowpea,2016,3176,3176,0,0.0
Indapur-Bhigwan,Cowpea,2016,4251,4251,0,0.0
Indapur-Bhigwan,Green Gram,2016,7500,7500,0,0.0
Jalgaon Jamod,Gram,2014,2100,2100,0,0.0
Indapur-Bhigwan,Green Peas (Dry),2016,1900,1900,0,0.0
Indapur-Bhigwan,COWPEA,2016,3875,3875,0,0.0
Indapur-Bhigwan,Black Gram,2016,6100,6100,0,0.0
Indapur-Bhigwan,Black Gram,2016,8100,8100,0,0.0
Indapur-Bhigwan,Safflower,2015,2600,2600,0,0.0
Jalgaon Jamod,Pigeon Pea (Tur),2015,5167,5167,0,0.0
Aheri,Maize,2016,1333,1333,0,0.0
Jalgaon Jamod,Gram,2015,3750,3750,0,0.0
Jalgaon Jamod,Gram,2015,4000,4000,0,0.0
Indapur-Bhigwan,Safflower,2015,2950,2950,0,0.0
Jalgaon Jamod,Black Gram,2015,6000,6000,0,0.0
Indapur-Bhigwan,Soybean,2015,3000,3000,0,0.0
Indapur-Bhigwan,Wheat(Unhusked),2015,3156,3156,0,0.0
Jalgaon Jamod,Sorgum(Jawar),2014,1175,1175,0,0.0
Indapur-Bhigwan,Soybean,2015,3000,3000,0,0.0
Indapur-Bhigwan,Sunflower,2015,3000,3000,0,0.0
Indapur-Bhigwan,Sunflower,2015,3100,3100,0,0.0
Indapur-Bhigwan,Wheat(Unhusked),2015,2300,2300,0,0.0
Indapur-Bhigwan,Wheat(Unhusked),2015,2750,2750,0,0.0
Jalgaon Jamod,Pigeon Pea (Tur),2015,5000,5000,0,0.0
Indapur-Bhigwan,Chillies(Red),2015,7500,7500,0,0.0
Jalgaon Jamod,Sorgum(Jawar),2015,1200,1200,0,0.0
Indapur-Bhigwan,Coriander (Dry),2015,10000,10000,0,0.0
Indapur,Wheat(Unhusked),2016,3000,3000,0,0.0
Indapur (Nimgaon Ketki),Chillies(Red),2015,4600,4600,0,0.0
Indapur (Nimgaon Ketki),Ground Nut Pods (Dry),2015,3511,3511,0,0.0
Jalgaon Jamod-Aasalgaon,Black Gram,2015,6667,6667,0,0.0
Indapur (Nimgaon Ketki),Ground Nut Pods (Dry),2015,5251,5251,0,0.0
Indapur (Nimgaon Ketki),Ground Nut Pods (Dry),2015,5300,5300,0,0.0
Indapur (Nimgaon Ketki),Bajri,2016,1421,1421,0,0.0
Indapur (Nimgaon Ketki),Bajri,2016,1543,1543,0,0.0
Aheri,MAIZE,2016,1425,1425,0,0.0
Indapur (Nimgaon Ketki),Bajri,2016,1721,1721,0,0.0
Indapur (Nimgaon Ketki),Gram,2016,2150,2150,0,0.0
Indapur (Nimgaon Ketki),Gram,2016,6111,6111,0,0.0
Indapur (Nimgaon Ketki),Ground Nut Pods (Dry),2016,3011,3011,0,0.0
Indapur (Nimgaon Ketki),Ground Nut Pods (Dry),2016,3501,3501,0,0.0
Indapur (Nimgaon Ketki),Pigeon Pea (Tur),2016,8700,8700,0,0.0
Yeotmal,Green Gram,2014,5121,5121,0,0.0
Indapur,Wheat(Unhusked),2016,2300,2300,0,0.0
Indapur,Tamarind,2016,5200,5200,0,0.0
Indapur,Soybean,2016,3151,3151,0,0.0
Indapur,Sesamum,2016,6000,6000,0,0.0
Indapur,Soybean,2016,3400,3400,0,0.0
Indapur,Soybean,2016,3111,3111,0,0.0
Indapur,Soybean,2016,3400,3400,0,0.0
Indapur,Soybean,2016,3334,3334,0,0.0
Indapur,Soybean,2016,3533,3533,0,0.0
Indapur,Sunflower,2016,3542,3542,0,0.0
Ahmednagar,Castor Seed,2015,3313,3313,0,0.0
Jalgaon Jamod-Aasalgaon,Black Gram,2015,5200,5200,0,0.0
Indapur,Sunflower,2016,3200,3200,0,0.0
Indapur,Sunflower,2016,3000,3000,0,0.0
Indapur,Sunflower,2016,3051,3051,0,0.0
Indapur,Sunflower,2016,3319,3319,0,0.0
Ahmednagar,Castor Seed,2015,3683,3683,0,0.0
Indapur (Nimgaon Ketki),Pigeon Pea (Tur),2016,6025,6025,0,0.0
Indapur (Nimgaon Ketki),Rice(Paddy-Hus),2016,1151,1151,0,0.0
Indapur (Nimgaon Ketki),Rice(Paddy-Hus),2016,1201,1201,0,0.0
Indapur-Bhigwan,Black Gram,2015,3251,3251,0,0.0
Ahmednagar,Bajri,2015,1615,1615,0,0.0
Jalgaon Jamod,Sorgum(Jawar),2016,1250,1250,0,0.0
Ahmednagar,Matki,2014,7400,7400,0,0.0
Ahmednagar,Horse Gram,2014,3261,3261,0,0.0
Aheri,Soybean,2016,3400,3400,0,0.0
Indapur-Bhigwan,Black Gram,2015,6917,6917,0,0.0
Indapur-Bhigwan,Castor Seed,2015,3500,3500,0,0.0
Ahmednagar,Black Gram,2015,8100,8100,0,0.0
Jalgaon Jamod,Pigeon Pea (Tur),2016,7500,7500,0,0.0
Jalgaon Jamod,Ground Nut Pods (Dry),2016,4000,4000,0,0.0
Indapur-Bhigwan,Green Peas (Dry),2016,2001,2001,0,0.0
Aheri,Soybean,2016,3500,3500,0,0.0
Jalgaon Jamod,Sorgum(Jawar),2015,1200,1200,0,0.0
Indapur-Bhigwan,Chillies(Red),2015,9500,9500,0,0.0
Ahmednagar,Black Gram,2015,5700,5700,0,0.0
Ahmednagar,Black Gram,2015,5200,5200,0,0.0
Indapur (Nimgaon Ketki),Soybean,2016,3311,3311,0,0.0
Indapur-Bhigwan,Safflower,2014,2500,2500,0,0.0
Indapur (Nimgaon Ketki),Sunflower,2016,3001,3001,0,0.0
Indapur (Nimgaon Ketki),Wheat(Husked),2016,1500,1500,0,0.0
Indapur-Bhigwan,Coriander (Dry),2014,10000,10000,0,0.0
Aheri,Maize,2016,1200,1200,0,0.0
Indapur-Bhigwan,Coriander (Dry),2014,10100,10100,0,0.0
Ahmednagar,Black Gram,2015,9400,9400,0,0.0
Indapur-Bhigwan,Sesamum,2014,10250,10250,0,0.0
Jalgaon Jamod,Soybean,2016,3300,3300,0,0.0
Indapur-Bhigwan,Sesamum,2014,11000,11000,0,0.0
Indapur-Bhigwan,Wheat(Unhusked),2014,2901,2901,0,0.0
Indapur-Bhigwan,Wheat(Unhusked),2014,2767,2767,0,0.0
Jalgaon Jamod-Aasalgaon,Sesamum,2014,6500,6500,0,0.0
Aheri,Maize,2016,1400,1400,0,0.0
Jalgaon Jamod-Aasalgaon,Ground Nut Pods (Dry),2014,3200,3200,0,0.0
Aheri,Maize,2016,1350,1350,0,0.0
Aheri,Soybean,2016,3500,3500,0,0.0
Indapur-Bhigwan,Green Peas (Dry),2016,3100,3100,0,0.0
Yeola,Wheat(Husked),2016,1784,1784,0,0.0
Jalgaon,Pigeon Pea (Tur),2015,6000,6000,0,0.0
Aheri,Maize,2016,1363,1363,0,0.0
Jalgaon,Pigeon Pea (Tur),2015,5120,5120,0,0.0
Jalgaon,Pigeon Pea (Tur),2015,5267,5267,0,0.0
Yeola,Wheat(Husked),2016,1567,1567,0,0.0
Yeola,Wheat(Husked),2016,1528,1528,0,0.0
Jalgaon,Green Gram,2016,6800,6800,0,0.0
Jalgaon,Pigeon Pea (Tur),2015,9900,9900,0,0.0
Aheri,Maize,2016,1350,1350,0,0.0
Jalgaon,Rajgira,2015,4500,4500,0,0.0
Jalgaon,Rajgira,2015,3600,3600,0,0.0
Jalgaon,Soybean,2015,2788,2788,0,0.0
Jalgaon,Soybean,2015,3200,3200,0,0.0
Aheri,Pigeon Pea (Tur),2016,8000,8000,0,0.0
Aheri,Pigeon Pea (Tur),2016,7000,7000,0,0.0
Yeola,Wheat(Husked),2016,1460,1460,0,0.0
Jalgaon,Pigeon Pea (Tur),2015,5467,5467,0,0.0
Jalgaon,Maize,2016,1605,1605,0,0.0
Aheri,Pigeon Pea (Tur),2016,6500,6500,0,0.0
Aheri,Pigeon Pea (Tur),2016,6600,6600,0,0.0
Aheri,Rice(Paddy-Hus),2016,3600,3600,0,0.0
Jalgaon,Soybean,2016,3700,3700,0,0.0
Jalgaon,Coriander (Dry),2015,10060,10060,0,0.0
Jalgaon,Soybean,2016,3600,3600,0,0.0
Jalgaon,Maize(Corn.),2016,1000,1000,0,0.0
Jalgaon,Cotton,2015,4100,4100,0,0.0
Jalgaon,Cotton,2015,3900,3900,0,0.0
Aheri,Rice(Paddy-Hus),2016,2000,2000,0,0.0
Jalgaon,Green Gram,2015,5000,5000,0,0.0
Jalgaon,Green Gram,2015,6000,6000,0,0.0
Jalgaon,Jaggery,2015,2525,2525,0,0.0
Aheri,Rice(Paddy-Hus),2016,3600,3600,0,0.0
Aheri,RICE(PADDY-HUS),2016,2000,2000,0,0.0
Aheri,Pigeon Pea (Tur),2016,6500,6500,0,0.0
Aheri,Pigeon Pea (Tur),2016,6833,6833,0,0.0
Jalgaon,Spinach,2015,1660,1660,0,0.0
Jalgaon,Spinach,2015,1459,1459,0,0.0
Jalgaon,CLUSTER BEAN,2016,2905,2905,0,0.0
Aheri,Paddy-Unhusked,2016,1645,1645,0,0.0
Aheri,Paddy-Unhusked,2016,1767,1767,0,0.0
Jalgaon,Bajri,2016,1425,1425,0,0.0
Jalgaon,Chikoo,2016,2500,2500,0,0.0
Vadgaon Peth,Coriander  ,2015,100,100,0,0.0
Aheri,Matki,2016,5700,5700,0,0.0
Aheri,Matki,2016,5867,5867,0,0.0
Jalgaon,Chikoo,2016,1500,1500,0,0.0
Aheri,Paddy-Unhusked,2016,1639,1639,0,0.0
Aheri,Matki,2016,6700,6700,0,0.0
Aheri,Paddy-Unhusked,2016,1490,1490,0,0.0
Aheri,Paddy-Unhusked,2016,1460,1460,0,0.0
Aheri,Paddy-Unhusked,2016,1783,1783,0,0.0
Aheri,PADDY-UNHUSKED,2016,1757,1757,0,0.0
Yeola,Sorgum(Jawar),2016,1601,1601,0,0.0
Jalgaon,Bajri,2016,1515,1515,0,0.0
Jalgaon,Beet Root,2016,1500,1500,0,0.0
Yeola,Pigeon Pea (Tur),2016,5175,5175,0,0.0
Aheri,Paddy-Unhusked,2016,1669,1669,0,0.0
Aheri,Paddy-Unhusked,2016,1618,1618,0,0.0
Aheri,Paddy-Unhusked,2016,1450,1450,0,0.0
Jalgaon,Spinach,2015,1779,1779,0,0.0
Jalgaon,Green Gram,2016,6943,6943,0,0.0
Jalgaon,Spinach,2015,1364,1364,0,0.0
Jalgaon,Gram,2016,6800,6800,0,0.0
Jalgaon,Gram,2016,7533,7533,0,0.0
Jalgaon,Gram,2016,7200,7200,0,0.0
Jalgaon,Spinach,2015,1338,1338,0,0.0
Jalgaon,Spinach,2015,2006,2006,0,0.0
Aheri,Pigeon Pea (Tur),2016,7700,7700,0,0.0
Jalgaon,Squash Gourd,2015,1400,1400,0,0.0
Jalgaon,Squash Gourd,2015,700,700,0,0.0
Jalgaon,Tamarind,2015,5000,5000,0,0.0
Jalgaon,Cluster Bean,2016,4000,4000,0,0.0
Jalgaon,Wal Papdi,2015,2500,2500,0,0.0
Jalgaon,Cluster Bean,2016,4000,4000,0,0.0
Jalgaon,Black Gram,2015,5200,5200,0,0.0
Jalgaon,Black Gram,2015,7605,7605,0,0.0
Aheri,Rice(Paddy-Hus),2016,2900,2900,0,0.0
Yeola,Green Gram,2016,6700,6700,0,0.0
Indapur-Bhigwan,Pigeon Pea (Tur),2016,6300,6300,0,0.0
Indapur-Bhigwan,Pigeon Pea (Tur),2016,5000,5000,0,0.0
Indapur-Bhigwan,Rajgira,2016,4000,4000,0,0.0
Jalgaon,Spinach,2016,1659,1659,0,0.0
Aheri,Sorgum(Jawar),2016,1500,1500,0,0.0
Aheri,Sorgum(Jawar),2016,1283,1283,0,0.0
Yeola,Green Gram,2016,5307,5307,0,0.0
Yeola,Green Gram,2016,6571,6571,0,0.0
Yeola,Matki,2016,7400,7400,0,0.0
Jalgaon,Spinach,2016,1686,1686,0,0.0
Indapur-Bhigwan,Safflower,2016,2500,2500,0,0.0
Indapur-Bhigwan,Safflower,2016,2551,2551,0,0.0
Jalgaon,Spinach,2016,1409,1409,0,0.0
Indapur-Bhigwan,Safflower,2016,2851,2851,0,0.0
Indapur-Bhigwan,Sesamum,2016,8000,8000,0,0.0
Jalgaon,Spinach,2016,1946,1946,0,0.0
Aheri,Soybean,2016,3400,3400,0,0.0
Indapur-Bhigwan,Mustard,2016,4000,4000,0,0.0
Indapur-Bhigwan,Mustard,2016,3600,3600,0,0.0
Indapur-Bhigwan,Mustard,2016,4100,4100,0,0.0
Yeotmal,Black Gram,2014,5022,5022,0,0.0
Indapur-Bhigwan,Green Peas (Dry),2016,3001,3001,0,0.0
Indapur-Bhigwan,Green Peas (Dry),2016,1575,1575,0,0.0
Indapur-Bhigwan,Green Peas (Dry),2016,1833,1833,0,0.0
Indapur-Bhigwan,Ground Nut Pods (Dry),2016,5050,5050,0,0.0
Indapur-Bhigwan,Horse Gram,2016,3000,3000,0,0.0
Indapur-Bhigwan,Horse Gram,2016,2767,2767,0,0.0
Indapur-Bhigwan,Horse Gram,2016,3000,3000,0,0.0
Indapur-Bhigwan,Horse Gram,2016,1926,1926,0,0.0
Indapur-Bhigwan,Horse Gram,2016,2750,2750,0,0.0
Indapur-Bhigwan,Horse Gram,2016,3100,3100,0,0.0
Yeotmal,Black Gram,2014,4840,4840,0,0.0
Indapur-Bhigwan,Matki,2016,7301,7301,0,0.0
Indapur-Bhigwan,Matki,2016,7000,7000,0,0.0
Indapur-Bhigwan,Matki,2016,5651,5651,0,0.0
Jalgaon,Spinach,2016,1342,1342,0,0.0
Indapur-Bhigwan,Sesamum,2016,7000,7000,0,0.0
Indapur-Bhigwan,Sesamum,2016,7701,7701,0,0.0
Aheri,Sorgum(Jawar),2016,1450,1450,0,0.0
Aheri,Sorgum(Jawar),2016,1500,1500,0,0.0
Aheri,Sesamum,2016,4500,4500,0,0.0
Aheri,Sesamum,2016,4500,4500,0,0.0
Jalgaon,Spinach,2016,1700,1700,0,0.0
Aheri,SESAMUM,2016,4500,4500,0,0.0
Jalgaon,Soybean,2014,3288,3288,0,0.0
Aheri,Rice(Paddy-Hus),2016,3133,3133,0,0.0
Jalgaon,Soybean,2016,4000,4000,0,0.0
Jalgaon,Spinach,2014,1677,1677,0,0.0
Jalgaon,Spinach,2014,1557,1557,0,0.0
Jalgaon,Spinach,2014,1780,1780,0,0.0
Jalgaon,Wal Papdi,2014,2317,2317,0,0.0
Aheri,Rice(Paddy-Hus),2016,4000,4000,0,0.0
Aheri,Rice(Paddy-Hus),2016,1813,1813,0,0.0
Aheri,Rice(Paddy-Hus),2016,2383,2383,0,0.0
Jalgaon,Spinach,2016,1629,1629,0,0.0
Jalgaon,Pigeon Pea (Tur),2014,4000,4000,0,0.0
Indapur-Bhigwan,Soybean,2016,3151,3151,0,0.0
Jalgaon,Pigeon Pea (Tur),2014,3300,3300,0,0.0
Indapur-Bhigwan,Soybean,2016,3200,3200,0,0.0
Indapur-Bhigwan,Sunflower,2016,3050,3050,0,0.0
Indapur-Bhigwan,Sunflower,2016,3000,3000,0,0.0
Indapur-Bhigwan,Sunflower,2016,3226,3226,0,0.0
Indapur-Bhigwan,Wheat(Unhusked),2016,3000,3000,0,0.0
Indapur-Bhigwan,Wheat(Unhusked),2016,2551,2551,0,0.0
Indapur-Bhigwan,Wheat(Unhusked),2016,3050,3050,0,0.0
Jalgaon,Bajri,2014,1398,1398,0,0.0
Jalgaon,Spinach,2016,1206,1206,0,0.0
Jalgaon,Cluster Bean,2014,4367,4367,0,0.0
Jalgaon,Cotton,2014,4050,4050,0,0.0
Jalgaon,Cotton,2014,4025,4025,0,0.0
Jalgaon,Fenugreek,2014,3700,3700,0,0.0
Jalgaon,Maize,2014,1053,1053,0,0.0
Jalgaon,Maize(Corn.),2014,1000,1000,0,0.0
Jalgaon,Cluster Bean,2014,3821,3821,0,0.0
Wardha,LINSEED,2016,9000,9000,0,0.0
Indapur,Sesamum,2016,6000,6000,0,0.0
Gevrai,Matki,2015,6000,6000,0,0.0
Ahmednagar,Matki,2016,9000,9000,0,0.0
Ahmednagar,Mango,2016,3875,3875,0,0.0
Ahmednagar,Maize,2016,1656,1656,0,0.0
Ahmednagar,Maize,2016,1655,1655,0,0.0
Ahmednagar,MATKI,2016,7700,7700,0,0.0
Ahmednagar,Horse Gram,2016,15000,15000,0,0.0
Ahmednagar,Horse Gram,2016,3300,3300,0,0.0
Gevrai,Mustard,2015,3525,3525,0,0.0
Gevrai,Mustard,2015,3588,3588,0,0.0
Gevrai,Rala,2015,1450,1450,0,0.0
Gevrai,Rala,2015,1564,1564,0,0.0
Gevrai,Rala,2015,2727,2727,0,0.0
Gevrai,Safflower,2015,2050,2050,0,0.0
Gevrai,Safflower,2015,2400,2400,0,0.0
Gevrai,Safflower,2015,2101,2101,0,0.0
Gevrai,Safflower,2015,2200,2200,0,0.0
Gevrai,Safflower,2015,2748,2748,0,0.0
Gevrai,Matki,2015,7800,7800,0,0.0
Gevrai,Maize,2015,1447,1447,0,0.0
Gevrai,Sesamum,2015,7650,7650,0,0.0
Gevrai,Maize,2015,1147,1147,0,0.0
Ahmednagar,Mosambi,2016,4800,4800,0,0.0
Gevrai,Black Gram,2015,8800,8800,0,0.0
Gevrai,Black Gram,2015,8334,8334,0,0.0
Gevrai,Green Gram,2015,6000,6000,0,0.0
Gevrai,Green Gram,2015,5425,5425,0,0.0
Gevrai,Green Gram,2015,6846,6846,0,0.0
Gevrai,Green Gram,2015,6900,6900,0,0.0
Gevrai,Green Gram,2015,4900,4900,0,0.0
Gevrai,Green Gram,2015,6150,6150,0,0.0
Gevrai,Ground Nut Pods (Dry),2015,3300,3300,0,0.0
Ahmednagar,Matki,2016,7500,7500,0,0.0
Gevrai,Ground Nut Pods (Dry),2015,4000,4000,0,0.0
Gevrai,Ground Nut Pods (Dry),2015,2650,2650,0,0.0
Gevrai,Ground Nut Pods (Dry),2015,3833,3833,0,0.0
Gevrai,Ground Nut Pods (Dry),2015,4350,4350,0,0.0
Gevrai,Ground Nut Pods (Dry),2015,5000,5000,0,0.0
Gevrai,Maize,2015,1228,1228,0,0.0
Gevrai,Sesamum,2015,7400,7400,0,0.0
Gevrai,Sesamum,2015,6801,6801,0,0.0
Gevrai,Bhagar/Vari,2015,1551,1551,0,0.0
Gevrai,Mustard,2016,4000,4000,0,0.0
Ahmednagar,Green Gram,2016,7500,7500,0,0.0
Gevrai,Safflower,2016,2650,2650,0,0.0
Ahmednagar,Green Gram,2016,7029,7029,0,0.0
Gevrai,Safflower,2016,2059,2059,0,0.0
Gevrai,Sesamum,2016,6001,6001,0,0.0
Gevrai,Sesamum,2016,8000,8000,0,0.0
Gevrai,Sesamum,2016,6500,6500,0,0.0
Ahmednagar,Green Gram,2016,6650,6650,0,0.0
Gevrai,Sunflower,2016,3532,3532,0,0.0
Ahmednagar,Cowpea,2016,3300,3300,0,0.0
Ghoti,Bitter Gourd,2014,2600,2600,0,0.0
Ghoti,Cucumber,2014,3000,3000,0,0.0
Ghoti,Cucumber,2014,900,900,0,0.0
Ghoti,Paddy-Unhusked,2014,2200,2200,0,0.0
Ghoti,Rice(Paddy-Hus),2014,3330,3330,0,0.0
Ghoti,Cucumber,2015,3500,3500,0,0.0
Ahmednagar,Cowpea,2016,4200,4200,0,0.0
Gevrai,Mustard,2016,3625,3625,0,0.0
Yeola,Green Gram,2015,7601,7601,0,0.0
Ahmednagar,Horse Gram,2016,9750,9750,0,0.0
Yeola,Green Gram,2015,7928,7928,0,0.0
Gevrai,Sesamum,2015,6875,6875,0,0.0
Gevrai,Sunflower,2015,2501,2501,0,0.0
Ahmednagar,Horse Gram,2016,8500,8500,0,0.0
Ahmednagar,HORSE GRAM,2016,4050,4050,0,0.0
Gevrai,Bhagar/Vari,2016,2000,2000,0,0.0
Gevrai,Green Gram,2016,4800,4800,0,0.0
Gevrai,Green Gram,2016,5700,5700,0,0.0
Gevrai,Green Gram,2016,5750,5750,0,0.0
Gevrai,Green Gram,2016,4301,4301,0,0.0
Gevrai,Ground Nut Pods (Dry),2016,4700,4700,0,0.0
Ahmednagar,Green Gram,2016,7376,7376,0,0.0
Gevrai,Maize,2016,1554,1554,0,0.0
Gevrai,Maize,2016,1398,1398,0,0.0
Gevrai,Matki,2016,8500,8500,0,0.0
Yeola,Green Gram,2015,7301,7301,0,0.0
Gevrai,Matki,2016,7700,7700,0,0.0
Gevrai,Mustard,2016,3951,3951,0,0.0
Gevrai,Black Gram,2015,3500,3500,0,0.0
Gevrai,Bhagar/Vari,2015,1300,1300,0,0.0
Indapur,Safflower,2016,3050,3050,0,0.0
Dondaicha-Sindkheda,Sorgum(Jawar),2016,1900,1900,0,0.0
Ahmedpur,Hemp-Seed,2015,1850,1850,0,0.0
Ahmedpur,Hemp-Seed,2015,1300,1300,0,0.0
Ahmedpur,Hemp-Seed,2015,1600,1600,0,0.0
Ahmedpur,Hemp-Seed,2015,1918,1918,0,0.0
Dound,Cowpea,2016,7358,7358,0,0.0
Ahmedpur,Hemp-Seed,2015,1534,1534,0,0.0
Dudhani,Bajri,2015,1305,1305,0,0.0
Yeola,Pigeon Pea (Tur),2014,4101,4101,0,0.0
Ahmedpur,Ground Nut Pods (Dry),2015,5150,5150,0,0.0
Ahmedpur,Ground Nut Pods (Dry),2015,5750,5750,0,0.0
Ahmedpur,Ground Nut Pods (Dry),2015,5975,5975,0,0.0
Dudhani,Black Gram,2015,5500,5500,0,0.0
Ahmedpur,Ground Nut Pods (Dry),2015,4687,4687,0,0.0
Dudhani,Black Gram,2015,9800,9800,0,0.0
Dudhani,Black Gram,2015,4867,4867,0,0.0
Dudhani,Black Gram,2015,4550,4550,0,0.0
Dudhani,Black Gram,2015,6500,6500,0,0.0
Dondaicha-Sindkheda,Sunflower,2016,4300,4300,0,0.0
Dondaicha-Sindkheda,Sesamum,2016,3956,3956,0,0.0
Ahmedpur,Green Gram,2015,6500,6500,0,0.0
Dondaicha-Sindkheda,Matki,2016,4300,4300,0,0.0
Yeola,Cowpea,2014,3454,3454,0,0.0
Ahmedpur,Niger-Seed,2015,7350,7350,0,0.0
Ahmedpur,Niger-Seed,2015,7687,7687,0,0.0
Ahmedpur,Niger-Seed,2015,7501,7501,0,0.0
Ahmedpur,Neem-Seed,2015,700,700,0,0.0
Ahmedpur,Mustard,2015,3683,3683,0,0.0
Ahmedpur,Mustard,2015,3300,3300,0,0.0
Dondaicha-Sindkheda,Green Gram,2016,6501,6501,0,0.0
Dondaicha-Sindkheda,Green Gram,2016,5000,5000,0,0.0
Dondaicha-Sindkheda,Ground Nut Pods (Dry),2016,3800,3800,0,0.0
Ahmedpur,Maize,2015,1330,1330,0,0.0
Ahmedpur,Maize,2015,1401,1401,0,0.0
Ahmedpur,Maize,2015,1330,1330,0,0.0
Dondaicha-Sindkheda,Maize,2016,1571,1571,0,0.0
Dondaicha-Sindkheda,Maize,2016,1603,1603,0,0.0
Dondaicha-Sindkheda,Matki,2016,4500,4500,0,0.0
Dondaicha-Sindkheda,Matki,2016,4767,4767,0,0.0
Dudhani,Green Gram,2015,6153,6153,0,0.0
Dudhani,Maize,2015,1375,1375,0,0.0
Ahmednagar,Mustard,2016,3800,3800,0,0.0
Ahmedpur,Hemp-Seed,2014,1326,1326,0,0.0
Ahmedpur,Bajri,2014,1111,1111,0,0.0
Ahmednagar,Water Melon,2016,1533,1533,0,0.0
Ahmednagar,Tamarind Seed,2016,1857,1857,0,0.0
Ahmednagar,Tamarind Seed,2016,1600,1600,0,0.0
Ahmednagar,Tamarind Seed,2016,1804,1804,0,0.0
Gangapur,Pigeon Pea (Tur),2015,7200,7200,0,0.0
Gangapur,Pigeon Pea (Tur),2015,5850,5850,0,0.0
Yeola,Cowpea,2015,4100,4100,0,0.0
Ahmednagar,Pomegranate,2016,6750,6750,0,0.0
Gangapur,Soybean,2016,3400,3400,0,0.0
Gangapur,Soybean,2016,3596,3596,0,0.0
Gevrai,Ground Nut Pods (Dry),2014,3200,3200,0,0.0
Ahmednagar,Orange,2016,1500,1500,0,0.0
Gevrai,Matki,2014,6500,6500,0,0.0
Gevrai,Rala,2014,5000,5000,0,0.0
Gevrai,Sesamum,2014,9901,9901,0,0.0
Gevrai,Sunflower,2014,3000,3000,0,0.0
Gangapur,Cotton,2014,4026,4026,0,0.0
Dudhani,Wheat(Husked),2016,1433,1433,0,0.0
Dudhani,Maize,2015,1555,1555,0,0.0
Dudhani,Wheat(Husked),2016,1772,1772,0,0.0
Dudhani,Black Gram,2016,9000,9000,0,0.0
Ahmedpur,Castor Seed,2015,3140,3140,0,0.0
Ahmedpur,Castor Seed,2015,2700,2700,0,0.0
Ahmedpur,Black Gram,2015,6700,6700,0,0.0
Dudhani,Black Gram,2016,8700,8700,0,0.0
Ahmedpur,Black Gram,2015,5600,5600,0,0.0
Dudhani,Green Gram,2016,7100,7100,0,0.0
Dudhani,Green Gram,2016,6753,6753,0,0.0
Ahmedpur,Black Gram,2015,8166,8166,0,0.0
Dudhani,Maize,2016,1341,1341,0,0.0
Dudhani,Maize,2016,1583,1583,0,0.0
Dudhani,Maize,2016,1497,1497,0,0.0
Dudhani,Maize,2016,1383,1383,0,0.0
Ahmedpur,Paddy-Unhusked,2014,851,851,0,0.0
Ahmedpur,Niger-Seed,2014,4056,4056,0,0.0
Vadvani,GRAM,2016,7700,7700,0,0.0
Ahmedpur,Maize,2014,988,988,0,0.0
Ghoti,Ladies Finger,2015,1900,1900,0,0.0
Ahmednagar,Cowpea,2016,4500,4500,0,0.0
Ahmednagar,Coriander (Dry),2016,6000,6000,0,0.0
Indapur,Soybean,2015,3311,3311,0,0.0
Indapur,Soybean,2015,2918,2918,0,0.0
Yeola,Sorgum(Jawar),2015,1701,1701,0,0.0
Indapur,Soybean,2015,2801,2801,0,0.0
Ahmednagar,Mustard,2015,3900,3900,0,0.0
Ahmednagar,Mustard,2015,3725,3725,0,0.0
Ahmednagar,Mustard,2015,4300,4300,0,0.0
Indapur,Sunflower,2015,3418,3418,0,0.0
Indapur,Wheat(Unhusked),2015,2700,2700,0,0.0
Indapur,Black Gram,2016,8051,8051,0,0.0
Indapur,Black Gram,2016,9000,9000,0,0.0
Ahmednagar,Mustard,2015,3501,3501,0,0.0
Ahmednagar,Mustard,2015,3617,3617,0,0.0
Indapur,CHILLIES(RED),2016,7100,7100,0,0.0
Indapur,COWPEA,2016,2100,2100,0,0.0
Indapur,Chillies(Red),2016,8600,8600,0,0.0
Indapur,Chillies(Red),2016,7000,7000,0,0.0
Indapur,Coriander (Dry),2016,5500,5500,0,0.0
Indapur,Soybean,2015,3000,3000,0,0.0
Indapur,Sesamum,2015,6300,6300,0,0.0
Indapur,Cowpea,2016,3051,3051,0,0.0
Indapur,Sesamum,2015,8000,8000,0,0.0
Indapur,Cowpea,2015,3375,3375,0,0.0
Indapur,Cowpea,2015,4250,4250,0,0.0
Indapur,Green Gram,2015,6400,6400,0,0.0
Ahmednagar,Mustard,2015,3800,3800,0,0.0
Indapur,Green Gram,2015,6500,6500,0,0.0
Indapur,Ground Nut Pods (Dry),2015,3500,3500,0,0.0
Indapur,Horse Gram,2015,2100,2100,0,0.0
Indapur,Horse Gram,2015,2800,2800,0,0.0
Indapur,Pavtta,2015,3200,3200,0,0.0
Indapur,Pigeon Pea (Tur),2015,4700,4700,0,0.0
Yeola,Pigeon Pea (Tur),2015,8500,8500,0,0.0
Indapur,Pigeon Pea (Tur),2015,7500,7500,0,0.0
Indapur,Rice(Paddy-Hus),2015,1168,1168,0,0.0
Indapur,Rice(Paddy-Hus),2015,1176,1176,0,0.0
Indapur,Rice(Paddy-Hus),2015,1200,1200,0,0.0
Indapur,Rice(Paddy-Hus),2015,1150,1150,0,0.0
Indapur,Rice(Paddy-Hus),2015,1175,1175,0,0.0
Indapur,Cowpea,2016,3100,3100,0,0.0
Indapur,Cowpea,2016,4500,4500,0,0.0
Ghoti,Paddy-Unhusked,2015,1967,1967,0,0.0
Ahmednagar,Cowpea,2015,5000,5000,0,0.0
Indapur,Pigeon Pea (Tur),2016,6963,6963,0,0.0
Ahmednagar,Cowpea,2015,4250,4250,0,0.0
Ahmednagar,Cowpea,2015,4967,4967,0,0.0
Ahmednagar,Coriander (Dry),2015,12500,12500,0,0.0
Indapur,Pigeon Pea (Tur),2016,7000,7000,0,0.0
Indapur,Pigeon Pea (Tur),2016,5900,5900,0,0.0
Indapur,Pigeon Pea (Tur),2016,8000,8000,0,0.0
Indapur,Pigeon Pea (Tur),2016,5300,5300,0,0.0
Ahmednagar,Castor Seed,2015,3750,3750,0,0.0
Indapur,Pigeon Pea (Tur),2016,5926,5926,0,0.0
Ahmednagar,Castor Seed,2015,3736,3736,0,0.0
Ahmednagar,Castor Seed,2015,3683,3683,0,0.0
Indapur,Rice(Paddy-Hus),2016,1400,1400,0,0.0
Indapur,Rice(Paddy-Hus),2016,1125,1125,0,0.0
Indapur,Rice(Paddy-Hus),2016,1371,1371,0,0.0
Indapur,Rice(Paddy-Hus),2016,1300,1300,0,0.0
Indapur,Safflower,2016,2551,2551,0,0.0
Ahmednagar,Cowpea,2015,5250,5250,0,0.0
Ahmednagar,Horse Gram,2015,7150,7150,0,0.0
Indapur,Cowpea,2016,2500,2500,0,0.0
Ahmednagar,Horse Gram,2015,7501,7501,0,0.0
Indapur,Cowpea,2016,3100,3100,0,0.0
Indapur,GREEN GRAM,2016,4000,4000,0,0.0
Indapur,Green Peas (Dry),2016,3100,3100,0,0.0
Indapur,Ground Nut Pods (Dry),2016,4275,4275,0,0.0
Indapur,Horse Gram,2016,2100,2100,0,0.0
Indapur,Horse Gram,2016,2500,2500,0,0.0
Indapur,Matki,2016,7000,7000,0,0.0
Jalgaon Jamod-Aasalgaon,Green Gram,2015,8000,8000,0,0.0
Ahmednagar,Matki,2015,7750,7750,0,0.0
Ahmednagar,Matki,2015,9000,9000,0,0.0
Indapur,Mustard,2016,4211,4211,0,0.0
Indapur,Mustard,2016,4100,4100,0,0.0
Indapur,PIGEON PEA (TUR),2016,5200,5200,0,0.0
Vadgaon Peth,Methi (Bhaji),2016,4,4,0,0.0
Ahmednagar,Matki,2015,7500,7500,0,0.0
Ahmednagar,Maize,2015,1406,1406,0,0.0
Ahmednagar,Horse Gram,2015,4817,4817,0,0.0
Indapur,Cowpea,2015,3100,3100,0,0.0
Indapur,Chillies(Red),2015,4267,4267,0,0.0
Indapur,Chillies(Red),2015,6700,6700,0,0.0
Hinganghat,Sesamum,2016,4850,4850,0,0.0
Hinganghat,Sorgum(Jawar),2016,1725,1725,0,0.0
Hinganghat,Sorgum(Jawar),2016,1125,1125,0,0.0
Hinganghat,Sorgum(Jawar),2016,1105,1105,0,0.0
Hinganghat,Sorgum(Jawar),2016,1130,1130,0,0.0
Ahmednagar,Castor Seed,2016,3100,3100,0,0.0
Hingna,Pigeon Pea (Tur),2015,7500,7500,0,0.0
Hingna,Pigeon Pea (Tur),2015,4601,4601,0,0.0
Hingna,Soybean,2015,3200,3200,0,0.0
Hingna,Soybean,2015,3100,3100,0,0.0
Hingna,Gram,2016,4850,4850,0,0.0
Hingna,Gram,2016,3000,3000,0,0.0
Hingna,Soybean,2016,3150,3150,0,0.0
Ahmednagar,Carrot,2016,3500,3500,0,0.0
Ahmednagar,Black Gram,2016,8250,8250,0,0.0
Hingoli,Cotton,2015,4200,4200,0,0.0
Ahmednagar,Black Gram,2016,7875,7875,0,0.0
Ahmednagar,Black Gram,2016,7500,7500,0,0.0
Hinganghat,Sesamum,2016,6383,6383,0,0.0
Hinganghat,Linseed,2016,5300,5300,0,0.0
Indapur,Black Gram,2015,7050,7050,0,0.0
Hinganghat,Linseed,2016,7159,7159,0,0.0
Ghoti,Paddy-Unhusked,2015,2000,2000,0,0.0
Ghoti,CAPSICUM,2016,900,900,0,0.0
Ghoti,Capsicum,2016,2000,2000,0,0.0
Ghoti,Cucumber,2016,3800,3800,0,0.0
Ghoti,Ladies Finger,2016,1800,1800,0,0.0
Gondiya,Other Cereals,2016,3925,3925,0,0.0
Hinganghat,Sesamum,2015,7150,7150,0,0.0
Ahmednagar,Coriander (Dry),2016,5000,5000,0,0.0
Yeola,Maize,2015,1541,1541,0,0.0
Ahmednagar,Chikoo,2016,2000,2000,0,0.0
Hinganghat,Sorgum(Jawar),2015,1183,1183,0,0.0
Ahmednagar,Chavli (Shenga ),2016,6500,6500,0,0.0
Hinganghat,Green Gram,2016,5600,5600,0,0.0
Hinganghat,Green Gram,2016,5700,5700,0,0.0
Hinganghat,Green Gram,2016,5139,5139,0,0.0
Hinganghat,Green Gram,2016,5000,5000,0,0.0
Hinganghat,Linseed,2016,5573,5573,0,0.0
Ahmednagar,Tamarind Seed,2015,1664,1664,0,0.0
Ahmednagar,Tamarind Seed,2015,1600,1600,0,0.0
Ahmednagar,Tamarind Seed,2015,1480,1480,0,0.0
Hingoli,Green Gram,2015,6800,6800,0,0.0
Hingoli,WHEAT(HUSKED),2016,2245,2245,0,0.0
Hingoli,Wheat(Husked),2016,2385,2385,0,0.0
Hingoli,Wheat(Husked),2016,2045,2045,0,0.0
Hingoli,Wheat(Husked),2016,2109,2109,0,0.0
Hingoli,Wheat(Husked),2016,2075,2075,0,0.0
Hingoli,Wheat(Husked),2016,2223,2223,0,0.0
Hingoli,Wheat(Husked),2016,2342,2342,0,0.0
Hingoli,Wheat(Husked),2016,2325,2325,0,0.0
Hingoli,Wheat(Husked),2016,2140,2140,0,0.0
Hingoli,Wheat(Husked),2016,2155,2155,0,0.0
Hingoli-Kanegaon Naka,WHEAT(HUSKED),2016,2100,2100,0,0.0
Indapur,Cowpea,2014,2951,2951,0,0.0
Indapur,Green Gram,2014,8000,8000,0,0.0
Indapur,Black Gram,2015,3850,3850,0,0.0
Indapur,Black Gram,2015,5700,5700,0,0.0
Indapur,Black Gram,2015,5511,5511,0,0.0
Indapur,Black Gram,2015,4726,4726,0,0.0
Hingoli,Sorgum(Jawar),2016,1800,1800,0,0.0
Hingoli,Sorgum(Jawar),2016,1700,1700,0,0.0
Hingoli,Sorgum(Jawar),2016,1680,1680,0,0.0
Hingoli,Wheat(Husked),2015,2035,2035,0,0.0
Hingoli,Ground Nut Pods (Dry),2015,5750,5750,0,0.0
Hingoli,Sesamum,2015,10000,10000,0,0.0
Hingoli,Sesamum,2015,6605,6605,0,0.0
Hingoli,Sorgum(Jawar),2015,1700,1700,0,0.0
Hingoli,Sorgum(Jawar),2015,1774,1774,0,0.0
Hingoli,Sorgum(Jawar),2015,1738,1738,0,0.0
Hingoli,Wheat(Husked),2015,1837,1837,0,0.0
Hingoli,Wheat(Husked),2015,2103,2103,0,0.0
Hingoli,Sorgum(Jawar),2016,1788,1788,0,0.0
Hingoli,Wheat(Husked),2015,2003,2003,0,0.0
Hingoli,Ground Nut Pods (Dry),2016,4475,4475,0,0.0
Hingoli,SORGUM(JAWAR),2016,2095,2095,0,0.0
Ahmednagar,Tamarind,2015,3000,3000,0,0.0
Hingoli,Sorgum(Jawar),2016,2060,2060,0,0.0
Hingoli,Sorgum(Jawar),2016,1675,1675,0,0.0
Hingoli,Sorgum(Jawar),2016,1650,1650,0,0.0
Aheri,Linseed,2016,4500,4500,0,0.0
Jalkot,Sorgum(Jawar),2016,1500,1500,0,0.0
Jalgaon Jamod-Aasalgaon,Ground Nut Pods (Dry),2015,5100,5100,0,0.0
Kalamb (Os),Ground Nut Pods (Dry),2016,5700,5700,0,0.0
Kalamb (Os),Ground Nut Pods (Dry),2016,3900,3900,0,0.0
Aheri,Pigeon Pea (Tur),2014,4000,4000,0,0.0
Kalamb (Os),Jaggery,2016,2530,2530,0,0.0
Kalamb (Os),Jaggery,2016,3451,3451,0,0.0
Aheri,Pigeon Pea (Tur),2014,4000,4000,0,0.0
Kalamb (Os),Jaggery,2016,2343,2343,0,0.0
Kalamb (Os),Jaggery,2016,2350,2350,0,0.0
Kalamb (Os),Jaggery,2016,2958,2958,0,0.0
Aheri,Paddy-Unhusked,2014,1400,1400,0,0.0
Aheri,Paddy-Unhusked,2014,1850,1850,0,0.0
Umarga,PIGEON PEA (TUR),2016,5682,5682,0,0.0
Umarga,Maize,2016,1320,1320,0,0.0
Aheri,Paddy-Unhusked,2014,1412,1412,0,0.0
Umarga,Maize,2016,1410,1410,0,0.0
Aheri,Matki,2014,5000,5000,0,0.0
Kalamb (Os),Paddy-Unhusked,2016,1200,1200,0,0.0
Kalamb (Os),Paddy-Unhusked,2016,1100,1100,0,0.0
Aheri,Rice(Paddy-Hus),2014,2000,2000,0,0.0
Kalamb (Os),Ground Nut Pods (Dry),2016,4300,4300,0,0.0
Umarga,Green Peas (Dry),2016,1700,1700,0,0.0
Umarga,Rice(Paddy-Hus),2016,1300,1300,0,0.0
Kalamb (Os),CORIANDER (DRY),2016,6100,6100,0,0.0
Kalamb (Os),Castor Seed,2016,2813,2813,0,0.0
Kalamb (Os),Castor Seed,2016,2877,2877,0,0.0
Kalamb (Os),Castor Seed,2016,2770,2770,0,0.0
Umarga,Sesamum,2016,5500,5500,0,0.0
Kalamb (Os),Castor Seed,2016,2900,2900,0,0.0
Kalamb (Os),Coriander (Dry),2016,8006,8006,0,0.0
Umarga,Safflower,2016,2800,2800,0,0.0
Umarga,Safflower,2016,2550,2550,0,0.0
Umarga,Safflower,2016,2600,2600,0,0.0
Umarga,Safflower,2016,2673,2673,0,0.0
Kalamb (Os),Coriander (Dry),2016,6500,6500,0,0.0
Kalamb (Os),Coriander (Dry),2016,9001,9001,0,0.0
Kalamb (Os),Coriander (Dry),2016,7650,7650,0,0.0
Kalamb (Os),Green Gram,2016,6863,6863,0,0.0
Kalamb (Os),Green Gram,2016,6100,6100,0,0.0
Kalamb (Os),Green Gram,2016,6625,6625,0,0.0
Umarga,Jaggery,2016,2355,2355,0,0.0
Aheri,Maize,2014,1067,1067,0,0.0
Aheri,Gram,2014,2600,2600,0,0.0
Kalamnuri,Soybean,2014,4000,4000,0,0.0
Kalamnuri,Wheat(Husked),2014,1600,1600,0,0.0
Kalamnuri,Wheat(Husked),2014,1600,1600,0,0.0
Kalamnuri,Wheat(Husked),2014,1600,1600,0,0.0
Kalamnuri,Black Gram,2015,8000,8000,0,0.0
Kalamnuri,Cotton,2015,4300,4300,0,0.0
Kalamnuri,Cotton,2015,4364,4364,0,0.0
Kalamnuri,Cotton,2015,4300,4300,0,0.0
Kalamnuri,Cotton,2015,4300,4300,0,0.0
Kalamnuri,Cotton,2015,4300,4300,0,0.0
Umarga,Wheat(Unhusked),2015,3450,3450,0,0.0
Umarga,Wheat(Unhusked),2015,3800,3800,0,0.0
Kalamnuri,Cotton,2015,4300,4300,0,0.0
Kalamnuri,Cotton,2015,4200,4200,0,0.0
Kalamnuri,Gram,2015,3100,3100,0,0.0
Kalamnuri,Gram,2015,4000,4000,0,0.0
Kalamnuri,Gram,2015,3900,3900,0,0.0
Kalamnuri,Gram,2015,4000,4000,0,0.0
Kalamnuri,Wheat(Husked),2014,1600,1600,0,0.0
Aheri,Green Gram,2014,5867,5867,0,0.0
Yeotmal,Sesamum,2016,5750,5750,0,0.0
Kalamnuri,Soybean,2014,3000,3000,0,0.0
Yeotmal,Sorgum(Jawar),2016,1645,1645,0,0.0
Umarga,Gram,2016,6450,6450,0,0.0
Kalamb (Os),Safflower,2016,2606,2606,0,0.0
Kalamb (Os),Sesamum,2016,5710,5710,0,0.0
Kalamb (Os),Sesamum,2016,5451,5451,0,0.0
Yeotmal,Sorgum(Jawar),2016,1633,1633,0,0.0
Kalamb (Os),Sesamum,2016,7000,7000,0,0.0
Kalamb (Os),Sunflower,2016,2764,2764,0,0.0
Kalamb (Os),Sunflower,2016,2950,2950,0,0.0
Yeotmal,Sorgum(Jawar),2016,1640,1640,0,0.0
Kalamnuri,Cotton,2014,4188,4188,0,0.0
Kalamnuri,Gram,2014,3200,3200,0,0.0
Kalamnuri,Gram,2014,3100,3100,0,0.0
Kalamnuri,Ground Nut Pods (Dry),2014,4300,4300,0,0.0
Yeotmal,Sorgum(Jawar),2016,1600,1600,0,0.0
Umarga,Coriander (Dry),2016,5500,5500,0,0.0
Aheri,Maize,2014,1296,1296,0,0.0
Kalamb (Os),Black Gram,2016,7451,7451,0,0.0
Kalamb (Os),Black Gram,2016,8242,8242,0,0.0
Kalamb (Os),Tamarind,2015,3101,3101,0,0.0
Kalamb (Os),Coriander (Dry),2015,9065,9065,0,0.0
Kalamb (Os),Green Gram,2015,6832,6832,0,0.0
Aheri,Batbati,2015,4000,4000,0,0.0
Kalamb (Os),Green Gram,2015,7012,7012,0,0.0
Kalamb (Os),Ground Nut Pods (Dry),2015,4700,4700,0,0.0
Kalamb (Os),Ground Nut Pods (Dry),2015,4200,4200,0,0.0
Kalamb (Os),Ground Nut Pods (Dry),2015,3851,3851,0,0.0
Kalamb (Os),Ground Nut Pods (Dry),2015,5031,5031,0,0.0
Yeotmal,Gram,2016,4477,4477,0,0.0
Kalamb (Os),Jaggery,2015,2521,2521,0,0.0
Kalamb (Os),Jaggery,2015,2000,2000,0,0.0
Kalamb (Os),Jaggery,2015,2301,2301,0,0.0
Kalamb (Os),Jaggery,2015,2061,2061,0,0.0
Aheri,Batbati,2015,4000,4000,0,0.0
Kalamb (Os),Jaggery,2015,2051,2051,0,0.0
Kalamb (Os),Linseed,2015,4200,4200,0,0.0
Kalamb (Os),Linseed,2015,4640,4640,0,0.0
Kalamb (Os),Linseed,2015,4291,4291,0,0.0
Kalamb (Os),Green Gram,2015,6183,6183,0,0.0
Kalamb (Os),Coriander (Dry),2015,8005,8005,0,0.0
Aheri,Rice(Paddy-Hus),2014,2043,2043,0,0.0
Kalamb (Os),Coriander (Dry),2015,9900,9900,0,0.0
Aheri,Gram,2015,3200,3200,0,0.0
Aheri,Gram,2015,3800,3800,0,0.0
Aheri,Cotton,2015,4000,4000,0,0.0
Kalamb (Os),Bajri,2015,1653,1653,0,0.0
Kalamb (Os),Black Gram,2015,6400,6400,0,0.0
Kalamb (Os),Black Gram,2015,5215,5215,0,0.0
Aheri,Cotton,2015,4000,4000,0,0.0
Aheri,Cotton,2015,4000,4000,0,0.0
Aheri,Cotton,2015,4000,4000,0,0.0
Aheri,Batbati,2015,4500,4500,0,0.0
Kalamb (Os),Castor Seed,2015,3426,3426,0,0.0
Kalamb (Os),Castor Seed,2015,3245,3245,0,0.0
Kalamb (Os),Castor Seed,2015,3125,3125,0,0.0
Kalamb (Os),Castor Seed,2015,3570,3570,0,0.0
Umari,Wheat(Husked),2016,1795,1795,0,0.0
Kalamb (Os),Coriander (Dry),2015,9000,9000,0,0.0
Kalamb (Os),Coriander (Dry),2015,6767,6767,0,0.0
Kalamb (Os),Linseed,2015,4301,4301,0,0.0
Yeotmal,Green Gram,2016,5148,5148,0,0.0
Kalamb (Os),Maize,2015,1505,1505,0,0.0
Yeotmal,Green Gram,2016,5460,5460,0,0.0
Umarga,Sunflower,2016,3351,3351,0,0.0
Aheri,Sorgum(Jawar),2014,1000,1000,0,0.0
Kalamb (Os),Safflower,2015,2344,2344,0,0.0
Kalamb (Os),Safflower,2015,2406,2406,0,0.0
Aheri,Sorgum(Jawar),2014,1200,1200,0,0.0
Aheri,Sorgum(Jawar),2014,1250,1250,0,0.0
Kalamb (Os),Safflower,2015,2331,2331,0,0.0
Kalamb (Os),Safflower,2015,2479,2479,0,0.0
Kalamb (Os),Sesamum,2015,7001,7001,0,0.0
Aheri,Rice(Paddy-Hus),2014,1750,1750,0,0.0
Kalamb (Os),Sesamum,2015,7300,7300,0,0.0
Kalamb (Os),Sesamum,2015,7460,7460,0,0.0
Kalamb (Os),Sesamum,2015,7501,7501,0,0.0
Kalamb (Os),Sesamum,2015,8027,8027,0,0.0
Kalamb (Os),Sunflower,2015,2890,2890,0,0.0
Umarga,Sorgum(Jawar),2016,1434,1434,0,0.0
Umarga,Sorgum(Jawar),2016,1588,1588,0,0.0
Umarga,Sunflower,2016,3600,3600,0,0.0
Umarga,Sunflower,2016,3200,3200,0,0.0
Umarga,WHEAT(HUSKED),2016,1425,1425,0,0.0
Kalamb (Os),Mustard,2015,3751,3751,0,0.0
Kalamb (Os),Mustard,2015,3500,3500,0,0.0
Kalamb (Os),Mustard,2015,3741,3741,0,0.0
Kalamb (Os),Mustard,2015,3750,3750,0,0.0
Yeotmal,Green Gram,2016,5522,5522,0,0.0
Umarga,Wheat(Unhusked),2016,3000,3000,0,0.0
Umarga,Wheat(Unhusked),2016,2900,2900,0,0.0
Umarga,Wheat(Unhusked),2016,2800,2800,0,0.0
Umarga,Wheat(Husked),2016,1300,1300,0,0.0
Aheri,Batbati,2015,4300,4300,0,0.0
Umarga,Wheat(Husked),2016,1700,1700,0,0.0
Umarga,Wheat(Husked),2016,1351,1351,0,0.0
Aheri,Batbati,2015,3500,3500,0,0.0
Kalamb (Os),Mustard,2015,3600,3600,0,0.0
Kalamb (Os),Niger-Seed,2015,9100,9100,0,0.0
Aheri,Batbati,2015,3500,3500,0,0.0
Umarga,WHEAT(UNHUSKED),2016,2250,2250,0,0.0
Aheri,Gram,2014,2800,2800,0,0.0
Aheri,Gram,2014,3000,3000,0,0.0
Aheri,Green Gram,2015,6000,6000,0,0.0
Zarijamini,Ground Nut Pods (Dry),2015,4188,4188,0,0.0
Achalpur,Mustard,2015,3100,3100,0,0.0
Kalvan,Maize,2015,1459,1459,0,0.0
Kalvan,Soybean,2015,3232,3232,0,0.0
Kalvan,Soybean,2015,3238,3238,0,0.0
Kalvan,Sunflower,2015,4726,4726,0,0.0
Kalvan,Sunflower,2015,2500,2500,0,0.0
Umarga,Jaggery,2015,1890,1890,0,0.0
Umarga,Hemp-Seed,2015,2296,2296,0,0.0
Umarga,Green Peas (Dry),2015,2300,2300,0,0.0
Umarga,Green Gram,2015,5700,5700,0,0.0
Umarga,Green Gram,2015,7400,7400,0,0.0
Kalvan,Sunflower,2015,2551,2551,0,0.0
Achalpur,Mustard,2015,3308,3308,0,0.0
Achalpur,Lentil,2015,6250,6250,0,0.0
Kalvan,Gram,2016,3750,3750,0,0.0
Kalvan,Ground Nut Pods (Dry),2016,4526,4526,0,0.0
Achalpur,Ground Nut Pods (Dry),2015,4000,4000,0,0.0
Umarga,Maize,2015,1273,1273,0,0.0
Zarijamini,Ground Nut Pods (Dry),2015,4050,4050,0,0.0
Kalvan,Matki,2016,3500,3500,0,0.0
Umarga,Maize,2015,1280,1280,0,0.0
Kalmeshwar,Gram,2016,7305,7305,0,0.0
Kalmeshwar,Wheat(Husked),2016,1600,1600,0,0.0
Achalpur,Batbati,2016,3100,3100,0,0.0
Achalpur,Bajri,2016,1700,1700,0,0.0
Achalpur,Bajri,2016,1700,1700,0,0.0
Achalpur,Bajri,2016,1725,1725,0,0.0
Zarijamini,Gram,2015,4800,4800,0,0.0
Kalvan,Green Gram,2014,7500,7500,0,0.0
Kalvan,Sunflower,2014,3000,3000,0,0.0
Kalvan,Gram,2015,3950,3950,0,0.0
Kalvan,Gram,2015,2500,2500,0,0.0
Kalvan,Gram,2015,3251,3251,0,0.0
Kalvan,Green Gram,2015,7100,7100,0,0.0
Umarga,Paddy-Unhusked,2015,1350,1350,0,0.0
Kalvan,Ground Nut Pods (Dry),2015,5051,5051,0,0.0
Umarga,Mustard,2015,3501,3501,0,0.0
Kalvan,Ground Nut Pods (Dry),2015,4551,4551,0,0.0
Achalpur,Gram,2015,3100,3100,0,0.0
Kalvan,PIGEON PEA (TUR),2016,4800,4800,0,0.0
Kalamnuri,Gram,2015,3100,3100,0,0.0
Zarijamini,Green Gram,2016,6800,6800,0,0.0
Achalpur,Black Gram,2014,4400,4400,0,0.0
Zarijamini,Ground Nut Pods (Dry),2016,4800,4800,0,0.0
Umarga,Coriander (Dry),2015,5801,5801,0,0.0
Umarga,Castor Seed,2015,2950,2950,0,0.0
Umarga,Black Gram,2015,7000,7000,0,0.0
Umarga,Black Gram,2015,7950,7950,0,0.0
Umarga,Black Gram,2015,9867,9867,0,0.0
Achalpur,Batbati,2014,4800,4800,0,0.0
Achalpur,Bajri,2014,1725,1725,0,0.0
Aarni,Pigeon Pea (Tur),2015,10775,10775,0,0.0
Zarijamini,Pigeon Pea (Tur),2016,5115,5115,0,0.0
Zarijamini,Sorgum(Jawar),2016,1550,1550,0,0.0
Umarga,Bajri,2015,1480,1480,0,0.0
Umarga,Bajri,2015,1100,1100,0,0.0
Umarga,Bajri,2015,1017,1017,0,0.0
Umarga,Bajri,2015,1400,1400,0,0.0
Umarga,Bajri,2015,1130,1130,0,0.0
Zarijamini,Green Gram,2016,5700,5700,0,0.0
Achalpur,Black Gram,2014,4350,4350,0,0.0
Kalvan,Pigeon Pea (Tur),2016,5150,5150,0,0.0
Achalpur,Green Gram,2014,8050,8050,0,0.0
Zarijamini,Pigeon Pea (Tur),2015,6500,6500,0,0.0
Umarga,Gram,2015,4240,4240,0,0.0
Kalvan,Sorgum(Jawar),2016,1567,1567,0,0.0
Zarijamini,Pigeon Pea (Tur),2015,9055,9055,0,0.0
Zarijamini,Sorgum(Jawar),2015,1550,1550,0,0.0
Kalvan,Sorgum(Jawar),2016,1211,1211,0,0.0
Kalvan,Soybean,2016,3031,3031,0,0.0
Achalpur,Black Gram,2015,7600,7600,0,0.0
Achalpur,Black Gram,2015,4350,4350,0,0.0
Achalpur,Sunflower,2014,3750,3750,0,0.0
Zarijamini,Soybean,2015,2938,2938,0,0.0
Kalvan,Sunflower,2016,3500,3500,0,0.0
Zarijamini,Soybean,2015,3260,3260,0,0.0
Zarijamini,Wheat(Husked),2015,1500,1500,0,0.0
Achalpur,Sesamum,2014,9200,9200,0,0.0
Achalpur,Sesamum,2014,12250,12250,0,0.0
Achalpur,Maize,2014,1338,1338,0,0.0
Kalmeshwar,Gram,2016,6500,6500,0,0.0
Kalmeshwar,Wheat(Husked),2015,1450,1450,0,0.0
Kalmeshwar,Wheat(Husked),2015,1400,1400,0,0.0
Kalamnuri,Sorgum(Jawar),2015,1600,1600,0,0.0
Kalamnuri,Sorgum(Jawar),2015,1575,1575,0,0.0
Aheri,Cotton,2014,3986,3986,0,0.0
Kalamnuri,Soybean,2015,3000,3000,0,0.0
Kalamnuri,Soybean,2015,3017,3017,0,0.0
Kalamnuri,Soybean,2015,3000,3000,0,0.0
Kalamnuri,Soybean,2015,3289,3289,0,0.0
Kalamnuri,Soybean,2015,3000,3000,0,0.0
Kalamnuri,Soybean,2015,3385,3385,0,0.0
Kalamnuri,Soybean,2015,3500,3500,0,0.0
Kalamnuri,Soybean,2015,3410,3410,0,0.0
Kalamnuri,Soybean,2015,3150,3150,0,0.0
Kalamnuri,Wheat(Husked),2015,1600,1600,0,0.0
Kalamnuri,Wheat(Husked),2015,1600,1600,0,0.0
Kalamnuri,Wheat(Husked),2015,1600,1600,0,0.0
Kalamnuri,Wheat(Husked),2015,1575,1575,0,0.0
Kalamnuri,Wheat(Husked),2015,1600,1600,0,0.0
Kalamnuri,Wheat(Husked),2015,1600,1600,0,0.0
Kalamnuri,Sorgum(Jawar),2015,1600,1600,0,0.0
Kalamnuri,Sorgum(Jawar),2015,1500,1500,0,0.0
Achalpur,Black Gram,2016,9956,9956,0,0.0
Kalamnuri,Sorgum(Jawar),2015,1500,1500,0,0.0
Kalamnuri,Green Gram,2015,7000,7000,0,0.0
Kalamnuri,Ground Nut Pods (Dry),2015,4500,4500,0,0.0
Kalamnuri,Ground Nut Pods (Dry),2015,4000,4000,0,0.0
Kalamnuri,Mustard,2015,3100,3100,0,0.0
Aheri,Cotton,2014,4000,4000,0,0.0
Kalamnuri,Pigeon Pea (Tur),2015,5000,5000,0,0.0
Kalamnuri,Pigeon Pea (Tur),2015,6667,6667,0,0.0
Kalamnuri,Pigeon Pea (Tur),2015,8000,8000,0,0.0
Kalamnuri,Pigeon Pea (Tur),2015,4900,4900,0,0.0
Kalamnuri,Pigeon Pea (Tur),2015,5700,5700,0,0.0
Kalamnuri,Pigeon Pea (Tur),2015,6000,6000,0,0.0
Kalamnuri,Pigeon Pea (Tur),2015,5000,5000,0,0.0
Kalamnuri,Pigeon Pea (Tur),2015,5357,5357,0,0.0
Kalamnuri,Sorgum(Jawar),2015,1520,1520,0,0.0
Umarga,Sunflower,2015,3200,3200,0,0.0
Umarga,Sunflower,2015,3210,3210,0,0.0
Umarga,Sunflower,2015,3000,3000,0,0.0
Kalamnuri,Wheat(Husked),2015,1600,1600,0,0.0
Kalamnuri,Wheat(Husked),2015,1600,1600,0,0.0
Kalamnuri,Wheat(Husked),2015,1600,1600,0,0.0
Kalamnuri,Wheat(Husked),2015,1600,1600,0,0.0
Umarga,Safflower,2015,2606,2606,0,0.0
Umarga,Safflower,2015,2300,2300,0,0.0
Achalpur,Sesamum,2016,5800,5800,0,0.0
Yeotmal,Wheat(Husked),2016,1703,1703,0,0.0
Yeotmal,Wheat(Husked),2016,1815,1815,0,0.0
Achalpur,SESAMUM,2016,5777,5777,0,0.0
Achalpur,Mustard,2016,3400,3400,0,0.0
Achalpur,Mustard,2016,3300,3300,0,0.0
Achalpur,Lentil,2016,4200,4200,0,0.0
Kalmeshwar,Pigeon Pea (Tur),2014,4361,4361,0,0.0
Kalmeshwar,Wheat(Husked),2014,1450,1450,0,0.0
Kalmeshwar,Gram,2015,2800,2800,0,0.0
Achalpur,Lentil,2016,5500,5500,0,0.0
Kalmeshwar,Sorgum(Jawar),2015,1300,1300,0,0.0
Kalmeshwar,Soybean,2015,2883,2883,0,0.0
Achalpur,Lentil,2016,4200,4200,0,0.0
Achalpur,Black Gram,2016,7222,7222,0,0.0
Umarga,Safflower,2015,2601,2601,0,0.0
Kalmeshwar,Gram,2014,2406,2406,0,0.0
Kalamnuri,Wheat(Husked),2016,1600,1600,0,0.0
Umarga,Sesamum,2015,8300,8300,0,0.0
Kalamnuri,Wheat(Husked),2015,1600,1600,0,0.0
Kalamnuri,Wheat(Husked),2015,1600,1600,0,0.0
Kalamnuri,Black Gram,2016,6000,6000,0,0.0
Kalamnuri,Black Gram,2016,6500,6500,0,0.0
Kalamnuri,Cotton,2016,4500,4500,0,0.0
Kalamnuri,Green Gram,2016,5500,5500,0,0.0
Kalamnuri,Ground Nut Pods (Dry),2016,5000,5000,0,0.0
Umarga,Sesamum,2015,7000,7000,0,0.0
Achalpur,Tamarind Seed,2016,2250,2250,0,0.0
Umarga,Sesamum,2015,7350,7350,0,0.0
Kalamnuri,Pigeon Pea (Tur),2016,6000,6000,0,0.0
Kalamnuri,Sorgum(Jawar),2016,1650,1650,0,0.0
Kalamnuri,WHEAT(HUSKED),2016,1600,1600,0,0.0
Aheri,Batbati,2014,3500,3500,0,0.0
Aheri,Batbati,2014,3500,3500,0,0.0
Aheri,Batbati,2014,3500,3500,0,0.0
Aheri,Green Gram,2015,6000,6000,0,0.0
Kalamb (Os),Jaggery,2014,2300,2300,0,0.0
Jalgaon Jamod-Aasalgaon,Maize,2015,1100,1100,0,0.0
Jalna,Black Gram,2016,11111,11111,0,0.0
Aheri,Soybean,2015,3100,3100,0,0.0
Aheri,Soybean,2015,2900,2900,0,0.0
Jalna,Black Gram,2016,4985,4985,0,0.0
Jalna,Black Gram,2016,5500,5500,0,0.0
Jalna,Black Gram,2016,11802,11802,0,0.0
Jalna,Castor Seed,2016,2750,2750,0,0.0
Aheri,Soybean,2015,3293,3293,0,0.0
Jalna,Castor Seed,2016,2925,2925,0,0.0
Aheri,Sorgum(Jawar),2015,1227,1227,0,0.0
Aheri,Sorgum(Jawar),2015,1200,1200,0,0.0
Aheri,Sorgum(Jawar),2015,1120,1120,0,0.0
Aheri,Sorgum(Jawar),2015,1200,1200,0,0.0
Jalna,Green Gram,2016,6150,6150,0,0.0
Jalna,Green Gram,2016,5829,5829,0,0.0
Yeotmal,Green Gram,2015,6511,6511,0,0.0
Jalna,HORSE GRAM,2016,3200,3200,0,0.0
Jalna,MATKI,2016,9756,9756,0,0.0
Aheri,Soybean,2015,3050,3050,0,0.0
Aheri,BATBATI,2016,4500,4500,0,0.0
Jalna,Matki,2016,12000,12000,0,0.0
Jalna,Tag,2015,2100,2100,0,0.0
Jalna,Safflower,2015,2250,2250,0,0.0
Jalna,Safflower,2015,2300,2300,0,0.0
Jalna,Safflower,2015,2400,2400,0,0.0
Jalna,Safflower,2015,2363,2363,0,0.0
Jalna,Safflower,2015,2475,2475,0,0.0
Jalna,Safflower,2015,2270,2270,0,0.0
Jalna,Safflower,2015,2100,2100,0,0.0
Jalna,Safflower,2015,2192,2192,0,0.0
Jalna,Sesamum,2015,8000,8000,0,0.0
Jalna,Sesamum,2015,7500,7500,0,0.0
Aheri,Batbati,2016,3687,3687,0,0.0
Aheri,Batbati,2016,4514,4514,0,0.0
Jalna,Sunflower,2015,3000,3000,0,0.0
Aheri,Batbati,2016,4929,4929,0,0.0
Jalna,Sunflower,2015,2550,2550,0,0.0
Aheri,Batbati,2016,4400,4400,0,0.0
Jalna,Sunflower,2015,2963,2963,0,0.0
Jalna,MUSTARD,2016,3600,3600,0,0.0
Jalna,Matki,2016,10051,10051,0,0.0
Aheri,Rice(Paddy-Hus),2015,1690,1690,0,0.0
Jalna,Tag,2016,4000,4000,0,0.0
Yeotmal,Green Gram,2015,6000,6000,0,0.0
Jalna-Badnapur,Cotton,2014,4050,4050,0,0.0
Yeotmal,Green Gram,2015,8401,8401,0,0.0
Jalna-Badnapur,Bajri,2015,1375,1375,0,0.0
Jalna-Badnapur,Bajri,2015,1250,1250,0,0.0
Yeotmal,Green Gram,2015,9797,9797,0,0.0
Aheri,Sesamum,2015,5553,5553,0,0.0
Jalna-Badnapur,Gram,2015,3750,3750,0,0.0
Jalna-Badnapur,Green Gram,2015,7650,7650,0,0.0
Jalna-Badnapur,Green Gram,2015,7350,7350,0,0.0
Jalna-Badnapur,Maize,2015,1350,1350,0,0.0
Aheri,Sesamum,2015,7000,7000,0,0.0
Aheri,Sesamum,2015,5250,5250,0,0.0
Aheri,Sesamum,2015,6700,6700,0,0.0
Aheri,Rice(Paddy-Hus),2015,1750,1750,0,0.0
Aheri,Rice(Paddy-Hus),2015,1700,1700,0,0.0
Aheri,Rice(Paddy-Hus),2015,1700,1700,0,0.0
Jalna-Badnapur,Bajri,2014,1450,1450,0,0.0
Jalna,Sunflower,2016,3100,3100,0,0.0
Jalna,Mustard,2016,4500,4500,0,0.0
Jalna,Sesamum,2016,5875,5875,0,0.0
Jalna,Mustard,2016,3650,3650,0,0.0
Jalna,Mustard,2016,4200,4200,0,0.0
Jalna,Mustard,2016,3500,3500,0,0.0
Jalna,Mustard,2016,4225,4225,0,0.0
Jalna,Mustard,2016,4100,4100,0,0.0
Jalna,Neem-Seed,2016,885,885,0,0.0
Yeotmal,Green Gram,2015,6735,6735,0,0.0
Jalna,Rajgira,2016,4100,4100,0,0.0
Jalna,Rajgira,2016,5302,5302,0,0.0
Jalna,Safflower,2016,2513,2513,0,0.0
Jalna,Safflower,2016,2350,2350,0,0.0
Jalna,Safflower,2016,2475,2475,0,0.0
Jalna,Safflower,2016,2500,2500,0,0.0
Jalna,Safflower,2016,2449,2449,0,0.0
Jalna,Safflower,2016,2565,2565,0,0.0
Jalna,Safflower,2016,2600,2600,0,0.0
Jalna,Safflower,2016,2650,2650,0,0.0
Jalna,Rajgira,2015,5000,5000,0,0.0
Jalna,Rajgira,2015,5750,5750,0,0.0
Jalna,Onion,2015,4100,4100,0,0.0
Aheri,Green Gram,2016,5700,5700,0,0.0
Jalkot,Pigeon Pea (Tur),2016,8500,8500,0,0.0
Aheri,Green Gram,2016,6000,6000,0,0.0
Aheri,Green Gram,2016,5600,5600,0,0.0
Jalkot,Pigeon Pea (Tur),2016,9000,9000,0,0.0
Jalkot,Sesamum,2016,5100,5100,0,0.0
Aheri,Gram,2016,3300,3300,0,0.0
Jalkot,Sorgum(Jawar),2016,1500,1500,0,0.0
Jalkot,Sorgum(Jawar),2016,1519,1519,0,0.0
Aheri,Gram,2016,4000,4000,0,0.0
Aheri,Gram,2016,4500,4500,0,0.0
Yeotmal,Black Gram,2015,8252,8252,0,0.0
Jalkot,Sorgum(Jawar),2016,1506,1506,0,0.0
Dondaicha-Sindkheda,Gram,2016,6801,6801,0,0.0
Yeotmal,Black Gram,2015,6680,6680,0,0.0
Jalkot,Sorgum(Jawar),2016,1500,1500,0,0.0
Yeotmal,Black Gram,2015,8647,8647,0,0.0
Jalkot,Soybean,2016,3738,3738,0,0.0
Jalkot,Pigeon Pea (Tur),2016,9013,9013,0,0.0
Aheri,Ground Nut Pods (Dry),2016,4500,4500,0,0.0
Jalna,Mustard,2015,3800,3800,0,0.0
Jalkot,Green Gram,2016,4875,4875,0,0.0
Jalgaon Jamod-Aasalgaon,Pigeon Pea (Tur),2015,6500,6500,0,0.0
Aheri,Indian Bean,2016,2200,2200,0,0.0
Jalgaon Jamod-Aasalgaon,Sesamum,2015,6000,6000,0,0.0
Jalgaon Jamod-Aasalgaon,Green Gram,2016,6000,6000,0,0.0
Aheri,Ground Nut Pods (Dry),2016,4000,4000,0,0.0
Jalgaon-Masawat,GREEN GRAM,2016,4800,4800,0,0.0
Jalgaon-Masawat,Gram,2016,2500,2500,0,0.0
Jalgaon-Masawat,Maize,2016,1500,1500,0,0.0
Jalgaon-Masawat,Wheat(Husked),2016,1600,1600,0,0.0
Jalgaon-Masawat,Wheat(Husked),2016,1817,1817,0,0.0
Jalkot,Sesamum,2015,7551,7551,0,0.0
Aheri,Ground Nut Pods (Dry),2016,4500,4500,0,0.0
Aheri,Ground Nut Pods (Dry),2016,4500,4500,0,0.0
Jalkot,Gram,2016,4200,4200,0,0.0
Jalkot,Gram,2016,4200,4200,0,0.0
Yeotmal,Sorgum(Jawar),2014,1297,1297,0,0.0
Yeotmal,Sorgum(Jawar),2014,1537,1537,0,0.0
Jalkot,Soybean,2016,3700,3700,0,0.0
Yeotmal,Black Gram,2015,7580,7580,0,0.0
Aheri,GRAM,2016,6000,6000,0,0.0
Aheri,Cotton,2016,4150,4150,0,0.0
Jalna,Black Gram,2015,5000,5000,0,0.0
Aheri,Batbati,2016,4500,4500,0,0.0
Aheri,Batbati,2016,4267,4267,0,0.0
Aheri,Batbati,2016,4240,4240,0,0.0
Jalna,Black Gram,2015,7127,7127,0,0.0
Jalna,Castor Seed,2015,3100,3100,0,0.0
Jalna,Castor Seed,2015,3240,3240,0,0.0
Jalna,Castor Seed,2015,2925,2925,0,0.0
Jalna,Cotton,2015,3950,3950,0,0.0
Jalna,Cotton,2015,3947,3947,0,0.0
Jalna,Cotton,2015,4100,4100,0,0.0
Jalna,Cowpea,2015,5100,5100,0,0.0
Jalna,Matki,2015,9776,9776,0,0.0
Jalna,Matki,2015,15025,15025,0,0.0
Jalna,Matki,2015,6900,6900,0,0.0
Jalna,Mustard,2015,3600,3600,0,0.0
Jalna,Mustard,2015,3367,3367,0,0.0
Jalna,Black Gram,2015,6100,6100,0,0.0
Jalna,Sunflower,2014,2400,2400,0,0.0
Jalna,Sesamum,2014,10001,10001,0,0.0
Jalna,Mustard,2014,4450,4450,0,0.0
Aheri,Cotton,2016,4100,4100,0,0.0
Jalkot,Soybean,2016,3506,3506,0,0.0
Jalkot,Wheat(Husked),2016,1600,1600,0,0.0
Jalkot,Wheat(Husked),2016,1600,1600,0,0.0
Jalna,Castor Seed,2014,3200,3200,0,0.0
Aheri,Cotton,2016,4125,4125,0,0.0
Jalna,Cowpea,2014,4000,4000,0,0.0
Aheri,Cotton,2016,4200,4200,0,0.0
Jalna,Sesamum,2014,11384,11384,0,0.0
Aheri,Batbati,2016,3500,3500,0,0.0
Jalna,Mustard,2014,2800,2800,0,0.0
Jalna,Rajgira,2014,4700,4700,0,0.0
Jalna,Rajgira,2014,6233,6233,0,0.0
Jalna,Safflower,2014,2275,2275,0,0.0
Jalna,Safflower,2014,2200,2200,0,0.0
Jalna,Sesamum,2014,11000,11000,0,0.0
Aheri,Rice(Paddy-Hus),2015,1788,1788,0,0.0
Jalna-Badnapur,Wheat(Husked),2015,1584,1584,0,0.0
Kalamb (Os),Ground Nut Pods (Dry),2014,3300,3300,0,0.0
Aheri,Linseed,2015,4000,4000,0,0.0
Aheri,Indian Bean,2015,2500,2500,0,0.0
Yeotmal,BLACK GRAM,2016,5533,5533,0,0.0
Kada,Black Gram,2015,5150,5150,0,0.0
Kada,Black Gram,2015,9300,9300,0,0.0
Kada,Green Gram,2015,5701,5701,0,0.0
Kada,Ground Nut Pods (Dry),2015,4151,4151,0,0.0
Kada,Ground Nut Pods (Dry),2015,3676,3676,0,0.0
Kada,Ground Nut Pods (Dry),2015,3001,3001,0,0.0
Kada,Ground Nut Pods (Dry),2015,4567,4567,0,0.0
Kada,Horse Gram,2015,3401,3401,0,0.0
Aheri,Indian Bean,2015,2200,2200,0,0.0
Kada,Pigeon Pea (Tur),2015,5400,5400,0,0.0
Kada,Safflower,2015,2351,2351,0,0.0
Kada,Sesamum,2015,8000,8000,0,0.0
Aheri,Indian Bean,2015,2600,2600,0,0.0
Yeotmal,Black Gram,2016,6000,6000,0,0.0
Kada,Sesamum,2015,9000,9000,0,0.0
Kada,Green Gram,2014,7500,7500,0,0.0
Kada,Black Gram,2014,5300,5300,0,0.0
Kada,Sunflower,2015,3175,3175,0,0.0
Jintur-Bori,Wheat(Husked),2016,1550,1550,0,0.0
Jintur-Bori,Sorgum(Jawar),2015,1300,1300,0,0.0
Jintur-Bori,Sorgum(Jawar),2015,1296,1296,0,0.0
Aheri,Maize,2015,1100,1100,0,0.0
Jintur-Bori,Wheat(Husked),2015,1500,1500,0,0.0
Jintur-Bori,Bajri,2016,1361,1361,0,0.0
Jintur-Bori,Bajri,2016,1898,1898,0,0.0
Aheri,Maize,2015,1265,1265,0,0.0
Aheri,Maize,2015,1200,1200,0,0.0
Jintur-Bori,Gram,2016,5983,5983,0,0.0
Jintur-Bori,Pigeon Pea (Tur),2016,8547,8547,0,0.0
Jintur-Bori,Safflower,2016,2050,2050,0,0.0
Aheri,Maize,2015,1184,1184,0,0.0
Jintur-Bori,Safflower,2016,2150,2150,0,0.0
Jintur-Bori,Safflower,2016,2400,2400,0,0.0
Aheri,Linseed,2015,4200,4200,0,0.0
Jintur-Bori,Wheat(Husked),2016,1501,1501,0,0.0
Jintur-Bori,Wheat(Husked),2016,1764,1764,0,0.0
Kada,Soybean,2015,2900,2900,0,0.0
Kada,Tamarind,2015,1301,1301,0,0.0
Jalna-Badnapur,BAJRI,2016,1250,1250,0,0.0
Kada (Ashti),Maize,2016,1385,1385,0,0.0
Kada (Ashti),Maize,2016,1213,1213,0,0.0
Kada (Ashti),Soybean,2016,3300,3300,0,0.0
Kada (Ashti),Soybean,2016,3251,3251,0,0.0
Kada (Ashti),Soybean,2016,3500,3500,0,0.0
Kada (Ashti),Soybean,2016,3449,3449,0,0.0
Kada (Ashti),Wheat(Husked),2016,2500,2500,0,0.0
Aheri,Horse Gram,2015,2500,2500,0,0.0
Kalamb (Os),Castor Seed,2014,3050,3050,0,0.0
Aheri,Horse Gram,2015,2450,2450,0,0.0
Aheri,Ground Nut Pods (Dry),2015,4200,4200,0,0.0
Kalamb (Os),Castor Seed,2014,3350,3350,0,0.0
Kalamb (Os),Castor Seed,2014,3000,3000,0,0.0
Kalamb (Os),Ground Nut Pods (Dry),2014,4325,4325,0,0.0
Kalamb (Os),Ground Nut Pods (Dry),2014,3600,3600,0,0.0
Umarkhed,Cotton,2015,4100,4100,0,0.0
Umarkhed,Cotton,2015,4100,4100,0,0.0
Aheri,Green Gram,2015,6200,6200,0,0.0
Kada (Ashti),Maize,2016,1700,1700,0,0.0
Kada (Ashti),Bajri,2016,1500,1500,0,0.0
Kada,Tamarind,2015,3000,3000,0,0.0
Kada (Ashti),Bajri,2016,1851,1851,0,0.0
Yeotmal,Black Gram,2016,10720,10720,0,0.0
Kada,Tamarind Seed,2015,1411,1411,0,0.0
Kada,Black Gram,2016,9000,9000,0,0.0
Kada,Coriander (Dry),2016,4100,4100,0,0.0
Yeotmal,Black Gram,2016,8100,8100,0,0.0
Kada,Cowpea,2016,3000,3000,0,0.0
Kada,Maize,2016,1363,1363,0,0.0
Aheri,Indian Bean,2015,2200,2200,0,0.0
Kada,Maize,2016,1626,1626,0,0.0
Kada,Pigeon Pea (Tur),2016,7211,7211,0,0.0
Kada,Pigeon Pea (Tur),2016,7900,7900,0,0.0
Kada (Ashti),Maize,2014,1380,1380,0,0.0
Kada (Ashti),Soybean,2015,3500,3500,0,0.0
Kada (Ashti),Wheat(Husked),2015,1550,1550,0,0.0
Kada (Ashti),Wheat(Husked),2015,1300,1300,0,0.0
Kada (Ashti),Wheat(Husked),2015,1846,1846,0,0.0
Kada (Ashti),Bajri,2016,1751,1751,0,0.0
Jintur-Bori,Sesamum,2015,9800,9800,0,0.0
Jintur-Bori,Safflower,2015,2596,2596,0,0.0
Jintur-Bori,Safflower,2015,2525,2525,0,0.0
Jamkhed,Green Gram,2016,6000,6000,0,0.0
Jamner,Sorgum(Jawar),2015,1570,1570,0,0.0
Yeotmal,Sorgum(Jawar),2015,1530,1530,0,0.0
Jamner,MAIZE,2016,1365,1365,0,0.0
Jamner-Neri,MAIZE,2016,1365,1365,0,0.0
Yeotmal,Sorgum(Jawar),2015,1530,1530,0,0.0
Jawala-Bajar,Pigeon Pea (Tur),2014,4350,4350,0,0.0
Jintur,Bajri,2014,1401,1401,0,0.0
Jintur,Jaggery,2014,3051,3051,0,0.0
Jintur,Mustard,2014,3750,3750,0,0.0
Jintur,Pigeon Pea (Tur),2014,3825,3825,0,0.0
Jintur,Safflower,2014,2351,2351,0,0.0
Jintur,Safflower,2014,2342,2342,0,0.0
Jintur,Bajri,2015,1788,1788,0,0.0
Aheri,Paddy-Unhusked,2015,1737,1737,0,0.0
Aheri,Paddy-Unhusked,2015,1544,1544,0,0.0
Aheri,Paddy-Unhusked,2015,1410,1410,0,0.0
Jintur,Black Gram,2015,5900,5900,0,0.0
Jamkhed,Pigeon Pea (Tur),2016,5225,5225,0,0.0
Jalna-Badnapur,Wheat(Husked),2016,1817,1817,0,0.0
Jintur-Bori,Safflower,2015,2560,2560,0,0.0
Yeotmal,Sesamum,2015,6455,6455,0,0.0
Aheri,Pigeon Pea (Tur),2015,5825,5825,0,0.0
Aheri,Pigeon Pea (Tur),2015,6000,6000,0,0.0
Jalna-Badnapur,Bajri,2016,1411,1411,0,0.0
Jalna-Badnapur,Bajri,2016,1500,1500,0,0.0
Aheri,Pigeon Pea (Tur),2015,7000,7000,0,0.0
Aheri,Paddy-Unhusked,2015,1686,1686,0,0.0
Aheri,Paddy-Unhusked,2015,1883,1883,0,0.0
Aheri,Paddy-Unhusked,2015,1407,1407,0,0.0
Jalna-Badnapur,Black Gram,2016,6900,6900,0,0.0
Jalna-Badnapur,Gram,2016,7700,7700,0,0.0
Jalna-Badnapur,Gram,2016,6600,6600,0,0.0
Jalna-Badnapur,Maize,2016,1211,1211,0,0.0
Aheri,Paddy-Unhusked,2015,1355,1355,0,0.0
Jalna-Badnapur,Pigeon Pea (Tur),2016,8500,8500,0,0.0
Aheri,Paddy-Unhusked,2015,1500,1500,0,0.0
Jalna-Badnapur,Wheat(Husked),2016,1650,1650,0,0.0
Aheri,Paddy-Unhusked,2015,1478,1478,0,0.0
Jintur,Black Gram,2015,8900,8900,0,0.0
Jintur,Gram,2015,3501,3501,0,0.0
Jintur,Gram,2015,4371,4371,0,0.0
Jintur,Green Gram,2015,6200,6200,0,0.0
Jintur-Bori,Safflower,2014,2451,2451,0,0.0
Jintur-Bori,Safflower,2014,2101,2101,0,0.0
Aheri,Matki,2015,6000,6000,0,0.0
Aheri,Maize,2015,1300,1300,0,0.0
Aheri,Maize,2015,1270,1270,0,0.0
Aheri,Maize,2015,1110,1110,0,0.0
Jintur-Bori,Wheat(Husked),2014,1450,1450,0,0.0
Jintur-Bori,Bajri,2015,1400,1400,0,0.0
Jintur-Bori,Gram,2015,4500,4500,0,0.0
Jintur-Bori,Gram,2015,4001,4001,0,0.0
Jintur-Bori,Green Gram,2015,5401,5401,0,0.0
Jintur-Bori,Green Gram,2015,7143,7143,0,0.0
Jintur-Bori,Green Gram,2015,6801,6801,0,0.0
Jintur-Bori,Other Oil Seeds,2015,3325,3325,0,0.0
Jintur-Bori,Pigeon Pea (Tur),2015,6100,6100,0,0.0
Jintur-Bori,Pigeon Pea (Tur),2015,8567,8567,0,0.0
Jintur-Bori,Safflower,2015,2688,2688,0,0.0
Jintur-Bori,Safflower,2014,2381,2381,0,0.0
Jintur-Bori,Safflower,2014,2463,2463,0,0.0
Jintur-Bori,Pigeon Pea (Tur),2014,4145,4145,0,0.0
Jintur,Bajri,2016,1860,1860,0,0.0
Jintur,Green Gram,2015,6300,6300,0,0.0
Jintur,Ground Nut Pods (Dry),2015,5692,5692,0,0.0
Jintur,Mustard,2015,3500,3500,0,0.0
Jintur,Safflower,2015,2650,2650,0,0.0
Aheri,Matki,2015,5337,5337,0,0.0
Jintur,Turmeric,2015,9000,9000,0,0.0
Jintur,Wheat(Husked),2015,1751,1751,0,0.0
Jintur,Bajri,2016,1450,1450,0,0.0
Jintur-Bori,Pigeon Pea (Tur),2014,4301,4301,0,0.0
Jintur,GREEN GRAM,2016,4301,4301,0,0.0
Jintur,Gram,2016,5950,5950,0,0.0
Jintur,Green Gram,2016,5600,5600,0,0.0
Jintur,SORGUM(JAWAR),2016,1985,1985,0,0.0
Jintur,Wheat(Husked),2016,1827,1827,0,0.0
Jintur-Bori,Bajri,2014,1501,1501,0,0.0
Jintur-Bori,Black Gram,2014,4451,4451,0,0.0
Dondaicha-Sindkheda,Gram,2016,7200,7200,0,0.0
Dondaicha,Pigeon Pea (Tur),2014,4000,4000,0,0.0
Dondaicha-Sindkheda,Black Gram,2016,6800,6800,0,0.0
Ambejogai,Sunflower,2015,3119,3119,0,0.0
Bhandara,Other Cereals,2016,3824,3824,0,0.0
Bhandara,Other Cereals,2016,4273,4273,0,0.0
Bhandara,Other Cereals,2016,2468,2468,0,0.0
Varud,Sorgum(Jawar),2015,1570,1570,0,0.0
Varud,Sorgum(Jawar),2015,1530,1530,0,0.0
Varud,Sorgum(Jawar),2015,1530,1530,0,0.0
Varud,Sorgum(Jawar),2015,1530,1530,0,0.0
Varud,Sorgum(Jawar),2015,1570,1570,0,0.0
Bhandara,Other Cereals,2016,2689,2689,0,0.0
Bhandara,Other Cereals,2016,3000,3000,0,0.0
Bhandara,Paddy-Unhusked,2016,2100,2100,0,0.0
Bhandara,Pigeon Pea (Tur),2016,7750,7750,0,0.0
Washim,Mustard,2015,3900,3900,0,0.0
Washim,Mustard,2015,3000,3000,0,0.0
Varud,Maize,2015,1310,1310,0,0.0
Varud,Maize,2015,1310,1310,0,0.0
Varud,Maize,2015,1310,1310,0,0.0
Washim,Mustard,2015,3100,3100,0,0.0
Bhandara,OTHER CEREALS,2016,3650,3650,0,0.0
Bhandara,Soybean,2016,3000,3000,0,0.0
Ambejogai,Sunflower,2015,3000,3000,0,0.0
Varud-Rajura Bazar,Castor Seed,2014,3300,3300,0,0.0
Ambejogai,Wheat(Husked),2015,1433,1433,0,0.0
Ambejogai,Sunflower,2015,3050,3050,0,0.0
Ambejogai,Sunflower,2015,3041,3041,0,0.0
Varud,Sorgum(Jawar),2016,1570,1570,0,0.0
Varud,Sorgum(Jawar),2016,1570,1570,0,0.0
Bhandara,Green Peas (Dry),2016,2000,2000,0,0.0
Bhandara,Green Peas (Dry),2016,2610,2610,0,0.0
Bhandara,Indian Bean,2016,4010,4010,0,0.0
Bhandara,Indian Bean,2016,3800,3800,0,0.0
Bhandara,Indian Bean,2016,3338,3338,0,0.0
Bhandara,Lentil,2016,3815,3815,0,0.0
Bhandara,Linseed,2016,4400,4400,0,0.0
Bhandara,Linseed,2016,4000,4000,0,0.0
Bhandara,Linseed,2016,5600,5600,0,0.0
Bhandara,Linseed,2016,5000,5000,0,0.0
Bhandara,Linseed,2016,4300,4300,0,0.0
Bhandara,Soybean,2016,3150,3150,0,0.0
Bhandara,Soybean,2016,3500,3500,0,0.0
Bhokar,Green Gram,2015,6950,6950,0,0.0
Bhokar,Black Gram,2014,4976,4976,0,0.0
Ambejogai,Green Gram,2015,7600,7600,0,0.0
Ambejogai,Black Gram,2015,4675,4675,0,0.0
Bhokar,Bajri,2015,1400,1400,0,0.0
Ambejogai,Black Gram,2015,4967,4967,0,0.0
Bhokar,Black Gram,2015,8380,8380,0,0.0
Bhokar,Black Gram,2015,4705,4705,0,0.0
Bhokar,Black Gram,2015,5285,5285,0,0.0
Bhokar,Black Gram,2015,5900,5900,0,0.0
Bhokar,Black Gram,2015,6601,6601,0,0.0
Bhokar,Black Gram,2015,7817,7817,0,0.0
Bhokar,Castor Seed,2015,2800,2800,0,0.0
Bhokar,Gram,2015,4101,4101,0,0.0
Bhokar,Gram,2015,3571,3571,0,0.0
Bhokar,Green Gram,2015,7040,7040,0,0.0
Bhokar,Green Gram,2015,6601,6601,0,0.0
Bhokar,Green Gram,2015,6500,6500,0,0.0
Bhokar,Green Gram,2015,5551,5551,0,0.0
Bhokar,Sunflower,2014,3700,3700,0,0.0
Bhokar,Black Gram,2014,5075,5075,0,0.0
Bhandara,Soybean,2016,3800,3800,0,0.0
Bhiwapur,Pigeon Pea (Tur),2016,6500,6500,0,0.0
Bhandara,Soybean,2016,3500,3500,0,0.0
Bhandara,Soybean,2016,4000,4000,0,0.0
Ambejogai,Sunflower,2015,3050,3050,0,0.0
Ambejogai,Sunflower,2015,3521,3521,0,0.0
Ambejogai,Sesamum,2015,7036,7036,0,0.0
Varud,Sorgum(Jawar),2014,1530,1530,0,0.0
Washim,Paddy-Unhusked,2015,1100,1100,0,0.0
Ambejogai,Sesamum,2015,6750,6750,0,0.0
Ambejogai,Sesamum,2015,7510,7510,0,0.0
Ambejogai,Sesamum,2015,6388,6388,0,0.0
Ambejogai,Safflower,2015,2450,2450,0,0.0
Ambejogai,Maize,2015,1301,1301,0,0.0
Ambejogai,Green Gram,2015,8200,8200,0,0.0
Ambejogai,Green Gram,2015,6825,6825,0,0.0
Bhiwapur,Linseed,2016,5400,5400,0,0.0
Bhiwapur,Linseed,2016,5200,5200,0,0.0
Bhiwapur,Linseed,2016,5600,5600,0,0.0
Bhandara,Green Peas (Dry),2016,2348,2348,0,0.0
Bhandara,Green Gram,2016,5983,5983,0,0.0
Bhandara,Green Gram,2016,5468,5468,0,0.0
Beed,Maize,2015,1360,1360,0,0.0
Beed,Sesamum,2015,6191,6191,0,0.0
Beed,Sesamum,2015,8301,8301,0,0.0
Ambejogai,Sunflower,2016,3246,3246,0,0.0
Beed,Soybean,2015,3423,3423,0,0.0
Beed,Soybean,2015,3204,3204,0,0.0
Beed,Wheat(Husked),2015,1798,1798,0,0.0
Beed,Wheat(Husked),2015,1737,1737,0,0.0
Varud-Rajura Bazar,Maize,2015,1271,1271,0,0.0
Varud-Rajura Bazar,Maize,2015,1067,1067,0,0.0
Varud-Rajura Bazar,Maize,2015,1308,1308,0,0.0
Varud-Rajura Bazar,Maize,2015,1257,1257,0,0.0
Varud-Rajura Bazar,Maize,2015,1219,1219,0,0.0
Beed,Black Gram,2016,9686,9686,0,0.0
Beed,Green Gram,2016,7900,7900,0,0.0
Beed,MAIZE,2016,1417,1417,0,0.0
Ambejogai,Sesamum,2016,6960,6960,0,0.0
Beed,Maize,2016,1730,1730,0,0.0
Beed,Pigeon Pea (Tur),2015,5377,5377,0,0.0
Beed,Maize,2015,1366,1366,0,0.0
Bhandara,Gram,2016,6415,6415,0,0.0
Ambejogai,Wheat(Husked),2016,1925,1925,0,0.0
Beed,Coriander (Dry),2014,11700,11700,0,0.0
Beed,Coriander (Dry),2014,9950,9950,0,0.0
Beed,Green Gram,2014,7090,7090,0,0.0
Varud-Rajura Bazar,Sorgum(Jawar),2015,1107,1107,0,0.0
Varud-Rajura Bazar,Sorgum(Jawar),2015,1106,1106,0,0.0
Varud-Rajura Bazar,Sorgum(Jawar),2015,1139,1139,0,0.0
Varud-Rajura Bazar,Sorgum(Jawar),2015,1417,1417,0,0.0
Beed,Maize,2014,1268,1268,0,0.0
Beed,Maize,2014,1310,1310,0,0.0
Beed,Maize,2014,1500,1500,0,0.0
Beed,Sesamum,2014,11000,11000,0,0.0
Beed,Black Gram,2015,5400,5400,0,0.0
Beed,Black Gram,2015,5700,5700,0,0.0
Varud-Rajura Bazar,Pigeon Pea (Tur),2015,8100,8100,0,0.0
Beed,Black Gram,2015,6700,6700,0,0.0
Beed,Green Gram,2015,7850,7850,0,0.0
Beed,Green Gram,2015,5250,5250,0,0.0
Beed,Pigeon Pea (Tur),2016,5710,5710,0,0.0
Beed,Sesamum,2016,6500,6500,0,0.0
Ambejogai,Sesamum,2016,5150,5150,0,0.0
Bhandara,Green Gram,2014,5670,5670,0,0.0
Ambejogai,Green Gram,2016,5040,5040,0,0.0
Ambejogai,Green Gram,2016,6301,6301,0,0.0
Varud-Rajura Bazar,Pigeon Pea (Tur),2014,4000,4000,0,0.0
Bhandara,CORIANDER (DRY),2016,6550,6550,0,0.0
Bhandara,Castor Seed,2016,2400,2400,0,0.0
Bhandara,Coriander (Dry),2016,6550,6550,0,0.0
Varud-Rajura Bazar,Maize,2014,1320,1320,0,0.0
Bhandara,Coriander (Dry),2016,6850,6850,0,0.0
Ambejogai,GREEN GRAM,2016,4640,4640,0,0.0
Ambejogai,Black Gram,2016,5400,5400,0,0.0
Ambejogai,Bajri,2016,1572,1572,0,0.0
Bhandara,Coriander (Dry),2016,6730,6730,0,0.0
Bhandara,Coriander (Dry),2016,6500,6500,0,0.0
Bhandara,Coriander (Dry),2016,7100,7100,0,0.0
Bhandara,Coriander (Dry),2016,6500,6500,0,0.0
Ambejogai,Bajri,2016,1500,1500,0,0.0
Ambejogai,BLACK GRAM,2016,6925,6925,0,0.0
Ambejogai,PIGEON PEA (TUR),2016,5287,5287,0,0.0
Bhandara,Black Gram,2016,7900,7900,0,0.0
Bhandara,Black Gram,2016,8600,8600,0,0.0
Varud-Rajura Bazar,Castor Seed,2015,3403,3403,0,0.0
Bhandara,Green Gram,2014,4805,4805,0,0.0
Bhandara,Pigeon Pea (Tur),2014,3600,3600,0,0.0
Bhandara,Coriander (Dry),2015,9500,9500,0,0.0
Bhandara,Gram,2015,3800,3800,0,0.0
Bhandara,Gram,2015,4833,4833,0,0.0
Bhandara,Green Gram,2015,7600,7600,0,0.0
Bhandara,Green Peas (Dry),2015,2500,2500,0,0.0
Bhandara,Indian Bean,2015,2000,2000,0,0.0
Bhandara,Black Gram,2016,8900,8900,0,0.0
Bhandara,Linseed,2015,4000,4000,0,0.0
Bhandara,Other Cereals,2015,3750,3750,0,0.0
Bhandara,Other Cereals,2015,2650,2650,0,0.0
Ambejogai,Sesamum,2016,5000,5000,0,0.0
Bhandara,Soybean,2015,3050,3050,0,0.0
Bhandara,Wheat(Husked),2015,1300,1300,0,0.0
Ambejogai,Sesamum,2016,5000,5000,0,0.0
Bhokar,Green Gram,2015,6665,6665,0,0.0
Bhokar,Green Gram,2015,7285,7285,0,0.0
Vaijapur,Soybean,2016,3870,3870,0,0.0
Akola,Batbati,2016,2900,2900,0,0.0
Bhusaval,Bajri,2015,1150,1150,0,0.0
Bhusaval,Bajri,2015,1100,1100,0,0.0
Akola,Bajri,2016,1200,1200,0,0.0
Washim,Green Gram,2016,5500,5500,0,0.0
Bhusaval,Bajri,2015,1300,1300,0,0.0
Bhusaval,Black Gram,2015,4700,4700,0,0.0
Washim,Mustard,2016,3838,3838,0,0.0
Akola,Bajri,2016,1750,1750,0,0.0
Bhusaval,Black Gram,2015,8800,8800,0,0.0
Bhusaval,Gram,2015,4000,4000,0,0.0
Bhusaval,Gram,2015,4000,4000,0,0.0
Akola,Sunflower,2015,2500,2500,0,0.0
Bhusaval,Gram,2015,4000,4000,0,0.0
Bhusaval,Gram,2015,4000,4000,0,0.0
Bhusaval,Green Gram,2015,6201,6201,0,0.0
Bhusaval,Green Gram,2015,7600,7600,0,0.0
Vani,Wheat(Husked),2014,1350,1350,0,0.0
Bhusaval,Maize,2014,1050,1050,0,0.0
Akola,Batbati,2016,3200,3200,0,0.0
Akola,Sunflower,2015,3450,3450,0,0.0
Akola,Ground Nut Pods (Dry),2016,4350,4350,0,0.0
Bhusaval,Bajri,2014,1317,1317,0,0.0
Bhusaval,Bajri,2014,1250,1250,0,0.0
Bhusaval,Black Gram,2014,4950,4950,0,0.0
Bhusaval,Cotton,2014,4050,4050,0,0.0
Bhusaval,Gram,2014,2800,2800,0,0.0
Amalner,Pigeon Pea (Tur),2014,3500,3500,0,0.0
Amalner,Gram,2014,2451,2451,0,0.0
Amalner,Black Gram,2014,4551,4551,0,0.0
Akola,Sunflower,2016,5487,5487,0,0.0
Akola,Sunflower,2016,3250,3250,0,0.0
Akola,Sesamum,2016,4800,4800,0,0.0
Bhusaval,Gram,2014,2308,2308,0,0.0
Akola,SAFFLOWER,2016,2067,2067,0,0.0
Akola,Mustard,2016,3900,3900,0,0.0
Akola,Maize,2016,1222,1222,0,0.0
Bhusaval,Maize,2014,975,975,0,0.0
Bhusaval,Maize,2014,992,992,0,0.0
Bhusaval,Green Gram,2015,6900,6900,0,0.0
Akola,Sesamum,2015,7000,7000,0,0.0
Bhokar,Ground Nut Pods (Dry),2015,5100,5100,0,0.0
Bhusaval,GREEN GRAM,2016,4600,4600,0,0.0
Akola,Safflower,2015,2400,2400,0,0.0
Akola,Safflower,2015,2250,2250,0,0.0
Akola,Mustard,2015,3111,3111,0,0.0
Akola,Maize,2015,1500,1500,0,0.0
Akola,Bajri,2015,1700,1700,0,0.0
Akola,Bajri,2015,1275,1275,0,0.0
Washim,Sesamum,2016,4100,4100,0,0.0
Washim,Sesamum,2016,6200,6200,0,0.0
Vaijapur,Thymol/Lovage,2016,10000,10000,0,0.0
Vaijapur,Thymol/Lovage,2016,12001,12001,0,0.0
Vaijapur,Tamarind,2016,1975,1975,0,0.0
Akola,Bajri,2015,1350,1350,0,0.0
Bhusaval,Gram,2016,5700,5700,0,0.0
Bhusaval,Green Gram,2016,4713,4713,0,0.0
Vaijapur,Tag,2016,4001,4001,0,0.0
Vaijapur,Sunflower,2016,3202,3202,0,0.0
Vaijapur,Sunflower,2016,3601,3601,0,0.0
Akola,Safflower,2015,2100,2100,0,0.0
Bhusaval,Black Gram,2016,9000,9000,0,0.0
Bhusaval,Maize,2015,1093,1093,0,0.0
Bhusaval,Black Gram,2016,9100,9100,0,0.0
Bhusaval,Maize,2015,1050,1050,0,0.0
Bhusaval,Maize,2015,1150,1150,0,0.0
Bhusaval,Maize,2015,1200,1200,0,0.0
Bhusaval,Maize,2015,1250,1250,0,0.0
Bhusaval,Pigeon Pea (Tur),2015,4300,4300,0,0.0
Bhusaval,Pigeon Pea (Tur),2015,4300,4300,0,0.0
Bhusaval,Pigeon Pea (Tur),2015,3550,3550,0,0.0
Bhusaval,Pigeon Pea (Tur),2015,3700,3700,0,0.0
Akola,Sesamum,2015,7000,7000,0,0.0
Akola,Sesamum,2015,6200,6200,0,0.0
Akola,Sesamum,2015,5600,5600,0,0.0
Bhusaval,Bajri,2016,1600,1600,0,0.0
Bhusaval,Bajri,2016,1550,1550,0,0.0
Bhusaval,Bajri,2016,1500,1500,0,0.0
Bhusaval,Bajri,2016,1644,1644,0,0.0
Bhusaval,Bajri,2016,1500,1500,0,0.0
Bhusaval,Black Gram,2016,9000,9000,0,0.0
Bhusaval,Bajri,2014,1300,1300,0,0.0
Amalner,Black Gram,2015,4500,4500,0,0.0
Amalner,Black Gram,2015,9500,9500,0,0.0
Bhokar,Black Gram,2016,8000,8000,0,0.0
Bhokar,Ground Nut Pods (Dry),2016,5200,5200,0,0.0
Bhokar,Ground Nut Pods (Dry),2016,4750,4750,0,0.0
Bhokar,MAIZE,2016,1325,1325,0,0.0
Bhokar,Maize,2016,1405,1405,0,0.0
Bhokar,Maize,2016,1345,1345,0,0.0
Bhokar,Maize,2016,1350,1350,0,0.0
Bhokar,Rice(Paddy-Hus),2016,1600,1600,0,0.0
Bhokar,Rice(Paddy-Hus),2016,1651,1651,0,0.0
Bhokar,Rice(Paddy-Hus),2016,1705,1705,0,0.0
Bhokar,Rice(Paddy-Hus),2016,1600,1600,0,0.0
Bhokar,Sesamum,2016,5400,5400,0,0.0
Bhokar,Sesamum,2016,5000,5000,0,0.0
Varora,Green Gram,2015,5800,5800,0,0.0
Varora,Green Gram,2015,6200,6200,0,0.0
Ambejogai,Bajri,2015,1500,1500,0,0.0
Ambejogai,Bajri,2015,1350,1350,0,0.0
Bhokar,Sunflower,2016,3345,3345,0,0.0
Washim,Safflower,2015,2000,2000,0,0.0
Bhokar,Black Gram,2016,9000,9000,0,0.0
Amalner,Coriander (Dry),2015,8500,8500,0,0.0
Bhokar,Turmeric,2015,9029,9029,0,0.0
Bhokar,Ground Nut Pods (Dry),2015,4000,4000,0,0.0
Bhokar,Ground Nut Pods (Dry),2015,4400,4400,0,0.0
Bhokar,Maize,2015,1450,1450,0,0.0
Bhokar,Pigeon Pea (Tur),2015,8036,8036,0,0.0
Bhokar,Pigeon Pea (Tur),2015,8223,8223,0,0.0
Bhokar,Rice(Paddy-Hus),2015,1725,1725,0,0.0
Bhokar,Rice(Paddy-Hus),2015,1550,1550,0,0.0
Bhokar,Rice(Paddy-Hus),2015,1610,1610,0,0.0
Bhokar,Rice(Paddy-Hus),2015,1700,1700,0,0.0
Bhokar,Rice(Paddy-Hus),2015,1650,1650,0,0.0
Bhokar,Rice(Paddy-Hus),2015,2000,2000,0,0.0
Bhokar,Sesamum,2015,5850,5850,0,0.0
Bhokar,Sesamum,2015,6600,6600,0,0.0
Ambejogai,Black Gram,2015,9000,9000,0,0.0
Bhokar,Sesamum,2015,6561,6561,0,0.0
Bhokar,Sunflower,2015,3250,3250,0,0.0
Ambejogai,Black Gram,2015,8000,8000,0,0.0
Bhokar,Turmeric,2016,8682,8682,0,0.0
Bhokar,WHEAT(HUSKED),2016,1500,1500,0,0.0
Ambejogai,Bajri,2015,1505,1505,0,0.0
Ambejogai,Bajri,2015,1500,1500,0,0.0
Amalner,Coriander (Dry),2016,7500,7500,0,0.0
Amalner,Chillies(Red),2016,8000,8000,0,0.0
Amalner,COWPEA,2016,5500,5500,0,0.0
Washim,Bajri,2016,1855,1855,0,0.0
Washim,Bajri,2016,2000,2000,0,0.0
Amalner,Black Gram,2016,10663,10663,0,0.0
Amalner,Black Gram,2016,12600,12600,0,0.0
Amalner,Black Gram,2016,7000,7000,0,0.0
Amalner,Soybean,2015,2850,2850,0,0.0
Vani,Green Gram,2016,5085,5085,0,0.0
Amalner,Pigeon Pea (Tur),2015,5500,5500,0,0.0
Amalner,Pigeon Pea (Tur),2015,4500,4500,0,0.0
Vani,Gram,2016,5000,5000,0,0.0
Amalner,Pigeon Pea (Tur),2015,5755,5755,0,0.0
Amalner,Matki,2015,5500,5500,0,0.0
Amalner,Cowpea,2015,4400,4400,0,0.0
Amalner,Cowpea,2015,4500,4500,0,0.0
Amalner,Cowpea,2016,3900,3900,0,0.0
Amalner,Cowpea,2016,6700,6700,0,0.0
Amalner,Green Gram,2016,5900,5900,0,0.0
Ambejogai,Castor Seed,2014,3150,3150,0,0.0
Ambejogai,Bajri,2015,1480,1480,0,0.0
Ambejogai,Bajri,2015,1642,1642,0,0.0
Ambejogai,Wheat(Husked),2014,1710,1710,0,0.0
Ambejogai,Sunflower,2014,2850,2850,0,0.0
Ambejogai,Sunflower,2014,2806,2806,0,0.0
Ambejogai,Safflower,2014,2400,2400,0,0.0
Ambejogai,Maize,2014,1300,1300,0,0.0
Ambejogai,Black Gram,2014,4900,4900,0,0.0
Amalner,Ground Nut Pods (Dry),2016,5951,5951,0,0.0
Ambejogai,Bajri,2014,1300,1300,0,0.0
Ambejogai,Bajri,2014,1496,1496,0,0.0
Amalner,Sesamum,2016,5550,5550,0,0.0
Amalner,Pigeon Pea (Tur),2016,5478,5478,0,0.0
Amalner,Pigeon Pea (Tur),2016,5100,5100,0,0.0
Amalner,Matki,2016,6525,6525,0,0.0
Amalner,Maize,2016,1699,1699,0,0.0
Beed,Black Gram,2014,5140,5140,0,0.0
Basmat (Kurunda),Soybean,2016,2850,2850,0,0.0
Basmat (Kurunda),Black Gram,2016,6800,6800,0,0.0
Barshi,Tamarind,2015,2500,2500,0,0.0
Balapur,Green Gram,2016,7000,7000,0,0.0
Balapur,Black Gram,2016,11500,11500,0,0.0
Balapur,Black Gram,2016,7550,7550,0,0.0
Vita,Cow,2016,61000,61000,0,0.0
Balapur,Black Gram,2016,9567,9567,0,0.0
Balapur,Black Gram,2016,9000,9000,0,0.0
Balapur,Black Gram,2016,9000,9000,0,0.0
Balapur,Black Gram,2016,8733,8733,0,0.0
Balapur,Black Gram,2016,11000,11000,0,0.0
Balapur,Sesamum,2015,6000,6000,0,0.0
Balapur,Sesamum,2015,7000,7000,0,0.0
Balapur,Other Cereals,2015,3600,3600,0,0.0
Balapur,Other Cereals,2015,3200,3200,0,0.0
Balapur,Maize,2015,1100,1100,0,0.0
Barshi,Wheat(Unhusked),2015,2400,2400,0,0.0
Barshi,Wheat(Unhusked),2015,2800,2800,0,0.0
Barshi,Wheat(Unhusked),2015,2775,2775,0,0.0
Balapur,Green Gram,2016,5750,5750,0,0.0
Barshi,Tamarind,2015,2500,2500,0,0.0
Barshi,Wheat(Unhusked),2015,3000,3000,0,0.0
Barshi,Sunflower,2015,3300,3300,0,0.0
Barshi,Rala,2015,2000,2000,0,0.0
Wardha,Sorgum(Jawar),2016,1345,1345,0,0.0
Wardha,Sorgum(Jawar),2016,1288,1288,0,0.0
Wardha,Sorgum(Jawar),2016,1200,1200,0,0.0
Wardha,Sorgum(Jawar),2016,1329,1329,0,0.0
Barshi,Safflower,2015,2525,2525,0,0.0
Barshi,Safflower,2015,2775,2775,0,0.0
Barshi,Safflower,2015,2756,2756,0,0.0
Barshi,Sesamum,2015,11000,11000,0,0.0
Barshi,Sesamum,2015,9200,9200,0,0.0
Balapur,Sesamum,2016,5500,5500,0,0.0
Barshi,Soybean,2015,3300,3300,0,0.0
Barshi,Sunflower,2015,3550,3550,0,0.0
Barshi,Sunflower,2015,3525,3525,0,0.0
Barshi,Sunflower,2015,3611,3611,0,0.0
Balapur,Sesamum,2016,6500,6500,0,0.0
Balapur,Green Gram,2016,4250,4250,0,0.0
Barshi,Wheat(Unhusked),2015,2450,2450,0,0.0
Barshi,Wheat(Unhusked),2015,2200,2200,0,0.0
Basmat,Soybean,2016,3730,3730,0,0.0
Barshi,Cowpea,2016,2550,2550,0,0.0
Barshi,Cowpea,2016,3500,3500,0,0.0
Barshi,Green Gram,2016,5500,5500,0,0.0
Barshi,Green Gram,2016,6250,6250,0,0.0
Barshi,Green Gram,2016,6000,6000,0,0.0
Ausa,Bajri,2016,1276,1276,0,0.0
Ausa,Sesamum,2015,8000,8000,0,0.0
Barshi,Green Gram,2016,6625,6625,0,0.0
Barshi,Ground Nut Pods (Dry),2016,4201,4201,0,0.0
Barshi,Ground Nut Pods (Dry),2016,6100,6100,0,0.0
Barshi,Matki,2016,7800,7800,0,0.0
Barshi,Methi (Bhaji),2016,750,750,0,0.0
Barshi,Neem-Seed,2016,1100,1100,0,0.0
Barshi,Onion,2016,1000,1000,0,0.0
Ausa,Mustard,2015,3651,3651,0,0.0
Barshi,Other Cereals,2016,2500,2500,0,0.0
Barshi,Other Cereals,2016,2700,2700,0,0.0
Barshi,Other Pulses,2016,2550,2550,0,0.0
Barshi,Cowpea,2016,3400,3400,0,0.0
Barshi,Cowpea,2016,3375,3375,0,0.0
Barshi,Wheat(Unhusked),2015,2900,2900,0,0.0
Barshi,Coriander (Dry),2016,7000,7000,0,0.0
Balapur,Green Gram,2015,7500,7500,0,0.0
Balapur,Green Gram,2015,5000,5000,0,0.0
Balapur,Black Gram,2015,6500,6500,0,0.0
Balapur,Bajri,2015,1400,1400,0,0.0
Barshi,Wheat(Unhusked),2015,2500,2500,0,0.0
Balapur,Bajri,2015,1250,1250,0,0.0
Barshi,Bajri,2016,1760,1760,0,0.0
Barshi,Bajri,2016,1725,1725,0,0.0
Barshi,Bajri,2016,1578,1578,0,0.0
Ausa,Jaggery,2016,2471,2471,0,0.0
Barshi,Bajri,2016,1900,1900,0,0.0
Barshi,Black Gram,2016,8967,8967,0,0.0
Barshi,Black Gram,2016,5500,5500,0,0.0
Barshi,Castor Seed,2016,2711,2711,0,0.0
Barshi,Castor Seed,2016,3000,3000,0,0.0
Barshi,Coriander (Dry),2016,7350,7350,0,0.0
Barshi,Coriander (Dry),2016,6500,6500,0,0.0
Barshi,Other Pulses,2015,2700,2700,0,0.0
Barshi,Other Pulses,2015,4000,4000,0,0.0
Barshi,Other Pulses,2015,1850,1850,0,0.0
Barshi,Tamarind,2014,2600,2600,0,0.0
Barshi,Custard Apple,2014,100,100,0,0.0
Barshi,Coriander (Dry),2014,9920,9920,0,0.0
Wardha,Black Gram,2016,7400,7400,0,0.0
Wardha,Black Gram,2016,4835,4835,0,0.0
Barshi,Bajri,2015,1250,1250,0,0.0
Barshi,Castor Seed,2014,3400,3400,0,0.0
Baramati,Safflower,2016,2900,2900,0,0.0
Barshi,Bajri,2015,1348,1348,0,0.0
Barshi,Bajri,2015,1425,1425,0,0.0
Barshi,Bajri,2015,1573,1573,0,0.0
Barshi,Bajri,2015,1551,1551,0,0.0
Barshi,Black Gram,2015,4875,4875,0,0.0
Baramati,Safflower,2016,2800,2800,0,0.0
Baramati,Ground Nut Pods (Dry),2016,3700,3700,0,0.0
Baramati,Safflower,2015,2951,2951,0,0.0
Baramati,Safflower,2015,2800,2800,0,0.0
Barshi,Castor Seed,2015,3500,3500,0,0.0
Barshi,Wheat(Unhusked),2014,2650,2650,0,0.0
Barshi,Tamarind,2014,7139,7139,0,0.0
Barshi,Other Pulses,2015,3100,3100,0,0.0
Barshi,Sunflower,2014,3100,3100,0,0.0
Wardha,Green Gram,2016,4683,4683,0,0.0
Wardha,Green Gram,2016,6050,6050,0,0.0
Wardha,Green Gram,2016,4000,4000,0,0.0
Wardha,Green Gram,2016,4500,4500,0,0.0
Barshi,Ground Nut Pods (Dry),2014,3500,3500,0,0.0
Barshi,Matki,2014,6400,6400,0,0.0
Barshi,Matki,2014,6500,6500,0,0.0
Barshi,Mustard,2014,3676,3676,0,0.0
Barshi,Other Cereals,2014,3300,3300,0,0.0
Barshi,Ground Nut Pods (Dry),2014,3500,3500,0,0.0
Barshi,Other Pulses,2014,2625,2625,0,0.0
Barshi,Other Pulses,2014,2200,2200,0,0.0
Barshi,Rice(Paddy-Hus),2014,1545,1545,0,0.0
Barshi,Sesamum,2014,8350,8350,0,0.0
Wardha,GREEN GRAM,2016,3996,3996,0,0.0
Barshi,Sesamum,2014,8500,8500,0,0.0
Barshi,Sunflower,2014,3075,3075,0,0.0
Barshi,Castor Seed,2015,3625,3625,0,0.0
Barshi,Castor Seed,2015,3300,3300,0,0.0
Barshi,Castor Seed,2015,3350,3350,0,0.0
Barshi,Coriander (Dry),2015,10000,10000,0,0.0
Barshi,Matki,2015,6000,6000,0,0.0
Barshi,Mustard,2015,3000,3000,0,0.0
Baramati,Ground Nut Pods (Dry),2015,3351,3351,0,0.0
Barshi,Mustard,2015,3500,3500,0,0.0
Barshi,Mustard,2015,3550,3550,0,0.0
Barshi,Neem-Seed,2015,937,937,0,0.0
Barshi,Other Cereals,2015,2800,2800,0,0.0
Barshi,Other Pulses,2015,3000,3000,0,0.0
Barshi,Other Pulses,2015,3500,3500,0,0.0
Wardha,Sorgum(Jawar),2014,1880,1880,0,0.0
Barshi,Other Pulses,2015,3060,3060,0,0.0
Baramati,Ground Nut Pods (Dry),2015,2300,2300,0,0.0
Barshi,Other Pulses,2015,2607,2607,0,0.0
Barshi,Other Pulses,2015,2841,2841,0,0.0
Barshi,Other Pulses,2015,3600,3600,0,0.0
Barshi,Other Pulses,2015,1975,1975,0,0.0
Balapur,Sunflower,2016,3375,3375,0,0.0
Wardha,Sesamum,2016,6000,6000,0,0.0
Barshi,Jaggery,2015,2280,2280,0,0.0
Barshi,Jaggery,2015,2350,2350,0,0.0
Barshi,Green Gram,2015,5425,5425,0,0.0
Barshi,Coriander (Dry),2015,6750,6750,0,0.0
Barshi,Coriander (Dry),2015,5000,5000,0,0.0
Barshi,Coriander (Dry),2015,6301,6301,0,0.0
Barshi,Coriander (Dry),2015,9000,9000,0,0.0
Wardha,Pigeon Pea (Tur),2015,4000,4000,0,0.0
Barshi,Coriander (Dry),2015,10100,10100,0,0.0
Barshi,Coriander (Dry),2015,9500,9500,0,0.0
Barshi,Green Gram,2015,6467,6467,0,0.0
Baramati,Safflower,2015,2200,2200,0,0.0
Barshi,Green Gram,2015,5375,5375,0,0.0
Barshi,Ground Nut Pods (Dry),2015,4525,4525,0,0.0
Barshi,Ground Nut Pods (Dry),2015,5094,5094,0,0.0
Barshi,Ground Nut Pods (Dry),2015,4228,4228,0,0.0
Barshi,Ground Nut Pods (Dry),2015,4300,4300,0,0.0
Barshi,Jaggery,2015,2100,2100,0,0.0
Barshi,Jaggery,2015,2150,2150,0,0.0
Barshi,Other Pulses,2016,2500,2500,0,0.0
Barshi,Other Pulses,2016,3100,3100,0,0.0
Barshi,Other Pulses,2016,3400,3400,0,0.0
Washim,Black Gram,2015,5610,5610,0,0.0
Barshi-Vairag,Safflower,2016,2345,2345,0,0.0
Barshi-Vairag,Safflower,2016,2000,2000,0,0.0
Anajngaon Surji,Cotton,2015,3950,3950,0,0.0
Barshi-Vairag,Soybean,2016,3750,3750,0,0.0
Anajngaon Surji,Cotton,2015,3950,3950,0,0.0
Barshi-Vairag,Sunflower,2016,3225,3225,0,0.0
Varud-Rajura Bazar,Sorgum(Jawar),2016,1470,1470,0,0.0
Anajngaon Surji,Sesamum,2014,10067,10067,0,0.0
Barshi-Vairag,Sunflower,2016,2500,2500,0,0.0
Anajngaon Surji,Cotton,2014,4050,4050,0,0.0
Barshi-Vairag,Wheat(Husked),2016,2315,2315,0,0.0
Barshi-Vairag,Wheat(Husked),2016,2191,2191,0,0.0
Barshi-Vairag,Wheat(Unhusked),2016,3000,3000,0,0.0
Basmat,Cotton,2014,4050,4050,0,0.0
Basmat,Green Gram,2014,6610,6610,0,0.0
Basmat,Green Gram,2014,5707,5707,0,0.0
Basmat,Ground Nut Pods (Dry),2014,3600,3600,0,0.0
Anajngaon Surji,Green Gram,2015,9000,9000,0,0.0
Armori-Desaiganj,Chillies(Red),2014,12700,12700,0,0.0
Barshi-Vairag,Ground Nut Pods (Dry),2016,3800,3800,0,0.0
Armori-Desaiganj,Chillies(Red),2015,14000,14000,0,0.0
Barshi-Vairag,Maize,2016,1800,1800,0,0.0
Barshi-Vairag,Maize,2016,1750,1750,0,0.0
Varud-Rajura Bazar,Wheat(Husked),2016,1400,1400,0,0.0
Barshi-Vairag,Maize,2016,1620,1620,0,0.0
Barshi-Vairag,Paddy-Unhusked,2016,1301,1301,0,0.0
Barshi-Vairag,Pigeon Pea (Tur),2016,6238,6238,0,0.0
Barshi-Vairag,Pigeon Pea (Tur),2016,4301,4301,0,0.0
Barshi-Vairag,Safflower,2016,2400,2400,0,0.0
Barshi-Vairag,Safflower,2016,2425,2425,0,0.0
Barshi-Vairag,Safflower,2016,2310,2310,0,0.0
Barshi-Vairag,Safflower,2016,2450,2450,0,0.0
Barshi-Vairag,Safflower,2016,2311,2311,0,0.0
Ashti (Jalna),Jaggery,2015,2511,2511,0,0.0
Ashti (Jalna),Green Gram,2015,8026,8026,0,0.0
Ashti (Jalna),Green Gram,2015,6913,6913,0,0.0
Ashti (Jalna),Gram,2015,4370,4370,0,0.0
Ashti (Jalna),Gram,2015,3950,3950,0,0.0
Basmat,Sorgum(Jawar),2014,1500,1500,0,0.0
Basmat,Wheat(Husked),2014,1500,1500,0,0.0
Basmat,Black Gram,2015,9900,9900,0,0.0
Basmat,Castor Seed,2015,3350,3350,0,0.0
Basmat,Wheat(Husked),2015,1550,1550,0,0.0
Ambejogai,Wheat(Husked),2016,2810,2810,0,0.0
Varud-Rajura Bazar,Castor Seed,2016,2500,2500,0,0.0
Basmat,Wheat(Husked),2015,1600,1600,0,0.0
Basmat,Wheat(Husked),2015,1720,1720,0,0.0
Basmat,Wheat(Husked),2015,1350,1350,0,0.0
Varud-Rajura Bazar,Wheat(Husked),2015,1488,1488,0,0.0
Basmat,Black Gram,2016,6800,6800,0,0.0
Basmat,Gram,2016,4900,4900,0,0.0
Basmat,Gram,2016,5580,5580,0,0.0
Basmat,Gram,2016,5360,5360,0,0.0
Basmat,Green Gram,2016,6300,6300,0,0.0
Basmat,Green Gram,2016,6800,6800,0,0.0
Basmat,Green Gram,2016,5100,5100,0,0.0
Basmat,Pigeon Pea (Tur),2016,7940,7940,0,0.0
Basmat,Sorgum(Jawar),2016,1250,1250,0,0.0
Basmat,Sorgum(Jawar),2016,1410,1410,0,0.0
Basmat,Wheat(Husked),2015,1585,1585,0,0.0
Basmat,Wheat(Husked),2015,1550,1550,0,0.0
Basmat,Soybean,2015,3915,3915,0,0.0
Varud-Rajura Bazar,Green Gram,2016,5000,5000,0,0.0
Basmat,Castor Seed,2015,3420,3420,0,0.0
Varud-Rajura Bazar,Mustard,2016,3150,3150,0,0.0
Varud-Rajura Bazar,Mustard,2016,3665,3665,0,0.0
Basmat,Cotton,2015,3950,3950,0,0.0
Basmat,Gram,2015,4195,4195,0,0.0
Basmat,Gram,2015,3900,3900,0,0.0
Varud-Rajura Bazar,Green Gram,2016,4511,4511,0,0.0
Basmat,Gram,2015,5000,5000,0,0.0
Basmat,Soybean,2015,3518,3518,0,0.0
Basmat,Green Gram,2015,7005,7005,0,0.0
Basmat,Ground Nut Pods (Dry),2015,3500,3500,0,0.0
Basmat,Pigeon Pea (Tur),2015,5700,5700,0,0.0
Basmat,Pigeon Pea (Tur),2015,7800,7800,0,0.0
Basmat,Pigeon Pea (Tur),2015,7030,7030,0,0.0
Basmat,Sesamum,2015,6100,6100,0,0.0
Basmat,Sorgum(Jawar),2015,1165,1165,0,0.0
Ashti (Jalna),Maize,2015,1200,1200,0,0.0
Ashti (Jalna),Pigeon Pea (Tur),2015,7050,7050,0,0.0
Barshi,Other Pulses,2016,2375,2375,0,0.0
Ausa,Coriander (Dry),2015,7701,7701,0,0.0
Barshi,Tamarind Seed,2016,1813,1813,0,0.0
Barshi,Tamarind Seed,2016,1800,1800,0,0.0
Barshi,Tamarind Seed,2016,1789,1789,0,0.0
Ausa,Black Gram,2015,4001,4001,0,0.0
Ausa,Black Gram,2015,4701,4701,0,0.0
Ausa,Bajri,2015,1501,1501,0,0.0
Barshi,Wheat(Unhusked),2016,2600,2600,0,0.0
Barshi-Vairag,Other Pulses,2014,2100,2100,0,0.0
Barshi-Vairag,Paddy-Unhusked,2014,800,800,0,0.0
Ausa,Pigeon Pea (Tur),2014,4751,4751,0,0.0
Barshi-Vairag,Pigeon Pea (Tur),2014,4400,4400,0,0.0
Barshi-Vairag,Pigeon Pea (Tur),2014,3801,3801,0,0.0
Barshi-Vairag,Pigeon Pea (Tur),2014,3975,3975,0,0.0
Barshi-Vairag,Safflower,2014,2331,2331,0,0.0
Barshi-Vairag,Sunflower,2014,2950,2950,0,0.0
Barshi-Vairag,Wheat(Husked),2014,1951,1951,0,0.0
Barshi-Vairag,Bajri,2015,1252,1252,0,0.0
Ausa,Castor Seed,2015,3075,3075,0,0.0
Ausa,Green Gram,2015,5601,5601,0,0.0
Ashti (Jalna),Sesamum,2015,7200,7200,0,0.0
Ausa,Green Gram,2015,6856,6856,0,0.0
Barshi,Other Pulses,2016,2000,2000,0,0.0
Barshi,Other Pulses,2016,3200,3200,0,0.0
Ausa,Mustard,2015,3701,3701,0,0.0
Barshi,Rala,2016,3100,3100,0,0.0
Barshi,Safflower,2016,2550,2550,0,0.0
Barshi,Safflower,2016,2925,2925,0,0.0
Ausa,Mustard,2015,3689,3689,0,0.0
Ausa,Linseed,2015,4751,4751,0,0.0
Ausa,Jaggery,2015,1801,1801,0,0.0
Ausa,Jaggery,2015,1951,1951,0,0.0
Ausa,Ground Nut Pods (Dry),2015,4926,4926,0,0.0
Barshi,Safflower,2016,2825,2825,0,0.0
Barshi,Safflower,2016,2600,2600,0,0.0
Barshi,Sesamum,2016,5700,5700,0,0.0
Barshi,Sesamum,2016,6101,6101,0,0.0
Ausa,Green Gram,2015,6500,6500,0,0.0
Barshi,Sunflower,2016,2925,2925,0,0.0
Barshi-Vairag,Black Gram,2015,4850,4850,0,0.0
Ausa,Niger-Seed,2014,4301,4301,0,0.0
Ausa,Niger-Seed,2014,4000,4000,0,0.0
Barshi-Vairag,Black Gram,2015,11900,11900,0,0.0
Barshi-Vairag,Wheat(Husked),2015,2059,2059,0,0.0
Barshi-Vairag,Wheat(Husked),2015,1947,1947,0,0.0
Barshi-Vairag,Bajri,2016,1140,1140,0,0.0
Barshi-Vairag,Black Gram,2016,5550,5550,0,0.0
Barshi-Vairag,Black Gram,2016,10333,10333,0,0.0
Barshi-Vairag,Green Gram,2016,5001,5001,0,0.0
Aurangabad,Soybean,2014,3125,3125,0,0.0
Aurangabad,Pigeon Pea (Tur),2014,4500,4500,0,0.0
Aurangabad,Gram,2014,2751,2751,0,0.0
Barshi-Vairag,Ground Nut Pods (Dry),2016,5650,5650,0,0.0
Barshi-Vairag,Ground Nut Pods (Dry),2016,5600,5600,0,0.0
Ashti (Jalna),Sorgum(Jawar),2016,1386,1386,0,0.0
Ashti (Jalna),Green Gram,2016,6861,6861,0,0.0
Ashti (Jalna),Gram,2016,4000,4000,0,0.0
Ashti (Jalna),Bajri,2016,1200,1200,0,0.0
Barshi-Vairag,Ground Nut Pods (Dry),2016,4435,4435,0,0.0
Barshi-Vairag,Ground Nut Pods (Dry),2016,5067,5067,0,0.0
Barshi-Vairag,Sunflower,2015,3093,3093,0,0.0
Barshi-Vairag,Sunflower,2015,3050,3050,0,0.0
Barshi-Vairag,Sunflower,2015,3175,3175,0,0.0
Barshi-Vairag,Pigeon Pea (Tur),2015,6117,6117,0,0.0
Barshi-Vairag,Gram,2015,3900,3900,0,0.0
Barshi-Vairag,Green Gram,2015,5000,5000,0,0.0
Barshi-Vairag,Green Gram,2015,5434,5434,0,0.0
Barshi-Vairag,Green Gram,2015,7900,7900,0,0.0
Barshi-Vairag,Green Gram,2015,8800,8800,0,0.0
Barshi-Vairag,Green Gram,2015,8001,8001,0,0.0
Barshi-Vairag,Paddy-Unhusked,2015,1386,1386,0,0.0
Barshi-Vairag,Pigeon Pea (Tur),2015,7000,7000,0,0.0
Barshi-Vairag,Sunflower,2015,3750,3750,0,0.0
Ausa,Ground Nut Pods (Dry),2014,4051,4051,0,0.0
Barshi-Vairag,Pigeon Pea (Tur),2015,6300,6300,0,0.0
Barshi-Vairag,Safflower,2015,3000,3000,0,0.0
Ausa,Bajri,2014,1551,1551,0,0.0
Ausa,Bajri,2014,1769,1769,0,0.0
Barshi-Vairag,Soybean,2015,3567,3567,0,0.0
Barshi-Vairag,Soybean,2015,3800,3800,0,0.0
Vaijapur,Sunflower,2016,3300,3300,0,0.0
Vaijapur,Soybean,2016,3534,3534,0,0.0
Ahmedpur,Niger-Seed,2015,7300,7300,0,0.0
Ahmedpur,Sesamum,2016,4700,4700,0,0.0
Devala,Green Peas (Dry),2016,2700,2700,0,0.0
Devala,Green Peas (Dry),2016,2405,2405,0,0.0
Devala,HORSE GRAM,2016,4005,4005,0,0.0
Devala,Horse Gram,2016,2379,2379,0,0.0
Devala,Horse Gram,2016,2843,2843,0,0.0
Devala,Horse Gram,2016,2901,2901,0,0.0
Ahmedpur,Sesamum,2016,3993,3993,0,0.0
Devala,Horse Gram,2016,2200,2200,0,0.0
Devala,Horse Gram,2016,3573,3573,0,0.0
Devala,MATKI,2016,6288,6288,0,0.0
Ahmedpur,Safflower,2016,2100,2100,0,0.0
Devala,Matki,2016,5253,5253,0,0.0
Devala,Matki,2016,5169,5169,0,0.0
Devala,Matki,2016,6581,6581,0,0.0
Devala,Matki,2016,3855,3855,0,0.0
Devala,Mustard,2016,5000,5000,0,0.0
Devala,Nagali,2016,1905,1905,0,0.0
Devala,Green Gram,2016,6570,6570,0,0.0
Devala,Green Gram,2016,5005,5005,0,0.0
Ahmedpur,Safflower,2016,2050,2050,0,0.0
Devala,Green Gram,2016,7420,7420,0,0.0
Devala,Sunflower,2015,3232,3232,0,0.0
Devala,Tag,2015,3105,3105,0,0.0
Devala,Tamarind,2015,1292,1292,0,0.0
Devala,Tamarind,2015,830,830,0,0.0
Devala,Bhagar/Vari,2016,4000,4000,0,0.0
Devala,Black Gram,2016,9000,9000,0,0.0
Ahmedpur,Sunflower,2016,3800,3800,0,0.0
Ahmedpur,Spilt Pigeon Pea,2016,9500,9500,0,0.0
Devala,Black Gram,2016,9905,9905,0,0.0
Devala,COWPEA,2016,2720,2720,0,0.0
Devala,Cowpea,2016,3205,3205,0,0.0
Devala,Cowpea,2016,3925,3925,0,0.0
Devala,Cowpea,2016,3350,3350,0,0.0
Devala,Cowpea,2016,3555,3555,0,0.0
Devala,Cowpea,2016,2465,2465,0,0.0
Devala,Fenugreek,2016,5000,5000,0,0.0
Devala,Fenugreek,2016,7000,7000,0,0.0
Devala,PIGEON PEA (TUR),2016,4895,4895,0,0.0
Devala,Pigeon Pea (Tur),2016,7550,7550,0,0.0
Ahmedpur,Ground Nut Pods (Dry),2016,5100,5100,0,0.0
Devala,Tag,2016,3450,3450,0,0.0
Devala,Tag,2016,3500,3500,0,0.0
Ahmedpur,Maize,2016,1712,1712,0,0.0
Ahmedpur,Hemp-Seed,2016,2141,2141,0,0.0
Ahmedpur,Ground Nut Pods (Dry),2016,7500,7500,0,0.0
Ahmedpur,Ground Nut Pods (Dry),2016,5647,5647,0,0.0
Devala,Wheat(Husked),2016,1655,1655,0,0.0
Devani,Safflower,2015,2680,2680,0,0.0
Ahmedpur,Ground Nut Pods (Dry),2016,4600,4600,0,0.0
Devani,GRAM,2016,7300,7300,0,0.0
Devani,PIGEON PEA (TUR),2016,5401,5401,0,0.0
Devani,SAFFLOWER,2016,2600,2600,0,0.0
Devani,SORGUM(JAWAR),2016,1601,1601,0,0.0
Ahmedpur,Ground Nut Pods (Dry),2016,5400,5400,0,0.0
Devani,Sorgum(Jawar),2016,1200,1200,0,0.0
Ahmedpur,Ground Nut Pods (Dry),2016,5801,5801,0,0.0
Dharangaon,Black Gram,2016,7600,7600,0,0.0
Dharangaon,GREEN GRAM,2016,6690,6690,0,0.0
Devala,Tag,2016,4500,4500,0,0.0
Devala,Soup Berries,2016,650,650,0,0.0
Devala,Pigeon Pea (Tur),2016,7272,7272,0,0.0
Devala,Soup Berries,2016,733,733,0,0.0
Ahmedpur,Safflower,2016,2350,2350,0,0.0
Ahmedpur,Safflower,2016,2463,2463,0,0.0
Ahmedpur,SAFFLOWER,2016,2700,2700,0,0.0
Ahmedpur,Rice(Paddy-Hus),2016,1425,1425,0,0.0
Devala,Rice(Paddy-Hus),2016,1415,1415,0,0.0
Devala,Rice(Paddy-Hus),2016,1373,1373,0,0.0
Devala,Rice(Paddy-Hus),2016,1675,1675,0,0.0
Devala,Rice(Paddy-Hus),2016,1490,1490,0,0.0
Devala,Rice(Paddy-Hus),2016,1534,1534,0,0.0
Devala,SORGUM(JAWAR),2016,1194,1194,0,0.0
Ahmedpur,Niger-Seed,2016,9845,9845,0,0.0
Ahmedpur,Neem-Seed,2016,700,700,0,0.0
Ahmedpur,Mustard,2016,3500,3500,0,0.0
Ahmedpur,Maize,2016,1604,1604,0,0.0
Ahmedpur,Maize,2016,1700,1700,0,0.0
Devala,Sorgum(Jawar),2016,1638,1638,0,0.0
Devala,Sorgum(Jawar),2016,1399,1399,0,0.0
Devala,Soybean,2015,3835,3835,0,0.0
Devala,Soup Berries,2015,603,603,0,0.0
Devala,Soup Berries,2015,987,987,0,0.0
Devala,Black Gram,2015,4398,4398,0,0.0
Devala,Black Gram,2015,9250,9250,0,0.0
Devala,Black Gram,2015,5643,5643,0,0.0
Devala,Black Gram,2015,7167,7167,0,0.0
Devala,Black Gram,2015,10450,10450,0,0.0
Devala,Castor Seed,2015,3336,3336,0,0.0
Devala,Coriander (Dry),2015,8670,8670,0,0.0
Devala,Cowpea,2015,3390,3390,0,0.0
Devala,Cowpea,2015,4755,4755,0,0.0
Devala,Cowpea,2015,3135,3135,0,0.0
Devala,Cowpea,2015,4300,4300,0,0.0
Devala,Cowpea,2015,2944,2944,0,0.0
Devala,Cowpea,2015,4358,4358,0,0.0
Devala,Cowpea,2015,3071,3071,0,0.0
Akhadabalapur,Wheat(Husked),2015,1800,1800,0,0.0
Devala,Cowpea,2015,2803,2803,0,0.0
Devala,Fenugreek,2015,5000,5000,0,0.0
Devala,Fenugreek,2015,3399,3399,0,0.0
Devala,Black Gram,2015,5436,5436,0,0.0
Devala,Tag,2014,3200,3200,0,0.0
Devala,Soup Berries,2015,863,863,0,0.0
Devala,Rice(Paddy-Hus),2014,1511,1511,0,0.0
Daryapur,Sorgum(Jawar),2016,1475,1475,0,0.0
Daryapur,Sorgum(Jawar),2016,1610,1610,0,0.0
Akhadabalapur,SORGUM(JAWAR),2016,1625,1625,0,0.0
Daryapur,Wheat(Husked),2016,1400,1400,0,0.0
Daryapur,Wheat(Husked),2016,1378,1378,0,0.0
Deglur,Soybean,2014,3378,3378,0,0.0
Devala,Black Gram,2014,5262,5262,0,0.0
Devala,Black Gram,2014,5013,5013,0,0.0
Devala,Cowpea,2014,2565,2565,0,0.0
Devala,Horse Gram,2014,2000,2000,0,0.0
Devala,Horse Gram,2014,2150,2150,0,0.0
Devala,Horse Gram,2014,3035,3035,0,0.0
Devala,Maize,2014,1290,1290,0,0.0
Devala,Matki,2014,6335,6335,0,0.0
Devala,Matki,2014,6345,6345,0,0.0
Devala,Pigeon Pea (Tur),2014,3800,3800,0,0.0
Devala,Pigeon Pea (Tur),2014,4105,4105,0,0.0
Devala,Fenugreek,2015,9300,9300,0,0.0
Devala,Green Gram,2015,7470,7470,0,0.0
Devala,Green Gram,2015,7625,7625,0,0.0
Devala,Green Gram,2015,5550,5550,0,0.0
Devala,Matki,2015,6048,6048,0,0.0
Devala,Matki,2015,7576,7576,0,0.0
Akhadabalapur,Wheat(Husked),2014,1800,1800,0,0.0
Devala,Matki,2015,8800,8800,0,0.0
Ahmedpur,Wheat(Husked),2016,1400,1400,0,0.0
Devala,Pigeon Pea (Tur),2015,5926,5926,0,0.0
Devala,Pigeon Pea (Tur),2015,5545,5545,0,0.0
Devala,Rice(Paddy-Hus),2015,1630,1630,0,0.0
Devala,Rice(Paddy-Hus),2015,1400,1400,0,0.0
Devala,Rice(Paddy-Hus),2015,1496,1496,0,0.0
Devala,Rice(Paddy-Hus),2015,1500,1500,0,0.0
Devala,Rice(Paddy-Hus),2015,1376,1376,0,0.0
Devala,Rice(Paddy-Hus),2015,1575,1575,0,0.0
Devala,Rice(Paddy-Hus),2015,1620,1620,0,0.0
Ahmedpur,Tamarind Seed,2016,1700,1700,0,0.0
Ahmedpur,Tamarind,2016,5701,5701,0,0.0
Devala,Soup Berries,2015,1000,1000,0,0.0
Devala,Matki,2015,7710,7710,0,0.0
Devala,Matki,2015,7885,7885,0,0.0
Devala,Matki,2015,6950,6950,0,0.0
Devala,Green Peas (Dry),2015,800,800,0,0.0
Devala,Green Gram,2015,7728,7728,0,0.0
Akhadabalapur,Wheat(Husked),2015,1800,1800,0,0.0
Akhadabalapur,Wheat(Husked),2015,1800,1800,0,0.0
Devala,Green Gram,2015,7200,7200,0,0.0
Devala,Green Peas (Dry),2015,2000,2000,0,0.0
Devala,Green Peas (Dry),2015,2000,2000,0,0.0
Devala,Green Peas (Dry),2015,2551,2551,0,0.0
Devala,Green Peas (Dry),2015,1051,1051,0,0.0
Devala,Horse Gram,2015,3070,3070,0,0.0
Devala,Green Peas (Dry),2015,2705,2705,0,0.0
Devala,Horse Gram,2015,2797,2797,0,0.0
Akhadabalapur,Sorgum(Jawar),2015,1500,1500,0,0.0
Devala,Horse Gram,2015,3268,3268,0,0.0
Devala,Horse Gram,2015,3447,3447,0,0.0
Devala,Horse Gram,2015,3290,3290,0,0.0
Devala,Horse Gram,2015,2875,2875,0,0.0
Ahmedpur,Ground Nut Pods (Dry),2016,9300,9300,0,0.0
Dhule,Castor Seed,2014,3105,3105,0,0.0
Vaijapur,Soybean,2016,3801,3801,0,0.0
Digras,Cotton,2016,4565,4565,0,0.0
Digras,Cotton,2016,4450,4450,0,0.0
Digras,Cotton,2016,4416,4416,0,0.0
Digras,GREEN GRAM,2016,5228,5228,0,0.0
Ahmedpur,Sesamum,2015,6301,6301,0,0.0
Digras,Gram,2016,3400,3400,0,0.0
Digras,Green Gram,2016,6259,6259,0,0.0
Digras,Green Gram,2016,5700,5700,0,0.0
Digras,Rice(Paddy-Hus),2016,1255,1255,0,0.0
Digras,Rice(Paddy-Hus),2016,1195,1195,0,0.0
Digras,SORGUM(JAWAR),2016,1628,1628,0,0.0
Digras,Sesamum,2016,5205,5205,0,0.0
Digras,Sesamum,2016,6178,6178,0,0.0
Digras,Sesamum,2016,6200,6200,0,0.0
Ahmedpur,Sesamum,2015,7200,7200,0,0.0
Digras,Sorgum(Jawar),2016,1590,1590,0,0.0
Digras,Sorgum(Jawar),2016,1585,1585,0,0.0
Digras,Sorgum(Jawar),2016,1580,1580,0,0.0
Digras,Cotton,2016,4325,4325,0,0.0
Digras,Black Gram,2016,8413,8413,0,0.0
Dondaicha,Black Gram,2014,4050,4050,0,0.0
Digras,Black Gram,2016,9505,9505,0,0.0
Digras,Sorgum(Jawar),2015,1572,1572,0,0.0
Ahmedpur,Spilt Pigeon Pea,2015,8300,8300,0,0.0
Digras,Sorgum(Jawar),2015,1543,1543,0,0.0
Digras,Sorgum(Jawar),2015,1573,1573,0,0.0
Digras,Sorgum(Jawar),2015,1535,1535,0,0.0
Ahmedpur,Spilt Pigeon Pea,2015,12100,12100,0,0.0
Digras,Bajri,2016,1600,1600,0,0.0
Digras,Bajri,2016,1395,1395,0,0.0
Digras,Bajri,2016,1605,1605,0,0.0
Digras,Bajri,2016,1378,1378,0,0.0
Digras,Bajri,2016,1945,1945,0,0.0
Digras,Batbati,2016,2200,2200,0,0.0
Digras,Batbati,2016,3450,3450,0,0.0
Digras,Batbati,2016,5350,5350,0,0.0
Digras,Black Gram,2016,5975,5975,0,0.0
Digras,Black Gram,2016,3380,3380,0,0.0
Digras,Black Gram,2016,7000,7000,0,0.0
Digras,Sorgum(Jawar),2016,1575,1575,0,0.0
Dondaicha,Black Gram,2014,5260,5260,0,0.0
Dhule,Castor Seed,2014,3830,3830,0,0.0
Dondaicha,Green Gram,2016,5833,5833,0,0.0
Ahmedpur,Sesamum,2015,7050,7050,0,0.0
Dondaicha,Matki,2016,4401,4401,0,0.0
Dondaicha,Pigeon Pea (Tur),2016,6531,6531,0,0.0
Dondaicha,Soybean,2016,3300,3300,0,0.0
Ahmedpur,Safflower,2015,2301,2301,0,0.0
Dondaicha,Soybean,2016,3469,3469,0,0.0
Dondaicha-Sindkheda,Green Gram,2015,8000,8000,0,0.0
Dondaicha-Sindkheda,Ground Nut Pods (Dry),2015,4400,4400,0,0.0
Dondaicha-Sindkheda,Sesamum,2015,5000,5000,0,0.0
Ahmedpur,Safflower,2015,2520,2520,0,0.0
Ahmedpur,Safflower,2015,2451,2451,0,0.0
Ahmedpur,Safflower,2015,2300,2300,0,0.0
Ahmedpur,Safflower,2015,2175,2175,0,0.0
Ahmedpur,Safflower,2015,2376,2376,0,0.0
Ahmedpur,Rice(Paddy-Hus),2015,1631,1631,0,0.0
Ahmedpur,Paddy-Unhusked,2015,1410,1410,0,0.0
Ahmedpur,Paddy-Unhusked,2015,1360,1360,0,0.0
Dondaicha,Ground Nut Pods (Dry),2016,5193,5193,0,0.0
Dondaicha,Green Gram,2016,5200,5200,0,0.0
Dondaicha,Cotton,2014,4050,4050,0,0.0
Dondaicha,Green Gram,2016,6300,6300,0,0.0
Dondaicha,Matki,2014,6612,6612,0,0.0
Dondaicha,Matki,2014,6356,6356,0,0.0
Ahmedpur,Sesamum,2015,7310,7310,0,0.0
Wardha,Green Gram,2016,5900,5900,0,0.0
Dondaicha,Black Gram,2015,10001,10001,0,0.0
Dondaicha,Black Gram,2015,8563,8563,0,0.0
Dondaicha,Black Gram,2015,7701,7701,0,0.0
Dondaicha,Green Gram,2015,6404,6404,0,0.0
Dondaicha,Matki,2015,7709,7709,0,0.0
Dondaicha,Matki,2015,7063,7063,0,0.0
Dondaicha,Matki,2015,8000,8000,0,0.0
Dondaicha,Pigeon Pea (Tur),2015,5212,5212,0,0.0
Dondaicha,Pigeon Pea (Tur),2015,5250,5250,0,0.0
Dondaicha,Pigeon Pea (Tur),2015,7351,7351,0,0.0
Dondaicha,Soybean,2015,3701,3701,0,0.0
Dondaicha,BLACK GRAM,2016,5001,5001,0,0.0
Dondaicha,Cowpea,2016,5351,5351,0,0.0
Ahmedpur,Sunflower,2015,3750,3750,0,0.0
Ahmedpur,Sunflower,2015,3219,3219,0,0.0
Digras,Sesamum,2015,7044,7044,0,0.0
Dhule,Horse Gram,2015,1953,1953,0,0.0
Dhule,Horse Gram,2015,2951,2951,0,0.0
Dhule,Horse Gram,2015,3010,3010,0,0.0
Dhule,Horse Gram,2015,1500,1500,0,0.0
Dhule,Horse Gram,2015,4000,4000,0,0.0
Dhule,Horse Gram,2015,1730,1730,0,0.0
Dhule,Horse Gram,2015,3803,3803,0,0.0
Dhule,Matki,2015,5855,5855,0,0.0
Dhule,Matki,2015,5864,5864,0,0.0
Dhule,Sesamum,2015,8104,8104,0,0.0
Dhule,Sesamum,2015,7238,7238,0,0.0
Dhule,Sesamum,2015,9108,9108,0,0.0
Dhule,Sesamum,2015,7500,7500,0,0.0
Dhule,Sesamum,2015,7850,7850,0,0.0
Ahmedpur,Coriander (Dry),2016,6100,6100,0,0.0
Ahmedpur,Black Gram,2016,6850,6850,0,0.0
Dhule,Sesamum,2015,7025,7025,0,0.0
Ahmedpur,Bajri,2016,1351,1351,0,0.0
Ahmedpur,GRAM,2016,9200,9200,0,0.0
Dhule,Cowpea,2015,3753,3753,0,0.0
Digras,Sesamum,2015,9600,9600,0,0.0
Dhule,Cowpea,2015,3798,3798,0,0.0
Dhule,Castor Seed,2014,3275,3275,0,0.0
Dhule,Cowpea,2014,3971,3971,0,0.0
Dhule,Black Gram,2015,6100,6100,0,0.0
Dhule,Black Gram,2015,4788,4788,0,0.0
Dhule,Black Gram,2015,8080,8080,0,0.0
Dhule,Black Gram,2015,6487,6487,0,0.0
Dhule,Black Gram,2015,5913,5913,0,0.0
Dhule,Castor Seed,2015,3250,3250,0,0.0
Ahmedpur,Green Gram,2016,6952,6952,0,0.0
Ahmedpur,Green Gram,2016,5850,5850,0,0.0
Ahmedpur,Green Gram,2016,5201,5201,0,0.0
Ahmedpur,Green Gram,2016,5451,5451,0,0.0
Ahmedpur,Gram,2016,7374,7374,0,0.0
Ahmedpur,Gram,2016,5500,5500,0,0.0
Dhule,Castor Seed,2015,3110,3110,0,0.0
Dhule,Castor Seed,2015,3135,3135,0,0.0
Dhule,Cowpea,2015,3005,3005,0,0.0
Ahmedpur,Bajri,2016,1540,1540,0,0.0
Ahmedpur,Bajri,2016,1425,1425,0,0.0
Ahmedpur,Bajri,2016,1341,1341,0,0.0
Ahmedpur,Tamarind Seed,2015,1522,1522,0,0.0
Dhule,Sesamum,2016,8401,8401,0,0.0
Digras,Bajri,2015,1325,1325,0,0.0
Digras,Bajri,2015,2105,2105,0,0.0
Digras,Batbati,2015,4900,4900,0,0.0
Digras,Black Gram,2015,8678,8678,0,0.0
Digras,Black Gram,2015,6655,6655,0,0.0
Digras,Cotton,2015,4100,4100,0,0.0
Digras,Cotton,2015,4084,4084,0,0.0
Digras,Gram,2015,3593,3593,0,0.0
Digras,Gram,2015,3923,3923,0,0.0
Digras,Gram,2015,3658,3658,0,0.0
Digras,Green Gram,2015,6000,6000,0,0.0
Digras,Green Gram,2015,7417,7417,0,0.0
Digras,Pigeon Pea (Tur),2015,7764,7764,0,0.0
Digras,Sesamum,2015,6830,6830,0,0.0
Digras,Sesamum,2015,5642,5642,0,0.0
Digras,Sesamum,2015,7605,7605,0,0.0
Dhule,SESAMUM,2016,4000,4000,0,0.0
Dhule,Matki,2016,4925,4925,0,0.0
Dhule,Matki,2016,5300,5300,0,0.0
Dhule,Castor Seed,2016,2925,2925,0,0.0
Dhule,Sesamum,2015,5800,5800,0,0.0
Ahmedpur,Tamarind Seed,2015,1500,1500,0,0.0
Dhule,Black Gram,2016,8600,8600,0,0.0
Dhule,Black Gram,2016,8040,8040,0,0.0
Dhule,Black Gram,2016,11000,11000,0,0.0
Dhule,COWPEA,2016,2750,2750,0,0.0
Dhule,Castor Seed,2016,2720,2720,0,0.0
Dhule,Castor Seed,2016,2850,2850,0,0.0
Ahmedpur,Tamarind,2015,2001,2001,0,0.0
Ahmedpur,Tamarind Seed,2015,1300,1300,0,0.0
Dhule,Cowpea,2016,1900,1900,0,0.0
Dhule,Cowpea,2016,4160,4160,0,0.0
Dhule,Green Gram,2016,6900,6900,0,0.0
Dhule,Green Gram,2016,5568,5568,0,0.0
Dhule,Horse Gram,2016,2800,2800,0,0.0
Dhule,Horse Gram,2016,4700,4700,0,0.0
Daryapur,Sorgum(Jawar),2016,1800,1800,0,0.0
Daryapur,Sorgum(Jawar),2016,1523,1523,0,0.0
Akhadabalapur,Sorgum(Jawar),2016,1500,1500,0,0.0
Akluj,Pigeon Pea (Tur),2015,4600,4600,0,0.0
Washim-Ansing,Black Gram,2016,10000,10000,0,0.0
Chandrapur,Kharbuj,2014,1800,1800,0,0.0
Chandrapur,Pigeon Pea (Tur),2014,4495,4495,0,0.0
Akluj,Maize,2015,1551,1551,0,0.0
Chandrapur,Horse Gram,2015,2398,2398,0,0.0
Akluj,Maize,2015,1505,1505,0,0.0
Chandrapur,Indian Bean,2015,2200,2200,0,0.0
Akluj,Maize,2015,1487,1487,0,0.0
Vaijapur,Green Gram,2016,5000,5000,0,0.0
Vaijapur,Green Gram,2016,6300,6300,0,0.0
Vaijapur,Green Gram,2016,6567,6567,0,0.0
Vaijapur,Green Gram,2016,6800,6800,0,0.0
Vaijapur,Green Gram,2016,6196,6196,0,0.0
Akluj,Lemon,2015,1,1,0,0.0
Vaijapur,Green Gram,2016,5620,5620,0,0.0
Vaijapur,Green Gram,2016,6600,6600,0,0.0
Akluj,Lemon,2015,1,1,0,0.0
Washim-Ansing,Black Gram,2016,9883,9883,0,0.0
Chandrapur,Cotton,2014,4035,4035,0,0.0
Akluj,Lemon,2015,1,1,0,0.0
Vaijapur,Ground Nut Pods (Dry),2016,5550,5550,0,0.0
Vaijapur,Horse Gram,2016,2257,2257,0,0.0
Vaijapur,Horse Gram,2016,3317,3317,0,0.0
Vaijapur,Horse Gram,2016,3780,3780,0,0.0
Vaijapur,Horse Gram,2016,3528,3528,0,0.0
Vaijapur,Horse Gram,2016,3322,3322,0,0.0
Vaijapur,Horse Gram,2016,3400,3400,0,0.0
Vaijapur,Horse Gram,2016,3200,3200,0,0.0
Chakur,Sorgum(Jawar),2016,2208,2208,0,0.0
Chakur,Sorgum(Jawar),2016,1701,1701,0,0.0
Akluj,Sorgum(Jawar),2015,1918,1918,0,0.0
Akluj,Sorgum(Jawar),2015,1411,1411,0,0.0
Akluj,Sorgum(Jawar),2015,1750,1750,0,0.0
Akluj,Sorgum(Jawar),2015,1700,1700,0,0.0
Akluj,Sorgum(Jawar),2015,1622,1622,0,0.0
Vaijapur,Ground Nut Pods (Dry),2016,5800,5800,0,0.0
Vaijapur,Ground Nut Pods (Dry),2016,5742,5742,0,0.0
Vaijapur,Ground Nut Pods (Dry),2016,6112,6112,0,0.0
Akluj,Lemon,2015,1,1,0,0.0
Akluj,Ground Nut Pods (Dry),2015,4100,4100,0,0.0
Daryapur,Sesamum,2016,4200,4200,0,0.0
Chandur Rly.,Green Gram,2014,6500,6500,0,0.0
Vaijapur,Castor Seed,2016,2860,2860,0,0.0
Vaijapur,Castor Seed,2016,2709,2709,0,0.0
Vaijapur,Castor Seed,2016,2358,2358,0,0.0
Vaijapur,Castor Seed,2016,2672,2672,0,0.0
Vaijapur,Castor Seed,2016,2809,2809,0,0.0
Vaijapur,Castor Seed,2016,2388,2388,0,0.0
Vaijapur,Castor Seed,2016,2825,2825,0,0.0
Vaijapur,Castor Seed,2016,4167,4167,0,0.0
Vaijapur,COWPEA,2016,5052,5052,0,0.0
Vaijapur,CASTOR SEED,2016,2700,2700,0,0.0
Vaijapur,Black Gram,2016,13100,13100,0,0.0
Vaijapur,Black Gram,2016,7081,7081,0,0.0
Chandur Rly.,Cotton,2015,3950,3950,0,0.0
Chandur Rly.,Gram,2015,4000,4000,0,0.0
Chandur Rly.,Gram,2015,3576,3576,0,0.0
Chandur Rly.,Gram,2015,3302,3302,0,0.0
Akluj,Bajri,2014,1351,1351,0,0.0
Chandur Rly.,Sorgum(Jawar),2014,1550,1550,0,0.0
Vaijapur,Cowpea,2016,4752,4752,0,0.0
Akluj,Ground Nut Pods (Dry),2015,3250,3250,0,0.0
Vaijapur,Cowpea,2016,4514,4514,0,0.0
Akluj,Gram,2015,3913,3913,0,0.0
Akluj,Gram,2015,4000,4000,0,0.0
Akluj,Bajri,2015,1401,1401,0,0.0
Akluj,Bajri,2015,1330,1330,0,0.0
Akluj,Bajri,2015,1383,1383,0,0.0
Akluj,Bajri,2015,1100,1100,0,0.0
Kannad,Gram,2014,2300,2300,0,0.0
Akluj,Soybean,2014,3205,3205,0,0.0
Akluj,Sorgum(Jawar),2014,2126,2126,0,0.0
Akluj,Gram,2014,2335,2335,0,0.0
Chandur Rly.,Cotton,2014,3950,3950,0,0.0
Akluj,Gram,2014,2363,2363,0,0.0
Vaijapur,Fenugreek,2016,5500,5500,0,0.0
Vaijapur,Cowpea,2016,2200,2200,0,0.0
Akluj,Gram,2014,2226,2226,0,0.0
Vaijapur,Cowpea,2016,2030,2030,0,0.0
Vaijapur,Cowpea,2016,1800,1800,0,0.0
Vaijapur,Horse Gram,2016,2701,2701,0,0.0
Chakur,Sorgum(Jawar),2016,2026,2026,0,0.0
Akluj,Sorgum(Jawar),2015,2005,2005,0,0.0
Akluj,Maize,2016,1458,1458,0,0.0
Vaijapur,Sesamum,2016,6301,6301,0,0.0
Vaijapur,Safflower,2016,2497,2497,0,0.0
Vaijapur,Safflower,2016,2884,2884,0,0.0
Vaijapur,Safflower,2016,2800,2800,0,0.0
Vaijapur,Safflower,2016,3000,3000,0,0.0
Vaijapur,Safflower,2016,2470,2470,0,0.0
Vaijapur,Safflower,2016,2850,2850,0,0.0
Bhusaval,WHEAT(HUSKED),2016,1790,1790,0,0.0
Akluj,Ground Nut Pods (Dry),2016,4000,4000,0,0.0
Bhusaval,Wheat(Husked),2016,1389,1389,0,0.0
Biloli,Soybean,2016,3600,3600,0,0.0
Vaijapur,SAFFLOWER,2016,2600,2600,0,0.0
Vaijapur,Pigeon Pea (Tur),2016,4800,4800,0,0.0
Bodwad-Varangaon,Gram,2016,4000,4000,0,0.0
Akluj,Gram,2016,6600,6600,0,0.0
Akluj,Gram,2016,5100,5100,0,0.0
Bodwad-Varangaon,Maize,2016,1181,1181,0,0.0
Vaijapur,Sesamum,2016,8501,8501,0,0.0
Akluj,Maize,2016,1700,1700,0,0.0
Chakur,Sorgum(Jawar),2016,1983,1983,0,0.0
Akluj,Maize,2016,1678,1678,0,0.0
Vaijapur,Soybean,2016,3325,3325,0,0.0
Vaijapur,Soybean,2016,3506,3506,0,0.0
Akluj,Wheat(Husked),2016,1651,1651,0,0.0
Akluj,Wheat(Husked),2016,1811,1811,0,0.0
Vaijapur,Soybean,2016,3543,3543,0,0.0
Vaijapur,Soybean,2016,3665,3665,0,0.0
Bhusaval,MAIZE,2016,1150,1150,0,0.0
Akluj,Wheat(Husked),2016,2260,2260,0,0.0
Akluj,Wheat(Husked),2016,2005,2005,0,0.0
Bhusaval,Maize,2016,1275,1275,0,0.0
Bhusaval,Maize,2016,1600,1600,0,0.0
Bhusaval,Maize,2016,1200,1200,0,0.0
Bhusaval,Maize,2016,1050,1050,0,0.0
Bhusaval,Pigeon Pea (Tur),2016,6000,6000,0,0.0
Bhusaval,Pigeon Pea (Tur),2016,7000,7000,0,0.0
Akluj,Sorgum(Jawar),2016,1601,1601,0,0.0
Akluj,Pigeon Pea (Tur),2016,7702,7702,0,0.0
Bodwad-Varangaon,Maize,2016,1146,1146,0,0.0
Bodwad-Varangaon,Wheat(Husked),2016,1463,1463,0,0.0
Bori,BAJRI,2016,1500,1500,0,0.0
Bori,Gram,2016,7901,7901,0,0.0
Vaijapur,Matki,2016,5827,5827,0,0.0
Vaijapur,Matki,2016,6560,6560,0,0.0
Vaijapur,Matki,2016,6500,6500,0,0.0
Vaijapur,Matki,2016,8300,8300,0,0.0
Vaijapur,Matki,2016,7121,7121,0,0.0
Vaijapur,Matki,2016,4600,4600,0,0.0
Akluj,Wheat(Husked),2015,1617,1617,0,0.0
Akluj,Wheat(Husked),2015,1528,1528,0,0.0
Akluj,Soybean,2015,3200,3200,0,0.0
Chakur,Green Gram,2016,5100,5100,0,0.0
Chakur,Guvar,2016,1350,1350,0,0.0
Chakur,PIGEON PEA (TUR),2016,5491,5491,0,0.0
Chakur,Punvad,2016,2657,2657,0,0.0
Chakur,SORGUM(JAWAR),2016,2451,2451,0,0.0
Chakur,Sorgum(Jawar),2016,1670,1670,0,0.0
Chakur,Sorgum(Jawar),2016,1988,1988,0,0.0
Vaijapur,MATKI,2016,5650,5650,0,0.0
Vaijapur,Mustard,2016,4351,4351,0,0.0
Vaijapur,Mustard,2016,4000,4000,0,0.0
Vaijapur,Mustard,2016,3450,3450,0,0.0
Akluj,Bajri,2016,1600,1600,0,0.0
Bori,PIGEON PEA (TUR),2016,4375,4375,0,0.0
Bori,SAFFLOWER,2016,2200,2200,0,0.0
Bori,Safflower,2016,2300,2300,0,0.0
Bori,Soybean,2016,3300,3300,0,0.0
Bori,WHEAT(HUSKED),2016,1721,1721,0,0.0
Bori Arab,Pigeon Pea (Tur),2015,7500,7500,0,0.0
Akluj,Bajri,2016,1646,1646,0,0.0
Bori Arab,Soybean,2016,3600,3600,0,0.0
Vaijapur,Mustard,2016,3498,3498,0,0.0
Chakur,Gram,2015,4049,4049,0,0.0
Chakur,BAJRI,2016,1363,1363,0,0.0
Akluj,Wheat(Husked),2015,1508,1508,0,0.0
Chakur,BLACK GRAM,2016,6330,6330,0,0.0
Vaijapur,Mustard,2016,3800,3800,0,0.0
Vaijapur,Mustard,2016,3497,3497,0,0.0
Vaijapur,Mustard,2016,4400,4400,0,0.0
Chandur Rly.,Gram,2015,4000,4000,0,0.0
Chandur Rly.,Gram,2015,4126,4126,0,0.0
Chandur Rly.,Pigeon Pea (Tur),2015,6000,6000,0,0.0
Vaijapur,Cowpea,2015,5126,5126,0,0.0
Vaijapur,Cowpea,2015,2625,2625,0,0.0
Vaijapur,Cowpea,2015,4100,4100,0,0.0
Vaijapur,Cowpea,2015,4196,4196,0,0.0
Chopda,Gram,2016,4093,4093,0,0.0
Akhadabalapur,Wheat(Husked),2016,1800,1800,0,0.0
Akhadabalapur,Wheat(Husked),2016,1800,1800,0,0.0
Akhadabalapur,Sorgum(Jawar),2016,1685,1685,0,0.0
Chopda,Gram,2016,7803,7803,0,0.0
Vaijapur,Castor Seed,2015,3267,3267,0,0.0
Akhadabalapur,Sorgum(Jawar),2016,1500,1500,0,0.0
Vaijapur,Black Gram,2015,9400,9400,0,0.0
Chopda,Green Gram,2016,6133,6133,0,0.0
Chopda,Green Gram,2016,6234,6234,0,0.0
Chopda,Green Gram,2016,5198,5198,0,0.0
Chopda,Green Gram,2016,4000,4000,0,0.0
Chopda,Ground Nut Pods (Dry),2016,4444,4444,0,0.0
Chopda,Ground Nut Pods (Dry),2016,5125,5125,0,0.0
Vaijapur,Cowpea,2015,5000,5000,0,0.0
Vaijapur,Fenugreek,2015,5501,5501,0,0.0
Vaijapur,Ground Nut Pods (Dry),2015,3067,3067,0,0.0
Chopda,GRAM,2016,5701,5701,0,0.0
Akkolkot,Bajri,2014,1350,1350,0,0.0
Akhadabalapur,Wheat(Husked),2016,1800,1800,0,0.0
Vaijapur,Green Peas (Dry),2015,1800,1800,0,0.0
Vaijapur,Green Gram,2015,8147,8147,0,0.0
Vaijapur,Green Gram,2015,6900,6900,0,0.0
Vaijapur,Green Gram,2015,8147,8147,0,0.0
Vaijapur,Green Gram,2015,6750,6750,0,0.0
Akhadabalapur,Wheat(Husked),2016,1800,1800,0,0.0
Akhadabalapur,Wheat(Husked),2016,1800,1800,0,0.0
Vaijapur,Green Gram,2015,6650,6650,0,0.0
Vaijapur,Green Gram,2015,7300,7300,0,0.0
Vaijapur,Green Gram,2015,7382,7382,0,0.0
Chopda,Black Gram,2016,8301,8301,0,0.0
Chopda,Black Gram,2016,7000,7000,0,0.0
Chopda,Black Gram,2016,8115,8115,0,0.0
Chopda,Black Gram,2016,10420,10420,0,0.0
Chopda,Black Gram,2016,9608,9608,0,0.0
Chopda,Ground Nut Pods (Dry),2016,4500,4500,0,0.0
Chopda,Maize,2016,1500,1500,0,0.0
Chopda,Pigeon Pea (Tur),2016,7213,7213,0,0.0
Chopda,Pigeon Pea (Tur),2016,5901,5901,0,0.0
Daryapur,Sesamum,2015,8800,8800,0,0.0
Daryapur,Sesamum,2015,6100,6100,0,0.0
Daryapur,Sesamum,2015,6801,6801,0,0.0
Vaijapur,Green Gram,2014,6256,6256,0,0.0
Vaijapur,Green Gram,2014,7466,7466,0,0.0
Daryapur,Sorgum(Jawar),2015,1170,1170,0,0.0
Daryapur,Sorgum(Jawar),2015,1066,1066,0,0.0
Daryapur,Sorgum(Jawar),2015,1501,1501,0,0.0
Daryapur,Sunflower,2015,3036,3036,0,0.0
Daryapur,Sunflower,2015,2700,2700,0,0.0
Vaijapur,Cowpea,2014,3600,3600,0,0.0
Vaijapur,Cowpea,2014,4100,4100,0,0.0
Daryapur,Thymol/Lovage,2015,7500,7500,0,0.0
Vaijapur,Black Gram,2014,3800,3800,0,0.0
Daryapur,Wheat(Husked),2015,1475,1475,0,0.0
Daryapur,Safflower,2016,2100,2100,0,0.0
Daryapur,Sesamum,2016,4500,4500,0,0.0
Daryapur,Safflower,2015,2100,2100,0,0.0
Daryapur,Safflower,2015,2412,2412,0,0.0
Akhadabalapur,Sorgum(Jawar),2016,1500,1500,0,0.0
Chopda,Soybean,2016,2826,2826,0,0.0
Chopda,Pigeon Pea (Tur),2016,6925,6925,0,0.0
Chopda,Sesamum,2016,5291,5291,0,0.0
Vaijapur,Soybean,2014,2824,2824,0,0.0
Vaijapur,Soybean,2014,3167,3167,0,0.0
Vaijapur,Sorgum(Jawar),2014,1411,1411,0,0.0
Chopda,Sesamum,2016,4827,4827,0,0.0
Chopda,Sesamum,2016,5976,5976,0,0.0
Vaijapur,Safflower,2014,2500,2500,0,0.0
Vaijapur,Mustard,2014,3500,3500,0,0.0
Vaijapur,Pigeon Pea (Tur),2014,3675,3675,0,0.0
Vaijapur,Pigeon Pea (Tur),2014,3350,3350,0,0.0
Vaijapur,Pigeon Pea (Tur),2014,3300,3300,0,0.0
Vaijapur,Pigeon Pea (Tur),2014,3000,3000,0,0.0
Akhadabalapur,Sorgum(Jawar),2016,1500,1500,0,0.0
Chopda,Sunflower,2016,3173,3173,0,0.0
Chopda,Sunflower,2016,2796,2796,0,0.0
Vaijapur,Ground Nut Pods (Dry),2015,6122,6122,0,0.0
Akkolkot,Gram,2014,2700,2700,0,0.0
Chandur Rly.,Sorgum(Jawar),2015,1600,1600,0,0.0
Vaijapur,Sunflower,2015,3800,3800,0,0.0
Vaijapur,Soybean,2015,2888,2888,0,0.0
Vaijapur,Soybean,2015,3515,3515,0,0.0
Akkolkot,Paddy-Unhusked,2015,2000,2000,0,0.0
Akkolkot,Maize,2015,1585,1585,0,0.0
Chandur Rly.,Wheat(Husked),2016,1661,1661,0,0.0
Chandvad,Cucumber,2016,1000,1000,0,0.0
Chandvad,Ladies Finger,2016,3186,3186,0,0.0
Chandvad,Ladies Finger,2016,2550,2550,0,0.0
Akkolkot,Green Gram,2015,6800,6800,0,0.0
Chandvad,Math (Bhaji),2016,2,2,0,0.0
Chikhali,Green Gram,2015,4900,4900,0,0.0
Chikhali,Green Gram,2016,6000,6000,0,0.0
Akkolkot,Bajri,2015,1635,1635,0,0.0
Chikhali,Mustard,2016,3601,3601,0,0.0
Vaijapur,Sesamum,2015,9401,9401,0,0.0
Vaijapur,Sesamum,2015,9301,9301,0,0.0
Vaijapur,Safflower,2015,2763,2763,0,0.0
Vaijapur,Soybean,2015,3299,3299,0,0.0
Vaijapur,Sunflower,2015,2767,2767,0,0.0
Vaijapur,Ground Nut Pods (Dry),2015,3950,3950,0,0.0
Vaijapur,Tamarind,2015,300,300,0,0.0
Akkolkot,Sesamum,2016,5000,5000,0,0.0
Akkolkot,Maize,2016,1400,1400,0,0.0
Akkolkot,MAIZE,2016,1238,1238,0,0.0
Akkolkot,Gram,2016,9400,9400,0,0.0
Akkolkot,Cowpea,2016,3561,3561,0,0.0
Akkolkot,Black Gram,2016,10600,10600,0,0.0
Vaijapur,BLACK GRAM,2016,5365,5365,0,0.0
Chandur Rly.,Wheat(Husked),2015,1501,1501,0,0.0
Akkolkot,BAJRI,2016,1438,1438,0,0.0
Akkolkot,Wheat(Unhusked),2015,4045,4045,0,0.0
Chandur Rly.,GRAM,2016,7500,7500,0,0.0
Akkolkot,Wheat(Husked),2015,1450,1450,0,0.0
Chandur Rly.,Gram,2016,4079,4079,0,0.0
Chandur Rly.,Gram,2016,5506,5506,0,0.0
Chandur Rly.,WHEAT(HUSKED),2016,1850,1850,0,0.0
Akkolkot,Pigeon Pea (Tur),2015,9410,9410,0,0.0
Vaijapur,Tamarind,2015,1104,1104,0,0.0
Vaijapur,Safflower,2015,2650,2650,0,0.0
Vaijapur,Safflower,2015,2564,2564,0,0.0
Vaijapur,Safflower,2015,2600,2600,0,0.0
Vaijapur,Pigeon Pea (Tur),2015,8285,8285,0,0.0
Vaijapur,Mustard,2015,3411,3411,0,0.0
Vaijapur,Mustard,2015,3784,3784,0,0.0
Vaijapur,Mustard,2015,3670,3670,0,0.0
Vaijapur,Matki,2015,6000,6000,0,0.0
Vaijapur,Matki,2015,7930,7930,0,0.0
Chopda,Ground Nut Pods (Dry),2015,4375,4375,0,0.0
Akkolkot,Bajri,2015,1451,1451,0,0.0
Chopda,Pigeon Pea (Tur),2015,4076,4076,0,0.0
Chopda,Pigeon Pea (Tur),2015,4100,4100,0,0.0
Akkolkot,Maize,2014,1201,1201,0,0.0
Akkolkot,Green Gram,2014,7200,7200,0,0.0
Vaijapur,Lentil,2015,3300,3300,0,0.0
Vaijapur,Horse Gram,2015,3456,3456,0,0.0
Vaijapur,Horse Gram,2015,3706,3706,0,0.0
Vaijapur,Horse Gram,2015,3610,3610,0,0.0
Vaijapur,Horse Gram,2015,3554,3554,0,0.0
Vaijapur,Ground Nut Pods (Dry),2015,6214,6214,0,0.0
Vaijapur,Mustard,2015,3750,3750,0,0.0
Vaijapur,Mustard,2015,3690,3690,0,0.0
Chopda,Ground Nut Pods (Dry),2015,4222,4222,0,0.0
Chopda,Black Gram,2015,8351,8351,0,0.0
Vaijapur,Pigeon Pea (Tur),2015,7907,7907,0,0.0
Vaijapur,Pigeon Pea (Tur),2015,5622,5622,0,0.0
Vaijapur,Pigeon Pea (Tur),2015,5847,5847,0,0.0
Vaijapur,Pigeon Pea (Tur),2015,3696,3696,0,0.0
Chopda,Ground Nut Pods (Dry),2014,3595,3595,0,0.0
Chopda,Sesamum,2014,10400,10400,0,0.0
Chopda,Sunflower,2014,2650,2650,0,0.0
Chopda,Black Gram,2015,4492,4492,0,0.0
Chopda,Ground Nut Pods (Dry),2015,3800,3800,0,0.0
Chopda,Black Gram,2015,5411,5411,0,0.0
Chopda,Gram,2015,4751,4751,0,0.0
Chopda,Gram,2015,3164,3164,0,0.0
Chopda,Green Gram,2015,5400,5400,0,0.0
Chopda,Green Gram,2015,5000,5000,0,0.0
Chopda,Green Gram,2015,5226,5226,0,0.0
Chopda,Ground Nut Pods (Dry),2015,4500,4500,0,0.0
Kannad,Black Gram,2014,4250,4250,0,0.0
Khed (Shel Pimpalgaon),Flower,2015,600,600,0,0.0
Kannad,Gram,2014,2500,2500,0,0.0
Rahata,Green Gram,2014,7655,7655,0,0.0
Rahata,Beet Root,2014,2250,2250,0,0.0
Rahata,Carrot,2014,1500,1500,0,0.0
Rahata,Carrot,2014,1750,1750,0,0.0
Rahata,Cluster Bean,2014,4500,4500,0,0.0
Solapur,Maize,2015,1411,1411,0,0.0
Rahata,Cluster Bean,2014,3000,3000,0,0.0
Rahata,Coriander  ,2014,5,5,0,0.0
Rahata,Ghevda,2014,2500,2500,0,0.0
Rahata,Ghevda,2014,2500,2500,0,0.0
Rahata,Green Gram,2014,5500,5500,0,0.0
Pusad,Split Gram,2016,6000,6000,0,0.0
Rahata,Green Gram,2014,5925,5925,0,0.0
Rahata,Green Peas (Dry),2014,4000,4000,0,0.0
Rahata,Ground Nut Pods (Dry),2014,4000,4000,0,0.0
Rahata,Ground Nut Pods (Dry),2014,4000,4000,0,0.0
Rahata,Ground Nut Pods (Dry),2014,5000,5000,0,0.0
Rahata,Lemon,2014,4250,4250,0,0.0
Rahata,Lemon,2014,3100,3100,0,0.0
Rahata,Maize,2014,900,900,0,0.0
Rahata,Maize,2014,1475,1475,0,0.0
Pusad,Sunflower,2016,4805,4805,0,0.0
Pusad,Spilt Pigeon Pea,2016,9625,9625,0,0.0
Rahata,Shepu,2014,10,10,0,0.0
Pusad,Black Gram,2016,9875,9875,0,0.0
Pusad,Bajri,2016,1990,1990,0,0.0
Pusad,Batbati,2016,4893,4893,0,0.0
Pusad,Batbati,2016,4200,4200,0,0.0
Pusad,Batbati,2016,5700,5700,0,0.0
Pusad,Batbati,2016,5300,5300,0,0.0
Pusad,Batbati,2016,5100,5100,0,0.0
Pusad,Black Gram,2016,4465,4465,0,0.0
Pusad,Black Gram,2016,9025,9025,0,0.0
Pusad,Black Gram,2016,10910,10910,0,0.0
Pusad,Green Gram,2016,6103,6103,0,0.0
Pusad,Spilt Pigeon Pea,2016,12700,12700,0,0.0
Pusad,Green Gram,2016,7000,7000,0,0.0
Pusad,Green Gram,2016,6237,6237,0,0.0
Pusad,Maize,2016,1514,1514,0,0.0
Pusad,Rice(Paddy-Hus),2016,960,960,0,0.0
Pusad,Rice(Paddy-Hus),2016,700,700,0,0.0
Pusad,SESAMUM,2016,5305,5305,0,0.0
Solapur,Matki,2015,7700,7700,0,0.0
Pusad,Sesamum,2016,6380,6380,0,0.0
Pusad,Spilt Pigeon Pea,2016,9100,9100,0,0.0
Rahata,Pigeon Pea (Tur),2014,3050,3050,0,0.0
Rahata,Shevga,2014,3417,3417,0,0.0
Pusad,Split Black Gram,2015,9105,9105,0,0.0
Rahata,Dhemse,2015,1300,1300,0,0.0
Rahata,Carrot,2015,2436,2436,0,0.0
Rahata,Cluster Bean,2015,4000,4000,0,0.0
Rahata,Cluster Bean,2015,2083,2083,0,0.0
Rahata,Cluster Bean,2015,6750,6750,0,0.0
Rahata,Cluster Bean,2015,3500,3500,0,0.0
Rahata,Cluster Bean,2015,3000,3000,0,0.0
Solapur,Green Gram,2015,7001,7001,0,0.0
Solapur,Green Gram,2015,7279,7279,0,0.0
Rahata,Curry Leaves,2015,10,10,0,0.0
Rahata,Ghevda,2015,3423,3423,0,0.0
Rahata,Carrot,2015,1929,1929,0,0.0
Rahata,Ghevda,2015,2800,2800,0,0.0
Rahata,Ghevda,2015,6000,6000,0,0.0
Rahata,Ghevda,2015,3786,3786,0,0.0
Rahata,Ghevda,2015,3225,3225,0,0.0
Solapur,Grapes,2015,57,57,0,0.0
Rahata,Ghevda,2015,3000,3000,0,0.0
Rahata,Green Gram,2015,8200,8200,0,0.0
Rahata,Green Gram,2015,6400,6400,0,0.0
Rahata,Ground Nut Pods (Dry),2015,4000,4000,0,0.0
Rahata,Carrot,2015,2000,2000,0,0.0
Rahata,Carrot,2015,2625,2625,0,0.0
Rahata,Shevga,2014,4000,4000,0,0.0
Rahata,Beet Root,2015,1350,1350,0,0.0
Rahata,Small Gourd,2014,1500,1500,0,0.0
Rahata,Small Gourd,2014,1600,1600,0,0.0
Rahata,Small Gourd,2014,1800,1800,0,0.0
Rahata,Soybean,2014,3300,3300,0,0.0
Rahata,Sweet Potato,2014,3000,3000,0,0.0
Rahata,Walvad,2014,2150,2150,0,0.0
Rahata,Walvad,2014,3467,3467,0,0.0
Rahata,Beet Root,2015,1800,1800,0,0.0
Rahata,Beet Root,2015,1000,1000,0,0.0
Rahata,Beet Root,2015,2500,2500,0,0.0
Rahata,Carrot,2015,3045,3045,0,0.0
Rahata,Bitter Gourd,2015,3000,3000,0,0.0
Rahata,Bitter Gourd,2015,2000,2000,0,0.0
Rahata,Bitter Gourd,2015,3000,3000,0,0.0
Rahata,Bor,2015,2500,2500,0,0.0
Solapur,Guava,2015,750,750,0,0.0
Solapur,Ground Nut Pods (Dry),2015,5325,5325,0,0.0
Solapur,Ground Nut Pods (Dry),2015,4683,4683,0,0.0
Solapur,Ground Nut Pods (Dry),2015,5150,5150,0,0.0
Solapur,Ground Nut Pods (Dry),2015,4500,4500,0,0.0
Pusad,Split Gram,2015,5050,5050,0,0.0
Pusad,Spilt Pigeon Pea,2015,13500,13500,0,0.0
Pune-Pimpri,Ginger (Dry),2016,3500,3500,0,0.0
Purna,Sorgum(Jawar),2014,1022,1022,0,0.0
Pune-Pimpri,Wal Papdi,2016,2200,2200,0,0.0
Pune-Pimpri,Wal Papdi,2016,1608,1608,0,0.0
Pune-Pimpri,Wal Papdi,2016,3000,3000,0,0.0
Pune-Pimpri,Walvad,2016,2200,2200,0,0.0
Purna,Gram,2014,2100,2100,0,0.0
Purna,Green Gram,2014,6700,6700,0,0.0
Purna,Ground Nut Pods (Dry),2014,3700,3700,0,0.0
Purna,Pigeon Pea (Tur),2014,4200,4200,0,0.0
Purna,Sorgum(Jawar),2014,1038,1038,0,0.0
Purna,Sorgum(Jawar),2014,1077,1077,0,0.0
Pune-Pimpri,Shevga,2016,4750,4750,0,0.0
Purna,Turmeric,2014,4900,4900,0,0.0
Purna,Wheat(Husked),2014,1498,1498,0,0.0
Purna,Wheat(Husked),2014,1494,1494,0,0.0
Purna,Wheat(Husked),2014,1476,1476,0,0.0
Purna,Black Gram,2015,7666,7666,0,0.0
Purna,Castor Seed,2015,3221,3221,0,0.0
Purna,Castor Seed,2015,3090,3090,0,0.0
Purna,Cotton,2015,4100,4100,0,0.0
Purna,Gram,2015,3817,3817,0,0.0
Pune-Pimpri,Shevga,2016,1800,1800,0,0.0
Pune-Pimpri,Shevga,2016,3000,3000,0,0.0
Purna,Gram,2015,4000,4000,0,0.0
Pune-Pimpri,Ground Nut Pods (Dry),2016,3750,3750,0,0.0
Pune-Pimpri,Ginger (Dry),2016,3350,3350,0,0.0
Pune-Pimpri,Ginger (Fresh),2016,3000,3000,0,0.0
Pune-Pimpri,Ginger (Fresh),2016,6000,6000,0,0.0
Pune-Pimpri,Ginger (Fresh),2016,3500,3500,0,0.0
Pune-Pimpri,Ginger (Fresh),2016,3500,3500,0,0.0
Pune-Pimpri,Ginger (Fresh),2016,6000,6000,0,0.0
Pune-Pimpri,Green Chilli,2016,4000,4000,0,0.0
Pune-Pimpri,Green Chilli,2016,6750,6750,0,0.0
Pune-Pimpri,Ground Nut Pods (Dry),2016,5000,5000,0,0.0
Pune-Pimpri,Ground Nut Pods (Dry),2016,3500,3500,0,0.0
Pune-Pimpri,Raddish,2016,6,6,0,0.0
Solapur,Sunflower,2015,3875,3875,0,0.0
Pune-Pimpri,Kardai,2016,4,4,0,0.0
Pune-Pimpri,Maize(Corn.),2016,1300,1300,0,0.0
Pune-Pimpri,Mango(Raw),2016,3200,3200,0,0.0
Pune-Pimpri,Onion,2016,1320,1320,0,0.0
Pune-Pimpri,Pavtta,2016,3000,3000,0,0.0
Pune-Pimpri,Pavtta,2016,4100,4100,0,0.0
Pune-Pimpri,Pavtta,2016,5000,5000,0,0.0
Pune-Pimpri,Pavtta,2016,2000,2000,0,0.0
Purna,Gram,2015,4093,4093,0,0.0
Purna,Green Gram,2015,6851,6851,0,0.0
Pusad,Gram,2015,2800,2800,0,0.0
Solapur,Papai,2015,250,250,0,0.0
Purna,Mustard,2016,3600,3600,0,0.0
Purna,Safflower,2016,2184,2184,0,0.0
Purna,Safflower,2016,2325,2325,0,0.0
Purna,Safflower,2016,2250,2250,0,0.0
Purna,Safflower,2016,2396,2396,0,0.0
Purna,Turmeric,2016,8620,8620,0,0.0
Purna,Turmeric,2016,5600,5600,0,0.0
Purna,Wheat(Husked),2016,1966,1966,0,0.0
Pusad,Batbati,2014,3900,3900,0,0.0
Solapur,Papai,2015,238,238,0,0.0
Purna,Ground Nut Pods (Dry),2016,5510,5510,0,0.0
Pusad,Batbati,2014,3925,3925,0,0.0
Pusad,Black Gram,2014,4642,4642,0,0.0
Pusad,Green Gram,2014,6620,6620,0,0.0
Pusad,Sesamum,2014,8000,8000,0,0.0
Pusad,Sesamum,2014,9252,9252,0,0.0
Pusad,Spilt Pigeon Pea,2014,6085,6085,0,0.0
Pusad,Bajri,2015,1503,1503,0,0.0
Pusad,Batbati,2015,5018,5018,0,0.0
Pusad,Batbati,2015,4193,4193,0,0.0
Purna,Mustard,2016,4100,4100,0,0.0
Solapur,Pigeon Pea (Tur),2015,6625,6625,0,0.0
Purna,Green Gram,2015,7000,7000,0,0.0
Purna,Safflower,2015,2435,2435,0,0.0
Purna,Ground Nut Pods (Dry),2015,5876,5876,0,0.0
Purna,Ground Nut Pods (Dry),2015,5790,5790,0,0.0
Purna,Mustard,2015,3700,3700,0,0.0
Purna,Mustard,2015,3230,3230,0,0.0
Purna,Pigeon Pea (Tur),2015,5590,5590,0,0.0
Purna,Pigeon Pea (Tur),2015,6267,6267,0,0.0
Purna,Pigeon Pea (Tur),2015,7860,7860,0,0.0
Purna,Pigeon Pea (Tur),2015,7367,7367,0,0.0
Purna,Safflower,2015,2300,2300,0,0.0
Purna,Sorgum(Jawar),2015,1395,1395,0,0.0
Purna,Green Gram,2016,6955,6955,0,0.0
Purna,Sorgum(Jawar),2015,1132,1132,0,0.0
Purna,Sorgum(Jawar),2015,1150,1150,0,0.0
Purna,Sorgum(Jawar),2015,1184,1184,0,0.0
Purna,Turmeric,2015,7810,7810,0,0.0
Purna,Wheat(Husked),2015,1438,1438,0,0.0
Purna,Castor Seed,2016,2813,2813,0,0.0
Purna,Gram,2016,4228,4228,0,0.0
Purna,Gram,2016,5690,5690,0,0.0
Purna,Green Gram,2016,5900,5900,0,0.0
Rahata,Kardai,2015,10,10,0,0.0
Rahata,Lemon,2015,2800,2800,0,0.0
Rahata,Maize,2015,1310,1310,0,0.0
Rahuri-Vambori,Maize,2015,1401,1401,0,0.0
Rahuri-Vambori,Green Gram,2015,6252,6252,0,0.0
Rahuri-Vambori,Green Gram,2015,7975,7975,0,0.0
Rahuri-Vambori,Green Gram,2015,6950,6950,0,0.0
Solapur,Black Gram,2015,9644,9644,0,0.0
Solapur,Black Gram,2015,5313,5313,0,0.0
Solapur,Black Gram,2015,5251,5251,0,0.0
Rahuri-Vambori,Ground Nut Pods (Dry),2015,4267,4267,0,0.0
Rahuri-Vambori,Maize,2015,1445,1445,0,0.0
Rahuri-Vambori,Maize,2015,1411,1411,0,0.0
Rahuri-Vambori,Pigeon Pea (Tur),2015,6001,6001,0,0.0
Rahuri-Vambori,Green Gram,2015,7600,7600,0,0.0
Rahuri-Vambori,Pigeon Pea (Tur),2015,5926,5926,0,0.0
Rahuri-Vambori,Pigeon Pea (Tur),2015,9412,9412,0,0.0
Rahuri-Vambori,Pigeon Pea (Tur),2015,4476,4476,0,0.0
Rahuri-Vambori,Safflower,2015,2500,2500,0,0.0
Rahuri-Vambori,Soybean,2015,3231,3231,0,0.0
Rahuri-Vambori,Soybean,2015,3215,3215,0,0.0
Rahuri-Vambori,Sunflower,2015,2908,2908,0,0.0
Rahuri-Vambori,Sunflower,2015,3399,3399,0,0.0
Rahuri-Vambori,Sunflower,2015,2751,2751,0,0.0
Rahuri-Vambori,Green Gram,2015,6950,6950,0,0.0
Rahuri-Vambori,Bajri,2015,1686,1686,0,0.0
Rahuri-Vambori,Bajri,2016,1763,1763,0,0.0
Rahuri,Sorgum(Jawar),2015,1583,1583,0,0.0
Rahuri,Green Gram,2015,6500,6500,0,0.0
Rahuri,Maize,2015,1310,1310,0,0.0
Rahuri,Maize,2015,1418,1418,0,0.0
Rahuri,Maize,2015,1310,1310,0,0.0
Rahuri,Maize,2015,1317,1317,0,0.0
Rahuri,Maize,2015,1310,1310,0,0.0
Rahuri,Pigeon Pea (Tur),2015,4350,4350,0,0.0
Rahuri,Pigeon Pea (Tur),2015,4350,4350,0,0.0
Rahuri,Pigeon Pea (Tur),2015,4350,4350,0,0.0
Rahuri,Sorgum(Jawar),2015,1592,1592,0,0.0
Rahuri-Vambori,Sunflower,2014,2865,2865,0,0.0
Rahuri,Sorgum(Jawar),2015,1537,1537,0,0.0
Rahuri,Sorgum(Jawar),2015,1550,1550,0,0.0
Rahuri,Soybean,2015,2900,2900,0,0.0
Rahuri-Vambori,Green Gram,2014,6850,6850,0,0.0
Rahuri-Vambori,Horse Gram,2014,2600,2600,0,0.0
Rahuri-Vambori,Pigeon Pea (Tur),2014,4200,4200,0,0.0
Rahuri-Vambori,Pigeon Pea (Tur),2014,3748,3748,0,0.0
Rahuri-Vambori,Pigeon Pea (Tur),2014,3647,3647,0,0.0
Rahuri-Vambori,Safflower,2014,2199,2199,0,0.0
Rahuri-Vambori,Sunflower,2015,3000,3000,0,0.0
Rahuri-Vambori,Green Gram,2016,5000,5000,0,0.0
Rahata,Math (Bhaji),2015,10,10,0,0.0
Solapur,Ground Nut Pods (Dry),2014,4200,4200,0,0.0
Rajura,Cotton,2014,3911,3911,0,0.0
Rajura,Soybean,2014,3339,3339,0,0.0
Rajura,Green Gram,2015,6391,6391,0,0.0
Rajura,Pigeon Pea (Tur),2015,6033,6033,0,0.0
Rajura,Green Gram,2016,6350,6350,0,0.0
Solapur,Pigeon Pea (Tur),2014,4845,4845,0,0.0
Ramtek,Rice(Paddy-Hus),2014,1600,1600,0,0.0
Solapur,Maize,2014,1431,1431,0,0.0
Solapur,Ground Nut Pods (Dry),2014,4001,4001,0,0.0
Ramtek,Coriander (Dry),2015,7100,7100,0,0.0
Rahuri-Vambori,Sunflower,2016,2700,2700,0,0.0
Solapur,Gram,2014,3100,3100,0,0.0
Solapur,Gram,2014,3226,3226,0,0.0
Ramtek,Linseed,2015,4001,4001,0,0.0
Ramtek,Linseed,2015,4195,4195,0,0.0
Ramtek,Mustard,2015,2800,2800,0,0.0
Ramtek,Mustard,2015,2700,2700,0,0.0
Ramtek,Other Pulses,2015,1500,1500,0,0.0
Ramtek,Other Pulses,2015,1975,1975,0,0.0
Ramtek,Paddy-Unhusked,2015,1500,1500,0,0.0
Rahuri-Vambori,Sunflower,2016,3300,3300,0,0.0
Rahuri-Vambori,Soybean,2016,2946,2946,0,0.0
Rahuri-Vambori,Green Gram,2016,6100,6100,0,0.0
Rahuri-Vambori,Maize,2016,1350,1350,0,0.0
Rahuri-Vambori,Green Gram,2016,6600,6600,0,0.0
Rahuri-Vambori,Ground Nut Pods (Dry),2016,5001,5001,0,0.0
Rahuri-Vambori,Ground Nut Pods (Dry),2016,4567,4567,0,0.0
Rahuri-Vambori,Ground Nut Pods (Dry),2016,4638,4638,0,0.0
Solapur,Bajri,2015,1250,1250,0,0.0
Solapur,Bajri,2015,1376,1376,0,0.0
Rahuri-Vambori,Ground Nut Pods (Dry),2016,4753,4753,0,0.0
Rahuri-Vambori,Ground Nut Pods (Dry),2016,4600,4600,0,0.0
Rahuri-Vambori,Maize,2016,1298,1298,0,0.0
Rahuri-Vambori,Maize,2016,1500,1500,0,0.0
Rahuri-Vambori,SUNFLOWER,2016,2800,2800,0,0.0
Solapur,Wheat(Unhusked),2014,3200,3200,0,0.0
Solapur,Wheat(Unhusked),2014,3200,3200,0,0.0
Rahuri-Vambori,Matki,2016,6500,6500,0,0.0
Rahuri-Vambori,Matki,2016,8200,8200,0,0.0
Rahuri-Vambori,Matki,2016,9911,9911,0,0.0
Rahuri-Vambori,Matki,2016,5700,5700,0,0.0
Rahuri-Vambori,PIGEON PEA (TUR),2016,4526,4526,0,0.0
Rahuri-Vambori,Pigeon Pea (Tur),2016,6500,6500,0,0.0
Rahuri-Vambori,Pigeon Pea (Tur),2016,8251,8251,0,0.0
Rahuri,Gram,2015,3138,3138,0,0.0
Rahuri,Bajri,2015,1310,1310,0,0.0
Rahuri,Bajri,2015,1380,1380,0,0.0
Rahata,Carrot,2016,1500,1500,0,0.0
Rahata,Beet Root,2016,1233,1233,0,0.0
Rahata,Beet Root,2016,1500,1500,0,0.0
Rahata,Beet Root,2016,1500,1500,0,0.0
Rahata,Beet Root,2016,2500,2500,0,0.0
Rahata,Beet Root,2016,800,800,0,0.0
Rahata,Bitter Gourd,2016,6300,6300,0,0.0
Rahata,Bitter Gourd,2016,800,800,0,0.0
Rahata,CLUSTER BEAN,2016,3200,3200,0,0.0
Rahata,Carrot,2016,2400,2400,0,0.0
Rahata,Carrot,2016,2846,2846,0,0.0
Rahata,Bajri,2016,1641,1641,0,0.0
Rahata,Carrot,2016,2000,2000,0,0.0
Rahata,Carrot,2016,2125,2125,0,0.0
Rahata,Cluster Bean,2016,5600,5600,0,0.0
Rahata,Cluster Bean,2016,7250,7250,0,0.0
Rahata,Dhemse,2016,2000,2000,0,0.0
Rahata,GRAM,2016,6705,6705,0,0.0
Rahata,Garlic,2016,9500,9500,0,0.0
Rahata,Ghevda,2016,3125,3125,0,0.0
Rahata,Ghevda,2016,6667,6667,0,0.0
Rahata,Bajri,2016,1540,1540,0,0.0
Rahata,Bajri,2016,1400,1400,0,0.0
Rahuri,Bajri,2015,1380,1380,0,0.0
Rahata,Small Gourd,2015,1625,1625,0,0.0
Rahata,Melon,2015,400,400,0,0.0
Rahata,Shepu,2015,4,4,0,0.0
Rahata,Shepu,2015,6,6,0,0.0
Rahata,Shevga,2015,3000,3000,0,0.0
Rahata,Shevga,2015,3875,3875,0,0.0
Rahata,Shevga,2015,3333,3333,0,0.0
Rahata,Shevga,2015,3000,3000,0,0.0
Rahata,Small Gourd,2015,2000,2000,0,0.0
Rahata,Small Gourd,2015,2000,2000,0,0.0
Rahata,Small Gourd,2015,2075,2075,0,0.0
Rahata,Bajri,2016,1511,1511,0,0.0
Rahata,Small Gourd,2015,1833,1833,0,0.0
Rahata,Soybean,2015,3135,3135,0,0.0
Rahata,Spinach,2015,5,5,0,0.0
Rahata,Walvad,2015,2000,2000,0,0.0
Rahata,Walvad,2015,3300,3300,0,0.0
Rahata,Walvad,2015,3000,3000,0,0.0
Rahata,Walvad,2015,2000,2000,0,0.0
Rahata,Walvad,2015,1650,1650,0,0.0
Rahata,BEET ROOT,2016,1000,1000,0,0.0
Rahata,Ghevda,2016,7000,7000,0,0.0
Rahata,Ghevda,2016,1500,1500,0,0.0
Rahata,Ghevda,2016,1788,1788,0,0.0
Rahata,Soybean,2016,3856,3856,0,0.0
Rahata,Pigeon Pea (Tur),2016,6595,6595,0,0.0
Rahata,Pigeon Pea (Tur),2016,6350,6350,0,0.0
Rahata,Pigeon Pea (Tur),2016,5500,5500,0,0.0
Rahata,SMALL GOURD,2016,1000,1000,0,0.0
Rahata,Shepu,2016,10,10,0,0.0
Rahata,Small Gourd,2016,2000,2000,0,0.0
Rahata,Small Gourd,2016,1850,1850,0,0.0
Rahata,Sorgum(Jawar),2016,1474,1474,0,0.0
Rahata,Sorgum(Jawar),2016,1463,1463,0,0.0
Rahata,Spinach,2016,5,5,0,0.0
Rahata,Ginger (Fresh),2016,1500,1500,0,0.0
Rahata,Sweet Potato,2016,3000,3000,0,0.0
Rahata,Walvad,2016,3000,3000,0,0.0
Rahata,Walvad,2016,1500,1500,0,0.0
Rahuri,Gram,2014,3175,3175,0,0.0
Rahuri,Gram,2014,3250,3250,0,0.0
Rahuri,Gram,2014,2900,2900,0,0.0
Rahuri,Green Gram,2014,5750,5750,0,0.0
Rahuri,Maize,2014,1255,1255,0,0.0
Rahuri,Sorgum(Jawar),2014,1444,1444,0,0.0
Rahata,Pigeon Pea (Tur),2016,7300,7300,0,0.0
Rahata,Pigeon Pea (Tur),2016,6050,6050,0,0.0
Rahata,Papai,2016,500,500,0,0.0
Rahata,Melon,2016,500,500,0,0.0
Rahata,Gram,2016,6000,6000,0,0.0
Rahata,Gram,2016,4001,4001,0,0.0
Rahata,Gram,2016,5125,5125,0,0.0
Rahata,Ground Nut Pods (Dry),2016,3200,3200,0,0.0
Rahata,Ground Nut Pods (Dry),2016,5000,5000,0,0.0
Rahata,Kanda Pat,2016,5,5,0,0.0
Rahata,Kardai,2016,5,5,0,0.0
Rahata,Kharbuj,2016,1680,1680,0,0.0
Rahata,Ladies Finger,2016,1000,1000,0,0.0
Rahata,Lemon,2016,4136,4136,0,0.0
Rahata,Lemon,2016,3182,3182,0,0.0
Rahata,Lemon,2016,4556,4556,0,0.0
Rahata,Maize,2016,1425,1425,0,0.0
Rahata,Maize,2016,1751,1751,0,0.0
Rahata,Maize,2016,1713,1713,0,0.0
Rahata,Maize,2016,1443,1443,0,0.0
Rahata,Maize,2016,1581,1581,0,0.0
Rahata,Math (Bhaji),2016,20,20,0,0.0
Rahata,Math (Bhaji),2016,5,5,0,0.0
Pune-Pimpri,Ginger (Dry),2016,3500,3500,0,0.0
Pune-Pimpri,Ghosali(Bhaji),2016,3000,3000,0,0.0
Paithan,Gram,2016,7425,7425,0,0.0
Parbhani,Green Gram,2016,6100,6100,0,0.0
Parbhani,Sorgum(Jawar),2014,1700,1700,0,0.0
Parbhani,Black Gram,2015,10000,10000,0,0.0
Parbhani,Cotton,2015,4500,4500,0,0.0
Parbhani,Gram,2015,2976,2976,0,0.0
Parbhani,Gram,2015,5215,5215,0,0.0
Parbhani,Green Gram,2015,6850,6850,0,0.0
Parbhani,Green Gram,2015,6927,6927,0,0.0
Parbhani,Green Gram,2015,6500,6500,0,0.0
Parbhani,Black Gram,2016,5501,5501,0,0.0
Parbhani,Green Gram,2016,4315,4315,0,0.0
Parbhani,Black Gram,2014,4500,4500,0,0.0
Parbhani,Green Gram,2016,6625,6625,0,0.0
Parli-Vaijnath,Black Gram,2014,4511,4511,0,0.0
Parli-Vaijnath,Green Gram,2014,7317,7317,0,0.0
Parli-Vaijnath,Ground Nut Pods (Dry),2014,3311,3311,0,0.0
Solapur,Pigeon Pea (Tur),2016,6117,6117,0,0.0
Parli-Vaijnath,Ground Nut Pods (Dry),2014,3443,3443,0,0.0
Parli-Vaijnath,Maize,2014,1250,1250,0,0.0
Parli-Vaijnath,Maize,2014,1350,1350,0,0.0
Parli-Vaijnath,Safflower,2014,2100,2100,0,0.0
Parbhani,Black Gram,2014,4500,4500,0,0.0
Parbhani,Black Gram,2014,4700,4700,0,0.0
Parli-Vaijnath,Bajri,2015,1400,1400,0,0.0
Pandharpur,Gram,2016,5750,5750,0,0.0
Pandharpur,Pigeon Pea (Tur),2015,4420,4420,0,0.0
Pandharpur,Wheat(Husked),2015,1950,1950,0,0.0
Pandharpur,Bajri,2016,1860,1860,0,0.0
Pandharpur,Bajri,2016,1650,1650,0,0.0
Pandharpur,Bajri,2016,1887,1887,0,0.0
Pandharpur,Bajri,2016,1330,1330,0,0.0
Solapur,SOYBEAN,2016,2790,2790,0,0.0
Pandharpur,CLUSTER BEAN,2016,2417,2417,0,0.0
Pandharpur,Capsicum,2016,4600,4600,0,0.0
Pandharpur,Gram,2016,8801,8801,0,0.0
Pandharpur,Wheat(Husked),2016,1924,1924,0,0.0
Pandharpur,Maize,2016,1395,1395,0,0.0
Pandharpur,Maize,2016,1813,1813,0,0.0
Pandharpur,Pigeon Pea (Tur),2016,8200,8200,0,0.0
Pandharpur,Pigeon Pea (Tur),2016,7280,7280,0,0.0
Pandharpur,SORGUM(JAWAR),2016,1845,1845,0,0.0
Pandharpur,Wheat(Husked),2016,1633,1633,0,0.0
Solapur,Rajgira,2016,1100,1100,0,0.0
Pandharpur,Wheat(Husked),2016,1668,1668,0,0.0
Pandharpur,Wheat(Husked),2016,1913,1913,0,0.0
Parli-Vaijnath,Sunflower,2014,2840,2840,0,0.0
Parli-Vaijnath,Bajri,2015,1400,1400,0,0.0
Pandharpur,Maize,2015,1460,1460,0,0.0
Parli-Vaijnath,Safflower,2016,2615,2615,0,0.0
Parli-Vaijnath,GRAM,2016,6500,6500,0,0.0
Parli-Vaijnath,Gram,2016,8600,8600,0,0.0
Parli-Vaijnath,Green Gram,2016,7000,7000,0,0.0
Solapur,Matki,2016,6700,6700,0,0.0
Parli-Vaijnath,Ground Nut Pods (Dry),2016,3100,3100,0,0.0
Parli-Vaijnath,Maize,2016,1456,1456,0,0.0
Parli-Vaijnath,PIGEON PEA (TUR),2016,4300,4300,0,0.0
Parli-Vaijnath,Pigeon Pea (Tur),2016,7120,7120,0,0.0
Parli-Vaijnath,Pigeon Pea (Tur),2016,5505,5505,0,0.0
Parli-Vaijnath,Safflower,2016,2450,2450,0,0.0
Parli-Vaijnath,Black Gram,2016,8560,8560,0,0.0
Parli-Vaijnath,Safflower,2016,2675,2675,0,0.0
Parli-Vaijnath,Safflower,2016,2700,2700,0,0.0
Parli-Vaijnath,Sunflower,2016,3300,3300,0,0.0
Parli-Vaijnath,WHEAT(HUSKED),2016,1711,1711,0,0.0
Parli-Vaijnath,Wheat(Husked),2016,2050,2050,0,0.0
Parli-Vaijnath,Wheat(Husked),2016,1975,1975,0,0.0
Parli-Vaijnath,Wheat(Husked),2016,2025,2025,0,0.0
Parli-Vaijnath,Wheat(Husked),2016,1741,1741,0,0.0
Parli-Vaijnath,Wheat(Husked),2016,1350,1350,0,0.0
Parli-Vaijnath,Black Gram,2016,6400,6400,0,0.0
Parli-Vaijnath,Bajri,2016,1691,1691,0,0.0
Parli-Vaijnath,Bajri,2015,1536,1536,0,0.0
Parli-Vaijnath,Ground Nut Pods (Dry),2015,3675,3675,0,0.0
Parli-Vaijnath,Bajri,2015,1381,1381,0,0.0
Solapur,Papai,2016,350,350,0,0.0
Solapur,Papai,2016,150,150,0,0.0
Parli-Vaijnath,Black Gram,2015,8000,8000,0,0.0
Parli-Vaijnath,Gram,2015,4213,4213,0,0.0
Parli-Vaijnath,Green Gram,2015,6700,6700,0,0.0
Parli-Vaijnath,Green Gram,2015,7100,7100,0,0.0
Parli-Vaijnath,Green Gram,2015,6500,6500,0,0.0
Parli-Vaijnath,Green Gram,2015,7881,7881,0,0.0
Parli-Vaijnath,Ground Nut Pods (Dry),2015,4300,4300,0,0.0
Parli-Vaijnath,Wheat(Husked),2015,1510,1510,0,0.0
Parli-Vaijnath,Ground Nut Pods (Dry),2015,4600,4600,0,0.0
Parli-Vaijnath,Pigeon Pea (Tur),2015,8250,8250,0,0.0
Parli-Vaijnath,Safflower,2015,2400,2400,0,0.0
Parli-Vaijnath,Safflower,2015,2811,2811,0,0.0
Parli-Vaijnath,Sunflower,2015,2900,2900,0,0.0
Parli-Vaijnath,Sunflower,2015,2875,2875,0,0.0
Parli-Vaijnath,Sunflower,2015,3500,3500,0,0.0
Parli-Vaijnath,Wheat(Husked),2015,1300,1300,0,0.0
Parli-Vaijnath,Wheat(Husked),2015,1624,1624,0,0.0
Pandharpur,Pigeon Pea (Tur),2015,4925,4925,0,0.0
Pandharpur,Maize,2015,1331,1331,0,0.0
Pune-Pimpri,Ghosali(Bhaji),2016,3667,3667,0,0.0
Sonpeth,Green Gram,2015,6200,6200,0,0.0
Palam,Soybean,2016,3300,3300,0,0.0
Palam,Soybean,2016,3601,3601,0,0.0
Palam,Soybean,2016,3600,3600,0,0.0
Palam,Soybean,2016,3700,3700,0,0.0
Palam,Soybean,2016,3700,3700,0,0.0
Palam,Soybean,2016,2700,2700,0,0.0
Palam,Soybean,2016,3150,3150,0,0.0
Sonpeth,Maize,2015,1451,1451,0,0.0
Sonpeth,Green Gram,2015,6250,6250,0,0.0
Sonpeth,Gram,2015,4001,4001,0,0.0
Palam,SOYBEAN,2016,2798,2798,0,0.0
Sonpeth,Gram,2015,3799,3799,0,0.0
Sonpeth,Gram,2015,4455,4455,0,0.0
Palam,Wheat(Husked),2016,1700,1700,0,0.0
Palam,Wheat(Husked),2016,1751,1751,0,0.0
Palghar(Bevur),Potato,2014,1500,1500,0,0.0
Palghar(Bevur),Onion,2015,1733,1733,0,0.0
Sonpeth,Bajri,2015,1500,1500,0,0.0
Sonpeth,Bajri,2015,1176,1176,0,0.0
Palghar(Bevur),Onion,2015,1117,1117,0,0.0
Palam,Soybean,2016,3600,3600,0,0.0
Palam,Pigeon Pea (Tur),2016,8400,8400,0,0.0
Kannad,Gram,2014,2160,2160,0,0.0
Sonpeth,Gram,2016,7490,7490,0,0.0
Paithan,Maize,2016,1562,1562,0,0.0
Paithan,Maize,2016,1375,1375,0,0.0
Paithan,Maize,2016,1300,1300,0,0.0
Paithan,Pigeon Pea (Tur),2016,7886,7886,0,0.0
Paithan,Pigeon Pea (Tur),2016,6481,6481,0,0.0
Sonpeth,Maize,2016,1550,1550,0,0.0
Sonpeth,Green Gram,2016,5400,5400,0,0.0
Sonpeth,Green Gram,2016,6150,6150,0,0.0
Paithan,Soybean,2016,4200,4200,0,0.0
Palam,Sorgum(Jawar),2015,1800,1800,0,0.0
Palam,Pigeon Pea (Tur),2016,8000,8000,0,0.0
Sonpeth,GRAM,2016,8100,8100,0,0.0
Sonpeth,Black Gram,2016,6700,6700,0,0.0
Sonpeth,Black Gram,2016,5455,5455,0,0.0
Sonpeth,Bajri,2016,1671,1671,0,0.0
Sonpeth,Bajri,2016,1448,1448,0,0.0
Sonpeth,Wheat(Husked),2015,1970,1970,0,0.0
Palam,Pigeon Pea (Tur),2016,8600,8600,0,0.0
Palam,Pigeon Pea (Tur),2016,8400,8400,0,0.0
Palam,Pigeon Pea (Tur),2016,8700,8700,0,0.0
Palghar(Bevur),ONION,2016,915,915,0,0.0
Sonpeth,Wheat(Husked),2014,1620,1620,0,0.0
Pandharpur,Maize,2015,1485,1485,0,0.0
Pandharkawada,Soybean,2016,3835,3835,0,0.0
Pandharkawada,Soybean,2015,3113,3113,0,0.0
Sonpeth,Black Gram,2014,4201,4201,0,0.0
Sonpeth,Black Gram,2014,4201,4201,0,0.0
Sonpeth,Bajri,2014,1426,1426,0,0.0
Pandharkawada,Wheat(Husked),2015,1300,1300,0,0.0
Pandharkawada,Gram,2016,5300,5300,0,0.0
Pandharkawada,Ground Nut Pods (Dry),2016,5315,5315,0,0.0
Pandharkawada,Pigeon Pea (Tur),2016,6500,6500,0,0.0
Pandharkawada,Sorgum(Jawar),2016,1485,1485,0,0.0
Pandharkawada,Soybean,2016,3300,3300,0,0.0
Pandharkawada,Pigeon Pea (Tur),2015,6200,6200,0,0.0
Pandharkawada,Soybean,2016,3435,3435,0,0.0
Pandharpur,Bajri,2014,1313,1313,0,0.0
Solapur,WHEAT(UNHUSKED),2016,3100,3100,0,0.0
Pandharpur,Maize,2014,1386,1386,0,0.0
Pandharpur,Math (Bhaji),2014,1000,1000,0,0.0
Pandharpur,Wheat(Husked),2014,1531,1531,0,0.0
Pandharpur,Bajri,2015,1281,1281,0,0.0
Pandharpur,Gram,2015,4675,4675,0,0.0
Pandharpur,Maize,2015,1318,1318,0,0.0
Pandharkawada,Sorgum(Jawar),2015,1100,1100,0,0.0
Pandharkawada,Ground Nut Pods (Dry),2015,5050,5050,0,0.0
Palghar(Bevur),Onion,2016,1075,1075,0,0.0
Sonpeth,Pigeon Pea (Tur),2014,5250,5250,0,0.0
Palghar(Bevur),Onion,2016,1185,1185,0,0.0
Palghar(Bevur),Onion,2016,947,947,0,0.0
Palghar(Bevur),Onion,2016,718,718,0,0.0
Palghar(Bevur),Onion,2016,832,832,0,0.0
Sonpeth,Sorgum(Jawar),2014,1616,1616,0,0.0
Sonpeth,Sesamum,2014,9050,9050,0,0.0
Sonpeth,Sesamum,2014,7901,7901,0,0.0
Sonpeth,Safflower,2014,2350,2350,0,0.0
Sonpeth,Safflower,2014,2300,2300,0,0.0
Palghar(Bevur),Potato,2016,1152,1152,0,0.0
Pandharkawada,Cotton,2015,4100,4100,0,0.0
Palus,Ghevda,2015,3750,3750,0,0.0
Palus,Papai,2016,700,700,0,0.0
Sonpeth,Mustard,2014,3751,3751,0,0.0
Sonpeth,Mustard,2014,3802,3802,0,0.0
Pandharkawada,Gram,2014,2100,2100,0,0.0
Pandharkawada,Ground Nut Pods (Dry),2014,3305,3305,0,0.0
Pandharkawada,Pigeon Pea (Tur),2014,4355,4355,0,0.0
Pandharkawada,Pigeon Pea (Tur),2014,4376,4376,0,0.0
Sonpeth,Gram,2014,2175,2175,0,0.0
Parola,Black Gram,2016,6200,6200,0,0.0
Parola,Black Gram,2016,8701,8701,0,0.0
Parola,Black Gram,2016,14150,14150,0,0.0
Pune-Pimpri,Garlic,2015,6000,6000,0,0.0
Pune-Pimpri,Carrot,2015,2300,2300,0,0.0
Pune-Pimpri,Carrot,2015,1000,1000,0,0.0
Pune-Pimpri,Carrot,2015,1800,1800,0,0.0
Pune-Pimpri,Chavli (Shenga ),2015,2000,2000,0,0.0
Pune-Pimpri,Cluster Bean,2015,3500,3500,0,0.0
Pune-Pimpri,Cluster Bean,2015,5000,5000,0,0.0
Pune-Pimpri,Cluster Bean,2015,3500,3500,0,0.0
Pune-Pimpri,Cucumber,2015,2000,2000,0,0.0
Pune-Pimpri,Cucumber,2015,2433,2433,0,0.0
Pune-Pimpri,Garlic,2015,6000,6000,0,0.0
Pune-Pimpri,Capsicum,2015,2500,2500,0,0.0
Pune-Pimpri,Garlic,2015,4000,4000,0,0.0
Pune-Pimpri,Garlic,2015,4000,4000,0,0.0
Pune-Pimpri,Garlic,2015,6000,6000,0,0.0
Pune-Pimpri,Garlic,2015,4000,4000,0,0.0
Pune-Pimpri,Garlic,2015,6000,6000,0,0.0
Pune-Pimpri,Ghosali(Bhaji),2015,3000,3000,0,0.0
Pune-Pimpri,Ginger (Dry),2015,4000,4000,0,0.0
Pune-Pimpri,Ginger (Dry),2015,3500,3500,0,0.0
Pune-Pimpri,Ginger (Fresh),2015,3500,3500,0,0.0
Pune-Pimpri,Capsicum,2015,3333,3333,0,0.0
Pune-Pimpri,Capsicum,2015,3000,3000,0,0.0
Pune-Pimpri,Green-Peas,2015,6000,6000,0,0.0
Pune-Pimpri,Beet Root,2014,2350,2350,0,0.0
Pune-Moshi,Snake Gourd,2016,2000,2000,0,0.0
Pune-Moshi,Snake Gourd,2016,2000,2000,0,0.0
Pune-Moshi,Spinach,2016,5,5,0,0.0
Pune-Moshi,Spinach,2016,7,7,0,0.0
Pune-Moshi,Wal Bhaji,2016,3000,3000,0,0.0
Pune-Moshi,Wal Papdi,2016,1700,1700,0,0.0
Pune-Moshi,Walvad,2016,3000,3000,0,0.0
Pune-Pimpri,Beet Root,2014,1564,1564,0,0.0
Pune-Pimpri,Beet Root,2014,2067,2067,0,0.0
Pune-Pimpri,Green-Peas,2014,3000,3000,0,0.0
Pune-Pimpri,Capsicum,2015,2333,2333,0,0.0
Pune-Pimpri,Pavtta,2014,7000,7000,0,0.0
Pune-Pimpri,Pavtta,2014,2800,2800,0,0.0
Pune-Pimpri,Potato,2014,4000,4000,0,0.0
Pune-Pimpri,Potato,2014,3913,3913,0,0.0
Pune-Pimpri,Potato,2014,4000,4000,0,0.0
Pune-Pimpri,Shevga,2014,4000,4000,0,0.0
Pune-Pimpri,Walvad,2014,3425,3425,0,0.0
Pune-Pimpri,Bitter Gourd,2015,4500,4500,0,0.0
Pune-Pimpri,Bitter Gourd,2015,2000,2000,0,0.0
Pune-Pimpri,Ginger (Fresh),2015,3500,3500,0,0.0
Pune-Pimpri,Green-Peas,2015,3100,3100,0,0.0
Parola,Black Gram,2016,14072,14072,0,0.0
Solapur,Wheat(Unhusked),2015,3501,3501,0,0.0
Pune-Pimpri,Cucumber,2016,2500,2500,0,0.0
Pune-Pimpri,GARLIC,2016,6000,6000,0,0.0
Pune-Pimpri,Garlic,2016,6000,6000,0,0.0
Pune-Pimpri,Garlic,2016,6000,6000,0,0.0
Pune-Pimpri,Garlic,2016,6000,6000,0,0.0
Pune-Pimpri,Garlic,2016,6000,6000,0,0.0
Pune-Pimpri,Garlic,2016,6000,6000,0,0.0
Pune-Pimpri,Garlic,2016,6000,6000,0,0.0
Solapur,Wheat(Unhusked),2015,3751,3751,0,0.0
Solapur,Wheat(Unhusked),2015,3113,3113,0,0.0
Pune-Pimpri,Carrot,2016,1533,1533,0,0.0
Pune-Pimpri,Garlic,2016,6000,6000,0,0.0
Pune-Pimpri,Garlic,2016,6000,6000,0,0.0
Pune-Pimpri,Garlic,2016,6000,6000,0,0.0
Pune-Pimpri,Garlic,2016,6000,6000,0,0.0
Pune-Pimpri,Garlic,2016,6000,6000,0,0.0
Pune-Pimpri,Garlic,2016,6000,6000,0,0.0
Pune-Pimpri,Garlic,2016,6000,6000,0,0.0
Pune-Pimpri,Garlic,2016,6000,6000,0,0.0
Pune-Pimpri,Garlic,2016,6000,6000,0,0.0
Pune-Pimpri,Cluster Bean,2016,4600,4600,0,0.0
Solapur,Bajri,2016,1615,1615,0,0.0
Pune-Pimpri,Mango(Raw),2015,2050,2050,0,0.0
Pune-Pimpri,Shevga,2015,3000,3000,0,0.0
Pune-Pimpri,Pavata,2015,2000,2000,0,0.0
Pune-Pimpri,Pavtta,2015,3000,3000,0,0.0
Pune-Pimpri,Pavtta,2015,2750,2750,0,0.0
Pune-Pimpri,Pavtta,2015,2000,2000,0,0.0
Pune-Pimpri,Pavtta,2015,2600,2600,0,0.0
Pune-Pimpri,Pavtta,2015,4300,4300,0,0.0
Pune-Pimpri,Pavtta,2015,3000,3000,0,0.0
Pune-Pimpri,Pumpkin,2015,800,800,0,0.0
Pune-Pimpri,Shevga,2015,2500,2500,0,0.0
Pune-Pimpri,Shevga,2015,3000,3000,0,0.0
Solapur,Bajri,2016,1902,1902,0,0.0
Pune-Pimpri,Shevga,2015,4000,4000,0,0.0
Pune-Pimpri,Squash Gourd,2015,957,957,0,0.0
Pune-Pimpri,Wal Papdi,2015,3292,3292,0,0.0
Pune-Pimpri,Wal Papdi,2015,4000,4000,0,0.0
Pune-Pimpri,Wal Papdi,2015,3340,3340,0,0.0
Pune-Pimpri,Beet Root,2016,2564,2564,0,0.0
Pune-Pimpri,CAPSICUM,2016,1800,1800,0,0.0
Pune-Pimpri,Carrot,2016,600,600,0,0.0
Pune-Pimpri,Carrot,2016,800,800,0,0.0
Pune-Moshi,Shepu,2016,6,6,0,0.0
Pune-Moshi,Raddish,2016,9,9,0,0.0
Pune-Moshi,Parwar,2016,3000,3000,0,0.0
Pavani,Wheat(Husked),2016,1700,1700,0,0.0
Solapur,Green Gram,2016,5350,5350,0,0.0
Pavani,Wheat(Husked),2014,1400,1400,0,0.0
Pavani,Paddy-Unhusked,2015,1900,1900,0,0.0
Pavani,Black Gram,2016,8500,8500,0,0.0
Pavani,Green Gram,2016,5150,5150,0,0.0
Pavani,Green Peas (Dry),2016,3150,3150,0,0.0
Pavani,Green Peas (Dry),2016,2000,2000,0,0.0
Pavani,Other Pulses,2016,3025,3025,0,0.0
Pavani,Wheat(Husked),2016,1775,1775,0,0.0
Phaltan,Jaggery,2015,2775,2775,0,0.0
Patur,PIGEON PEA (TUR),2016,4000,4000,0,0.0
Phaltan,GREEN-PEAS,2016,6500,6500,0,0.0
Phaltan,Jaggery,2016,2790,2790,0,0.0
Pulgaon,Gram,2014,2300,2300,0,0.0
Pulgaon,Gram,2014,2200,2200,0,0.0
Pulgaon,Pigeon Pea (Tur),2014,4000,4000,0,0.0
Pulgaon,Wheat(Husked),2015,1141,1141,0,0.0
Pulgaon,GRAM,2016,6500,6500,0,0.0
Pulgaon,Wheat(Husked),2016,1543,1543,0,0.0
Pune-Manjri,Ambat Chuka,2016,990,990,0,0.0
Patur,WHEAT(HUSKED),2016,1900,1900,0,0.0
Patur,Gram,2016,4000,4000,0,0.0
Pune-Moshi,Parwar,2016,1500,1500,0,0.0
Parshiwani,Brinjal,2016,800,800,0,0.0
Parola,GRAM,2016,8050,8050,0,0.0
Parola,Gram,2016,3067,3067,0,0.0
Parola,Green Gram,2016,4000,4000,0,0.0
Parola,Green Gram,2016,4400,4400,0,0.0
Parola,Maize,2016,1641,1641,0,0.0
Parola,Pigeon Pea (Tur),2016,6377,6377,0,0.0
Parola,Pigeon Pea (Tur),2016,7000,7000,0,0.0
Parola,WHEAT(HUSKED),2016,1667,1667,0,0.0
Parola,Wheat(Husked),2016,1466,1466,0,0.0
Solapur,Kanda Pat,2016,400,400,0,0.0
Solapur,Green Peas (Dry),2016,3850,3850,0,0.0
Parshiwani,Chavli (Shenga ),2016,2000,2000,0,0.0
Parshiwani,Coriander  ,2016,10000,10000,0,0.0
Parshiwani,Cotton,2016,5051,5051,0,0.0
Parshiwani,Tomato,2016,2500,2500,0,0.0
Partur,Black Gram,2014,4450,4450,0,0.0
Partur,Black Gram,2015,7600,7600,0,0.0
Partur,Neem-Seed,2015,450,450,0,0.0
Solapur,Ground Nut Pods (Dry),2016,5500,5500,0,0.0
Solapur,Ground Nut Pods (Dry),2016,4600,4600,0,0.0
Pune-Manjri,Ambat Chuka,2016,1031,1031,0,0.0
Pune-Manjri,BEET ROOT,2016,3000,3000,0,0.0
Pune-Manjri,Beet Root,2016,600,600,0,0.0
Pune-Manjri,Zendu,2016,3000,3000,0,0.0
Pune-Manjri,MINT,2016,1757,1757,0,0.0
Pune-Manjri,Mint,2016,1800,1800,0,0.0
Pune-Manjri,Mint,2016,1800,1800,0,0.0
Pune-Manjri,NOLKOL,2016,3000,3000,0,0.0
Pune-Manjri,Nolkol,2016,3000,3000,0,0.0
Pune-Manjri,Nolkol,2016,3000,3000,0,0.0
Pune-Manjri,OTHER VEGETABLES,2016,1800,1800,0,0.0
Pune-Manjri,Other Vegetables,2016,1800,1800,0,0.0
Pune-Manjri,Other Vegetables,2016,1800,1800,0,0.0
Pune-Moshi,CHAVLI (PALA),2016,2000,2000,0,0.0
Pune-Manjri,Beet Root,2016,3000,3000,0,0.0
Pune-Moshi,Curry Leaves,2016,2500,2500,0,0.0
Pune-Moshi,Curry Leaves,2016,2000,2000,0,0.0
Pune-Moshi,ELEPHANT ROOT,2016,2250,2250,0,0.0
Pune-Moshi,Elephant Root,2016,2500,2500,0,0.0
Pune-Moshi,Green-Peas,2016,6275,6275,0,0.0
Pune-Moshi,Mango(Raw),2016,3333,3333,0,0.0
Pune-Moshi,Methi (Bhaji),2016,8,8,0,0.0
Pune-Moshi,Mint,2016,5,5,0,0.0
Pune-Moshi,Mint,2016,5,5,0,0.0
Pune-Manjri,MAIZE(CORN.),2016,1000,1000,0,0.0
Pune-Manjri,Lemon,2016,600,600,0,0.0
Pune-Manjri,Lemon,2016,600,600,0,0.0
Pune-Manjri,Lemon,2016,600,600,0,0.0
Pune-Manjri,CARROT,2016,1000,1000,0,0.0
Pune-Manjri,Curry Leaves,2016,4500,4500,0,0.0
Pune-Manjri,Curry Leaves,2016,4500,4500,0,0.0
Pune-Manjri,GOOSEFOOT,2016,985,985,0,0.0
Pune-Manjri,GROUND NUT PODS (DRY),2016,3500,3500,0,0.0
Pune-Manjri,Ghevda,2016,2700,2700,0,0.0
Pune-Manjri,Goosefoot,2016,1000,1000,0,0.0
Pune-Manjri,Goosefoot,2016,865,865,0,0.0
Pune-Manjri,Goosefoot,2016,826,826,0,0.0
Pune-Manjri,Green-Peas,2016,7525,7525,0,0.0
Pune-Manjri,HEMP,2016,844,844,0,0.0
Pune-Manjri,Harbara(Bhaji),2016,5300,5300,0,0.0
Pune-Manjri,Harbara(Bhaji),2016,1260,1260,0,0.0
Pune-Manjri,Harbara(Pendi),2016,1200,1200,0,0.0
Pune-Manjri,Hemp,2016,796,796,0,0.0
Pune-Manjri,Hemp,2016,983,983,0,0.0
Pune-Manjri,Kardai,2016,843,843,0,0.0
Pune-Manjri,Kardai,2016,831,831,0,0.0
Pune-Manjri,LEMON,2016,667,667,0,0.0
Ramtek,Pigeon Pea (Tur),2015,6967,6967,0,0.0
Ramtek,Rice(Paddy-Hus),2015,1550,1550,0,0.0
Ramtek,Soybean,2015,3100,3100,0,0.0
Shirpur,Matki,2016,5000,5000,0,0.0
Shirpur,Black Gram,2016,7900,7900,0,0.0
Shirpur,Black Gram,2016,11192,11192,0,0.0
Shirpur,Castor Seed,2016,2801,2801,0,0.0
Shirpur,Chillies(Red),2016,1111,1111,0,0.0
Shirpur,Cowpea,2016,4676,4676,0,0.0
Shirpur,Green Gram,2016,7200,7200,0,0.0
Shirpur,Green Gram,2016,5642,5642,0,0.0
Shirpur,Matki,2016,3983,3983,0,0.0
Shirpur,Matki,2016,3050,3050,0,0.0
Shirpur,Matki,2016,4401,4401,0,0.0
Shirpur,Black Gram,2016,12900,12900,0,0.0
Sillod-Bharadi,Castor Seed,2016,2750,2750,0,0.0
Sillod-Bharadi,Castor Seed,2016,2700,2700,0,0.0
Shirpur,Pigeon Pea (Tur),2016,4600,4600,0,0.0
Shirpur,Pigeon Pea (Tur),2016,4750,4750,0,0.0
Shirpur,Sesamum,2016,4101,4101,0,0.0
Sillod-Bharadi,Bajri,2016,1301,1301,0,0.0
Shirpur,Sesamum,2016,5300,5300,0,0.0
Shirpur,Sesamum,2016,5300,5300,0,0.0
Shirpur,Sesamum,2016,5467,5467,0,0.0
Shirpur,Black Gram,2016,11050,11050,0,0.0
Sillod-Bharadi,Green Gram,2016,6501,6501,0,0.0
Shirur,Castor Seed,2014,3800,3800,0,0.0
Shirpur,Matki,2015,5511,5511,0,0.0
Shirpur,Cotton,2015,4100,4100,0,0.0
Shirpur,Cotton,2015,3999,3999,0,0.0
Shirpur,Cotton,2015,4100,4100,0,0.0
Shirpur,Cowpea,2015,4257,4257,0,0.0
Shirpur,Cowpea,2015,4200,4200,0,0.0
Sillod-Bharadi,Mustard,2016,4159,4159,0,0.0
Sillod-Bharadi,Mustard,2016,4000,4000,0,0.0
Shirpur,Cowpea,2015,2251,2251,0,0.0
Shirpur,Cowpea,2015,4313,4313,0,0.0
Shirpur,Matki,2015,7600,7600,0,0.0
Shirpur,Black Gram,2016,13500,13500,0,0.0
Shirpur,Pigeon Pea (Tur),2015,7010,7010,0,0.0
Shirpur,Pigeon Pea (Tur),2015,5156,5156,0,0.0
Shirpur,Pigeon Pea (Tur),2015,9101,9101,0,0.0
Shirpur,Pigeon Pea (Tur),2015,6800,6800,0,0.0
Shirpur,Sesamum,2015,7051,7051,0,0.0
Shirpur,Sesamum,2015,7200,7200,0,0.0
Shirpur,Sesamum,2015,5767,5767,0,0.0
Shirpur,Sunflower,2015,2850,2850,0,0.0
Shirpur,Black Gram,2016,11900,11900,0,0.0
Shirpur,Sunflower,2016,2500,2500,0,0.0
Shirur,Cowpea,2014,2700,2700,0,0.0
Sillod-Bharadi,Pigeon Pea (Tur),2016,7766,7766,0,0.0
Shirur,Green Gram,2015,7000,7000,0,0.0
Shirur,Castor Seed,2015,3200,3200,0,0.0
Shirur,Castor Seed,2015,3000,3000,0,0.0
Shirur,Castor Seed,2015,3000,3000,0,0.0
Shirur,Chillies(Red),2015,6000,6000,0,0.0
Shirur,Chillies(Red),2015,2000,2000,0,0.0
Shirur,Coriander (Dry),2015,8000,8000,0,0.0
Shirur,Coriander (Dry),2015,8400,8400,0,0.0
Shirur,Cowpea,2015,2700,2700,0,0.0
Shirur,Cowpea,2015,5075,5075,0,0.0
Shirur,Green Gram,2015,6360,6360,0,0.0
Shirur,Castor Seed,2015,2900,2900,0,0.0
Shirur,Green Gram,2015,5944,5944,0,0.0
Shirur,Green Peas (Dry),2015,2000,2000,0,0.0
Shirur,Ground Nut Pods (Dry),2015,2800,2800,0,0.0
Shirur,Ground Nut Pods (Dry),2015,3745,3745,0,0.0
Shirur,Ground Nut Pods (Dry),2015,4100,4100,0,0.0
Shirur,Ground Nut Pods (Dry),2015,2925,2925,0,0.0
Shirur,Ground Nut Pods (Dry),2015,3313,3313,0,0.0
Shirur,Ground Nut Pods (Dry),2015,2860,2860,0,0.0
Shirur,Ground Nut Pods (Dry),2015,3200,3200,0,0.0
Shirur,Castor Seed,2015,3400,3400,0,0.0
Sillod-Bharadi,Bajri,2015,1175,1175,0,0.0
Shirur,Cowpea,2014,2300,2300,0,0.0
Shirur,Soybean,2014,3100,3100,0,0.0
Shirur,Green Gram,2014,6200,6200,0,0.0
Shirur,Ground Nut Pods (Dry),2014,2775,2775,0,0.0
Shirur,Ground Nut Pods (Dry),2014,2800,2800,0,0.0
Shirur,Indian Bean,2014,3100,3100,0,0.0
Sillod-Bharadi,Wheat(Husked),2015,1533,1533,0,0.0
Shirur,Maize,2014,1210,1210,0,0.0
Shirur,Pigeon Pea (Tur),2014,3400,3400,0,0.0
Shirur,Pigeon Pea (Tur),2014,3000,3000,0,0.0
Shirur,Soybean,2014,3100,3100,0,0.0
Sillod-Bharadi,Sorgum(Jawar),2015,1125,1125,0,0.0
Shirur,Black Gram,2015,6743,6743,0,0.0
Shirur,Soybean,2014,2900,2900,0,0.0
Sillod-Bharadi,Safflower,2015,2171,2171,0,0.0
Sillod-Bharadi,Maize,2015,1340,1340,0,0.0
Shirur,Bajri,2015,1376,1376,0,0.0
Shirur,Black Gram,2015,5750,5750,0,0.0
Shirur,Black Gram,2015,7100,7100,0,0.0
Shirur,Black Gram,2015,6800,6800,0,0.0
Shirur,Black Gram,2015,7200,7200,0,0.0
Sillod-Bharadi,Black Gram,2015,5600,5600,0,0.0
Shirpur,Chillies(Red),2015,6200,6200,0,0.0
Shirpur,Black Gram,2015,6500,6500,0,0.0
Ramtek,Soybean,2015,3100,3100,0,0.0
Shegaon,Sesamum,2016,6087,6087,0,0.0
Shegaon,Mustard,2016,3292,3292,0,0.0
Shegaon,Mustard,2016,2838,2838,0,0.0
Shegaon,Mustard,2016,3236,3236,0,0.0
Shegaon,Mustard,2016,3075,3075,0,0.0
Shegaon,Mustard,2016,3350,3350,0,0.0
Shegaon,Mustard,2016,3223,3223,0,0.0
Shegaon,Mustard,2016,3200,3200,0,0.0
Shegaon,SESAMUM,2016,4450,4450,0,0.0
Shegaon,Sesamum,2016,5500,5500,0,0.0
Shegaon,Sesamum,2016,4750,4750,0,0.0
Shegaon,Maize,2016,1151,1151,0,0.0
Shegaon,Sesamum,2016,5000,5000,0,0.0
Shegaon,Sesamum,2016,5500,5500,0,0.0
Shegaon,Sesamum,2016,6000,6000,0,0.0
Shegaon,Sunflower,2016,3063,3063,0,0.0
Shegaon,Sunflower,2016,3030,3030,0,0.0
Shegaon,Thymol/Lovage,2016,11417,11417,0,0.0
Shegaon,Thymol/Lovage,2016,9943,9943,0,0.0
Shevgaon,Maize,2014,1000,1000,0,0.0
Shevgaon,Soybean,2014,3113,3113,0,0.0
Shegaon,Maize,2016,1154,1154,0,0.0
Shegaon,Maize,2016,1150,1150,0,0.0
Sindi,Cotton,2014,3950,3950,0,0.0
Shegaon,Bajri,2016,1508,1508,0,0.0
Shegaon,Sunflower,2015,3134,3134,0,0.0
Shegaon,Sunflower,2015,3250,3250,0,0.0
Shegaon,Sunflower,2015,2940,2940,0,0.0
Shegaon,Sunflower,2015,2917,2917,0,0.0
Shegaon,Sunflower,2015,3030,3030,0,0.0
Shegaon,Sunflower,2015,3105,3105,0,0.0
Shegaon,Sunflower,2015,2843,2843,0,0.0
Shegaon,BAJRI,2016,1190,1190,0,0.0
Shegaon,Bajri,2016,1350,1350,0,0.0
Shegaon,Bajri,2016,1383,1383,0,0.0
Shegaon,Maize,2016,1144,1144,0,0.0
Shegaon,Bajri,2016,1350,1350,0,0.0
Shegaon,Bajri,2016,1270,1270,0,0.0
Shegaon,Bajri,2016,1200,1200,0,0.0
Shegaon,Bajri,2016,1617,1617,0,0.0
Shegaon,Black Gram,2016,5500,5500,0,0.0
Shegaon,Black Gram,2016,6405,6405,0,0.0
Shegaon,Green Gram,2016,6720,6720,0,0.0
Shegaon,MAIZE,2016,1025,1025,0,0.0
Shegaon,Maize,2016,1448,1448,0,0.0
Sindi,Gram,2014,2245,2245,0,0.0
Shevgaon,Maize,2015,1250,1250,0,0.0
Shirpur,Black Gram,2015,5607,5607,0,0.0
Sillod-Bharadi,Sorgum(Jawar),2016,1350,1350,0,0.0
Sillod-Bharadi,Sunflower,2016,3400,3400,0,0.0
Shevgaon-Bodhegaon,SOYBEAN,2016,2650,2650,0,0.0
Shirpur,Cowpea,2014,5200,5200,0,0.0
Shirpur,Cowpea,2014,4300,4300,0,0.0
Shirpur,Matki,2014,6175,6175,0,0.0
Shirpur,Matki,2014,5676,5676,0,0.0
Shirpur,Pigeon Pea (Tur),2014,3500,3500,0,0.0
Shirpur,Pigeon Pea (Tur),2014,3400,3400,0,0.0
Shirpur,Pigeon Pea (Tur),2014,3901,3901,0,0.0
Sillod-Bharadi,Sorgum(Jawar),2016,1400,1400,0,0.0
Shevgaon-Bodhegaon,Pigeon Pea (Tur),2016,6067,6067,0,0.0
Sillod-Bharadi,Sorgum(Jawar),2016,1251,1251,0,0.0
Sillod-Bharadi,Sorgum(Jawar),2016,1250,1250,0,0.0
Shirpur,Black Gram,2015,6465,6465,0,0.0
Shirpur,Black Gram,2015,6925,6925,0,0.0
Shirpur,Black Gram,2015,7800,7800,0,0.0
Shirpur,Black Gram,2015,7934,7934,0,0.0
Sillod-Bharadi,Safflower,2016,2421,2421,0,0.0
Sillod-Bharadi,Safflower,2016,2301,2301,0,0.0
Sillod-Bharadi,Safflower,2016,2375,2375,0,0.0
Shevgaon-Bodhegaon,Pigeon Pea (Tur),2016,5800,5800,0,0.0
Shevgaon-Bodhegaon,Matki,2016,7000,7000,0,0.0
Shevgaon,Maize,2015,1375,1375,0,0.0
Shevgaon-Bodhegaon,Pigeon Pea (Tur),2014,4000,4000,0,0.0
Shevgaon,Maize,2015,1400,1400,0,0.0
Shevgaon,Soybean,2015,3400,3400,0,0.0
Shevgaon,Black Gram,2016,5000,5000,0,0.0
Shevgaon,Maize,2016,1325,1325,0,0.0
Shevgaon,Maize,2016,1150,1150,0,0.0
Shevgaon,Pigeon Pea (Tur),2016,8200,8200,0,0.0
Shevgaon,Pigeon Pea (Tur),2016,8200,8200,0,0.0
Shevgaon,Pigeon Pea (Tur),2016,6000,6000,0,0.0
Shevgaon-Bodhegaon,Pigeon Pea (Tur),2014,4900,4900,0,0.0
Shevgaon-Bodhegaon,Wheat(Husked),2014,1497,1497,0,0.0
Shevgaon-Bodhegaon,Maize,2016,1450,1450,0,0.0
Shevgaon-Bodhegaon,Gram,2015,3500,3500,0,0.0
Shevgaon-Bodhegaon,Gram,2015,3625,3625,0,0.0
Shevgaon-Bodhegaon,Gram,2015,4100,4100,0,0.0
Shevgaon-Bodhegaon,Maize,2015,1400,1400,0,0.0
Sillod-Bharadi,Wheat(Husked),2016,1655,1655,0,0.0
Shevgaon-Bodhegaon,Matki,2015,9233,9233,0,0.0
Shevgaon-Bodhegaon,Pigeon Pea (Tur),2015,5400,5400,0,0.0
Shevgaon-Bodhegaon,Wheat(Husked),2015,1542,1542,0,0.0
Shevgaon-Bodhegaon,MAIZE,2016,1313,1313,0,0.0
Shirur,Ground Nut Pods (Dry),2015,3967,3967,0,0.0
Shirur,Indian Bean,2015,2300,2300,0,0.0
Shirur,Indian Bean,2015,2943,2943,0,0.0
Shrirampur-Belapur,Maize,2016,1150,1150,0,0.0
Shrirampur-Belapur,Sorgum(Jawar),2016,1600,1600,0,0.0
Shrirampur-Belapur,Sorgum(Jawar),2016,1375,1375,0,0.0
Shrirampur-Belapur,Sorgum(Jawar),2016,1700,1700,0,0.0
Shrirampur-Belapur,Sorgum(Jawar),2016,1500,1500,0,0.0
Shrirampur-Belapur,Sorgum(Jawar),2016,1367,1367,0,0.0
Shrirampur-Belapur,Sorgum(Jawar),2016,1546,1546,0,0.0
Shrirampur-Belapur,Sorgum(Jawar),2016,1500,1500,0,0.0
Shrirampur,Green Gram,2015,6867,6867,0,0.0
Shrirampur,Green Gram,2015,7380,7380,0,0.0
Shrirampur-Belapur,Maize,2016,1225,1225,0,0.0
Shrirampur-Belapur,Sorgum(Jawar),2016,1600,1600,0,0.0
Shrirampur-Belapur,Maize,2016,1775,1775,0,0.0
Shrirampur,Green Gram,2015,6826,6826,0,0.0
Shrirampur,Green Gram,2015,7800,7800,0,0.0
Shrirampur,Green Gram,2015,7603,7603,0,0.0
Shrirampur,Maize,2015,1313,1313,0,0.0
Shrirampur-Belapur,Green Gram,2016,4517,4517,0,0.0
Shrirampur-Belapur,Green Gram,2016,4150,4150,0,0.0
Shrirampur,Mustard,2015,3500,3500,0,0.0
Shrirampur-Belapur,Gram,2016,3667,3667,0,0.0
Shrirampur-Belapur,Sorgum(Jawar),2016,1317,1317,0,0.0
Shrirampur-Belapur,Soybean,2016,3517,3517,0,0.0
Shrirampur-Belapur,Gram,2016,4656,4656,0,0.0
Shrirampur,Black Gram,2015,8933,8933,0,0.0
Shrigonda-Ghogargaon,Cotton,2015,4421,4421,0,0.0
Shrigonda-Ghogargaon,Cotton,2016,4586,4586,0,0.0
Shrirampur,Fenugreek,2014,3526,3526,0,0.0
Shrirampur,Green Gram,2014,7200,7200,0,0.0
Shrirampur,Ground Nut Pods (Dry),2014,3000,3000,0,0.0
Shrirampur,Pigeon Pea (Tur),2014,3733,3733,0,0.0
Shrirampur,Rice(Paddy-Hus),2014,1017,1017,0,0.0
Shrirampur,Soybean,2014,3188,3188,0,0.0
Shrirampur,Black Gram,2015,8200,8200,0,0.0
Shrirampur,Black Gram,2015,7500,7500,0,0.0
Shrirampur-Belapur,Soybean,2016,3483,3483,0,0.0
Shrirampur,Cowpea,2015,4100,4100,0,0.0
Shrirampur,Fenugreek,2015,3400,3400,0,0.0
Shrirampur,Fenugreek,2015,4600,4600,0,0.0
Shrirampur,Fenugreek,2015,4100,4100,0,0.0
Shrirampur,Fenugreek,2015,5400,5400,0,0.0
Shrirampur,Fenugreek,2015,5576,5576,0,0.0
Shrirampur,Green Gram,2015,7126,7126,0,0.0
Shrirampur,Green Gram,2015,5051,5051,0,0.0
Shrirampur-Belapur,Soybean,2016,3100,3100,0,0.0
Shrirampur-Belapur,Gram,2016,4500,4500,0,0.0
Shrirampur-Belapur,Gram,2016,3800,3800,0,0.0
Shirur,Indian Bean,2015,2267,2267,0,0.0
Shrirampur,Green Gram,2016,7001,7001,0,0.0
Shrirampur,Cowpea,2016,4500,4500,0,0.0
Shrirampur,Cowpea,2016,4301,4301,0,0.0
Shrirampur,Fenugreek,2016,4021,4021,0,0.0
Shrirampur,Green Gram,2016,7401,7401,0,0.0
Shrirampur-Belapur,Bajri,2015,1250,1250,0,0.0
Shrirampur-Belapur,Bajri,2015,1367,1367,0,0.0
Shrirampur-Belapur,Bajri,2015,1200,1200,0,0.0
Shrirampur-Belapur,Bajri,2015,1325,1325,0,0.0
Shrirampur,Green Gram,2016,6301,6301,0,0.0
Shrirampur,Maize,2016,1425,1425,0,0.0
Shrirampur,Black Gram,2016,5900,5900,0,0.0
Shrirampur,Maize,2016,1457,1457,0,0.0
Shrirampur,Maize,2016,1400,1400,0,0.0
Shrirampur,Maize,2016,1400,1400,0,0.0
Shrirampur,Mustard,2016,3960,3960,0,0.0
Shrirampur,Pigeon Pea (Tur),2016,5700,5700,0,0.0
Shrirampur,Pigeon Pea (Tur),2016,5001,5001,0,0.0
Shrirampur,Safflower,2016,2400,2400,0,0.0
Shrirampur,Safflower,2016,2500,2500,0,0.0
Shrirampur,Soybean,2016,3926,3926,0,0.0
Shrirampur,Cowpea,2016,5002,5002,0,0.0
Shrirampur,Black Gram,2016,11500,11500,0,0.0
Shrirampur-Belapur,Gram,2016,4300,4300,0,0.0
Shrirampur-Belapur,Bajri,2016,1400,1400,0,0.0
Shrirampur,Mustard,2015,3726,3726,0,0.0
Shrirampur,Pigeon Pea (Tur),2015,4500,4500,0,0.0
Shrirampur,Pigeon Pea (Tur),2015,4675,4675,0,0.0
Shrirampur-Belapur,GREEN GRAM,2016,4033,4033,0,0.0
Shrirampur-Belapur,GRAM,2016,5725,5725,0,0.0
Shrirampur-Belapur,Black Gram,2016,5000,5000,0,0.0
Shrirampur-Belapur,Bajri,2016,1500,1500,0,0.0
Shrirampur-Belapur,Bajri,2016,1500,1500,0,0.0
Shrirampur-Belapur,Bajri,2016,1300,1300,0,0.0
Shrirampur-Belapur,Bajri,2016,1756,1756,0,0.0
Shrirampur,Black Gram,2016,7000,7000,0,0.0
Shrirampur,Pigeon Pea (Tur),2015,6401,6401,0,0.0
Shrirampur,Rice(Paddy-Hus),2015,1172,1172,0,0.0
Shrirampur,Rice(Paddy-Hus),2015,1300,1300,0,0.0
Shrirampur,Safflower,2015,2401,2401,0,0.0
Shrirampur,Safflower,2015,2601,2601,0,0.0
Shrirampur,Sesamum,2015,12100,12100,0,0.0
Shrirampur-Belapur,Sorgum(Jawar),2015,1000,1000,0,0.0
Shrirampur-Belapur,Sorgum(Jawar),2015,1180,1180,0,0.0
Shrirampur,Soybean,2015,3780,3780,0,0.0
Shrigonda-Ghogargaon,Cotton,2015,4277,4277,0,0.0
Shrigonda-Ghogargaon,Cotton,2015,3850,3850,0,0.0
Shrigonda-Ghogargaon,Cotton,2015,4329,4329,0,0.0
Shirur,Ground Nut Pods (Dry),2016,4350,4350,0,0.0
Shirur,Cowpea,2016,4750,4750,0,0.0
Shirur,Cowpea,2016,4000,4000,0,0.0
Shirur,GRAM,2016,6600,6600,0,0.0
Shirur,GROUND NUT PODS (DRY),2016,4600,4600,0,0.0
Shirur,Green Gram,2016,6992,6992,0,0.0
Shirur,Green Gram,2016,6800,6800,0,0.0
Shirur,Green Gram,2016,5067,5067,0,0.0
Shirur,Green Gram,2016,7000,7000,0,0.0
Shirur,Ground Nut Pods (Dry),2016,3750,3750,0,0.0
Shirur,Ground Nut Pods (Dry),2016,3400,3400,0,0.0
Shirur,Cowpea,2016,4500,4500,0,0.0
Shirur,Ground Nut Pods (Dry),2016,3625,3625,0,0.0
Shirur,Ground Nut Pods (Dry),2016,4000,4000,0,0.0
Shirur,Ground Nut Pods (Dry),2016,3542,3542,0,0.0
Shirur,Ground Nut Pods (Dry),2016,4000,4000,0,0.0
Shirur,Ground Nut Pods (Dry),2016,3867,3867,0,0.0
Shirur,Horse Gram,2016,2000,2000,0,0.0
Shirur,Indian Bean,2016,4200,4200,0,0.0
Shirur,Indian Bean,2016,3000,3000,0,0.0
Shirur,Indian Bean,2016,2800,2800,0,0.0
Shirur,Cowpea,2016,6867,6867,0,0.0
Shirur,Cowpea,2016,4500,4500,0,0.0
Shrigonda-Ghogargaon,Cotton,2014,4091,4091,0,0.0
Shirur,Soybean,2015,3000,3000,0,0.0
Shirur,Indian Bean,2015,3500,3500,0,0.0
Shirur,Indian Bean,2015,2450,2450,0,0.0
Shirur,Maize,2015,1466,1466,0,0.0
Shirur,Pigeon Pea (Tur),2015,3900,3900,0,0.0
Shirur,Pigeon Pea (Tur),2015,4410,4410,0,0.0
Shirur,Pigeon Pea (Tur),2015,4000,4000,0,0.0
Shirur,Pigeon Pea (Tur),2015,4267,4267,0,0.0
Shirur,Safflower,2015,2500,2500,0,0.0
Shirur,Soybean,2015,3000,3000,0,0.0
Shirur,Soybean,2015,2800,2800,0,0.0
Shirur,Cowpea,2016,5300,5300,0,0.0
Shirur,Soybean,2015,3400,3400,0,0.0
Shirur,Soybean,2015,3307,3307,0,0.0
Shirur,Soybean,2015,3100,3100,0,0.0
Shirur,Tamarind,2015,1967,1967,0,0.0
Shirur,BLACK GRAM,2016,4000,4000,0,0.0
Shirur,Black Gram,2016,8500,8500,0,0.0
Shirur,Black Gram,2016,5725,5725,0,0.0
Shirur,Castor Seed,2016,2900,2900,0,0.0
Shirur,Castor Seed,2016,2800,2800,0,0.0
Shirur,Indian Bean,2016,4150,4150,0,0.0
Shirur,Indian Bean,2016,3450,3450,0,0.0
Shirur,Indian Bean,2016,3550,3550,0,0.0
Shrigonda,Ground Nut Pods (Dry),2016,5560,5560,0,0.0
Shrigonda,Cotton,2015,3950,3950,0,0.0
Shrigonda,Ground Nut Pods (Dry),2015,3000,3000,0,0.0
Shrigonda,Bajri,2016,1925,1925,0,0.0
Shrigonda,Cowpea,2016,6050,6050,0,0.0
Shrigonda,Cowpea,2016,5250,5250,0,0.0
Shrigonda,GREEN GRAM,2016,5000,5000,0,0.0
Shrigonda,Green Gram,2016,5100,5100,0,0.0
Shrigonda,Green Gram,2016,7200,7200,0,0.0
Shrigonda,Ground Nut Pods (Dry),2016,5700,5700,0,0.0
Shrigonda,Ground Nut Pods (Dry),2016,5450,5450,0,0.0
Shirur,Jaggery,2016,2250,2250,0,0.0
Shrigonda,Ground Nut Pods (Dry),2016,4275,4275,0,0.0
Shrigonda,Maize,2016,1483,1483,0,0.0
Shrigonda,Maize,2016,1700,1700,0,0.0
Shrigonda,Maize,2016,1600,1600,0,0.0
Shrigonda,Onion,2016,500,500,0,0.0
Shrigonda,Soybean,2016,3000,3000,0,0.0
Shrigonda,Sunflower,2016,3800,3800,0,0.0
Shrigonda,Sunflower,2016,3750,3750,0,0.0
Shrigonda,Tamarind,2016,2500,2500,0,0.0
Shrigonda,Cotton,2014,4100,4100,0,0.0
Shrigonda,Cotton,2014,4094,4094,0,0.0
Shirur,Tamarind,2016,4700,4700,0,0.0
Shirur,Soybean,2016,3800,3800,0,0.0
Shirur,Maize,2016,1364,1364,0,0.0
Shirur,Maize,2016,1592,1592,0,0.0
Shirur,Maize,2016,1575,1575,0,0.0
Shirur,Maize,2016,1700,1700,0,0.0
Shirur,Maize,2016,1946,1946,0,0.0
Shirur,Maize,2016,1700,1700,0,0.0
Shirur,PIGEON PEA (TUR),2016,4300,4300,0,0.0
Shirur,Pigeon Pea (Tur),2016,4700,4700,0,0.0
Shirur,Pigeon Pea (Tur),2016,7300,7300,0,0.0
Shirur,Pigeon Pea (Tur),2016,7000,7000,0,0.0
Shirur,Pigeon Pea (Tur),2016,6350,6350,0,0.0
Shirur,Pigeon Pea (Tur),2016,4400,4400,0,0.0
Shirur,Rajgira,2016,4000,4000,0,0.0
Shirur,SUNFLOWER,2016,2600,2600,0,0.0
Shirur,Safflower,2016,2900,2900,0,0.0
Shirur,Soybean,2016,3134,3134,0,0.0
Shirur,Soybean,2016,3050,3050,0,0.0
Shirur,Soybean,2016,3215,3215,0,0.0
Shirur,Soybean,2016,3267,3267,0,0.0
Shegaon,Sesamum,2015,7250,7250,0,0.0
Shegaon,Sesamum,2015,5961,5961,0,0.0
Shegaon,Sesamum,2015,7583,7583,0,0.0
Sakri,Matki,2014,5001,5001,0,0.0
Sailu,Green Gram,2016,4308,4308,0,0.0
Sailu,WHEAT(HUSKED),2016,2125,2125,0,0.0
Sailu,Wheat(Husked),2016,1650,1650,0,0.0
Sakri,Gram,2014,2286,2286,0,0.0
Sakri,Green Gram,2014,5980,5980,0,0.0
Sakri,Horse Gram,2014,800,800,0,0.0
Sakri,Horse Gram,2014,1125,1125,0,0.0
Sakri,Maize,2014,1015,1015,0,0.0
Sakri,Maize,2014,1151,1151,0,0.0
Sakri,Pigeon Pea (Tur),2014,3030,3030,0,0.0
Sailu,Bajri,2016,1611,1611,0,0.0
Sakri,Sorgum(Jawar),2014,1111,1111,0,0.0
Sakri,Soybean,2014,2843,2843,0,0.0
Sakri,Bajri,2015,1251,1251,0,0.0
Sakri,Green Gram,2015,7493,7493,0,0.0
Sakri,Ground Nut Pods (Dry),2015,4242,4242,0,0.0
Sakri,Horse Gram,2015,1192,1192,0,0.0
Sakri,Matki,2015,6675,6675,0,0.0
Sakri,Sesamum,2015,7000,7000,0,0.0
Sakri,Sesamum,2015,7777,7777,0,0.0
Sailu,Bajri,2016,1201,1201,0,0.0
Sinner,Sunflower,2015,2600,2600,0,0.0
Sinner,Rice(Paddy-Hus),2015,2651,2651,0,0.0
Sailu,Black Gram,2014,4513,4513,0,0.0
Sinner,Castor Seed,2016,2900,2900,0,0.0
Roha,PADDY-UNHUSKED,2016,1510,1510,0,0.0
Sinner,Black Gram,2016,7076,7076,0,0.0
Sinner,Black Gram,2016,7400,7400,0,0.0
Sadak Arjuni,PADDY-UNHUSKED,2016,1470,1470,0,0.0
Sinner,BLACK GRAM,2016,6455,6455,0,0.0
Sailu,Bajri,2014,1586,1586,0,0.0
Sailu,Bajri,2014,1600,1600,0,0.0
Sailu,Black Gram,2014,4101,4101,0,0.0
Sailu,Pigeon Pea (Tur),2014,4200,4200,0,0.0
Sailu,Wheat(Husked),2015,2050,2050,0,0.0
Sailu,Sorgum(Jawar),2014,1200,1200,0,0.0
Sailu,Wheat(Husked),2014,1509,1509,0,0.0
Sailu,Bajri,2015,1250,1250,0,0.0
Sailu,Bajri,2015,1551,1551,0,0.0
Sailu,Black Gram,2015,5500,5500,0,0.0
Sailu,Green Gram,2015,6100,6100,0,0.0
Sailu,Green Gram,2015,5200,5200,0,0.0
Sailu,Green Gram,2015,6150,6150,0,0.0
Sailu,Safflower,2015,2721,2721,0,0.0
Sinner,Rice(Paddy-Hus),2015,2600,2600,0,0.0
Sinner,Rice(Paddy-Hus),2015,1625,1625,0,0.0
Sangamner,Coriander (Dry),2015,12000,12000,0,0.0
Samudrapur,Wheat(Husked),2016,1400,1400,0,0.0
Sinner,Matki,2015,8233,8233,0,0.0
Sinner,Matki,2015,8500,8500,0,0.0
Sinner,Matki,2015,7601,7601,0,0.0
Sinner,Matki,2015,7510,7510,0,0.0
Sinner,Matki,2015,6351,6351,0,0.0
Sakri,Soybean,2016,3423,3423,0,0.0
Sakri,Soybean,2016,3486,3486,0,0.0
Sakri,Sunflower,2016,4444,4444,0,0.0
Samudrapur,Pigeon Pea (Tur),2015,12000,12000,0,0.0
Samudrapur,Wheat(Husked),2016,1485,1485,0,0.0
Sakri,Soybean,2016,3917,3917,0,0.0
Sangamner,Green Gram,2014,6000,6000,0,0.0
Sangamner,Horse Gram,2014,4600,4600,0,0.0
Sangamner,Maize,2014,1330,1330,0,0.0
Sangamner,Maize,2014,1359,1359,0,0.0
Sangamner,Maize,2014,1310,1310,0,0.0
Sinner,Horse Gram,2015,3900,3900,0,0.0
Sinner,Ground Nut Pods (Dry),2015,3500,3500,0,0.0
Sangamner,Matki,2014,4750,4750,0,0.0
Sangamner,Matki,2014,7000,7000,0,0.0
Sakri,Soybean,2016,3300,3300,0,0.0
Sakri,Sorgum(Jawar),2016,1186,1186,0,0.0
Sinner,Rice(Paddy-Hus),2015,1502,1502,0,0.0
Sakri,Gram,2016,3867,3867,0,0.0
Sakri,Sesamum,2015,7272,7272,0,0.0
Sakri,Sorgum(Jawar),2015,1133,1133,0,0.0
Sakri,Sorgum(Jawar),2015,1151,1151,0,0.0
Sakri,Sunflower,2015,2733,2733,0,0.0
Sakri,Bajri,2016,1351,1351,0,0.0
Sakri,Black Gram,2016,5151,5151,0,0.0
Sakri,Castor Seed,2016,3000,3000,0,0.0
Sakri,GRAM,2016,5555,5555,0,0.0
Sakri,GREEN GRAM,2016,4444,4444,0,0.0
Sakri,Gram,2016,5097,5097,0,0.0
Sakri,Sorgum(Jawar),2016,1139,1139,0,0.0
Sakri,Green Gram,2016,4723,4723,0,0.0
Sakri,Ground Nut Pods (Dry),2016,4517,4517,0,0.0
Sakri,Horse Gram,2016,5253,5253,0,0.0
Sakri,MATKI,2016,4926,4926,0,0.0
Sakri,Matki,2016,7001,7001,0,0.0
Sakri,Matki,2016,4444,4444,0,0.0
Sakri,RICE(PADDY-HUS),2016,2700,2700,0,0.0
Sakri,Sesamum,2016,5500,5500,0,0.0
Sakri,Sorgum(Jawar),2016,1450,1450,0,0.0
Sinner,Castor Seed,2016,2825,2825,0,0.0
Sinner,Castor Seed,2016,2930,2930,0,0.0
Sinner,Castor Seed,2016,2801,2801,0,0.0
Sinner,Safflower,2016,2700,2700,0,0.0
Sironcha,Maize,2016,1350,1350,0,0.0
Sironcha,Maize,2016,1400,1400,0,0.0
Sironcha,Cotton,2016,4114,4114,0,0.0
Sironcha,Chillies(Red),2016,14957,14957,0,0.0
Ramtek,Soybean,2016,2900,2900,0,0.0
Ramtek,Soybean,2016,3201,3201,0,0.0
Ramtek,Wheat(Husked),2016,1292,1292,0,0.0
Sinner,Tamarind,2016,2180,2180,0,0.0
Sinner,Sunflower,2016,3401,3401,0,0.0
Sinner,Safflower,2016,3200,3200,0,0.0
Sironcha,PADDY-UNHUSKED,2016,1713,1713,0,0.0
Sinner,Rice(Paddy-Hus),2016,2300,2300,0,0.0
Sinner,Rice(Paddy-Hus),2016,1700,1700,0,0.0
Sinner,Rice(Paddy-Hus),2016,1967,1967,0,0.0
Sinner,RICE(PADDY-HUS),2016,1700,1700,0,0.0
Raver,Bajri,2014,1238,1238,0,0.0
Sinner,Pigeon Pea (Tur),2016,5800,5800,0,0.0
Sinner,Pigeon Pea (Tur),2016,6617,6617,0,0.0
Sinner,Pigeon Pea (Tur),2016,6826,6826,0,0.0
Raver,Bajri,2014,1575,1575,0,0.0
Sironcha,Maize,2016,1338,1338,0,0.0
Sironcha,Paddy-Unhusked,2016,1438,1438,0,0.0
Sinner,Coriander (Dry),2016,9400,9400,0,0.0
Ramtek,PIGEON PEA (TUR),2016,4000,4000,0,0.0
Ramtek,Soybean,2015,3104,3104,0,0.0
Ramtek,Wheat(Husked),2015,1431,1431,0,0.0
Ramtek,Green Gram,2016,5400,5400,0,0.0
Ramtek,Linseed,2016,4001,4001,0,0.0
Ramtek,Linseed,2016,4400,4400,0,0.0
Ramtek,Mustard,2016,3200,3200,0,0.0
Ramtek,Oth.Split Pulses,2016,3820,3820,0,0.0
Ramtek,Other Pulses,2016,2900,2900,0,0.0
Ramtek,Other Pulses,2016,3276,3276,0,0.0
Ramtek,SOYBEAN,2016,2635,2635,0,0.0
Sironcha,Paddy-Unhusked,2016,1459,1459,0,0.0
Sironcha,Turmeric,2016,10000,10000,0,0.0
Sironcha,Rice(Paddy-Hus),2016,2000,2000,0,0.0
Sironcha,Rice(Paddy-Hus),2016,2000,2000,0,0.0
Sironcha,Rice(Paddy-Hus),2016,2000,2000,0,0.0
Sironcha,Rice(Paddy-Hus),2016,2000,2000,0,0.0
Sironcha,Rice(Paddy-Hus),2016,2000,2000,0,0.0
Ramtek,Soybean,2016,3101,3101,0,0.0
Sironcha,RICE(PADDY-HUS),2016,2000,2000,0,0.0
Sironcha,Paddy-Unhusked,2016,1450,1450,0,0.0
Raver,Black Gram,2014,4900,4900,0,0.0
Raver,Green Gram,2014,5929,5929,0,0.0
Raver,Bajri,2015,1726,1726,0,0.0
Sinner,Green Gram,2016,5500,5500,0,0.0
Raver,Black Gram,2016,7050,7050,0,0.0
Sinner,MATKI,2016,5100,5100,0,0.0
Raver,Black Gram,2016,9800,9800,0,0.0
Sinner,Ground Nut Pods (Dry),2016,5200,5200,0,0.0
Sinner,Ground Nut Pods (Dry),2016,5650,5650,0,0.0
Raver,Black Gram,2016,9610,9610,0,0.0
Raver,Black Gram,2016,11950,11950,0,0.0
Raver,GREEN GRAM,2016,3800,3800,0,0.0
Sinner,Green Gram,2016,5000,5000,0,0.0
Sinner,Green Gram,2016,6300,6300,0,0.0
Raver,Bajri,2015,1243,1243,0,0.0
Raver,Gram,2016,6415,6415,0,0.0
Raver,Green Gram,2016,3854,3854,0,0.0
Raver,Green Gram,2016,6255,6255,0,0.0
Raver,Green Gram,2016,5525,5525,0,0.0
Raver,Pigeon Pea (Tur),2016,4851,4851,0,0.0
Raver,Pigeon Pea (Tur),2016,7100,7100,0,0.0
Raver,Pigeon Pea (Tur),2016,4600,4600,0,0.0
Raver,RICE(PADDY-HUS),2016,1450,1450,0,0.0
Raver,Rice(Paddy-Hus),2016,1527,1527,0,0.0
Raver,Bajri,2016,1270,1270,0,0.0
Raver,Bajri,2016,1695,1695,0,0.0
Raver,Bajri,2016,1378,1378,0,0.0
Raver,Bajri,2016,1626,1626,0,0.0
Raver,Bajri,2015,1600,1600,0,0.0
Raver,Bajri,2015,1318,1318,0,0.0
Raver,Bajri,2015,1300,1300,0,0.0
Raver,Bajri,2015,1200,1200,0,0.0
Raver,Black Gram,2015,5200,5200,0,0.0
Raver,Gram,2015,5305,5305,0,0.0
Sinner,Mustard,2016,4001,4001,0,0.0
Sinner,Mustard,2016,4000,4000,0,0.0
Sinner,Matki,2016,5700,5700,0,0.0
Sinner,Matki,2016,4900,4900,0,0.0
Sinner,Matki,2016,5757,5757,0,0.0
Sinner,Matki,2016,6200,6200,0,0.0
Sinner,Matki,2016,5500,5500,0,0.0
Raver,Green Gram,2015,9550,9550,0,0.0
Raver,Pigeon Pea (Tur),2015,4271,4271,0,0.0
Raver,Pigeon Pea (Tur),2015,6560,6560,0,0.0
Sinner,Maize,2016,1964,1964,0,0.0
Sinner,Maize,2016,1640,1640,0,0.0
Raver,Bajri,2016,1554,1554,0,0.0
Sangamner,Soybean,2014,3500,3500,0,0.0
Sangamner,Green Gram,2015,6320,6320,0,0.0
Shegaon,Sesamum,2015,6943,6943,0,0.0
Shahada,Cowpea,2015,5200,5200,0,0.0
Shahada,Cotton,2014,4050,4050,0,0.0
Shahada,Green Gram,2014,6585,6585,0,0.0
Shahada,Pigeon Pea (Tur),2014,4801,4801,0,0.0
Shahada,Pigeon Pea (Tur),2014,2952,2952,0,0.0
Shahada,Bajri,2015,1210,1210,0,0.0
Shahada,Black Gram,2015,6076,6076,0,0.0
Shahada,Black Gram,2015,4999,4999,0,0.0
Shahada,Black Gram,2015,5418,5418,0,0.0
Shahada,Black Gram,2015,7601,7601,0,0.0
Shahada,Green Gram,2015,7100,7100,0,0.0
Sengaon,Wheat(Husked),2016,1500,1500,0,0.0
Shahada,Green Gram,2015,7025,7025,0,0.0
Shahada,Green Gram,2015,6199,6199,0,0.0
Shahada,Green Gram,2015,5630,5630,0,0.0
Shahada,Matki,2015,6300,6300,0,0.0
Shahada,Matki,2015,6400,6400,0,0.0
Shahada,Pigeon Pea (Tur),2015,5350,5350,0,0.0
Shahada,Pigeon Pea (Tur),2015,5026,5026,0,0.0
Shahada,Pigeon Pea (Tur),2015,7599,7599,0,0.0
Shahada,Sunflower,2015,3281,3281,0,0.0
Shahada,Black Gram,2014,4007,4007,0,0.0
Sengaon,Wheat(Husked),2016,1670,1670,0,0.0
Shahada,Bajri,2016,1500,1500,0,0.0
Sengaon,Sorgum(Jawar),2015,1600,1600,0,0.0
Savner,Maize,2016,1371,1371,0,0.0
Savner,Sorgum(Jawar),2016,1175,1175,0,0.0
Savner,Sorgum(Jawar),2016,1181,1181,0,0.0
Savner,Wheat(Husked),2016,1390,1390,0,0.0
Sengaon,Black Gram,2015,8675,8675,0,0.0
Sengaon,Green Gram,2015,6658,6658,0,0.0
Sengaon,Green Gram,2015,7000,7000,0,0.0
Sengaon,Sorgum(Jawar),2015,1590,1590,0,0.0
Sengaon,Sorgum(Jawar),2015,1578,1578,0,0.0
Sengaon,Sorgum(Jawar),2015,1550,1550,0,0.0
Sengaon,Wheat(Husked),2016,1550,1550,0,0.0
Sengaon,Wheat(Husked),2015,1700,1700,0,0.0
Sengaon,Wheat(Husked),2015,1521,1521,0,0.0
Sengaon,Wheat(Husked),2015,1538,1538,0,0.0
Sengaon,Black Gram,2016,6850,6850,0,0.0
Sengaon,Gram,2016,7100,7100,0,0.0
Sengaon,Green Gram,2016,5700,5700,0,0.0
Sengaon,Sorgum(Jawar),2016,1600,1600,0,0.0
Sengaon,Wheat(Husked),2016,1650,1650,0,0.0
Sengaon,Wheat(Husked),2016,1650,1650,0,0.0
Shahada,Bajri,2016,1638,1638,0,0.0
Shahada,Black Gram,2016,6526,6526,0,0.0
Sinner,Green Gram,2015,7251,7251,0,0.0
Shegaon,Maize,2015,900,900,0,0.0
Shegaon,Bajri,2015,1325,1325,0,0.0
Shegaon,Black Gram,2015,6421,6421,0,0.0
Shegaon,Maize,2015,1200,1200,0,0.0
Shegaon,Maize,2015,1050,1050,0,0.0
Shegaon,Maize,2015,1144,1144,0,0.0
Shegaon,Maize,2015,850,850,0,0.0
Shegaon,Maize,2015,1000,1000,0,0.0
Shegaon,Maize,2015,950,950,0,0.0
Shegaon,Maize,2015,1203,1203,0,0.0
Shegaon,Maize,2015,1250,1250,0,0.0
Shegaon,Bajri,2015,1183,1183,0,0.0
Shegaon,Mustard,2015,3367,3367,0,0.0
Shegaon,Mustard,2015,3167,3167,0,0.0
Shegaon,Safflower,2015,2200,2200,0,0.0
Shegaon,Safflower,2015,2650,2650,0,0.0
Shegaon,Safflower,2015,2600,2600,0,0.0
Shegaon,Sesamum,2015,7852,7852,0,0.0
Shegaon,Sesamum,2015,6050,6050,0,0.0
Shegaon,Sesamum,2015,5593,5593,0,0.0
Shegaon,Sesamum,2015,7765,7765,0,0.0
Shegaon,Bajri,2015,1000,1000,0,0.0
Shegaon,Bajri,2015,1125,1125,0,0.0
Shahada,Black Gram,2016,10800,10800,0,0.0
Shahada,Sorgum(Jawar),2016,1738,1738,0,0.0
Shahada,Cowpea,2016,5000,5000,0,0.0
Shahada,Cowpea,2016,2650,2650,0,0.0
Shahada,Cowpea,2016,5167,5167,0,0.0
Shahada,Green Gram,2016,6000,6000,0,0.0
Shahada,Green Gram,2016,5463,5463,0,0.0
Shahada,Maize,2016,1451,1451,0,0.0
Shahada,Maize,2016,1457,1457,0,0.0
Shahada,Matki,2016,6161,6161,0,0.0
Shahada,Pigeon Pea (Tur),2016,4900,4900,0,0.0
Shegaon,Bajri,2014,1220,1220,0,0.0
Shegaon,Bajri,2015,1123,1123,0,0.0
Shegaon,Maize,2014,1025,1025,0,0.0
Shegaon,Mustard,2014,2833,2833,0,0.0
Shegaon,Mustard,2014,2250,2250,0,0.0
Shegaon,Mustard,2014,2761,2761,0,0.0
Shegaon,Sesamum,2014,8500,8500,0,0.0
Shegaon,Thymol/Lovage,2014,6369,6369,0,0.0
Shegaon,Bajri,2015,1900,1900,0,0.0
Shegaon,Bajri,2015,1300,1300,0,0.0
Shegaon,Bajri,2015,1210,1210,0,0.0
Savner,Ground Nut Pods (Dry),2016,4500,4500,0,0.0
Savner,Cotton,2016,5051,5051,0,0.0
Savner,Cotton,2016,4700,4700,0,0.0
Sangamner,Maize,2016,1550,1550,0,0.0
Sangamner,Soybean,2015,3660,3660,0,0.0
Sangamner,Soybean,2015,3950,3950,0,0.0
Sangamner,Soybean,2015,3500,3500,0,0.0
Sangamner,Soybean,2015,3600,3600,0,0.0
Sangamner,Green Gram,2016,5801,5801,0,0.0
Sangamner,Green Gram,2016,7651,7651,0,0.0
Sangamner,Green Gram,2016,5900,5900,0,0.0
Sangamner,Green Gram,2016,7000,7000,0,0.0
Sangamner,MAIZE,2016,1400,1400,0,0.0
Sangamner,Maize,2016,1551,1551,0,0.0
Sinner,Black Gram,2015,7500,7500,0,0.0
Sangamner,Matki,2016,7000,7000,0,0.0
Sangamner,Matki,2016,5900,5900,0,0.0
Sangamner,Matki,2016,7100,7100,0,0.0
Sangamner,Matki,2016,7000,7000,0,0.0
Sangamner,Matki,2016,6701,6701,0,0.0
Sangamner,Matki,2016,6500,6500,0,0.0
Sangamner,Mustard,2016,4100,4100,0,0.0
Sinner,Sunflower,2014,3800,3800,0,0.0
Sangamner,PIGEON PEA (TUR),2016,5800,5800,0,0.0
Sangamner,Soybean,2015,4100,4100,0,0.0
Sinner,Black Gram,2015,9239,9239,0,0.0
Savner,Sorgum(Jawar),2015,1100,1100,0,0.0
Sangamner,Horse Gram,2015,3200,3200,0,0.0
Sinner,Green Gram,2015,7901,7901,0,0.0
Sangamner,Green Gram,2015,7500,7500,0,0.0
Sangamner,Green Gram,2015,6100,6100,0,0.0
Sangamner,Green Gram,2015,7300,7300,0,0.0
Sangamner,Green Gram,2015,6000,6000,0,0.0
Sangamner,Green Gram,2015,7500,7500,0,0.0
Sangamner,Green Gram,2015,5500,5500,0,0.0
Sangamner,Green Gram,2015,7625,7625,0,0.0
Sangamner,Green Gram,2015,7500,7500,0,0.0
Sangamner,Maize,2015,1450,1450,0,0.0
Sinner,Castor Seed,2015,3351,3351,0,0.0
Sangamner,Maize,2015,1310,1310,0,0.0
Sangamner,Maize,2015,1325,1325,0,0.0
Sangamner,Maize,2015,1353,1353,0,0.0
Sangamner,Maize,2015,1450,1450,0,0.0
Sangamner,Pigeon Pea (Tur),2015,6467,6467,0,0.0
Sinner,Garlic,2015,5803,5803,0,0.0
Sinner,Fenugreek,2015,3500,3500,0,0.0
Sangamner,Pigeon Pea (Tur),2015,10000,10000,0,0.0
Sinner,Castor Seed,2015,3385,3385,0,0.0
Sangamner,Pigeon Pea (Tur),2016,7000,7000,0,0.0
Sangamner,Pigeon Pea (Tur),2016,6830,6830,0,0.0
Sangamner,Pigeon Pea (Tur),2016,6250,6250,0,0.0
Sinner,Cowpea,2014,4400,4400,0,0.0
Satana,Horse Gram,2016,2011,2011,0,0.0
Satana,Maize,2016,1791,1791,0,0.0
Satana,Matki,2016,7105,7105,0,0.0
Satana,Matki,2016,7060,7060,0,0.0
Satana,Matki,2016,4067,4067,0,0.0
Satana,Pigeon Pea (Tur),2016,6000,6000,0,0.0
Satana,Pigeon Pea (Tur),2016,7500,7500,0,0.0
Satana,Pigeon Pea (Tur),2016,5050,5050,0,0.0
Sinner,Fenugreek,2014,1501,1501,0,0.0
Satana,Sorgum(Jawar),2016,1700,1700,0,0.0
Sangamner,Pigeon Pea (Tur),2016,6100,6100,0,0.0
Savner,Ground Nut Pods (Dry),2014,3000,3000,0,0.0
Savner,Sorgum(Jawar),2014,1125,1125,0,0.0
Sindkhed Raja,Wheat(Husked),2016,1800,1800,0,0.0
Savner,Green Gram,2015,5250,5250,0,0.0
Savner,Ground Nut Pods (Dry),2015,3600,3600,0,0.0
Savner,Ground Nut Pods (Dry),2015,5085,5085,0,0.0
Savner,Maize,2015,1019,1019,0,0.0
Savner,Maize,2015,900,900,0,0.0
Savner,Maize,2015,994,994,0,0.0
Satana,Green Gram,2016,6967,6967,0,0.0
Satana,Green Gram,2016,7100,7100,0,0.0
Satana,Green Gram,2016,5425,5425,0,0.0
Sinner,Ground Nut Pods (Dry),2014,3000,3000,0,0.0
Sangamner,Rice(Paddy-Hus),2016,1550,1550,0,0.0
Sangamner,Rice(Paddy-Hus),2016,1549,1549,0,0.0
Sinner,Safflower,2014,3301,3301,0,0.0
Sinner,Rice(Paddy-Hus),2014,1476,1476,0,0.0
Sinner,Rice(Paddy-Hus),2014,1421,1421,0,0.0
Sangamner,Soybean,2016,3500,3500,0,0.0
Sangamner,Soybean,2016,3000,3000,0,0.0
Satana,Black Gram,2014,4950,4950,0,0.0
Satana,Green Gram,2014,6857,6857,0,0.0
Satana,Horse Gram,2014,2981,2981,0,0.0
Satana,Pigeon Pea (Tur),2014,3781,3781,0,0.0
Sinner,Matki,2014,6550,6550,0,0.0
Satana,Rice(Paddy-Hus),2014,1452,1452,0,0.0
Satana,Rice(Paddy-Hus),2014,1541,1541,0,0.0
Satana,Sorgum(Jawar),2014,2501,2501,0,0.0
Satana,Soybean,2014,3349,3349,0,0.0
Satana,Sunflower,2014,5036,5036,0,0.0
Satana,Green Gram,2016,5700,5700,0,0.0
Sinner,Horse Gram,2014,4001,4001,0,0.0
Paithan,Green Gram,2016,6800,6800,0,0.0
Sonpeth,Wheat(Husked),2014,1489,1489,0,0.0
Paithan,Gram,2016,6871,6871,0,0.0
Lohara,Gram,2016,4100,4100,0,0.0
Lohara,Safflower,2016,2400,2400,0,0.0
Lohara,Sorgum(Jawar),2016,1321,1321,0,0.0
Lonand,Gram,2014,3200,3200,0,0.0
Lonand,Gram,2014,3200,3200,0,0.0
Lonand,Gram,2014,3200,3200,0,0.0
Lonand,Gram,2014,3275,3275,0,0.0
Udgir,Soybean,2015,3390,3390,0,0.0
Lonand,Gram,2015,3175,3175,0,0.0
Lonand,Gram,2015,3200,3200,0,0.0
Lonand,Maize,2015,1329,1329,0,0.0
Lonand,Maize,2015,1419,1419,0,0.0
Lonand,Maize,2015,1444,1444,0,0.0
Lonand,GRAM,2016,7450,7450,0,0.0
Lonand,MAIZE,2016,1375,1375,0,0.0
Lonand,Maize,2016,1600,1600,0,0.0
Lonand,Maize,2016,1800,1800,0,0.0
Lonand,Maize,2016,1469,1469,0,0.0
Lonand,Maize,2016,1450,1450,0,0.0
Lonand,Maize,2016,1600,1600,0,0.0
Majalgaon,Ground Nut Pods (Dry),2014,3900,3900,0,0.0
Majalgaon,Ground Nut Pods (Dry),2014,2800,2800,0,0.0
Lohara,Maize,2016,1400,1400,0,0.0
Lohara,Safflower,2015,2701,2701,0,0.0
Mantha,Pigeon Pea (Tur),2015,7850,7850,0,0.0
Lohara,Black Gram,2015,7800,7800,0,0.0
Latur-Murud,Maize,2016,1451,1451,0,0.0
Latur-Murud,Maize,2016,1362,1362,0,0.0
Latur-Murud,Maize,2016,1500,1500,0,0.0
Latur-Murud,Maize,2016,1531,1531,0,0.0
Latur-Murud,Pigeon Pea (Tur),2016,8500,8500,0,0.0
Latur-Murud,Pigeon Pea (Tur),2016,7638,7638,0,0.0
Latur-Murud,Pigeon Pea (Tur),2016,8100,8100,0,0.0
Latur-Murud,SUNFLOWER,2016,2657,2657,0,0.0
Latur-Murud,Safflower,2016,2684,2684,0,0.0
Latur-Murud,Safflower,2016,2511,2511,0,0.0
Latur-Murud,Safflower,2016,2480,2480,0,0.0
Latur-Murud,Safflower,2016,4201,4201,0,0.0
Latur-Murud,Safflower,2016,2618,2618,0,0.0
Latur-Murud,Sunflower,2016,3400,3400,0,0.0
Latur-Murud,Sunflower,2016,3301,3301,0,0.0
Latur-Murud,Sunflower,2016,2743,2743,0,0.0
Latur-Murud,Wheat(Husked),2016,1469,1469,0,0.0
Loha,Safflower,2014,2175,2175,0,0.0
Loha,Maize,2015,1471,1471,0,0.0
Loha,Sesamum,2015,7400,7400,0,0.0
Lohara,Bajri,2015,1470,1470,0,0.0
Majalgaon,Sesamum,2014,10000,10000,0,0.0
Majalgaon,Sunflower,2014,2899,2899,0,0.0
Majalgaon,Gram,2015,4414,4414,0,0.0
Majalgaon,Green Gram,2015,7200,7200,0,0.0
Malkapur,Bajri,2015,1174,1174,0,0.0
Malkapur,Bajri,2015,1058,1058,0,0.0
Malkapur,Bajri,2015,1110,1110,0,0.0
Malkapur,Sesamum,2015,7250,7250,0,0.0
Malkapur,Sesamum,2015,7067,7067,0,0.0
Malkapur,Sesamum,2015,6000,6000,0,0.0
Malkapur,Bajri,2016,1508,1508,0,0.0
Malkapur,Bajri,2016,1793,1793,0,0.0
Malkapur,Black Gram,2016,9200,9200,0,0.0
Malkapur,Green Gram,2016,6750,6750,0,0.0
Manchar,Bitter Gourd,2015,2900,2900,0,0.0
Manchar,Bitter Gourd,2015,1000,1000,0,0.0
Manchar,Bottle Gourd,2015,2400,2400,0,0.0
Manchar,Capsicum,2015,2200,2200,0,0.0
Manchar,Capsicum,2015,2100,2100,0,0.0
Manchar,Carrot,2015,1625,1625,0,0.0
Manchar,Chavli (Shenga ),2015,1800,1800,0,0.0
Manchar,French Bean,2015,2000,2000,0,0.0
Manchar,French Bean,2015,3210,3210,0,0.0
Manchar,French Bean,2015,2000,2000,0,0.0
Manchar,Ghevda,2015,1777,1777,0,0.0
Malkapur,Bajri,2014,1500,1500,0,0.0
Malegaon,Soybean,2016,3726,3726,0,0.0
Malegaon,Matki,2016,4240,4240,0,0.0
Majalgaon,Green Gram,2016,6400,6400,0,0.0
Majalgaon,Pigeon Pea (Tur),2015,8370,8370,0,0.0
Majalgaon,Safflower,2015,2500,2500,0,0.0
Majalgaon,Sesamum,2015,7000,7000,0,0.0
Majalgaon,Sesamum,2015,7200,7200,0,0.0
Majalgaon,Sesamum,2015,7600,7600,0,0.0
Majalgaon,GREEN GRAM,2016,5225,5225,0,0.0
Majalgaon,Green Gram,2016,4850,4850,0,0.0
Majalgaon,Green Gram,2016,5800,5800,0,0.0
Majalgaon,Green Gram,2016,6453,6453,0,0.0
Majalgaon,Sunflower,2016,3201,3201,0,0.0
Malegaon,Maize,2016,1752,1752,0,0.0
Malegaon,Matki,2014,6501,6501,0,0.0
Malegaon,Sunflower,2014,4500,4500,0,0.0
Malegaon,Castor Seed,2015,3451,3451,0,0.0
Malegaon,Castor Seed,2015,3305,3305,0,0.0
Malegaon,Green Gram,2015,6290,6290,0,0.0
Malegaon,Green Gram,2015,7326,7326,0,0.0
Malegaon,Matki,2015,8068,8068,0,0.0
Malegaon,Sunflower,2015,3785,3785,0,0.0
Malegaon,Horse Gram,2016,4570,4570,0,0.0
Latur-Murud,MAIZE,2016,1150,1150,0,0.0
Latur-Murud,GREEN GRAM,2016,4400,4400,0,0.0
Latur-Murud,Black Gram,2016,6361,6361,0,0.0
Lasalgaon,Ground Nut Pods (Dry),2015,4599,4599,0,0.0
Lakhandur,RICE(PADDY-HUS),2016,1617,1617,0,0.0
Lakhandur,Rice(Paddy-Hus),2016,1650,1650,0,0.0
Lakhandur,Soybean,2016,3100,3100,0,0.0
Lakhandur,WHEAT(HUSKED),2016,1550,1550,0,0.0
Lakhandur,Wheat(Husked),2016,1550,1550,0,0.0
Lakhani,Paddy-Unhusked,2014,2725,2725,0,0.0
Lakhani,Paddy-Unhusked,2015,1685,1685,0,0.0
Lakhani,PADDY-UNHUSKED,2016,1918,1918,0,0.0
Lakhani,Paddy-Unhusked,2016,1921,1921,0,0.0
Lakhani,Paddy-Unhusked,2016,2075,2075,0,0.0
Lasalgaon,Ground Nut Pods (Dry),2014,3701,3701,0,0.0
Lasalgaon,Pigeon Pea (Tur),2014,3100,3100,0,0.0
Lasalgaon,Pigeon Pea (Tur),2014,3901,3901,0,0.0
Lasalgaon,Rice(Paddy-Hus),2014,1592,1592,0,0.0
Lasalgaon,Sorgum(Jawar),2014,1737,1737,0,0.0
Lasalgaon,Sunflower,2014,2701,2701,0,0.0
Lasalgaon,Sunflower,2014,3001,3001,0,0.0
Lasalgaon,Sunflower,2014,2851,2851,0,0.0
Lasalgaon,Black Gram,2015,6656,6656,0,0.0
Lasalgaon,Green Gram,2015,8500,8500,0,0.0
Lasalgaon,Green Gram,2015,6500,6500,0,0.0
Lakhandur,Mustard,2016,2550,2550,0,0.0
Lakhandur,Mustard,2016,3040,3040,0,0.0
Lakhandur,Lentil,2016,3520,3520,0,0.0
Kurdwadi,WHEAT(HUSKED),2016,1951,1951,0,0.0
Kurdwadi,Linseed,2016,4000,4000,0,0.0
Kurdwadi,Linseed,2016,5500,5500,0,0.0
Kurdwadi,Maize,2016,1557,1557,0,0.0
Kurdwadi,Pigeon Pea (Tur),2016,5800,5800,0,0.0
Kurdwadi,Pigeon Pea (Tur),2016,6500,6500,0,0.0
Kurdwadi,Pigeon Pea (Tur),2016,5909,5909,0,0.0
Kurdwadi,Pigeon Pea (Tur),2016,5000,5000,0,0.0
Kurdwadi,Soybean,2016,3400,3400,0,0.0
Kurdwadi,Sunflower,2016,3246,3246,0,0.0
Kurdwadi,Wheat(Husked),2016,1889,1889,0,0.0
Lakhandur,Indian Bean,2016,2500,2500,0,0.0
Kurdwadi,Wheat(Husked),2016,1801,1801,0,0.0
Kurdwadi,Wheat(Husked),2016,1921,1921,0,0.0
Kurdwadi-Modnimb,Green Gram,2015,5401,5401,0,0.0
Kurdwadi-Modnimb,Pigeon Pea (Tur),2016,7619,7619,0,0.0
Lakhandur,Paddy-Unhusked,2014,1867,1867,0,0.0
Lakhandur,Green Peas (Dry),2015,1882,1882,0,0.0
Lakhandur,Rice(Paddy-Hus),2015,1500,1500,0,0.0
Lakhandur,Wheat(Husked),2015,1400,1400,0,0.0
Lakhandur,Wheat(Husked),2015,1400,1400,0,0.0
Lasalgaon,Green Gram,2015,5300,5300,0,0.0
Lasalgaon,Horse Gram,2015,3500,3500,0,0.0
Latur-Murud,BLACK GRAM,2016,4213,4213,0,0.0
Lasalgaon,Pigeon Pea (Tur),2015,4501,4501,0,0.0
Lasalgaon-Vinchur,Bajri,2016,1836,1836,0,0.0
Lasalgaon-Vinchur,Maize,2016,2012,2012,0,0.0
Lasalgaon-Vinchur,Rice(Paddy-Hus),2016,1526,1526,0,0.0
Lasur Station,Black Gram,2015,6300,6300,0,0.0
Lasur Station,Castor Seed,2015,3433,3433,0,0.0
Lasur Station,Safflower,2015,2250,2250,0,0.0
Lasur Station,Soybean,2015,3197,3197,0,0.0
Lasur Station,PIGEON PEA (TUR),2016,5500,5500,0,0.0
Lasur Station,Safflower,2016,2850,2850,0,0.0
Latur,Bajri,2015,1320,1320,0,0.0
Latur,Maize,2015,1481,1481,0,0.0
Latur,Black Gram,2016,9180,9180,0,0.0
Latur,Green Gram,2016,6150,6150,0,0.0
Latur,Green Gram,2016,6850,6850,0,0.0
Latur,Linseed,2016,5200,5200,0,0.0
Latur,Mustard,2016,4200,4200,0,0.0
Latur,Tamarind Seed,2016,1728,1728,0,0.0
Latur,Tamarind Seed,2016,1791,1791,0,0.0
Latur-Murud,Black Gram,2015,10000,10000,0,0.0
Latur-Murud,Maize,2015,1486,1486,0,0.0
Latur-Murud,Safflower,2015,2500,2500,0,0.0
Lasalgaon-Vinchur,Bajri,2016,1636,1636,0,0.0
Lasalgaon-Vinchur,Sorgum(Jawar),2015,1471,1471,0,0.0
Lasalgaon-Vinchur,Sorgum(Jawar),2015,1100,1100,0,0.0
Lasalgaon,Sunflower,2015,2801,2801,0,0.0
Lasalgaon,Pigeon Pea (Tur),2015,5551,5551,0,0.0
Lasalgaon,Rice(Paddy-Hus),2015,1650,1650,0,0.0
Lasalgaon,Rice(Paddy-Hus),2015,1681,1681,0,0.0
Lasalgaon,Rice(Paddy-Hus),2015,1691,1691,0,0.0
Lasalgaon,Rice(Paddy-Hus),2015,1652,1652,0,0.0
Lasalgaon,Rice(Paddy-Hus),2015,1662,1662,0,0.0
Lasalgaon,Sorgum(Jawar),2015,2226,2226,0,0.0
Lasalgaon,Sunflower,2015,3311,3311,0,0.0
Lasalgaon,Sunflower,2015,2551,2551,0,0.0
Lasalgaon,Black Gram,2016,8000,8000,0,0.0
Lasalgaon-Niphad,SUNFLOWER,2016,5701,5701,0,0.0
Lasalgaon,Coriander (Dry),2016,10800,10800,0,0.0
Lasalgaon,Green Gram,2016,6600,6600,0,0.0
Lasalgaon,Green Gram,2016,6834,6834,0,0.0
Lasalgaon,Green Gram,2016,6800,6800,0,0.0
Lasalgaon,Rice(Paddy-Hus),2016,1816,1816,0,0.0
Lasalgaon,Rice(Paddy-Hus),2016,1701,1701,0,0.0
Lasalgaon,Sunflower,2016,3050,3050,0,0.0
Lasalgaon-Niphad,Maize,2016,1760,1760,0,0.0
Lasalgaon-Niphad,Maize,2016,1371,1371,0,0.0
Manchar,Kanda Pat,2015,418,418,0,0.0
Manchar,Kanda Pat,2015,547,547,0,0.0
Manchar,Ladies Finger,2015,800,800,0,0.0
Tumsar,Pigeon Pea (Tur),2015,9017,9017,0,0.0
Mangalwedha,Green Gram,2015,7900,7900,0,0.0
Mangalwedha,Horse Gram,2015,2201,2201,0,0.0
Mangalwedha,Horse Gram,2015,1551,1551,0,0.0
Mangalwedha,Horse Gram,2015,1651,1651,0,0.0
Mangalwedha,Matki,2015,7900,7900,0,0.0
Mangalwedha,Matki,2015,8700,8700,0,0.0
Mangalwedha,Matki,2015,8700,8700,0,0.0
Mangalwedha,Matki,2015,6500,6500,0,0.0
Mangalwedha,Pigeon Pea (Tur),2015,5000,5000,0,0.0
Mangalwedha,Pigeon Pea (Tur),2015,5850,5850,0,0.0
Mangalwedha,Pigeon Pea (Tur),2015,5600,5600,0,0.0
Mangalwedha,Pigeon Pea (Tur),2015,9000,9000,0,0.0
Mangalwedha,Wheat(Unhusked),2015,3144,3144,0,0.0
Mangalwedha,Wheat(Unhusked),2015,2350,2350,0,0.0
Mangalwedha,Wheat(Unhusked),2015,2300,2300,0,0.0
Mangalwedha,Wheat(Unhusked),2015,2000,2000,0,0.0
Mangalwedha,Wheat(Unhusked),2015,2601,2601,0,0.0
Mangalwedha,Wheat(Unhusked),2015,2600,2600,0,0.0
Mangalwedha,Wheat(Unhusked),2015,2750,2750,0,0.0
Mangalwedha,Wheat(Unhusked),2015,3317,3317,0,0.0
Mangalwedha,Bajri,2016,1888,1888,0,0.0
Tumsar,Wheat(Husked),2015,1452,1452,0,0.0
Mangalwedha,Green Gram,2015,8000,8000,0,0.0
Mangalwedha,Black Gram,2015,6901,6901,0,0.0
Tumsar,GREEN GRAM,2016,4231,4231,0,0.0
Tumsar,Gram,2016,6141,6141,0,0.0
Tumsar,Gram,2016,3601,3601,0,0.0
Mangalwedha,Matki,2014,5802,5802,0,0.0
Mangalwedha,Matki,2014,5700,5700,0,0.0
Mangalwedha,Pigeon Pea (Tur),2014,4000,4000,0,0.0
Mangalwedha,Pigeon Pea (Tur),2014,3151,3151,0,0.0
Mangalwedha,Pigeon Pea (Tur),2014,3101,3101,0,0.0
Mangalwedha,Pigeon Pea (Tur),2014,3534,3534,0,0.0
Mangalwedha,Wheat(Unhusked),2014,2733,2733,0,0.0
Mangalwedha,Bajri,2015,1640,1640,0,0.0
Mangalwedha,Bajri,2015,1563,1563,0,0.0
Tumsar,Castor Seed,2016,2550,2550,0,0.0
Tumsar,Castor Seed,2016,3100,3100,0,0.0
Tumsar,Castor Seed,2016,2880,2880,0,0.0
Tumsar,Castor Seed,2016,2600,2600,0,0.0
Mangalwedha,Bajri,2015,1451,1451,0,0.0
Mangalwedha,Bajri,2015,1331,1331,0,0.0
Tumsar,Black Gram,2016,5500,5500,0,0.0
Tumsar,Black Gram,2016,10000,10000,0,0.0
Mangalwedha,Bajri,2015,1313,1313,0,0.0
Mangalwedha,Bajri,2016,1680,1680,0,0.0
Mangalwedha,Bajri,2016,1200,1200,0,0.0
Mangalwedha,Matki,2014,6000,6000,0,0.0
Mangalwedha,Bajri,2016,1875,1875,0,0.0
Mangrulpeer,COTTON,2016,4900,4900,0,0.0
Mangrulpeer,Green Gram,2016,5971,5971,0,0.0
Mangrulpeer,SORGUM(JAWAR),2016,1355,1355,0,0.0
Tumsar,Linseed,2015,4500,4500,0,0.0
Paithan,Soybean,2015,3571,3571,0,0.0
Mangrulpeer,Sorgum(Jawar),2016,1416,1416,0,0.0
Mangrulpeer,Sorgum(Jawar),2016,1203,1203,0,0.0
Mangrulpeer,Sorgum(Jawar),2016,1382,1382,0,0.0
Manmad,Wheat(Husked),2015,1502,1502,0,0.0
Manmad,Pigeon Pea (Tur),2016,7201,7201,0,0.0
Manmad,SORGUM(JAWAR),2016,2380,2380,0,0.0
Manmad,Wheat(Husked),2016,1923,1923,0,0.0
Manmad,Wheat(Husked),2016,1663,1663,0,0.0
Manmad,Wheat(Husked),2016,1515,1515,0,0.0
Mantha,Bajri,2014,1475,1475,0,0.0
Mantha,Bajri,2014,1525,1525,0,0.0
Mantha,Mustard,2014,3900,3900,0,0.0
Mantha,Pigeon Pea (Tur),2014,4301,4301,0,0.0
Mantha,Safflower,2014,2240,2240,0,0.0
Mantha,Bajri,2015,1200,1200,0,0.0
Mantha,Black Gram,2015,5150,5150,0,0.0
Mangrulpeer,Black Gram,2016,7000,7000,0,0.0
Mangrulpeer,Green Gram,2015,5500,5500,0,0.0
Mangrulpeer,Green Gram,2015,5000,5000,0,0.0
Mangalwedha,Pigeon Pea (Tur),2016,4502,4502,0,0.0
Mangalwedha,Bajri,2016,1800,1800,0,0.0
Mangalwedha,Black Gram,2016,5717,5717,0,0.0
Mangalwedha,Green Gram,2016,6000,6000,0,0.0
Mangalwedha,HORSE GRAM,2016,2001,2001,0,0.0
Mangalwedha,PIGEON PEA (TUR),2016,5000,5000,0,0.0
Mangalwedha,Pigeon Pea (Tur),2016,7300,7300,0,0.0
Mangalwedha,Pigeon Pea (Tur),2016,6800,6800,0,0.0
Mangalwedha,Pigeon Pea (Tur),2016,7050,7050,0,0.0
Mangalwedha,Pigeon Pea (Tur),2016,6800,6800,0,0.0
Mangalwedha,Wheat(Unhusked),2016,3100,3100,0,0.0
Tumsar,Other Cereals,2015,3800,3800,0,0.0
Mangalwedha,Wheat(Unhusked),2016,2650,2650,0,0.0
Mangalwedha,Wheat(Unhusked),2016,3001,3001,0,0.0
Mangalwedha,Wheat(Unhusked),2016,2900,2900,0,0.0
Mangalwedha,Wheat(Unhusked),2016,3151,3151,0,0.0
Mangrulpeer,Sorgum(Jawar),2014,1325,1325,0,0.0
Mangrulpeer,Black Gram,2015,6400,6400,0,0.0
Mangrulpeer,Black Gram,2015,6000,6000,0,0.0
Mangrulpeer,Black Gram,2015,6025,6025,0,0.0
Mangrulpeer,Green Gram,2015,6650,6650,0,0.0
Mangalwedha,Matki,2014,6000,6000,0,0.0
Mangalwedha,Horse Gram,2014,1400,1400,0,0.0
Manchar,Pavtta,2015,2000,2000,0,0.0
Mandhal,Gram,2015,2722,2722,0,0.0
Manchar,Kanda Pat,2016,326,326,0,0.0
Manchar,Pavtta,2016,4400,4400,0,0.0
Manchar,Pavtta,2016,2150,2150,0,0.0
Manchar,Sweet Potato,2016,2600,2600,0,0.0
Manchar,Wal Papdi,2016,2100,2100,0,0.0
Tumsar,Pigeon Pea (Tur),2016,7984,7984,0,0.0
Tumsar,Pigeon Pea (Tur),2016,5988,5988,0,0.0
Manchar,Walvad,2016,2000,2000,0,0.0
Mandhal,Chillies(Red),2014,4444,4444,0,0.0
Mandhal,Chillies(Red),2014,3778,3778,0,0.0
Mandhal,Chillies(Red),2014,4240,4240,0,0.0
Mandhal,Gram,2014,2424,2424,0,0.0
Mandhal,Gram,2014,2397,2397,0,0.0
Mandhal,Gram,2014,2714,2714,0,0.0
Mandhal,Wheat(Husked),2014,1501,1501,0,0.0
Mandhal,Wheat(Husked),2014,1489,1489,0,0.0
Mandhal,Wheat(Husked),2014,1441,1441,0,0.0
Mandhal,Wheat(Husked),2014,1446,1446,0,0.0
Mandhal,Coriander (Dry),2015,6313,6313,0,0.0
Mandhal,Coriander (Dry),2015,6300,6300,0,0.0
Mandhal,Gram,2015,4000,4000,0,0.0
Manchar,Harbara(Bhaji),2016,583,583,0,0.0
Manchar,Ghosali(Bhaji),2016,1200,1200,0,0.0
Manchar,Ghevda,2016,5000,5000,0,0.0
Tumsar,Sarsav,2016,3040,3040,0,0.0
Manchar,Raddish,2015,201,201,0,0.0
Manchar,Raddish,2015,201,201,0,0.0
Tumsar,Wheat(Husked),2016,1451,1451,0,0.0
Manchar,Small Gourd,2015,2700,2700,0,0.0
Manchar,Tandulja,2015,298,298,0,0.0
Manchar,Tandulja,2015,152,152,0,0.0
Manchar,Wal Papdi,2015,3000,3000,0,0.0
Manchar,Wal Papdi,2015,2500,2500,0,0.0
Tumsar,WHEAT(HUSKED),2016,1674,1674,0,0.0
Manchar,Walvad,2015,4000,4000,0,0.0
Manchar,Ghevda,2016,1900,1900,0,0.0
Manchar,Walvad,2015,3400,3400,0,0.0
Manchar,Carrot,2016,2000,2000,0,0.0
Manchar,Carrot,2016,800,800,0,0.0
Manchar,Carrot,2016,1000,1000,0,0.0
Manchar,Chavli (Shenga ),2016,2000,2000,0,0.0
Manchar,Chavli (Shenga ),2016,3575,3575,0,0.0
Tumsar,SARSAV,2016,2550,2550,0,0.0
Manchar,Cluster Bean,2016,1351,1351,0,0.0
Manchar,Farshi,2016,5000,5000,0,0.0
Mandhal,Gram,2015,3850,3850,0,0.0
Tumsar,Other Pulses,2016,3911,3911,0,0.0
Mangalwedha,Horse Gram,2014,1400,1400,0,0.0
Mandhal,Gram,2015,4066,4066,0,0.0
Tumsar,Lentil,2016,4367,4367,0,0.0
Tumsar,Lentil,2016,3800,3800,0,0.0
Mandhal,Coriander (Dry),2016,7000,7000,0,0.0
Mandhal,GRAM,2016,8000,8000,0,0.0
Tumsar,LINSEED,2016,5544,5544,0,0.0
Mandhal,Green Gram,2016,6338,6338,0,0.0
Mandhal,Green Gram,2016,5300,5300,0,0.0
Mandhal,Green Gram,2016,5961,5961,0,0.0
Mandhal,Green Peas (Dry),2016,2567,2567,0,0.0
Mandhal,Green Peas (Dry),2016,2200,2200,0,0.0
Mandhal,Linseed,2016,5532,5532,0,0.0
Mandhal,Linseed,2016,5234,5234,0,0.0
Mandhal,Linseed,2016,6500,6500,0,0.0
Mandhal,Pigeon Pea (Tur),2016,7800,7800,0,0.0
Mandhal,Wheat(Husked),2016,1484,1484,0,0.0
Mandhal,Wheat(Husked),2016,1593,1593,0,0.0
Tumsar,Green Gram,2016,5000,5000,0,0.0
Mandhal,Wheat(Husked),2016,1650,1650,0,0.0
Mangalwedha,Black Gram,2014,4501,4501,0,0.0
Mangalwedha,Green Gram,2014,6700,6700,0,0.0
Mangalwedha,Horse Gram,2014,2102,2102,0,0.0
Mandhal,Coriander (Dry),2016,6640,6640,0,0.0
Mandhal,Coriander (Dry),2016,7505,7505,0,0.0
Mandhal,Coriander (Dry),2016,6771,6771,0,0.0
Mandhal,Linseed,2015,4897,4897,0,0.0
Mandhal,Gram,2015,4169,4169,0,0.0
Mandhal,Green Gram,2015,5565,5565,0,0.0
Mandhal,Green Gram,2015,5600,5600,0,0.0
Mandhal,Green Gram,2015,6071,6071,0,0.0
Mandhal,Green Peas (Dry),2015,1583,1583,0,0.0
Mandhal,Green Peas (Dry),2015,2400,2400,0,0.0
Mandhal,Lentil,2015,4000,4000,0,0.0
Mandhal,Linseed,2015,4654,4654,0,0.0
Mandhal,Linseed,2015,4180,4180,0,0.0
Mandhal,Linseed,2015,4886,4886,0,0.0
Mandhal,Wheat(Husked),2015,1524,1524,0,0.0
Mandhal,Paddy-Unhusked,2015,1741,1741,0,0.0
Mandhal,Pigeon Pea (Tur),2015,6550,6550,0,0.0
Mandhal,Pigeon Pea (Tur),2015,6303,6303,0,0.0
Mandhal,Soybean,2015,3055,3055,0,0.0
Mandhal,Wheat(Husked),2015,1450,1450,0,0.0
Mandhal,Wheat(Husked),2015,1500,1500,0,0.0
Mandhal,Wheat(Husked),2015,1459,1459,0,0.0
Mandhal,Wheat(Husked),2015,1500,1500,0,0.0
Mandhal,Wheat(Husked),2015,1491,1491,0,0.0
Kurdwadi,Green Gram,2016,7076,7076,0,0.0
Kurdwadi,Gram,2016,5051,5051,0,0.0
Kurdwadi,Gram,2016,7300,7300,0,0.0
Khamgaon,Safflower,2015,2400,2400,0,0.0
Kej,Green Peas (Dry),2016,3380,3380,0,0.0
Kej,Pigeon Pea (Tur),2016,5525,5525,0,0.0
Kej,Sesamum,2016,6401,6401,0,0.0
Kej,Sesamum,2016,6701,6701,0,0.0
Kej,Sunflower,2016,3418,3418,0,0.0
Kej,Sunflower,2016,3751,3751,0,0.0
Kej,Tamarind,2016,6801,6801,0,0.0
Kej,Wheat(Husked),2016,1858,1858,0,0.0
Kej,Wheat(Husked),2016,2023,2023,0,0.0
Khamgaon,Bajri,2014,1200,1200,0,0.0
Umared,GREEN GRAM,2016,4250,4250,0,0.0
Khamgaon,Maize,2014,1190,1190,0,0.0
Khamgaon,Ground Nut Pods (Dry),2015,3250,3250,0,0.0
Khamgaon,Ground Nut Pods (Dry),2015,3425,3425,0,0.0
Umared,Coriander (Dry),2016,7413,7413,0,0.0
Khamgaon,Ground Nut Pods (Dry),2015,3350,3350,0,0.0
Khamgaon,Ground Nut Pods (Dry),2015,3625,3625,0,0.0
Khamgaon,Maize,2015,1304,1304,0,0.0
Khamgaon,Mustard,2015,3200,3200,0,0.0
Khamgaon,Mustard,2015,2800,2800,0,0.0
Khamgaon,Neem-Seed,2015,725,725,0,0.0
Kej,Green Peas (Dry),2016,2100,2100,0,0.0
Kej,Castor Seed,2016,2861,2861,0,0.0
Kej,Castor Seed,2016,3200,3200,0,0.0
Umared,LINSEED,2016,6251,6251,0,0.0
Kej,Maize,2015,1366,1366,0,0.0
Umared,Lentil,2016,3950,3950,0,0.0
Umared,Lentil,2016,4100,4100,0,0.0
Umared,Lang,2016,4605,4605,0,0.0
Kej,Niger-Seed,2015,4200,4200,0,0.0
Kej,Safflower,2015,3300,3300,0,0.0
Kej,Soybean,2015,3383,3383,0,0.0
Kej,Bhagar/Vari,2016,2000,2000,0,0.0
Kej,Bhagar/Vari,2016,2202,2202,0,0.0
Umared,Green Peas (Dry),2016,2610,2610,0,0.0
Kej,Castor Seed,2016,2600,2600,0,0.0
Umared,Green Peas (Dry),2016,2355,2355,0,0.0
Umared,Green Peas (Dry),2016,2350,2350,0,0.0
Umared,Green Peas (Dry),2016,2530,2530,0,0.0
Kej,Bhagar/Vari,2016,2301,2301,0,0.0
Umared,Green Gram,2016,3733,3733,0,0.0
Umared,Green Gram,2016,4200,4200,0,0.0
Umared,Green Gram,2016,4843,4843,0,0.0
Umared,Green Gram,2016,4105,4105,0,0.0
Kej,Bhagar/Vari,2016,1901,1901,0,0.0
Khamgaon,Safflower,2015,2100,2100,0,0.0
Khamgaon,Sesamum,2015,7725,7725,0,0.0
Kej,Ground Nut Pods (Dry),2015,4600,4600,0,0.0
Khamgaon,Sesamum,2015,7200,7200,0,0.0
Khed,Cluster Bean,2014,4010,4010,0,0.0
Khed,Cabbage,2015,700,700,0,0.0
Khed,Raddish,2015,250,250,0,0.0
Khed,Kanda Pat,2016,7,7,0,0.0
Khed (Shel Pimpalgaon),Bitter Gourd,2014,1307,1307,0,0.0
Khed (Shel Pimpalgaon),Bitter Gourd,2014,1583,1583,0,0.0
Khed (Shel Pimpalgaon),Brinjal,2014,1803,1803,0,0.0
Khed (Shel Pimpalgaon),Cabbage,2014,447,447,0,0.0
Khed (Shel Pimpalgaon),Cucumber,2014,817,817,0,0.0
Khed (Shel Pimpalgaon),Farshi,2014,3945,3945,0,0.0
Khed (Shel Pimpalgaon),Flower,2014,1370,1370,0,0.0
Khed (Shel Pimpalgaon),Walvad,2014,2430,2430,0,0.0
Khed (Shel Pimpalgaon),Bitter Gourd,2015,1975,1975,0,0.0
Khed (Shel Pimpalgaon),Bitter Gourd,2015,2250,2250,0,0.0
Khed (Shel Pimpalgaon),Bottle Gourd,2015,650,650,0,0.0
Khed (Shel Pimpalgaon),Bottle Gourd,2015,575,575,0,0.0
Khed (Shel Pimpalgaon),Bottle Gourd,2015,200,200,0,0.0
Khed (Shel Pimpalgaon),Bottle Gourd,2015,537,537,0,0.0
Khed (Shel Pimpalgaon),Brinjal,2015,470,470,0,0.0
Khed (Shel Pimpalgaon),Brinjal,2015,1049,1049,0,0.0
Khed (Shel Pimpalgaon),Brinjal,2015,1000,1000,0,0.0
Khamgaon,Thymol/Lovage,2016,12250,12250,0,0.0
Khamgaon,Sunflower,2016,3063,3063,0,0.0
Khamgaon,Sunflower,2016,2975,2975,0,0.0
Khamgaon,Bajri,2016,1321,1321,0,0.0
Khamgaon,Sesamum,2015,5700,5700,0,0.0
Khamgaon,Sunflower,2015,3175,3175,0,0.0
Khamgaon,Sunflower,2015,3000,3000,0,0.0
Umared,Castor Seed,2016,2750,2750,0,0.0
Khamgaon,Thymol/Lovage,2015,7000,7000,0,0.0
Umared,Black Gram,2016,6955,6955,0,0.0
Umared,Black Gram,2016,7500,7500,0,0.0
Khamgaon,Bajri,2016,1550,1550,0,0.0
Khamgaon,Bajri,2016,1533,1533,0,0.0
Khamgaon,Bajri,2016,1575,1575,0,0.0
Khamgaon,Sheep,2016,1500,1500,0,0.0
Khamgaon,Black Gram,2016,6750,6750,0,0.0
Khamgaon,Cow,2016,7000,7000,0,0.0
Khamgaon,Maize,2016,1320,1320,0,0.0
Khamgaon,SESAMUM,2016,4700,4700,0,0.0
Khamgaon,SUNFLOWER,2016,2700,2700,0,0.0
Khamgaon,Safflower,2016,2735,2735,0,0.0
Khamgaon,Sesamum,2016,4650,4650,0,0.0
Khamgaon,Sesamum,2016,6315,6315,0,0.0
Khamgaon,Sesamum,2016,3800,3800,0,0.0
Kej,Maize,2015,1610,1610,0,0.0
Umared,Linseed,2016,5000,5000,0,0.0
Khed (Shel Pimpalgaon),Cabbage,2015,678,678,0,0.0
Karanja,Green Gram,2016,6500,6500,0,0.0
Umarga,Paddy-Unhusked,2014,884,884,0,0.0
Umarga,Ground Nut Pods (Dry),2014,2810,2810,0,0.0
Umarga,Ground Nut Pods (Dry),2014,3150,3150,0,0.0
Karanja,Batbati,2014,4580,4580,0,0.0
Karanja,Batbati,2014,4935,4935,0,0.0
Karanja,Sesamum,2014,9853,9853,0,0.0
Umarga,Coriander (Dry),2014,6910,6910,0,0.0
Umarga,Coriander (Dry),2014,9300,9300,0,0.0
Karanja,Bajri,2015,1656,1656,0,0.0
Karanja,Batbati,2015,4800,4800,0,0.0
Karanja,Batbati,2015,4700,4700,0,0.0
Karanja,Green Gram,2015,7012,7012,0,0.0
Karanja,Green Gram,2015,6950,6950,0,0.0
Karanja,Ground Nut Pods (Dry),2015,3993,3993,0,0.0
Karanja,Ground Nut Pods (Dry),2015,4018,4018,0,0.0
Karanja,Sesamum,2015,6455,6455,0,0.0
Karanja,Sorgum(Jawar),2015,1548,1548,0,0.0
Karanja,Sunflower,2015,2800,2800,0,0.0
Karanja,Sunflower,2015,3501,3501,0,0.0
Karanja,Bajri,2016,1625,1625,0,0.0
Karanja,Batbati,2016,5700,5700,0,0.0
Karad,Flower,2015,971,971,0,0.0
Umarga,Safflower,2014,2325,2325,0,0.0
Kannad,Sorgum(Jawar),2016,1750,1750,0,0.0
Kannad,Onion,2015,675,675,0,0.0
Kannad,Gram,2014,2156,2156,0,0.0
Umarga,Wheat(Unhusked),2014,2870,2870,0,0.0
Umarga,Wheat(Unhusked),2014,2967,2967,0,0.0
Kannad,Green Gram,2014,6500,6500,0,0.0
Kannad,Sorgum(Jawar),2014,1375,1375,0,0.0
Kannad,Gram,2015,3040,3040,0,0.0
Kannad,Gram,2015,4000,4000,0,0.0
Kannad,Gram,2015,3290,3290,0,0.0
Kannad,Green Gram,2015,7500,7500,0,0.0
Kannad,Pigeon Pea (Tur),2015,3000,3000,0,0.0
Kannad,SORGUM(JAWAR),2016,1414,1414,0,0.0
Kannad,Sorgum(Jawar),2015,1460,1460,0,0.0
Kannad,Sorgum(Jawar),2015,1751,1751,0,0.0
Kannad,Sorgum(Jawar),2015,1502,1502,0,0.0
Kannad,Black Gram,2016,5900,5900,0,0.0
Kannad,Gram,2016,3600,3600,0,0.0
Kannad,Gram,2016,5250,5250,0,0.0
Kannad,Green Gram,2016,4811,4811,0,0.0
Kannad,Green Gram,2016,4830,4830,0,0.0
Kannad,Pigeon Pea (Tur),2016,7000,7000,0,0.0
Karanja,Black Gram,2016,6500,6500,0,0.0
Karmala,Ground Nut Pods (Dry),2016,5051,5051,0,0.0
Umared,Linseed,2016,4900,4900,0,0.0
Karmala,Pigeon Pea (Tur),2016,7300,7300,0,0.0
Umared,Pigeon Pea (Tur),2016,4250,4250,0,0.0
Katol,Sorgum(Jawar),2016,1323,1323,0,0.0
Umared,PIGEON PEA (TUR),2016,4393,4393,0,0.0
Umared,Other Pulses,2016,7900,7900,0,0.0
Umared,Other Pulses,2016,8150,8150,0,0.0
Umared,Other Pulses,2016,4095,4095,0,0.0
Kej,Coriander (Dry),2014,9000,9000,0,0.0
Kej,Sesamum,2014,10000,10000,0,0.0
Kej,Bhagar/Vari,2015,2101,2101,0,0.0
Kej,Coriander (Dry),2015,9100,9100,0,0.0
Umared,Mustard,2016,3200,3200,0,0.0
Umared,Mustard,2016,3100,3100,0,0.0
Umared,Mustard,2016,3500,3500,0,0.0
Umared,Mustard,2016,2800,2800,0,0.0
Kej,Green Peas (Dry),2015,2201,2201,0,0.0
Kej,Ground Nut Pods (Dry),2015,4799,4799,0,0.0
Kej,Ground Nut Pods (Dry),2015,4042,4042,0,0.0
Umared,MUSTARD,2016,3400,3400,0,0.0
Umared,Linseed,2016,7071,7071,0,0.0
Umared,Linseed,2016,6373,6373,0,0.0
Umared,Linseed,2016,7415,7415,0,0.0
Katol,Maize,2016,1340,1340,0,0.0
Katol,Maize,2016,1020,1020,0,0.0
Katol,Maize,2016,1200,1200,0,0.0
Umared,Sorgum(Jawar),2016,1550,1550,0,0.0
Katol,Black Gram,2015,7300,7300,0,0.0
Katol,Black Gram,2015,8117,8117,0,0.0
Katol,Green Gram,2015,5100,5100,0,0.0
Katol,Maize,2015,1150,1150,0,0.0
Katol,Maize,2015,1278,1278,0,0.0
Katol,Maize,2015,1196,1196,0,0.0
Katol,Maize,2015,950,950,0,0.0
Umared,Sorgum(Jawar),2016,2100,2100,0,0.0
Umared,Sorgum(Jawar),2016,2500,2500,0,0.0
Umared,Sorgum(Jawar),2016,1750,1750,0,0.0
Katol,Green Gram,2016,4411,4411,0,0.0
Umared,Sorgum(Jawar),2016,1300,1300,0,0.0
Umared,Sesamum,2016,6940,6940,0,0.0
Katol,Sorgum(Jawar),2015,950,950,0,0.0
Umared,SORGUM(JAWAR),2016,2475,2475,0,0.0
Katol,Sorgum(Jawar),2015,1038,1038,0,0.0
Katol,Sorgum(Jawar),2015,1127,1127,0,0.0
Katol,Black Gram,2016,6750,6750,0,0.0
Katol,Black Gram,2016,6500,6500,0,0.0
Katol,GREEN GRAM,2016,3850,3850,0,0.0
Khed (Shel Pimpalgaon),Cabbage,2015,1010,1010,0,0.0
Khed (Shel Pimpalgaon),Cabbage,2015,500,500,0,0.0
Kurdwadi,Chillies(Red),2016,8501,8501,0,0.0
Kurdwadi,Green Gram,2014,5501,5501,0,0.0
Koregaon,Sorgum(Jawar),2014,1600,1600,0,0.0
Koregaon,Black Gram,2015,4350,4350,0,0.0
Umared,Mustard,2014,2900,2900,0,0.0
Umared,Mustard,2014,2525,2525,0,0.0
Umared,Linseed,2014,4708,4708,0,0.0
Umared,Lentil,2014,3553,3553,0,0.0
Umared,Lentil,2014,3743,3743,0,0.0
Umared,Lang,2014,1618,1618,0,0.0
Korpana,Cotton,2014,4050,4050,0,0.0
Korpana,Cotton,2015,4100,4100,0,0.0
Korpana,Cotton,2015,4100,4100,0,0.0
Umared,Green Gram,2014,5034,5034,0,0.0
Korpana,Gram,2015,3100,3100,0,0.0
Korpana,Gram,2015,3100,3100,0,0.0
Korpana,Pigeon Pea (Tur),2015,5000,5000,0,0.0
Kundalwadi,Sorgum(Jawar),2016,1702,1702,0,0.0
Kurdwadi,Bajri,2014,1363,1363,0,0.0
Kurdwadi,Bajri,2014,1501,1501,0,0.0
Umared,Coriander (Dry),2014,11027,11027,0,0.0
Kurdwadi,Bajri,2014,1541,1541,0,0.0
Kurdwadi,Bajri,2014,1500,1500,0,0.0
Koregaon,Green Gram,2014,6800,6800,0,0.0
Koregaon,Gram,2014,3200,3200,0,0.0
Koregaon,Gram,2014,3200,3200,0,0.0
Kopargaon,Maize,2015,1466,1466,0,0.0
Kopargaon,Sorgum(Jawar),2014,1400,1400,0,0.0
Kopargaon,Green Gram,2015,6355,6355,0,0.0
Umared,Castor Seed,2015,2738,2738,0,0.0
Umared,Castor Seed,2015,2840,2840,0,0.0
Umared,Black Gram,2015,5200,5200,0,0.0
Umared,Black Gram,2015,6205,6205,0,0.0
Kopargaon,Green Gram,2015,8016,8016,0,0.0
Kopargaon,Green Gram,2015,7501,7501,0,0.0
Kopargaon,Maize,2015,1318,1318,0,0.0
Kopargaon,Pigeon Pea (Tur),2015,5350,5350,0,0.0
Umared,Pigeon Pea (Tur),2014,3700,3700,0,0.0
Kopargaon,Pigeon Pea (Tur),2015,5400,5400,0,0.0
Kopargaon,Pigeon Pea (Tur),2015,5850,5850,0,0.0
Kopargaon,Pigeon Pea (Tur),2015,6750,6750,0,0.0
Umared,Sorgum(Jawar),2014,1775,1775,0,0.0
Kopargaon,Pigeon Pea (Tur),2015,6000,6000,0,0.0
Kopargaon,Sorgum(Jawar),2015,1158,1158,0,0.0
Kopargaon,Green Gram,2016,7700,7700,0,0.0
Kopargaon,Pigeon Pea (Tur),2016,6750,6750,0,0.0
Kopargaon,Pigeon Pea (Tur),2016,6900,6900,0,0.0
Kurdwadi,Black Gram,2014,3400,3400,0,0.0
Kurdwadi,Soybean,2014,3225,3225,0,0.0
Kopargaon,Maize,2014,1117,1117,0,0.0
Kurdwadi,Wheat(Unhusked),2014,2000,2000,0,0.0
Kurdwadi,Mustard,2015,4000,4000,0,0.0
Kurdwadi,Pigeon Pea (Tur),2015,4601,4601,0,0.0
Kurdwadi,Pigeon Pea (Tur),2015,4267,4267,0,0.0
Kurdwadi,Pigeon Pea (Tur),2015,5000,5000,0,0.0
Kurdwadi,Sunflower,2015,3200,3200,0,0.0
Kurdwadi,Sunflower,2015,3000,3000,0,0.0
Kurdwadi,Sunflower,2015,3376,3376,0,0.0
Kurdwadi,Tamarind,2015,2200,2200,0,0.0
Kurdwadi,Tamarind,2015,3600,3600,0,0.0
Kurdwadi,Tamarind,2015,2400,2400,0,0.0
Kurdwadi,Tamarind Seed,2015,1326,1326,0,0.0
Kurdwadi,Tamarind Seed,2015,1500,1500,0,0.0
Kurdwadi,Tamarind Seed,2015,1400,1400,0,0.0
Kurdwadi,Wheat(Husked),2015,1746,1746,0,0.0
Kurdwadi,Wheat(Husked),2015,2029,2029,0,0.0
Kurdwadi,Wheat(Husked),2015,1867,1867,0,0.0
Kurdwadi,BAJRI,2016,1421,1421,0,0.0
Kurdwadi,Black Gram,2016,5801,5801,0,0.0
Kurdwadi,Black Gram,2016,3415,3415,0,0.0
Kurdwadi,Chavli (Pala),2016,2351,2351,0,0.0
Kurdwadi,Chavli (Pala),2016,3000,3000,0,0.0
Kurdwadi,Matki,2015,5100,5100,0,0.0
Kurdwadi,Ground Nut Pods (Dry),2015,5200,5200,0,0.0
Kurdwadi,Green Gram,2015,6667,6667,0,0.0
Kurdwadi,Chillies(Red),2015,7000,7000,0,0.0
Kurdwadi,Wheat(Unhusked),2014,2006,2006,0,0.0
Kurdwadi,Bajri,2015,1100,1100,0,0.0
Kurdwadi,Bajri,2015,1350,1350,0,0.0
Kurdwadi,Bajri,2015,1251,1251,0,0.0
Kurdwadi,Black Gram,2015,4000,4000,0,0.0
Kurdwadi,Black Gram,2015,5400,5400,0,0.0
Kurdwadi,Black Gram,2015,3400,3400,0,0.0
Kurdwadi,Castor Seed,2015,3050,3050,0,0.0
Kurdwadi,Chillies(Red),2015,5000,5000,0,0.0
Kurdwadi,Chillies(Red),2015,4251,4251,0,0.0
Kurdwadi,Green Gram,2015,7651,7651,0,0.0
Kurdwadi,Chillies(Red),2015,1500,1500,0,0.0
Kurdwadi,Chillies(Red),2015,6000,6000,0,0.0
Kurdwadi,Chillies(Red),2015,5500,5500,0,0.0
Kurdwadi,Gr.Nut Kernels,2015,4900,4900,0,0.0
Kurdwadi,Gram,2015,3613,3613,0,0.0
Kurdwadi,Gram,2015,4501,4501,0,0.0
Kurdwadi,Gram,2015,4213,4213,0,0.0
Kurdwadi,Green Gram,2015,7000,7000,0,0.0
Kurdwadi,Green Gram,2015,5651,5651,0,0.0
Kopargaon,Sorgum(Jawar),2014,1636,1636,0,0.0
Kolhapur-Laxmipuri,Lentil,2014,5100,5100,0,0.0
Khed (Shel Pimpalgaon),Cluster Bean,2015,3850,3850,0,0.0
Khed (Shel Pimpalgaon),CLUSTER BEAN,2016,3352,3352,0,0.0
Khed (Shel Pimpalgaon),Green Chilli,2015,1855,1855,0,0.0
Khed (Shel Pimpalgaon),Green Chilli,2015,2100,2100,0,0.0
Khed (Shel Pimpalgaon),Green Chilli,2015,1744,1744,0,0.0
Khed (Shel Pimpalgaon),Green Chilli,2015,2022,2022,0,0.0
Khed (Shel Pimpalgaon),Ladies Finger,2015,1605,1605,0,0.0
Umared,Linseed,2015,4595,4595,0,0.0
Umared,Linseed,2015,4678,4678,0,0.0
Umared,Linseed,2015,4849,4849,0,0.0
Khed (Shel Pimpalgaon),Ladies Finger,2015,2750,2750,0,0.0
Khed (Shel Pimpalgaon),Shevga,2015,1800,1800,0,0.0
Khed (Shel Pimpalgaon),Tomato,2015,1423,1423,0,0.0
Khed (Shel Pimpalgaon),Tomato,2015,1100,1100,0,0.0
Khed (Shel Pimpalgaon),Walvad,2015,2061,2061,0,0.0
Khed (Shel Pimpalgaon),BOTTLE GOURD,2016,600,600,0,0.0
Khed (Shel Pimpalgaon),Bottle Gourd,2016,175,175,0,0.0
Umared,Lentil,2015,3815,3815,0,0.0
Khed (Shel Pimpalgaon),Bottle Gourd,2016,1150,1150,0,0.0
Umared,Lang,2015,1614,1614,0,0.0
Umared,Lang,2015,1500,1500,0,0.0
Khed (Shel Pimpalgaon),Brinjal,2016,1000,1000,0,0.0
Khed (Shel Pimpalgaon),Brinjal,2016,2375,2375,0,0.0
Umared,Mustard,2015,3205,3205,0,0.0
Umared,Mustard,2015,2543,2543,0,0.0
Umared,Mustard,2015,2775,2775,0,0.0
Khed (Shel Pimpalgaon),Farshi,2015,3100,3100,0,0.0
Khed (Shel Pimpalgaon),Cluster Bean,2015,4630,4630,0,0.0
Khed (Shel Pimpalgaon),Coriander  ,2015,400,400,0,0.0
Khed (Shel Pimpalgaon),Cucumber,2015,640,640,0,0.0
Khed (Shel Pimpalgaon),Cucumber,2015,570,570,0,0.0
Khed (Shel Pimpalgaon),Cucumber,2015,1555,1555,0,0.0
Khed (Shel Pimpalgaon),Cucumber,2015,200,200,0,0.0
Khed (Shel Pimpalgaon),Cucumber,2015,1200,1200,0,0.0
Khed (Shel Pimpalgaon),Cucumber,2015,1105,1105,0,0.0
Khed (Shel Pimpalgaon),Cucumber,2015,510,510,0,0.0
Umared,Other Pulses,2015,6250,6250,0,0.0
Khed (Shel Pimpalgaon),Green Chilli,2015,2800,2800,0,0.0
Khed (Shel Pimpalgaon),Farshi,2015,1330,1330,0,0.0
Khed (Shel Pimpalgaon),Flower,2015,850,850,0,0.0
Khed (Shel Pimpalgaon),Flower,2015,250,250,0,0.0
Khed (Shel Pimpalgaon),Flower,2015,550,550,0,0.0
Khed (Shel Pimpalgaon),Flower,2015,400,400,0,0.0
Khed (Shel Pimpalgaon),Flower,2015,2510,2510,0,0.0
Khed (Shel Pimpalgaon),Flower,2015,850,850,0,0.0
Khed (Shel Pimpalgaon),Flower,2015,725,725,0,0.0
Shrirampur,Soybean,2016,3688,3688,0,0.0
Khed (Shel Pimpalgaon),CABBAGE,2016,300,300,0,0.0
Khed (Shel Pimpalgaon),Cabbage,2016,750,750,0,0.0
Umared,Chillies(Red),2015,6500,6500,0,0.0
Khed (Shel Pimpalgaon),Cabbage,2016,500,500,0,0.0
Kille Dharur,Ground Nut Pods (Dry),2015,5400,5400,0,0.0
Kille Dharur,Maize,2015,1425,1425,0,0.0
Kille Dharur,Sesamum,2015,7400,7400,0,0.0
Kille Dharur,Tamarind,2015,3500,3500,0,0.0
Kille Dharur,Tamarind,2015,3900,3900,0,0.0
Kille Dharur,Tamarind,2016,6600,6600,0,0.0
Kille Dharur,Tamarind,2016,7000,7000,0,0.0
Kolhapur,Chavli (Shenga ),2015,2000,2000,0,0.0
Kolhapur,Peer,2015,4500,4500,0,0.0
Kolhapur,Plum,2015,3500,3500,0,0.0
Kolhapur,Raddish,2015,255,255,0,0.0
Kolhapur,Snake Gourd,2015,975,975,0,0.0
Kolhapur,AWALA,2016,1750,1750,0,0.0
Kolhapur,Ghevda,2016,2100,2100,0,0.0
Kolhapur,Melon,2016,2000,2000,0,0.0
Kolhapur,Naspatti ,2016,10000,10000,0,0.0
Kolhapur,Shepu,2016,4200,4200,0,0.0
Kolhapur,Small Gourd,2016,3000,3000,0,0.0
Kolhapur,Water Melon,2016,450,450,0,0.0
Kolhapur-Laxmipuri,Cowpea,2014,4000,4000,0,0.0
Umared,Chillies(Red),2015,7000,7000,0,0.0
Kille Dharur,Green Gram,2015,5500,5500,0,0.0
Kille Dharur,Green Gram,2015,5650,5650,0,0.0
Kille Dharur,Castor Seed,2015,3400,3400,0,0.0
Khed (Shel Pimpalgaon),Farshi,2016,1750,1750,0,0.0
Khed (Shel Pimpalgaon),Cabbage,2016,250,250,0,0.0
Umared,Green Peas (Dry),2015,2300,2300,0,0.0
Umared,Green Peas (Dry),2015,2325,2325,0,0.0
Umared,Green Peas (Dry),2015,2300,2300,0,0.0
Khed (Shel Pimpalgaon),Cabbage,2016,733,733,0,0.0
Khed (Shel Pimpalgaon),Cluster Bean,2016,5905,5905,0,0.0
Khed (Shel Pimpalgaon),Cucumber,2016,1525,1525,0,0.0
Umared,Green Gram,2015,6900,6900,0,0.0
Khed (Shel Pimpalgaon),Cucumber,2016,720,720,0,0.0
Khed (Shel Pimpalgaon),Flower,2016,200,200,0,0.0
Kille Dharur,Black Gram,2015,8401,8401,0,0.0
Khed (Shel Pimpalgaon),Flower,2016,905,905,0,0.0
Khed (Shel Pimpalgaon),Green Chilli,2016,2532,2532,0,0.0
Khed (Shel Pimpalgaon),Shevga,2016,1100,1100,0,0.0
Khed (Shel Pimpalgaon),Tomato,2016,500,500,0,0.0
Khed (Shel Pimpalgaon),Walvad,2016,1254,1254,0,0.0
Kille Dharur,Cotton,2014,3980,3980,0,0.0
Kille Dharur,Green Gram,2014,6281,6281,0,0.0
Kille Dharur,Maize,2014,1334,1334,0,0.0
Kille Dharur,Sesamum,2014,11925,11925,0,0.0
Mantha,Gram,2015,3850,3850,0,0.0
Zarijamini,Soybean,2016,3400,3400,0,0.0
Mantha,Safflower,2015,2550,2550,0,0.0
Nandurbar,Horse Gram,2016,3000,3000,0,0.0
Nandurbar,Matki,2016,7000,7000,0,0.0
Nandurbar,PIGEON PEA (TUR),2016,5546,5546,0,0.0
Nandurbar,Pigeon Pea (Tur),2016,5000,5000,0,0.0
Nandurbar,Pigeon Pea (Tur),2016,8000,8000,0,0.0
Nandurbar,Pigeon Pea (Tur),2016,4612,4612,0,0.0
Nandurbar,RICE(PADDY-HUS),2016,3000,3000,0,0.0
Nandurbar,Rice(Paddy-Hus),2016,2700,2700,0,0.0
Nandurbar,Rice(Paddy-Hus),2016,2684,2684,0,0.0
Nandurbar,Rice(Paddy-Hus),2016,3650,3650,0,0.0
Nandurbar,Rice(Paddy-Hus),2016,3500,3500,0,0.0
Nandurbar,Rice(Paddy-Hus),2016,2428,2428,0,0.0
Nandurbar,Safflower,2016,3600,3600,0,0.0
Nandurbar,Soybean,2016,2957,2957,0,0.0
Nandurbar,Sunflower,2016,3286,3286,0,0.0
Nandurbar,Thymol/Lovage,2016,17700,17700,0,0.0
Nashik,Ground Nut Pods (Dry),2016,5500,5500,0,0.0
Navapur,Cotton,2014,3800,3800,0,0.0
Navapur,Brinjal,2015,1000,1000,0,0.0
Navapur,Brinjal,2015,1000,1000,0,0.0
Navapur,Coriander  ,2015,500,500,0,0.0
Navapur,Ginger (Fresh),2015,2400,2400,0,0.0
Nandurbar,Horse Gram,2016,1900,1900,0,0.0
Nandurbar,Horse Gram,2016,6250,6250,0,0.0
Navapur,Gram,2015,5350,5350,0,0.0
Nandurbar,Ground Nut Pods (Dry),2016,3400,3400,0,0.0
Nandurbar,Shepa,2015,3068,3068,0,0.0
Nandurbar,Soybean,2015,3087,3087,0,0.0
Nandurbar,Soybean,2015,4457,4457,0,0.0
Nandurbar,Soybean,2015,3123,3123,0,0.0
Nandurbar,Sunflower,2015,3060,3060,0,0.0
Nandurbar,Sunflower,2015,2941,2941,0,0.0
Nandurbar,Thymol/Lovage,2015,10000,10000,0,0.0
Nandurbar,Black Gram,2016,7780,7780,0,0.0
Nandurbar,Black Gram,2016,9012,9012,0,0.0
Nandurbar,Chillies(Red),2016,11600,11600,0,0.0
Nandurbar,Chillies(Red),2016,1531,1531,0,0.0
Nandurbar,Cluster Bean,2016,3850,3850,0,0.0
Nandurbar,Cluster Bean,2016,4038,4038,0,0.0
Nandurbar,Cluster Bean,2016,3533,3533,0,0.0
Nandurbar,Cluster Bean,2016,3030,3030,0,0.0
Nandurbar,Cowpea,2016,3500,3500,0,0.0
Nandurbar,Cowpea,2016,5502,5502,0,0.0
Nandurbar,GROUND NUT PODS (DRY),2016,2800,2800,0,0.0
Nandurbar,Green Gram,2016,7053,7053,0,0.0
Nandurbar,Green Gram,2016,7000,7000,0,0.0
Nandurbar,Ground Nut Pods (Dry),2016,3600,3600,0,0.0
Navapur,Gram,2015,5200,5200,0,0.0
Navapur,Green Peas (Dry),2015,2900,2900,0,0.0
Nanded,Sorgum(Jawar),2014,1625,1625,0,0.0
Navapur,Gram,2016,4600,4600,0,0.0
Navapur,Green Chilli,2016,3000,3000,0,0.0
Navapur,Green Chilli,2016,6000,6000,0,0.0
Navapur,Green Gram,2016,6000,6000,0,0.0
Navapur,Green Gram,2016,5500,5500,0,0.0
Navapur,Green Peas (Dry),2016,3400,3400,0,0.0
Navapur,Green Peas (Dry),2016,2900,2900,0,0.0
Navapur,Green Peas (Dry),2016,3200,3200,0,0.0
Navapur,Ground Nut Pods (Dry),2016,4000,4000,0,0.0
Navapur,Jaggery,2016,2300,2300,0,0.0
Navapur,Maize,2016,1331,1331,0,0.0
Navapur,Maize,2016,1381,1381,0,0.0
Navapur,Methi (Bhaji),2016,2500,2500,0,0.0
Navapur,Other Cereals,2016,3500,3500,0,0.0
Navapur,Other Pulses,2016,2000,2000,0,0.0
Navapur,Other Vegetables,2016,3500,3500,0,0.0
Navapur,Other Vegetables,2016,1900,1900,0,0.0
Navapur,Other Vegetables,2016,2917,2917,0,0.0
Navapur,POTATO,2016,1000,1000,0,0.0
Navapur,Paddy-Unhusked,2016,1350,1350,0,0.0
Navapur,Paddy-Unhusked,2016,1467,1467,0,0.0
Navapur,Pigeon Pea (Tur),2016,6000,6000,0,0.0
Navapur,Gram,2016,5300,5300,0,0.0
Navapur,Ginger (Fresh),2016,2500,2500,0,0.0
Navapur,Ground Nut Pods (Dry),2015,4000,4000,0,0.0
Navapur,Ginger (Fresh),2016,2833,2833,0,0.0
Navapur,Other Vegetables,2015,1200,1200,0,0.0
Navapur,Other Vegetables,2015,2000,2000,0,0.0
Navapur,Potato,2015,1000,1000,0,0.0
Navapur,Rice(Paddy-Hus),2015,1720,1720,0,0.0
Navapur,Soybean,2015,3500,3500,0,0.0
Navapur,Wal Papdi,2015,1500,1500,0,0.0
Navapur,Wal Papdi,2015,2000,2000,0,0.0
Navapur,Bajri,2016,1500,1500,0,0.0
Navapur,Bitter Gourd,2016,1929,1929,0,0.0
Navapur,Bitter Gourd,2016,3000,3000,0,0.0
Navapur,Brinjal,2016,583,583,0,0.0
Navapur,Brinjal,2016,800,800,0,0.0
Navapur,Brinjal,2016,1100,1100,0,0.0
Navapur,Cabbage,2016,2000,2000,0,0.0
Navapur,Cabbage,2016,500,500,0,0.0
Navapur,Cluster Bean,2016,2000,2000,0,0.0
Navapur,Cluster Bean,2016,2500,2500,0,0.0
Navapur,Coriander  ,2016,2333,2333,0,0.0
Navapur,Flower,2016,1000,1000,0,0.0
Navapur,Flower,2016,2500,2500,0,0.0
Navapur,Ginger (Fresh),2016,5000,5000,0,0.0
Nandurbar,Shepa,2015,5900,5900,0,0.0
Nandurbar,Shepa,2015,3513,3513,0,0.0
Nandurbar,Sesamum,2015,8200,8200,0,0.0
Nanded,Mustard,2016,5000,5000,0,0.0
Nanded,Pigeon Pea (Tur),2016,4800,4800,0,0.0
Nanded,Sesamum,2016,5200,5200,0,0.0
Nanded,Soybean,2016,3881,3881,0,0.0
Nanded,Soybean,2016,3650,3650,0,0.0
Nanded,Soybean,2016,3651,3651,0,0.0
Nandgaon,Pigeon Pea (Tur),2015,7201,7201,0,0.0
Nandgaon,Soybean,2015,3350,3350,0,0.0
Nandgaon,Gram,2016,5800,5800,0,0.0
Nandgaon,Pigeon Pea (Tur),2016,5901,5901,0,0.0
Nandgaon,Sorgum(Jawar),2016,1834,1834,0,0.0
Nandura,Black Gram,2016,6000,6000,0,0.0
Nandura,Black Gram,2016,6666,6666,0,0.0
Nandura,Black Gram,2016,11417,11417,0,0.0
Nandura,Green Gram,2016,6100,6100,0,0.0
Nandura,Green Gram,2016,7300,7300,0,0.0
Nandura,Green Gram,2016,6565,6565,0,0.0
Nandura,Sesamum,2016,5088,5088,0,0.0
Nandurbar,Chillies(Red),2014,1080,1080,0,0.0
Mantha,Bajri,2016,1450,1450,0,0.0
Nandurbar,Green Gram,2014,6394,6394,0,0.0
Nandurbar,Ground Nut Pods (Dry),2014,3700,3700,0,0.0
Nanded,PIGEON PEA (TUR),2016,4800,4800,0,0.0
Nanded,Ground Nut Pods (Dry),2016,5600,5600,0,0.0
Nandurbar,Safflower,2015,2676,2676,0,0.0
Nanded,Green Gram,2016,5800,5800,0,0.0
Nanded,Gram,2015,4300,4300,0,0.0
Nanded,Gram,2015,2860,2860,0,0.0
Nanded,Gram,2015,3800,3800,0,0.0
Nanded,Green Gram,2015,7550,7550,0,0.0
Nanded,Green Gram,2015,7400,7400,0,0.0
Nanded,Ground Nut Pods (Dry),2015,5611,5611,0,0.0
Nanded,Maize,2015,1350,1350,0,0.0
Nanded,Pigeon Pea (Tur),2015,8100,8100,0,0.0
Nanded,Sorgum(Jawar),2015,1211,1211,0,0.0
Nanded,Soybean,2015,3600,3600,0,0.0
Nanded,Soybean,2015,3340,3340,0,0.0
Nanded,Soybean,2015,3207,3207,0,0.0
Nanded,Soybean,2015,3900,3900,0,0.0
Nanded,Baru Seed,2016,4800,4800,0,0.0
Nanded,Black Gram,2016,6110,6110,0,0.0
Nanded,Castor Seed,2016,2900,2900,0,0.0
Nanded,Gram,2016,7026,7026,0,0.0
Nanded,Gram,2016,4600,4600,0,0.0
Nanded,Gram,2016,5000,5000,0,0.0
Nanded,Green Gram,2016,4350,4350,0,0.0
Nanded,Green Gram,2016,5200,5200,0,0.0
Nandurbar,Pigeon Pea (Tur),2014,4410,4410,0,0.0
Nandurbar,Pigeon Pea (Tur),2014,3501,3501,0,0.0
Nandurbar,Rice(Paddy-Hus),2014,3500,3500,0,0.0
Nandurbar,Rice(Paddy-Hus),2014,2375,2375,0,0.0
Nandurbar,Horse Gram,2015,6911,6911,0,0.0
Nandurbar,Horse Gram,2015,1925,1925,0,0.0
Nandurbar,Horse Gram,2015,1700,1700,0,0.0
Nandurbar,Matki,2015,6700,6700,0,0.0
Nandurbar,Matki,2015,7189,7189,0,0.0
Nandurbar,Matki,2015,6267,6267,0,0.0
Nandurbar,Matki,2015,6700,6700,0,0.0
Nandurbar,Matki,2015,7000,7000,0,0.0
Nandurbar,Matki,2015,7000,7000,0,0.0
Nandurbar,Matki,2015,6702,6702,0,0.0
Nandurbar,Nagali,2015,2261,2261,0,0.0
Nandurbar,Nagali,2015,2000,2000,0,0.0
Nandurbar,Pigeon Pea (Tur),2015,5298,5298,0,0.0
Nandurbar,Pigeon Pea (Tur),2015,4653,4653,0,0.0
Nandurbar,Pigeon Pea (Tur),2015,5151,5151,0,0.0
Nandurbar,Pigeon Pea (Tur),2015,8560,8560,0,0.0
Nandurbar,Pigeon Pea (Tur),2015,4951,4951,0,0.0
Nandurbar,Rice(Paddy-Hus),2015,3375,3375,0,0.0
Nandurbar,Rice(Paddy-Hus),2015,3238,3238,0,0.0
Nandurbar,Rice(Paddy-Hus),2015,3500,3500,0,0.0
Nandurbar,Rice(Paddy-Hus),2015,6000,6000,0,0.0
Nandurbar,Ground Nut Pods (Dry),2015,3100,3100,0,0.0
Nandurbar,Ground Nut Pods (Dry),2015,5400,5400,0,0.0
Nandurbar,Green Gram,2015,8226,8226,0,0.0
Nandurbar,Black Gram,2015,7793,7793,0,0.0
Nandurbar,Rice(Paddy-Hus),2014,1863,1863,0,0.0
Nandurbar,Rice(Paddy-Hus),2014,1888,1888,0,0.0
Nandurbar,Shepa,2014,3700,3700,0,0.0
Nandurbar,Shepa,2014,5000,5000,0,0.0
Nandurbar,Black Gram,2015,5145,5145,0,0.0
Nandurbar,Black Gram,2015,2000,2000,0,0.0
Nandurbar,Black Gram,2015,7413,7413,0,0.0
Nandurbar,Black Gram,2015,5063,5063,0,0.0
Nandurbar,Black Gram,2015,8913,8913,0,0.0
Telhara,Cotton,2015,4000,4000,0,0.0
Nandurbar,Green Gram,2015,5413,5413,0,0.0
Nandurbar,Castor Seed,2015,3100,3100,0,0.0
Nandurbar,Cluster Bean,2015,3442,3442,0,0.0
Nandurbar,Cluster Bean,2015,4082,4082,0,0.0
Nandurbar,Cowpea,2015,4753,4753,0,0.0
Nandurbar,Cowpea,2015,5000,5000,0,0.0
Nandurbar,Cowpea,2015,6000,6000,0,0.0
Nandurbar,Green Gram,2015,6600,6600,0,0.0
Nandurbar,Green Gram,2015,7939,7939,0,0.0
Nandurbar,Green Gram,2015,6282,6282,0,0.0
Navapur,Pigeon Pea (Tur),2016,6140,6140,0,0.0
Navapur,RICE(PADDY-HUS),2016,1800,1800,0,0.0
Navapur,Rice(Paddy-Hus),2016,1700,1700,0,0.0
Tadkalas,Sorgum(Jawar),2016,1630,1630,0,0.0
Tadkalas,Green Gram,2016,5003,5003,0,0.0
Tadkalas,Green Gram,2016,5313,5313,0,0.0
Tadkalas,Black Gram,2016,7100,7100,0,0.0
Tadkalas,Wheat(Husked),2014,0,0,0,
Tadkalas,Wheat(Husked),2014,0,0,0,
Tadkalas,Soybean,2014,0,0,0,
Tadkalas,Sorgum(Jawar),2014,0,0,0,
Tadkalas,Sorgum(Jawar),2014,0,0,0,
Tadkalas,Pigeon Pea (Tur),2014,0,0,0,
Osmanabad,Black Gram,2016,11000,11000,0,0.0
Tadkalas,Green Gram,2014,0,0,0,
Tadkalas,Gram,2014,0,0,0,
Osmanabad,Coriander (Dry),2016,5500,5500,0,0.0
Osmanabad,Gram,2016,8250,8250,0,0.0
Osmanabad,Green Gram,2016,4481,4481,0,0.0
Osmanabad,Green Gram,2016,4400,4400,0,0.0
Osmanabad,Ground Nut Pods (Dry),2016,3751,3751,0,0.0
Osmanabad,Ground Nut Pods (Dry),2016,4401,4401,0,0.0
Osmanabad,Ground Nut Pods (Dry),2016,5510,5510,0,0.0
Osmanabad,KHARBUJ,2016,4450,4450,0,0.0
Osmanabad,Maize,2016,1401,1401,0,0.0
Tadkalas,SOYBEAN,2016,2802,2802,0,0.0
Tadkalas,Sorgum(Jawar),2016,1600,1600,0,0.0
Nira-Saswad,Green Gram,2016,4918,4918,0,0.0
Tadkalas,Soybean,2016,2786,2786,0,0.0
Nira-Saswad,Maize,2016,1676,1676,0,0.0
Nira-Saswad,Maize,2016,1621,1621,0,0.0
Nira-Saswad,Pigeon Pea (Tur),2016,6500,6500,0,0.0
Nira-Saswad,Pigeon Pea (Tur),2016,6000,6000,0,0.0
Nira-Saswad,Soybean,2016,3300,3300,0,0.0
Nira-Saswad,Soybean,2016,3350,3350,0,0.0
Osmanabad,Green Gram,2014,5701,5701,0,0.0
Osmanabad,Green Gram,2014,5900,5900,0,0.0
Osmanabad,Sesamum,2014,11600,11600,0,0.0
Osmanabad,Gram,2015,4200,4200,0,0.0
Osmanabad,Gram,2015,4550,4550,0,0.0
Osmanabad,Green Gram,2015,7400,7400,0,0.0
Osmanabad,Green Gram,2015,7410,7410,0,0.0
Osmanabad,Maize,2015,1245,1245,0,0.0
Osmanabad,Maize,2015,1025,1025,0,0.0
Osmanabad,Pigeon Pea (Tur),2015,8173,8173,0,0.0
Osmanabad,Pigeon Pea (Tur),2015,6400,6400,0,0.0
Osmanabad,Pigeon Pea (Tur),2015,10300,10300,0,0.0
Tadkalas,Wheat(Husked),2016,1583,1583,0,0.0
Tadkalas,Wheat(Husked),2016,1560,1560,0,0.0
Tadkalas,Soybean,2016,3100,3100,0,0.0
Osmanabad,Maize,2016,1351,1351,0,0.0
Osmanabad,Maize,2016,1686,1686,0,0.0
Osmanabad,Maize,2016,1435,1435,0,0.0
Osmanabad,Maize,2016,1800,1800,0,0.0
Pachora,Sesamum,2016,4500,4500,0,0.0
Pachora,Soybean,2016,2800,2800,0,0.0
Paithan,Gram,2014,2658,2658,0,0.0
Paithan,Gram,2015,4120,4120,0,0.0
Paithan,Gram,2015,4103,4103,0,0.0
Paithan,Gram,2015,4082,4082,0,0.0
Paithan,Gram,2015,4300,4300,0,0.0
Paithan,Green Gram,2015,6601,6601,0,0.0
Paithan,Maize,2015,1700,1700,0,0.0
Paithan,Maize,2015,1482,1482,0,0.0
Paithan,Maize,2015,1335,1335,0,0.0
Paithan,Maize,2015,1330,1330,0,0.0
Sonpeth,Sesamum,2016,6000,6000,0,0.0
Paithan,Maize,2015,1351,1351,0,0.0
Sonpeth,Safflower,2016,4082,4082,0,0.0
Sonpeth,Safflower,2016,2576,2576,0,0.0
Paithan,Maize,2015,1504,1504,0,0.0
Paithan,Maize,2015,1426,1426,0,0.0
Paithan,Pigeon Pea (Tur),2015,7667,7667,0,0.0
Paithan,Pigeon Pea (Tur),2015,6049,6049,0,0.0
Sonpeth,SESAMUM,2016,4600,4600,0,0.0
Pachora,Rice(Paddy-Hus),2016,1326,1326,0,0.0
Pachora,Other Cereals,2016,5367,5367,0,0.0
Osmanabad,Wheat(Husked),2016,1834,1834,0,0.0
Osmanabad,Safflower,2016,2402,2402,0,0.0
Osmanabad,Onion,2016,700,700,0,0.0
Osmanabad,PIGEON PEA (TUR),2016,5000,5000,0,0.0
Osmanabad,Pigeon Pea (Tur),2016,6750,6750,0,0.0
Osmanabad,Pigeon Pea (Tur),2016,6526,6526,0,0.0
Osmanabad,Pigeon Pea (Tur),2016,6335,6335,0,0.0
Osmanabad,Pomegranate,2016,1800,1800,0,0.0
Osmanabad,Potato,2016,400,400,0,0.0
Osmanabad,SUNFLOWER,2016,2501,2501,0,0.0
Osmanabad,Safflower,2016,2700,2700,0,0.0
Sonpeth,Wheat(Husked),2016,5573,5573,0,0.0
Sonpeth,WHEAT(HUSKED),2016,1918,1918,0,0.0
Sonpeth,Wheat(Husked),2016,1520,1520,0,0.0
Osmanabad,Soybean,2016,3478,3478,0,0.0
Osmanabad,Soybean,2016,3700,3700,0,0.0
Osmanabad,Sunflower,2016,3291,3291,0,0.0
Osmanabad,Sunflower,2016,3151,3151,0,0.0
Osmanabad,Sunflower,2016,3061,3061,0,0.0
Osmanabad,Sunflower,2016,2750,2750,0,0.0
Osmanabad,Tomato,2016,400,400,0,0.0
Osmanabad,Wheat(Husked),2016,1695,1695,0,0.0
Nira-Saswad,MAIZE,2016,1531,1531,0,0.0
Nira-Saswad,Green Gram,2016,5900,5900,0,0.0
Navapur,Rice(Paddy-Hus),2016,1800,1800,0,0.0
Newasa,Sorgum(Jawar),2014,1540,1540,0,0.0
Newasa,Bajri,2015,1250,1250,0,0.0
Newasa,Bajri,2015,1317,1317,0,0.0
Newasa,Bajri,2015,1283,1283,0,0.0
Taloda,Bajri,2016,1500,1500,0,0.0
Newasa,Bajri,2015,1342,1342,0,0.0
Newasa,Bajri,2015,1300,1300,0,0.0
Newasa,Gram,2015,3200,3200,0,0.0
Newasa,Gram,2015,3175,3175,0,0.0
Taloda,Wheat(Husked),2015,1655,1655,0,0.0
Taloda,Wheat(Husked),2015,1693,1693,0,0.0
Newasa,Gram,2015,3217,3217,0,0.0
Newasa,Gram,2015,3620,3620,0,0.0
Newasa,Gram,2015,3460,3460,0,0.0
Newasa,Maize,2015,1310,1310,0,0.0
Newasa,Maize,2015,1330,1330,0,0.0
Newasa,Maize,2015,1310,1310,0,0.0
Newasa,Maize,2015,1310,1310,0,0.0
Newasa,Maize,2015,1310,1310,0,0.0
Newasa,Maize,2015,1310,1310,0,0.0
Newasa,Maize,2015,1350,1350,0,0.0
Newasa,Maize,2015,1417,1417,0,0.0
Newasa,Bajri,2015,1419,1419,0,0.0
Newasa,Sorgum(Jawar),2014,1550,1550,0,0.0
Nira-Saswad,Ghevda Seed,2016,3200,3200,0,0.0
Newasa,Maize,2014,1310,1310,0,0.0
Navapur,Rice(Paddy-Hus),2016,1800,1800,0,0.0
Navapur,Rice(Paddy-Hus),2016,1800,1800,0,0.0
Navapur,Rice(Paddy-Hus),2016,1300,1300,0,0.0
Navapur,Sorgum(Jawar),2016,1525,1525,0,0.0
Navapur,Soybean,2016,3600,3600,0,0.0
Navapur,Soybean,2016,3600,3600,0,0.0
Navapur,Soybean,2016,4000,4000,0,0.0
Navapur,Wal Papdi,2016,5000,5000,0,0.0
Navapur,Wheat(Husked),2016,1650,1650,0,0.0
Ner Parasopant,Gram,2014,2550,2550,0,0.0
Ner Parasopant,Pigeon Pea (Tur),2014,4300,4300,0,0.0
Ner Parasopant,Wheat(Husked),2014,1575,1575,0,0.0
Ner Parasopant,Black Gram,2015,4300,4300,0,0.0
Ner Parasopant,Black Gram,2015,4300,4300,0,0.0
Ner Parasopant,Gram,2016,7033,7033,0,0.0
Ner Parasopant,Gram,2016,7550,7550,0,0.0
Ner Parasopant,Wheat(Husked),2016,1500,1500,0,0.0
Newasa,Gram,2014,3175,3175,0,0.0
Newasa,Gram,2014,3175,3175,0,0.0
Newasa,Gram,2014,3084,3084,0,0.0
Newasa,Gram,2014,3000,3000,0,0.0
Newasa,Pigeon Pea (Tur),2015,4800,4800,0,0.0
Newasa,Sorgum(Jawar),2015,1550,1550,0,0.0
Newasa,Sorgum(Jawar),2015,1800,1800,0,0.0
Newasa,Sorgum(Jawar),2015,1600,1600,0,0.0
Newasa,Pigeon Pea (Tur),2016,7500,7500,0,0.0
Newasa,Pigeon Pea (Tur),2016,7500,7500,0,0.0
Newasa,Sorgum(Jawar),2016,1698,1698,0,0.0
Newasa,Sorgum(Jawar),2016,1642,1642,0,0.0
Newasa,Sorgum(Jawar),2016,1600,1600,0,0.0
Newasa,Tamarind,2016,2350,2350,0,0.0
Newasa,Tamarind,2016,1600,1600,0,0.0
Taloda,Castor Seed,2015,3325,3325,0,0.0
Newasa,Tamarind,2016,2000,2000,0,0.0
Newasa,Tamarind,2016,2000,2000,0,0.0
Nilanga,Green Gram,2015,8000,8000,0,0.0
Nilanga,Pigeon Pea (Tur),2015,10100,10100,0,0.0
Nilanga,Safflower,2015,2521,2521,0,0.0
Nira,Maize,2015,1400,1400,0,0.0
Nira-Saswad,Maize,2015,1563,1563,0,0.0
Nira-Saswad,Soybean,2015,3300,3300,0,0.0
Taloda,Bajri,2015,1530,1530,0,0.0
Taloda,Bajri,2015,1545,1545,0,0.0
Taloda,Bajri,2015,1513,1513,0,0.0
Nira-Saswad,Coriander (Dry),2016,8000,8000,0,0.0
Nira-Saswad,Ghevda Seed,2016,900,900,0,0.0
Newasa,Pigeon Pea (Tur),2016,6500,6500,0,0.0
Newasa,Maize,2016,1450,1450,0,0.0
Newasa,Maize,2016,1600,1600,0,0.0
Newasa,Bajri,2016,1600,1600,0,0.0
Taloda,Pigeon Pea (Tur),2015,8400,8400,0,0.0
Newasa,Sorgum(Jawar),2015,1592,1592,0,0.0
Newasa,Sorgum(Jawar),2015,1550,1550,0,0.0
Newasa,Sorgum(Jawar),2015,1550,1550,0,0.0
Newasa,Sorgum(Jawar),2015,1550,1550,0,0.0
Newasa,Tamarind,2015,1300,1300,0,0.0
Newasa,Tamarind,2015,1200,1200,0,0.0
Newasa,Tamarind,2015,1200,1200,0,0.0
Newasa,Bajri,2016,1750,1750,0,0.0
Newasa,Bajri,2016,1500,1500,0,0.0
Newasa,Maize,2016,1450,1450,0,0.0
Newasa,Bajri,2016,1500,1500,0,0.0
Newasa,Bajri,2016,1650,1650,0,0.0
Newasa,Bajri,2016,1700,1700,0,0.0
Newasa,GRAM,2016,6000,6000,0,0.0
Newasa,Gram,2016,6460,6460,0,0.0
Newasa,Gram,2016,5633,5633,0,0.0
Newasa,Green Gram,2016,5650,5650,0,0.0
Newasa,Maize,2016,1400,1400,0,0.0
Newasa,Maize,2016,1375,1375,0,0.0
Nanded,Black Gram,2015,6450,6450,0,0.0
Nandurbar,Green Gram,2014,5000,5000,0,0.0
Nanded,Pigeon Pea (Tur),2014,3900,3900,0,0.0
Mohol,Green Gram,2016,4675,4675,0,0.0
Mohol,Pigeon Pea (Tur),2016,8405,8405,0,0.0
Mohol,Pigeon Pea (Tur),2016,7590,7590,0,0.0
Mohol,Pigeon Pea (Tur),2016,8078,8078,0,0.0
Murum,Maize,2015,1600,1600,0,0.0
Murum,Sesamum,2015,8460,8460,0,0.0
Murum,Sorgum(Jawar),2015,1921,1921,0,0.0
Murum,Sorgum(Jawar),2015,1831,1831,0,0.0
Mohol,Green Gram,2016,4400,4400,0,0.0
Murum,Sorgum(Jawar),2015,1962,1962,0,0.0
Tuljapur,Safflower,2015,2759,2759,0,0.0
Tuljapur,Pigeon Pea (Tur),2015,8900,8900,0,0.0
Tuljapur,Pigeon Pea (Tur),2015,11267,11267,0,0.0
Tuljapur,Pigeon Pea (Tur),2015,10707,10707,0,0.0
Tuljapur,Pigeon Pea (Tur),2015,6338,6338,0,0.0
Tuljapur,Pigeon Pea (Tur),2015,5413,5413,0,0.0
Mohol,WHEAT(HUSKED),2016,2200,2200,0,0.0
Mohol,Wheat(Husked),2016,1575,1575,0,0.0
Mohol,Wheat(Husked),2016,3168,3168,0,0.0
Murum,Maize,2015,1451,1451,0,0.0
Tuljapur,Soybean,2015,3767,3767,0,0.0
Mukhed,Gram,2015,4100,4100,0,0.0
Mukhed,Bajri,2015,1500,1500,0,0.0
Murum,Green Gram,2015,7625,7625,0,0.0
Murum,Green Gram,2015,7000,7000,0,0.0
Murum,Maize,2015,1456,1456,0,0.0
Tuljapur,Sorgum(Jawar),2015,1650,1650,0,0.0
Mohol,Wheat(Husked),2016,1700,1700,0,0.0
Tuljapur,Sorgum(Jawar),2015,1150,1150,0,0.0
Tuljapur,Sorgum(Jawar),2015,1121,1121,0,0.0
Tuljapur,Sorgum(Jawar),2015,2450,2450,0,0.0
Murum,Maize,2015,1786,1786,0,0.0
Mudkhed,Green Gram,2015,6937,6937,0,0.0
Mohol,Wheat(Unhusked),2016,2300,2300,0,0.0
Tuljapur,Pigeon Pea (Tur),2015,9333,9333,0,0.0
Murum,Sorgum(Jawar),2015,1879,1879,0,0.0
Tuljapur,Soybean,2015,3425,3425,0,0.0
Tuljapur,Paddy-Unhusked,2015,1000,1000,0,0.0
Mohol,Wheat(Husked),2015,1500,1500,0,0.0
Mohol,Wheat(Husked),2015,1593,1593,0,0.0
Murum,Wheat(Husked),2015,1400,1400,0,0.0
Murum,Wheat(Husked),2015,1701,1701,0,0.0
Murum,Wheat(Husked),2015,2500,2500,0,0.0
Mohol,Pigeon Pea (Tur),2015,6000,6000,0,0.0
Tuljapur,Gram,2015,4382,4382,0,0.0
Tuljapur,Gram,2015,4000,4000,0,0.0
Tuljapur,Gram,2015,4151,4151,0,0.0
Murum,Wheat(Unhusked),2015,3599,3599,0,0.0
Murum,Wheat(Unhusked),2015,3500,3500,0,0.0
Murum,Wheat(Unhusked),2015,3001,3001,0,0.0
Murum,Wheat(Unhusked),2015,3451,3451,0,0.0
Manwat,Wheat(Husked),2016,1560,1560,0,0.0
Murum,Wheat(Unhusked),2015,3150,3150,0,0.0
Mohol,Wheat(Unhusked),2015,3000,3000,0,0.0
Mohol,GREEN GRAM,2016,4173,4173,0,0.0
Tuljapur,Green Gram,2015,6850,6850,0,0.0
Murum,Sunflower,2015,3401,3401,0,0.0
Murum,Soybean,2015,3265,3265,0,0.0
Mohol,Green Gram,2016,4853,4853,0,0.0
Tuljapur,Maize,2015,1700,1700,0,0.0
Tuljapur,Maize,2015,1725,1725,0,0.0
Murum,Soybean,2015,3182,3182,0,0.0
Murum,Soybean,2015,3970,3970,0,0.0
Murum,Sunflower,2015,3826,3826,0,0.0
Tuljapur,Green Gram,2015,6000,6000,0,0.0
Murum,Sunflower,2015,3789,3789,0,0.0
Murum,Wheat(Husked),2015,2488,2488,0,0.0
Tuljapur,Linseed,2015,4800,4800,0,0.0
Tuljapur,Linseed,2015,4400,4400,0,0.0
Tuljapur,Green Gram,2015,6376,6376,0,0.0
Tuljapur,Green Gram,2015,6000,6000,0,0.0
Tuljapur,Soybean,2015,3475,3475,0,0.0
Murum,Green Gram,2015,6901,6901,0,0.0
Manwat,Wheat(Husked),2016,1926,1926,0,0.0
Tuljapur,Bajri,2016,1526,1526,0,0.0
Tuljapur,Linseed,2016,4601,4601,0,0.0
Murum,Pigeon Pea (Tur),2014,4500,4500,0,0.0
Murum,Pigeon Pea (Tur),2014,4963,4963,0,0.0
Murum,Safflower,2014,2550,2550,0,0.0
Tuljapur,Gram,2016,5400,5400,0,0.0
Murum,Sesamum,2014,8761,8761,0,0.0
Murum,Sorgum(Jawar),2014,2137,2137,0,0.0
Murum,Sorgum(Jawar),2014,1900,1900,0,0.0
Murum,Wheat(Husked),2014,1667,1667,0,0.0
Murum,Wheat(Husked),2014,1450,1450,0,0.0
Murum,Wheat(Unhusked),2014,2100,2100,0,0.0
Tuljapur,GRAM,2016,7600,7600,0,0.0
Tuljapur,Castor Seed,2016,2647,2647,0,0.0
Murum,Wheat(Unhusked),2014,3951,3951,0,0.0
Murum,Bajri,2015,1348,1348,0,0.0
Murum,Maize,2014,1350,1350,0,0.0
Murum,Maize,2014,1400,1400,0,0.0
Murum,Gram,2014,2700,2700,0,0.0
Tuljapur,Pigeon Pea (Tur),2016,4450,4450,0,0.0
Tuljapur,Sorgum(Jawar),2016,1735,1735,0,0.0
Tuljapur,Sorgum(Jawar),2016,2090,2090,0,0.0
Tuljapur,Sorgum(Jawar),2016,1839,1839,0,0.0
Tuljapur,Pigeon Pea (Tur),2016,5200,5200,0,0.0
Tuljapur,Pigeon Pea (Tur),2016,8500,8500,0,0.0
Tuljapur,Sorgum(Jawar),2016,1250,1250,0,0.0
Murum,Bajri,2014,1355,1355,0,0.0
Tuljapur,Maize,2016,1392,1392,0,0.0
Murum,Bajri,2014,1250,1250,0,0.0
Murum,Coriander (Dry),2014,9500,9500,0,0.0
Murum,Coriander (Dry),2014,8790,8790,0,0.0
Tuljapur,Maize,2016,1500,1500,0,0.0
Tuljapur,Maize,2016,1481,1481,0,0.0
Tuljapur,Maize,2016,1650,1650,0,0.0
Tuljapur,Bajri,2016,1600,1600,0,0.0
Murum,Black Gram,2015,6400,6400,0,0.0
Tuljapur,Sunflower,2015,3551,3551,0,0.0
Murum,Black Gram,2015,5846,5846,0,0.0
Tuljapur,Turmeric,2016,6801,6801,0,0.0
Tuljapur,Wheat(Husked),2016,2541,2541,0,0.0
Tuljapur,Wheat(Husked),2016,1450,1450,0,0.0
Tuljapur,Wheat(Husked),2016,3201,3201,0,0.0
Tuljapur,Wheat(Unhusked),2016,3100,3100,0,0.0
Tuljapur,Wheat(Unhusked),2016,2250,2250,0,0.0
Tuljapur,Wheat(Unhusked),2016,2850,2850,0,0.0
Mukhed,Soybean,2016,3813,3813,0,0.0
Mukhed,Sorgum(Jawar),2016,1600,1600,0,0.0
Mukhed,Gram,2016,4250,4250,0,0.0
Mukhed,Gram,2016,4300,4300,0,0.0
Mukhed,Gram,2016,4157,4157,0,0.0
Mukhed,Soybean,2015,3300,3300,0,0.0
Mukhed,Sorgum(Jawar),2015,1291,1291,0,0.0
Murum,Green Gram,2015,7126,7126,0,0.0
Tuljapur,Soybean,2016,3300,3300,0,0.0
Tuljapur,Soybean,2016,4060,4060,0,0.0
Tuljapur,Sorgum(Jawar),2016,1400,1400,0,0.0
Tuljapur,Wheat(Husked),2015,2528,2528,0,0.0
Murum,Black Gram,2015,7941,7941,0,0.0
Tuljapur,Wheat(Unhusked),2015,2900,2900,0,0.0
Tuljapur,Wheat(Unhusked),2015,2665,2665,0,0.0
Tuljapur,Wheat(Unhusked),2015,3000,3000,0,0.0
Tuljapur,Wheat(Unhusked),2015,2720,2720,0,0.0
Tuljapur,Wheat(Husked),2015,1386,1386,0,0.0
Tuljapur,Wheat(Husked),2015,1350,1350,0,0.0
Murum,Gram,2015,4350,4350,0,0.0
Murum,Coriander (Dry),2015,8875,8875,0,0.0
Tuljapur,Turmeric,2015,7111,7111,0,0.0
Tuljapur,Turmeric,2015,6150,6150,0,0.0
Murum,Gram,2015,4700,4700,0,0.0
Nanded,Green Gram,2014,6575,6575,0,0.0
Murum,Gram,2015,4476,4476,0,0.0
Murbad,Cabbage,2015,2200,2200,0,0.0
Manwat,Wheat(Husked),2016,1551,1551,0,0.0
Manwat,Wheat(Husked),2016,1625,1625,0,0.0
Naigaon,Wheat(Husked),2015,1475,1475,0,0.0
Mantha,Sesamum,2016,5100,5100,0,0.0
Naigaon,Black Gram,2016,7550,7550,0,0.0
Mantha,Safflower,2016,2550,2550,0,0.0
Naigaon,GRAM,2016,9025,9025,0,0.0
Naigaon,Gram,2016,6500,6500,0,0.0
Naigaon,Green Gram,2016,7000,7000,0,0.0
Naigaon,SESAMUM,2016,4000,4000,0,0.0
Naigaon,Safflower,2016,2150,2150,0,0.0
Naigaon,Sorgum(Jawar),2016,1410,1410,0,0.0
Naigaon,Sorgum(Jawar),2016,1388,1388,0,0.0
Naigaon,Sorgum(Jawar),2016,1350,1350,0,0.0
Naigaon,Soybean,2016,3808,3808,0,0.0
Naigaon,Soybean,2016,3350,3350,0,0.0
Mantha,Pigeon Pea (Tur),2016,6360,6360,0,0.0
Naigaon,WHEAT(HUSKED),2016,1600,1600,0,0.0
Naigaon,Black Gram,2016,8833,8833,0,0.0
Naigaon,Soybean,2015,3335,3335,0,0.0
Murum,Wheat(Husked),2016,2099,2099,0,0.0
Naigaon,Sorgum(Jawar),2015,1300,1300,0,0.0
Murum,Wheat(Husked),2016,2301,2301,0,0.0
Murum,Wheat(Unhusked),2016,3491,3491,0,0.0
Murum,Wheat(Unhusked),2016,3201,3201,0,0.0
Murum,Wheat(Unhusked),2016,3100,3100,0,0.0
Murum,Wheat(Unhusked),2016,3200,3200,0,0.0
Naigaon,Black Gram,2014,5200,5200,0,0.0
Naigaon,Cotton,2014,4050,4050,0,0.0
Naigaon,Pigeon Pea (Tur),2014,4700,4700,0,0.0
Naigaon,Sorgum(Jawar),2014,1200,1200,0,0.0
Naigaon,Wheat(Husked),2014,1375,1375,0,0.0
Naigaon,Black Gram,2015,10000,10000,0,0.0
Naigaon,Cotton,2015,4100,4100,0,0.0
Naigaon,Cotton,2015,3950,3950,0,0.0
Naigaon,Cotton,2015,4250,4250,0,0.0
Naigaon,Pigeon Pea (Tur),2015,9833,9833,0,0.0
Mantha,Mustard,2016,3400,3400,0,0.0
Mantha,Green Gram,2016,5211,5211,0,0.0
Naigaon,Wheat(Husked),2016,1601,1601,0,0.0
Mantha,Green Gram,2016,4901,4901,0,0.0
Mantha,Bajri,2016,1700,1700,0,0.0
Nampur,Sorgum(Jawar),2016,1400,1400,0,0.0
Mantha,Bajri,2016,1600,1600,0,0.0
Nampur,Sorgum(Jawar),2016,1700,1700,0,0.0
Nampur,Sorgum(Jawar),2016,1700,1700,0,0.0
Nampur,Soybean,2016,4000,4000,0,0.0
Nampur,Soybean,2016,3525,3525,0,0.0
Nampur,Soybean,2016,3200,3200,0,0.0
Nampur,Soybean,2016,3100,3100,0,0.0
Telhara,Green Gram,2016,5101,5101,0,0.0
Nampur,Wheat(Husked),2016,1754,1754,0,0.0
Nanded,Black Gram,2014,5400,5400,0,0.0
Nanded,Cotton,2014,4050,4050,0,0.0
Mantha,Bajri,2016,1500,1500,0,0.0
Nanded,Gram,2014,2600,2600,0,0.0
Nampur,Sorgum(Jawar),2016,1036,1036,0,0.0
Nampur,SORGUM(JAWAR),2016,3150,3150,0,0.0
Nampur,Pigeon Pea (Tur),2016,6217,6217,0,0.0
Nampur,Ground Nut Pods (Dry),2016,3575,3575,0,0.0
Nampur,Bajri,2016,1800,1800,0,0.0
Nampur,Black Gram,2016,5400,5400,0,0.0
Mantha,Green Gram,2016,4963,4963,0,0.0
Nampur,Ground Nut Pods (Dry),2016,3200,3200,0,0.0
Tumsar,Gram,2015,4763,4763,0,0.0
Nampur,Ground Nut Pods (Dry),2016,3525,3525,0,0.0
Nampur,Horse Gram,2016,2200,2200,0,0.0
Nampur,Pigeon Pea (Tur),2016,5385,5385,0,0.0
Nampur,Horse Gram,2016,5700,5700,0,0.0
Nampur,Horse Gram,2016,3213,3213,0,0.0
Nampur,Horse Gram,2016,2600,2600,0,0.0
Nampur,Maize,2016,1525,1525,0,0.0
Nampur,Matki,2016,6700,6700,0,0.0
Mantha,Green Gram,2016,5275,5275,0,0.0
Manwat,Soybean,2016,3500,3500,0,0.0
Murum,Wheat(Husked),2016,2496,2496,0,0.0
Murum,Wheat(Husked),2016,2200,2200,0,0.0
Mantha,Sesamum,2016,5000,5000,0,0.0
Murum,Wheat(Husked),2016,2811,2811,0,0.0
Tuljapur,Turmeric,2014,3601,3601,0,0.0
Tuljapur,Wheat(Husked),2014,1400,1400,0,0.0
Tuljapur,Wheat(Husked),2014,1415,1415,0,0.0
Tuljapur,Wheat(Unhusked),2014,2450,2450,0,0.0
Manwat,Gram,2015,4450,4450,0,0.0
Tumsar,Black Gram,2015,5210,5210,0,0.0
Manwat,Ground Nut Pods (Dry),2015,4300,4300,0,0.0
Manwat,Bajri,2016,1784,1784,0,0.0
Tuljapur,Bajri,2015,1600,1600,0,0.0
Tuljapur,Bajri,2015,1400,1400,0,0.0
Tuljapur,Bajri,2015,1350,1350,0,0.0
Manwat,Green Gram,2016,5233,5233,0,0.0
Murum,GREEN GRAM,2016,5228,5228,0,0.0
Murum,Black Gram,2016,8120,8120,0,0.0
Murum,Bajri,2016,1455,1455,0,0.0
Manwat,Safflower,2016,2633,2633,0,0.0
Murum,Bajri,2016,1507,1507,0,0.0
Tuljapur,Black Gram,2015,5000,5000,0,0.0
Tuljapur,Black Gram,2015,5401,5401,0,0.0
Tuljapur,Black Gram,2015,6025,6025,0,0.0
Tuljapur,Black Gram,2015,6011,6011,0,0.0
Tuljapur,Black Gram,2015,5200,5200,0,0.0
Tuljapur,Coriander (Dry),2015,6000,6000,0,0.0
Tuljapur,Coriander (Dry),2015,9500,9500,0,0.0
Murum,Bajri,2016,1501,1501,0,0.0
Manwat,Safflower,2016,2801,2801,0,0.0
Murum,Bajri,2016,1784,1784,0,0.0
Murum,Bajri,2016,1751,1751,0,0.0
Manwat,Bajri,2015,1226,1226,0,0.0
Tuljapur,Sorgum(Jawar),2016,2638,2638,0,0.0
Murum,Maize,2016,1601,1601,0,0.0
Tuljapur,Bajri,2014,1251,1251,0,0.0
Tuljapur,Coriander (Dry),2014,6500,6500,0,0.0
Murum,Sorgum(Jawar),2016,1751,1751,0,0.0
Murum,Sorgum(Jawar),2016,2063,2063,0,0.0
Tuljapur,Bajri,2014,1326,1326,0,0.0
Murum,SORGUM(JAWAR),2016,2600,2600,0,0.0
Murum,Soybean,2016,3227,3227,0,0.0
Murum,Sunflower,2016,3890,3890,0,0.0
Murum,Maize,2016,1464,1464,0,0.0
Murum,Maize,2016,1799,1799,0,0.0
Murum,Sunflower,2016,3750,3750,0,0.0
Murum,Maize,2016,1500,1500,0,0.0
Murum,Maize,2016,1600,1600,0,0.0
Tuljapur,Maize,2014,1150,1150,0,0.0
Murum,Green Gram,2016,5500,5500,0,0.0
Murum,WHEAT(UNHUSKED),2016,2100,2100,0,0.0
Murum,Green Gram,2016,6750,6750,0,0.0
Murum,Green Gram,2016,5499,5499,0,0.0
Tuljapur,Sorgum(Jawar),2014,1425,1425,0,0.0
Murum,Gram,2016,7673,7673,0,0.0
Murum,Wheat(Husked),2016,2400,2400,0,0.0
Tuljapur,Soybean,2014,3285,3285,0,0.0
Murum,Sorgum(Jawar),2016,1801,1801,0,0.0
Ramtek,Ladies Finger,2015,7,6,-1,-14.285714285714286
Ramtek,Lemon,2015,5,4,-1,-20.0
Ramtek,Tomato,2015,13,12,-1,-7.6923076923076925
Ramtek,Onion,2015,12,10,-2,-16.666666666666668
Ramtek,Ladies Finger,2014,9,7,-2,-22.22222222222222
Ramtek,Jambhul,2015,7,5,-2,-28.571428571428573
Ramtek,Brinjal,2014,9,7,-2,-22.22222222222222
Ramtek,Brinjal,2015,10,8,-2,-20.0
Chandur Rly.,Wheat(Husked),2015,1471,1469,-2,-0.13596193065941536
Ramtek,Kharbuj,2015,14,11,-3,-21.428571428571427
Ramtek,Ladies Finger,2014,11,8,-3,-27.272727272727273
Ramtek,Chavli (Shenga ),2014,14,11,-3,-21.428571428571427
Ramtek,Cabbage,2015,17,14,-3,-17.647058823529413
Ramtek,Chavli (Shenga ),2014,12,9,-3,-25.0
Ramtek,Tomato,2014,12,9,-3,-25.0
Ramtek,Brinjal,2014,16,12,-4,-25.0
Ramtek,Cucumber,2014,18,14,-4,-22.22222222222222
Ramtek,Spinach,2015,18,14,-4,-22.22222222222222
Ramtek,Cabbage,2015,20,16,-4,-20.0
Ahmednagar,Coriander  ,2015,5,1,-4,-80.0
Ramtek,Coriander  ,2014,35,30,-5,-14.285714285714286
Ramtek,Spinach,2014,23,18,-5,-21.73913043478261
Ramtek,Lemon,2015,20,15,-5,-25.0
Ramtek,Spinach,2014,32,27,-5,-15.625
Ramtek,Tomato,2014,18,13,-5,-27.77777777777778
Ramtek,Cucumber,2014,20,15,-5,-25.0
Digras,Wheat(Husked),2015,1439,1434,-5,-0.34746351633078526
Ramtek,Bitter Gourd,2014,25,20,-5,-20.0
Ramtek,Coriander  ,2015,23,17,-6,-26.08695652173913
Majalgaon,Cotton,2014,3880,3874,-6,-0.15463917525773196
Ramtek,Coriander  ,2014,32,26,-6,-18.75
Tuljapur,Maize,2015,1184,1178,-6,-0.5067567567567568
Yeotmal,Sorgum(Jawar),2015,1489,1482,-7,-0.47011417058428473
Ramtek,Paddy-Unhusked,2015,2264,2255,-9,-0.39752650176678445
Shahada,Bajri,2015,1350,1341,-9,-0.6666666666666666
Satara,Ladies Finger,2014,2253,2242,-11,-0.4882379050155348
Chopda,Sunflower,2015,2950,2939,-11,-0.3728813559322034
Ramtek,Gram,2015,3688,3675,-13,-0.3524945770065076
Aamgaon,Paddy-Unhusked,2015,1459,1445,-14,-0.9595613433858807
Ramtek,Bitter Gourd,2014,35,20,-15,-42.857142857142854
Roha,Paddy-Unhusked,2015,1408,1392,-16,-1.1363636363636365
Ramtek,Wheat(Husked),2015,1401,1381,-20,-1.4275517487508922
Ramtek,Pigeon Pea (Tur),2014,4100,4080,-20,-0.4878048780487805
Palam,Soybean,2015,3451,3426,-25,-0.7244277021153289
Palam,Soybean,2015,3511,3483,-28,-0.7974935915693535
Mumbai,Potato,2015,1121,1090,-31,-2.7653880463871543
Nanded,Wheat(Husked),2015,1592,1560,-32,-2.0100502512562812
Ramtek,Soybean,2015,2954,2920,-34,-1.1509817197020988
Palam,Wheat(Husked),2015,1851,1817,-34,-1.8368449486763911
Pandharpur,Banana,2015,382,342,-40,-10.471204188481675
Ramtek,Pigeon Pea (Tur),2014,4100,4060,-40,-0.975609756097561
Palam,Soybean,2015,3413,3371,-42,-1.2305889246996777
Palam,Soybean,2015,3150,3100,-50,-1.5873015873015872
Palam,Soybean,2015,3351,3300,-51,-1.521933751119069
Palam,Wheat(Husked),2015,1651,1600,-51,-3.0890369473046637
Palam,Soybean,2015,3349,3290,-59,-1.7617199163929531
Palam,Sorgum(Jawar),2015,1725,1663,-62,-3.5942028985507246
Palam,Soybean,2015,3350,3288,-62,-1.8507462686567164
Palam,Sorgum(Jawar),2015,1734,1667,-67,-3.8638985005767013
Palam,Wheat(Husked),2015,1701,1634,-67,-3.93885949441505
Roha,Paddy-Unhusked,2015,1406,1337,-69,-4.907539118065434
Palam,Wheat(Husked),2015,1720,1650,-70,-4.069767441860465
Pachora,Sorgum(Jawar),2015,1250,1180,-70,-5.6
Ramtek,Wheat(Husked),2015,1537,1467,-70,-4.554326610279766
Shrirampur-Belapur,Wheat(Husked),2015,1325,1253,-72,-5.433962264150943
Ramtek,Wheat(Husked),2014,1428,1355,-73,-5.1120448179271705
Darwha,Soybean,2015,3225,3150,-75,-2.3255813953488373
Palam,Wheat(Husked),2015,2113,2038,-75,-3.549455750118315
Roha,Paddy-Unhusked,2015,1400,1320,-80,-5.714285714285714
Hadgaon,Soybean,2015,3360,3280,-80,-2.380952380952381
Ramtek,Paddy-Unhusked,2014,1770,1687,-83,-4.6892655367231635
Palam,Sorgum(Jawar),2015,1734,1651,-83,-4.786620530565167
Ramtek,Wheat(Husked),2015,1469,1386,-83,-5.650102110279102
Kannad,Onion,2015,667,583,-84,-12.593703148425787
Ramtek,Wheat(Husked),2015,1395,1311,-84,-6.021505376344086
Palam,Soybean,2015,3254,3167,-87,-2.673632452366318
Palam,Wheat(Husked),2015,1794,1701,-93,-5.183946488294314
Ramtek,Paddy-Unhusked,2015,2315,2221,-94,-4.060475161987041
Ramtek,Wheat(Husked),2014,1439,1343,-96,-6.6712995135510775
Ramtek,Wheat(Husked),2015,1357,1258,-99,-7.295504789977892
Ramtek,Mustard,2015,3000,2900,-100,-3.3333333333333335
Ramtek,Pigeon Pea (Tur),2014,3888,3788,-100,-2.57201646090535
Murbad,Ghosali(Bhaji),2015,3500,3400,-100,-2.857142857142857
Palam,Sorgum(Jawar),2015,1726,1626,-100,-5.793742757821553
Darwha,Cotton,2015,3850,3750,-100,-2.5974025974025974
Palam,Pigeon Pea (Tur),2015,4750,4650,-100,-2.1052631578947367
Ghatanji,Soybean,2015,3250,3150,-100,-3.076923076923077
Chimur,Cotton,2015,4200,4100,-100,-2.380952380952381
Palam,Sorgum(Jawar),2015,1834,1734,-100,-5.452562704471101
Palam,Pigeon Pea (Tur),2015,4901,4800,-101,-2.0608039175678434
Ghatanji,Ground Nut Pods (Dry),2015,4825,4721,-104,-2.155440414507772
Ramtek,Wheat(Husked),2015,1426,1321,-105,-7.363253856942497
Digras,Gram,2014,2265,2160,-105,-4.635761589403973
Ramtek,Paddy-Unhusked,2014,1692,1586,-106,-6.264775413711584
Narkhed,Cotton,2015,4159,4052,-107,-2.572733830247656
Ghatanji,Gram,2015,4371,4264,-107,-2.4479524136353237
Ramtek,Linseed,2015,4360,4251,-109,-2.5
Ramtek,Wheat(Husked),2014,1483,1373,-110,-7.4173971679029
Palam,Sorgum(Jawar),2015,1827,1717,-110,-6.0207991242474
Ramtek,Wheat(Husked),2015,1368,1252,-116,-8.47953216374269
Palam,Wheat(Husked),2015,1800,1683,-117,-6.5
Ramtek,Linseed,2015,4280,4160,-120,-2.803738317757009
Ramtek,Pigeon Pea (Tur),2015,6575,6450,-125,-1.9011406844106464
Hadgaon,Gram,2015,4650,4525,-125,-2.6881720430107525
Pathari,Soybean,2015,3083,2954,-129,-4.184236133636069
Ramtek,Gram,2014,2463,2334,-129,-5.237515225334957
Dharmabad,Soybean,2014,3160,3028,-132,-4.177215189873418
Ramtek,Soybean,2014,2943,2801,-142,-4.825008494733265
Ramtek,Other Pulses,2015,1650,1506,-144,-8.727272727272727
Ramtek,Wheat(Husked),2014,1550,1400,-150,-9.67741935483871
Hadgaon,Wheat(Husked),2015,1733,1583,-150,-8.655510675129833
Ghatanji,Cotton,2015,4120,3969,-151,-3.6650485436893203
Palam,Pigeon Pea (Tur),2015,4876,4725,-151,-3.0968006562756356
Ramtek,Gram,2015,3288,3136,-152,-4.622871046228711
Hadgaon,Pigeon Pea (Tur),2015,8688,8525,-163,-1.8761510128913443
Ramtek,Soybean,2015,4617,4450,-167,-3.617067359757418
Pathari,Sorgum(Jawar),2014,2151,1983,-168,-7.810320781032078
Digras,Wheat(Husked),2015,1428,1246,-182,-12.745098039215685
Ashti-Karanja,Soybean,2015,3588,3398,-190,-5.295429208472687
Patur,Soybean,2014,2908,2712,-196,-6.740027510316368
Ramtek,Soybean,2015,3009,2812,-197,-6.547025589896975
Ramtek,Gram,2014,2480,2280,-200,-8.064516129032258
Ramtek,Gram,2014,2700,2500,-200,-7.407407407407407
Ghansawangi,Cotton,2015,3700,3500,-200,-5.405405405405405
Murbad,Brinjal,2015,1200,1000,-200,-16.666666666666668
Murbad,Tomato,2015,2500,2300,-200,-8.0
Ramtek,Gram,2015,4176,3971,-205,-4.909003831417625
Digras,Soybean,2015,2995,2782,-213,-7.111853088480801
Dharmabad,Wheat(Husked),2014,1420,1200,-220,-15.492957746478874
Shahada,Sorgum(Jawar),2015,1779,1555,-224,-12.591343451377178
Digras,Wheat(Husked),2015,1450,1224,-226,-15.586206896551724
Ramtek,Gram,2015,3101,2865,-236,-7.610448242502419
Hadgaon,Pigeon Pea (Tur),2015,9760,9520,-240,-2.459016393442623
Ashti (Jalna),Wheat(Husked),2015,1914,1672,-242,-12.64367816091954
Ramtek,Pigeon Pea (Tur),2015,5057,4810,-247,-4.884318766066838
Shrirampur-Belapur,Maize,2015,1200,940,-260,-21.666666666666668
Digras,Sorgum(Jawar),2014,1398,1133,-265,-18.955650929899857
Ramtek,Soybean,2014,2965,2699,-266,-8.97133220910624
Ramtek,Gram,2015,3488,3214,-274,-7.855504587155964
Ratanagari,French Bean,2015,3000,2725,-275,-9.166666666666666
Ramtek,Pigeon Pea (Tur),2015,5504,5216,-288,-5.232558139534884
Koregaon,Potato,2015,1240,950,-290,-23.387096774193548
Ghatanji,Soybean,2015,3642,3351,-291,-7.990115321252059
Amarawati,Spinach,2014,1015,715,-300,-29.55665024630542
Palam,Pigeon Pea (Tur),2015,8050,7750,-300,-3.7267080745341614
Kurdwadi,Black Gram,2015,8400,8100,-300,-3.5714285714285716
Murbad,Ladies Finger,2015,2500,2200,-300,-12.0
Ramtek,Pigeon Pea (Tur),2015,5446,5143,-303,-5.56371648916636
Dhule,Bajri,2015,1535,1217,-318,-20.71661237785016
Ramtek,Gram,2015,3445,3122,-323,-9.375907111756169
Narkhed,Orange,2015,21111,20778,-333,-1.5773767230353843
Ramtek,Soybean,2014,3087,2753,-334,-10.819565921606738
Gangapur,Green Gram,2015,7361,7018,-343,-4.659692976497759
Ramtek,Gram,2014,2501,2132,-369,-14.754098360655737
Aurangabad,Ladies Finger,2014,3350,2959,-391,-11.671641791044776
Shahada,Wheat(Husked),2014,2067,1671,-396,-19.15820029027576
Vadgaon Peth,Cabbage,2015,1425,1025,-400,-28.07017543859649
Ramtek,Soybean,2015,3157,2751,-406,-12.86031042128603
Ramtek,Gram,2015,4342,3927,-415,-9.55780746199908
Dondaicha,Wheat(Husked),2015,2191,1773,-418,-19.078046554084892
Ramtek,Pigeon Pea (Tur),2015,6674,6243,-431,-6.45789631405454
Ramtek,Pigeon Pea (Tur),2015,6004,5562,-442,-7.361758827448368
Digras,Gram,2015,3900,3447,-453,-11.615384615384615
Gangakhed,Cotton,2014,4050,3576,-474,-11.703703703703704
Dharmabad,Pigeon Pea (Tur),2014,4567,4067,-500,-10.948105977665865
Murbad,Bitter Gourd,2015,5000,4500,-500,-10.0
Dharmabad,Pigeon Pea (Tur),2014,4551,4043,-508,-11.162381894089211
Pandharpur,Potato,2015,1688,1100,-588,-34.834123222748815
Barshi-Vairag,Ground Nut Pods (Dry),2015,4108,3517,-591,-14.386562804284324
Umarga,Sorgum(Jawar),2015,2313,1721,-592,-25.594466061392133
Murbad,Paddy-Unhusked,2015,2220,1614,-606,-27.2972972972973
Solapur,Sorgum(Jawar),2015,2675,2036,-639,-23.88785046728972
Aurangabad,Capsicum,2014,3900,3178,-722,-18.512820512820515
Shahada,Bajri,2014,2034,1302,-732,-35.9882005899705
Pune-Pimpri,Ghevda,2015,4406,3639,-767,-17.40807989105765
Partur,Wheat(Husked),2014,2345,1555,-790,-33.688699360341154
Ramtek,Pigeon Pea (Tur),2015,6566,5776,-790,-12.031678342978983
Pavani,Paddy-Unhusked,2015,2578,1743,-835,-32.38944918541505
Pune,Maize,2014,2534,1548,-986,-38.910812943962114
Dondaicha,Sesamum,2015,6052,5052,-1000,-16.523463317911435
Malegaon (Washim),Soybean,2015,4846,3801,-1045,-21.56417664052827
Patur,Green Gram,2015,7878,6763,-1115,-14.153338410764153
Pathardi,Bajri,2015,2600,1446,-1154,-44.38461538461539
Dharmabad,Green Gram,2014,5934,4775,-1159,-19.531513313110885
Digras,Rice(Paddy-Hus),2014,1200,0,-1200,-100.0
Umarkhed-Danki,Sorgum(Jawar),2015,2700,1500,-1200,-44.44444444444444
Dharmabad,Green Gram,2014,5677,4359,-1318,-23.216487581469085
Digras,Rice(Paddy-Hus),2015,1350,0,-1350,-100.0
Tumsar,Gram,2015,5794,4399,-1395,-24.076630997583706
Umari,Soybean,2015,5058,3656,-1402,-27.718465796757613
Patur,Wheat(Husked),2015,3142,1725,-1417,-45.0986632718014
Chikhali,Soybean,2014,4761,3324,-1437,-30.182734719596723
Narkhed,Orange,2015,21567,20067,-1500,-6.955070246209487
Korpana,Cotton,2015,5655,4045,-1610,-28.470380194518125
Mumbai,Cucumber,2015,2680,1065,-1615,-60.26119402985075
Dharmabad,Black Gram,2014,4934,3319,-1615,-32.73206323469801
Dharmabad,Black Gram,2014,5023,3333,-1690,-33.6452319331077
Loha,Sorgum(Jawar),2014,3286,1333,-1953,-59.43396226415094
Pathardi,Pigeon Pea (Tur),2015,5000,3025,-1975,-39.5
Paithan,Mosambi,2015,4143,1877,-2266,-54.69466570118272
Pathari,Pigeon Pea (Tur),2015,5950,3100,-2850,-47.89915966386555
Pathardi,Cotton,2015,6805,3873,-2932,-43.085966201322556
Patur,Soybean,2015,6522,3337,-3185,-48.83471327813554
Narkhed,Orange,2015,23000,19800,-3200,-13.91304347826087
Parli-Vaijnath,Wheat(Husked),2015,5761,1761,-4000,-69.43239021003298
Loha,Pigeon Pea (Tur),2015,9426,5356,-4070,-43.17844260555909
Pathari,Gram,2015,9815,4387,-5428,-55.303107488537954
Ahmednagar,Garlic,2015,14500,8813,-5687,-39.220689655172414
Digras,Spilt Pigeon Pea,2015,6000,0,-6000,-100.0
Pathari,Sorgum(Jawar),2014,8758,2717,-6041,-68.97693537337291
Pune-Pimpri,Tomato,2015,7892,1783,-6109,-77.40750126710593
Buldhana,Black Gram,2015,9500,1050,-8450,-88.94736842105263
Patur,Green Gram,2014,23500,6833,-16667,-70.92340425531916
Rajura,Green Gram,2015,600018,6251,-593767,-98.95819792072905
Khamgaon,Sunflower,2015,3153038,3065,-3149973,-99.90279216425556
